time,open,high,low,close,EMA,EMA,EMA,EMA,MA,MA,MA,MA,Basis,Upper,Lower,Volume,RSI,RSI-based MA,Upper Bollinger Band,Lower Bollinger Band,Regular Bullish,Regular Bullish Label,Regular Bearish,Regular Bearish Label,Histogram,MACD,Signal,%K,%D,OnBalanceVolume,Accumulation/Distribution,DI+,DI-,ADX,Aroon Up,Aroon Down
1999-03-10,51.125,51.15625,50.28125,51.0625,NaN,NaN,NaN,NaN,NaN,NaN,NaN,NaN,NaN,NaN,NaN,5232202,NaN,NaN,NaN,NaN,NaN,NaN,NaN,NaN,NaN,NaN,NaN,NaN,NaN,NaN,4111015.8571428573,100,0,NaN,NaN,NaN
1999-03-11,51.4375,51.734375,50.3125,51.3125,NaN,NaN,NaN,NaN,NaN,NaN,NaN,NaN,NaN,NaN,NaN,9688602,NaN,NaN,NaN,NaN,NaN,NaN,NaN,NaN,NaN,NaN,NaN,NaN,NaN,9688602,8050337.54945055,98.27539009033671,0,NaN,NaN,NaN
1999-03-12,51.125,51.15625,49.65625,50.0625,NaN,NaN,NaN,NaN,NaN,NaN,NaN,NaN,NaN,NaN,NaN,8743602,NaN,NaN,NaN,NaN,NaN,NaN,NaN,NaN,NaN,NaN,NaN,NaN,NaN,945000,4042853.29945055,94.81853705446936,1.3937329423476745,NaN,NaN,NaN
1999-03-15,50.4375,51.5625,49.90625,51.5,NaN,NaN,NaN,NaN,NaN,NaN,NaN,NaN,NaN,NaN,NaN,6369000,NaN,NaN,NaN,NaN,NaN,NaN,NaN,NaN,NaN,NaN,NaN,NaN,NaN,7314000,9931174.054167531,92.25305913891872,1.3428639834483507,NaN,NaN,NaN
1999-03-16,51.71875,52.15625,51.15625,51.9375,NaN,NaN,NaN,NaN,NaN,NaN,NaN,NaN,NaN,NaN,NaN,4905800,NaN,NaN,NaN,NaN,NaN,NaN,NaN,NaN,NaN,NaN,NaN,NaN,NaN,12219800,12690686.554167531,91.49088883728645,1.311734072677419,NaN,NaN,NaN
1999-03-17,51.9375,52,51.40625,51.5625,NaN,NaN,NaN,NaN,NaN,NaN,NaN,NaN,NaN,NaN,NaN,3965000,NaN,NaN,NaN,NaN,NaN,NaN,NaN,NaN,NaN,NaN,NaN,NaN,NaN,8254800,10812528.65943069,90.15453418553707,1.2925743295362395,NaN,NaN,NaN
1999-03-18,51.5,52.59375,51.484375,52.5625,NaN,NaN,NaN,NaN,NaN,NaN,NaN,NaN,NaN,NaN,NaN,4848400,NaN,NaN,NaN,NaN,NaN,NaN,NaN,NaN,NaN,NaN,NaN,NaN,NaN,13103200,15387779.363656042,89.10860909116943,1.2556698747604667,NaN,NaN,NaN
1999-03-19,53.25,53.25,51.1875,51.21875,NaN,NaN,NaN,NaN,NaN,NaN,NaN,NaN,NaN,NaN,NaN,7160400,NaN,NaN,NaN,NaN,NaN,NaN,NaN,NaN,NaN,NaN,NaN,NaN,NaN,5942800,8444361.18183786,86.01073916505258,1.1877719356577254,NaN,NaN,NaN
1999-03-22,51.4375,51.5625,50.5,50.59375,NaN,NaN,NaN,NaN,NaN,NaN,NaN,NaN,NaN,NaN,NaN,5024800,NaN,NaN,NaN,NaN,NaN,NaN,NaN,NaN,NaN,NaN,NaN,NaN,NaN,918000,4306290.593602566,83.50568665557716,3.037729318219147,NaN,NaN,NaN
1999-03-23,50.3125,50.5,48.71875,48.8125,NaN,NaN,NaN,NaN,NaN,NaN,NaN,NaN,NaN,NaN,NaN,10962398,NaN,NaN,NaN,NaN,NaN,NaN,NaN,NaN,NaN,NaN,NaN,NaN,NaN,-10044398,-5502170.774818487,79.1260253974791,7.860916938637604,NaN,NaN,NaN
1999-03-24,49.25,50.5,48.5,50.46875,NaN,NaN,NaN,NaN,NaN,NaN,NaN,NaN,NaN,NaN,NaN,8447000,NaN,NaN,NaN,NaN,NaN,NaN,NaN,NaN,NaN,NaN,NaN,NaN,NaN,-1597398,2680860.4751815125,74.62977968606276,8.035740245204288,NaN,NaN,NaN
1999-03-25,51.25,52.3125,50.91406,52.3125,NaN,NaN,NaN,NaN,NaN,NaN,NaN,NaN,NaN,NaN,NaN,8133800,NaN,NaN,NaN,NaN,NaN,NaN,NaN,NaN,NaN,NaN,NaN,NaN,NaN,6536402,10814660.475181513,75.89407583422954,7.606619884809261,NaN,NaN,NaN
1999-03-26,51.875,52.46875,51.53125,51.75,NaN,NaN,NaN,NaN,NaN,NaN,NaN,NaN,NaN,NaN,NaN,8256204,NaN,NaN,NaN,NaN,NaN,NaN,NaN,NaN,NaN,NaN,NaN,NaN,NaN,-1719802,6411351.675181513,74.21135376542466,7.390506647220799,NaN,NaN,NaN
1999-03-29,52.375,53.65625,52.0625,53.625,NaN,NaN,NaN,NaN,NaN,NaN,NaN,NaN,NaN,NaN,NaN,5113800,NaN,NaN,NaN,NaN,NaN,NaN,NaN,NaN,NaN,NaN,NaN,99.39393939393939,NaN,3393998,11324610.498710925,73.51342418883512,6.95764868103619,91.77966819339052,NaN,NaN
1999-03-30,53.5625,54,53.03125,53.25,NaN,NaN,NaN,NaN,NaN,NaN,NaN,NaN,NaN,NaN,NaN,4940600,57.383966244725734,NaN,NaN,NaN,NaN,NaN,NaN,NaN,NaN,NaN,NaN,86.36363636363636,NaN,-1546602,8615249.208388343,72.3322705956773,6.741552223321889,90.56171912413852,100,71.42857142857143
1999-03-31,54.125,54.1875,52.3125,52.46875,NaN,NaN,NaN,NaN,NaN,NaN,NaN,NaN,NaN,NaN,NaN,8256602,54.2997542997543,NaN,NaN,NaN,54.2997542997543,NaN,NaN,NaN,NaN,NaN,NaN,69.78021978021978,85.17926517926519,-9803204,1734747.5417216765,67.93433637481289,8.662390240676768,88.94613530642687,100,64.28571428571429
1999-04-01,54,54.0625,52.6875,53.5625,NaN,NaN,NaN,NaN,NaN,NaN,NaN,NaN,NaN,NaN,NaN,8715796,57.72542506228418,NaN,NaN,NaN,NaN,NaN,NaN,NaN,NaN,NaN,NaN,89.01098901098901,81.71828171828172,-1087408,4111782.814448949,64.35265686762084,8.205685910231061,87.53749464269781,92.85714285714286,57.142857142857146
1999-04-05,54.429685,55.578125,54.09375,55.5,NaN,NaN,NaN,NaN,NaN,NaN,NaN,NaN,NaN,NaN,NaN,5697200,63.01436349677461,NaN,NaN,NaN,NaN,NaN,NaN,NaN,NaN,NaN,NaN,98.8962472406181,85.89581867727561,4609792,9209277.551291054,65.07897972331753,7.65593040909736,86.23877282590892,100,50
1999-04-06,55.4375,56.21875,54.96875,55.609375,NaN,NaN,NaN,NaN,NaN,NaN,NaN,NaN,NaN,NaN,NaN,7522400,63.293548893451515,NaN,NaN,NaN,NaN,NaN,63.293548893451515,NaN,NaN,NaN,NaN,92.10526315789474,93.33749980316729,12132192,9397337.551291054,64.48670976974319,7.328040887333222,84.98296966174296,100,42.857142857142854
1999-04-07,56.125,56.25,53.84375,55.03125,NaN,NaN,NaN,52.21015625,NaN,NaN,NaN,52.21015625,52.21015625,55.71920530821653,48.701107191783464,11923602,60.68597685471815,NaN,NaN,NaN,NaN,NaN,NaN,NaN,NaN,NaN,NaN,84.2741935483871,91.7585679823,208590,9242485.57726508,59.22807958814992,10.543006858186576,83.02620006273001,100,35.714285714285715
1999-04-08,54.9375,55.734375,53.8125,55.46875,NaN,NaN,NaN,52.52049851190476,NaN,NaN,NaN,52.43046875,52.43046875,56.169390863954284,48.69154663604572,7952400,61.96307211136767,NaN,NaN,NaN,NaN,NaN,NaN,NaN,NaN,NaN,NaN,89.91935483870968,88.76627051499717,8160990,14996661.187021177,55.346056059271795,9.958554896397159,81.04622496247104,92.85714285714286,28.571428571428573
1999-04-09,55.375,55.9375,55.21875,55.8125,NaN,NaN,NaN,52.834022463151925,NaN,NaN,NaN,52.65546875,52.65546875,56.63223814540367,48.678699354596326,4946800,62.98061867544612,NaN,NaN,NaN,NaN,NaN,NaN,NaN,NaN,NaN,NaN,94.35483870967742,89.51612903225806,13107790,18222835.100064658,54.64945516329646,9.7024319317289,79.08693851715141,85.71428571428571,21.428571428571427
1999-04-12,54.5,55.8125,54.4375,55.4375,NaN,NaN,NaN,53.0819727047565,NaN,NaN,NaN,52.92421875,52.92421875,56.89020296097697,48.95823453902303,10934000,61.06155252365399,NaN,NaN,NaN,NaN,NaN,NaN,NaN,NaN,NaN,NaN,89.51612903225806,91.26344086021506,2173790,23192835.100064658,51.8995043100625,12.073288076842466,76.89229970881824,78.57142857142857,14.285714285714286
1999-04-13,55.78125,55.90625,54.25,54.6875,NaN,NaN,NaN,53.23488006620826,NaN,NaN,NaN,53.08359375,53.08359375,57.06399342126033,49.10319407873967,9962204,57.300933008040886,NaN,NaN,NaN,NaN,NaN,NaN,NaN,NaN,NaN,NaN,79.83870967741936,87.90322580645163,-7788414,18493682.269875977,48.719348185766584,12.027176392252906,75.35486244439015,71.42857142857143,7.142857142857143
1999-04-14,55.375,55.4375,52.50781,52.8125,NaN,NaN,NaN,53.194653393236045,NaN,NaN,NaN,53.12734375,53.12734375,57.07549742994568,49.179190070054325,21253796,49.15108749332411,NaN,NaN,NaN,NaN,NaN,NaN,NaN,NaN,NaN,NaN,35.5783610760241,68.31106659523384,-29042210,1660708.3385863304,43.62696900869679,16.985782317365246,72.74019690792242,64.28571428571429,0
1999-04-15,53,53.617185,51.125,53.53125,NaN,NaN,NaN,53.22671021292785,NaN,NaN,NaN,53.22578125,53.22578125,57.110628553848535,49.34093394615146,17650602,51.971103421056405,NaN,NaN,NaN,NaN,NaN,NaN,NaN,NaN,1.2493751697163162,NaN,46.951219512195124,54.12276342187954,-11391608,18094061.632836167,39.814520021056325,20.35020443241942,69.20955436381668,57.142857142857146,0
1999-04-16,53.40625,53.40625,51.6875,51.96875,NaN,NaN,NaN,53.10690447836329,NaN,NaN,NaN,53.19609375,53.19609375,57.109730203858206,49.2824572961418,17274000,45.99878317846696,NaN,NaN,NaN,NaN,NaN,NaN,NaN,NaN,0.9934514092208389,NaN,16.463414634146343,32.99766507412186,-28665608,6473370.7237452585,37.22293169881195,19.025578337857635,65.67136016846489,50,92.85714285714286
1999-04-19,52.3125,52.75,49.00781,49.53125,NaN,NaN,NaN,52.76636595661441,NaN,NaN,NaN,53.11171875,53.11171875,57.25808004777893,48.96535745222107,19460602,38.55532432642841,56.098964970678075,NaN,NaN,38.55532432642841,NaN,NaN,NaN,NaN,0.5871755124312656,NaN,7.227647990455936,23.54742737893247,-48126210,-7543115.658993185,32.586622764876935,25.574933334194743,60.62477710811809,42.857142857142854,100
1999-04-20,49.3125,51.0625,48.84375,50.65625,NaN,NaN,NaN,52.56540253217494,NaN,NaN,NaN,53.11484375,53.11484375,57.25369684964846,48.975990650351534,17413602,43.12945356594589,55.08078549362237,NaN,NaN,NaN,NaN,NaN,NaN,NaN,0.35192031679919467,NaN,24.47257383966245,16.05454548808824,-30712608,3493674.3410068154,30.185945421529908,24.235551022968487,55.48086220650203,35.714285714285715,100
1999-04-21,51.125,53.1875,50.4375,53.15625,NaN,NaN,NaN,52.62167371958685,NaN,NaN,NaN,53.33203125,53.33203125,56.97067576227644,49.69338673772356,10940398,51.72911924046798,54.897168703673344,NaN,NaN,NaN,NaN,NaN,NaN,NaN,0.36302327957407954,NaN,58.22784810126582,29.9760233104614,-19772210,14185426.931915907,34.401629449384515,22.065739850129003,51.51402100756679,28.571428571428573,92.85714285714286
1999-04-22,53.65625,54.75,53.304685,54.59375,NaN,NaN,NaN,52.80949050819763,NaN,NaN,NaN,53.53828125,53.53828125,56.965858904002786,50.11070359599721,13630602,55.862056295826164,54.764070934640635,NaN,NaN,NaN,NaN,NaN,NaN,NaN,0.4822575292743565,NaN,77.63713080168776,53.445850914205344,-6141608,24868876.840503313,37.7693897071661,20.89800037224896,48.0408687820255,21.428571428571427,85.71428571428571
1999-04-23,54.3125,55.71875,53.75,55.3125,NaN,NaN,NaN,53.04787236455976,NaN,NaN,NaN,53.68828125,53.68828125,57.150556668596586,50.22600583140342,7064400,57.80726384117703,54.39213524495509,NaN,NaN,NaN,NaN,NaN,NaN,NaN,0.6275150465121797,NaN,87.34177215189874,74.40225035161744,922792,29017810.173836645,38.52161227640568,19.523513776129978,44.7395455780872,14.285714285714286,78.57142857142857
1999-04-26,55.6875,57,55.50781,56.585935,NaN,NaN,NaN,53.384830710792166,NaN,NaN,NaN,53.930078,53.930078,57.4911706709557,50.36898532904431,5421000,61.07999509042945,54.23402425902494,NaN,NaN,NaN,NaN,61.07999509042945,NaN,NaN,0.8357541834191693,NaN,94.92334099616858,86.63408131658502,6343792,31430283.96068684,40.66251989618596,18.406048026060322,41.74577570503804,100,71.42857142857143
1999-04-27,57,57.28125,55.00781,55.71875,NaN,NaN,NaN,53.60710873833577,NaN,NaN,NaN,54.034765500000006,54.034765500000006,57.676028757168716,50.393502242831296,16482796,57.79250945059738,54.027348015873464,NaN,NaN,NaN,NaN,NaN,NaN,0.2079058073720993,0.9202030891620367,0.7122972817899375,81.48148148148148,87.91553154318292,-10139004,25256340.614145923,37.54471159399085,18.681086309253182,39.15802402784912,100,64.28571428571429
1999-04-28,55.25,55.4375,53.57031,53.8125,NaN,NaN,NaN,53.62666981087522,NaN,NaN,NaN,54.0628905,54.0628905,57.68812746577326,50.43765353422674,7676800,51.26111780841015,53.26292270851935,NaN,NaN,NaN,NaN,NaN,NaN,0.08921384640512364,0.823814589796342,0.7346007433912184,58.888888888888886,78.43123712217964,-17815804,19571029.634545565,34.82704507282328,22.172055245428,35.77951454436281,92.85714285714286,57.142857142857146
1999-04-29,53.5625,53.875,52.25,53.375,NaN,NaN,NaN,53.602701257458534,NaN,NaN,NaN,54.108203,54.108203,57.674785684956625,50.54162031504338,19148204,49.86815238798674,52.326317973700824,NaN,NaN,NaN,NaN,NaN,NaN,-0.024474155205819526,0.704008049383944,0.7284822045897635,53.7037037037037,64.69135802469135,-36964008,26935723.480699413,32.88795037271869,25.461379131645206,31.699663050271347,85.71428571428571,50
1999-04-30,54.125,54.40625,51.8125,53.71875,NaN,NaN,NaN,53.613753518652956,NaN,NaN,NaN,54.1160155,54.1160155,57.67846469725274,50.553566302747264,15295204,50.99494116066526,51.60727430491591,NaN,NaN,NaN,NaN,NaN,NaN,-0.07915272772236515,0.6295412949368071,0.7086940226591723,57.77777777777778,56.79012345679012,-21668804,34122626.56503676,31.804322613863796,23.23740631152714,28.36462547966865,78.57142857142857,42.857142857142854
1999-05-03,53.5625,53.78125,52.53906,53.4375,NaN,NaN,NaN,53.596967469257436,NaN,NaN,NaN,54.012890500000005,54.012890500000005,57.52821399265427,50.49756700734574,11109796,50.00462585792131,51.0861095084788,NaN,NaN,NaN,NaN,NaN,NaN,-0.13368462697039152,0.5415882389461828,0.6752728659165743,54.44444444444444,55.30864197530864,-32778600,39083617.028041616,30.433310335641096,22.235694382178707,25.161933366120984,71.42857142857143,35.714285714285715
1999-05-04,53.53125,54.375,52.28125,52.59375,NaN,NaN,NaN,53.501422948375776,NaN,NaN,NaN,53.86210925,53.86210925,57.34917086640456,50.37504763359544,15428398,47.052498927859226,50.93621032523131,NaN,NaN,NaN,NaN,NaN,NaN,-0.22085868357792626,0.39919951144416643,0.6200581950220927,44.44444444444444,52.22222222222222,-48206998,28260710.96834012,30.282720006552587,20.6220476629757,23.377992404741523,64.28571428571429,28.571428571428573
1999-05-05,52.625,54.1875,51.03125,54.1875,NaN,NaN,NaN,53.56676361995903,NaN,NaN,NaN,53.819921750000006,53.819921750000006,57.26959961689568,50.37024388310433,12642602,52.729350149905414,50.99037080586338,NaN,NaN,NaN,NaN,NaN,NaN,-0.1678634667685086,0.4102288615614569,0.5780923283299655,63.333333333333336,54.074074074074076,-35564396,40903312.96834012,27.09107055876036,22.62264771737684,21.709178268893112,57.142857142857146,21.428571428571427
1999-05-06,53.6875,54.15625,51.71875,52.21875,NaN,NaN,NaN,53.438381370439124,NaN,NaN,NaN,53.657421750000005,53.657421750000005,57.08724327018873,50.22760022981128,15173398,46.14727067753917,51.000977055797115,NaN,NaN,46.14727067753917,NaN,NaN,NaN,-0.25675879430139603,0.2571438354532205,0.5139026297546165,40,49.25925925925926,-50737794,31954898.763211913,24.882063522638635,20.77799606822934,20.0403641330447,50,14.285714285714286
1999-05-07,52.6875,53.125,51.5625,52.96875,NaN,NaN,NaN,53.393654573254445,NaN,NaN,NaN,53.515234250000006,53.515234250000006,56.8089840618178,50.22148443818221,16430398,48.77078695351668,51.73065295773199,NaN,NaN,NaN,NaN,NaN,NaN,-0.25583884745611146,0.1941040704344772,0.44994291789058866,48.888888888888886,50.74074074074073,-34307396,45099217.16321191,23.571992551944838,20.21052143902938,19.727658210256056,42.857142857142854,7.142857142857143
1999-05-10,53.3125,53.859375,52.6875,53.5,NaN,NaN,NaN,53.40378270913497,NaN,NaN,NaN,53.41835925,53.41835925,56.59204386793265,50.24467463206735,10604204,50.60635090162046,52.26471705313731,NaN,NaN,NaN,NaN,NaN,NaN,-0.21204965725125374,0.18488084632652146,0.3969305035777752,44.74885844748859,44.545915778792484,-23703192,49199509.37654524,25.16671491564723,19.38610810778307,19.87343119640439,35.714285714285715,0
1999-05-11,53.9375,54.625,53.625,54.34375,NaN,NaN,NaN,53.49330340350307,NaN,NaN,NaN,53.40117175,53.40117175,56.55080956613889,50.25153393386112,8800796,53.45862074549491,52.388252874924945,NaN,NaN,NaN,NaN,NaN,NaN,-0.12326003352748455,0.24285546166841954,0.3661154951959041,53,48.87924911212582,-14902396,53049857.62654524,26.902229796226635,18.601641132327646,19.615963363516375,28.571428571428573,0
1999-05-12,54.59375,55.65625,53,55.46875,NaN,NaN,NaN,53.681441174598014,NaN,NaN,NaN,53.53398425,53.53398425,56.7951697415585,50.2727987584415,12507398,57.022205127398024,52.471120648608654,NaN,NaN,NaN,NaN,57.022205127398024,NaN,0.007310143827239157,0.37525317497995303,0.3679430311527139,71,56.24961948249619,-2394998,63791505.320662886,28.0144106906784,16.8662271640504,19.33610141305363,21.428571428571427,64.28571428571429
1999-05-13,55.90625,56,54.1875,54.4375,NaN,NaN,NaN,53.75344677701725,NaN,NaN,NaN,53.579296750000005,53.579296750000005,56.864168827661835,50.294424672338174,9864000,53.01499046697069,52.12881540759391,NaN,NaN,NaN,NaN,NaN,NaN,0.019599359416786477,0.39244223042369697,0.3728428710069105,54.5,59.5,-12258998,56648608.76893875,27.43385517086197,15.784130073015948,18.92366260288076,14.285714285714286,57.142857142857146
1999-05-14,53.375,54,53,53.40625,NaN,NaN,NaN,53.72038041730132,NaN,NaN,NaN,53.65117175,53.65117175,56.853817121072346,50.44852637892766,12205398,49.28507727257432,51.28632127774712,NaN,NaN,NaN,NaN,NaN,NaN,-0.042936532237889236,0.31917220570954896,0.3621087379474382,38,54.5,-24464396,54360096.64393875,26.00863996121541,19.255730642759975,17.297932192770837,7.142857142857143,50
1999-05-17,52.9375,54.53125,52.41406,54.367185,NaN,NaN,NaN,53.78198085374881,NaN,NaN,NaN,53.892968499999995,53.892968499999995,56.487358341412346,51.298578658587644,9906796,52.62951131781659,50.91753569683421,NaN,NaN,NaN,NaN,NaN,NaN,-0.02185866309909612,0.334785409073568,0.35664407217266414,67.1383144654088,53.2127714884696,-14557600,62731500.463038586,24.02866409291005,19.896697153820725,15.57343376976298,0,42.857142857142854
1999-05-18,54.3125,54.625,53.5,54.125,NaN,NaN,NaN,53.81464934386798,NaN,NaN,NaN,54.06640599999999,54.06640599999999,56.19385394938658,51.93895805061341,9267796,51.704068690033274,50.949175045521564,NaN,NaN,NaN,NaN,NaN,NaN,-0.026208732670022994,0.3238831563351354,0.3500918890051584,62.264150943396224,55.80082180293501,-23825396,63761255.5741497,23.373467924676596,19.066116394779982,14.712525598032332,78.57142857142857,35.714285714285715
1999-05-19,54.34375,54.90625,53.5,54.875,NaN,NaN,53.2062499,53.915635120642456,NaN,NaN,53.2062499,54.15234349999999,54.15234349999999,56.26458918273287,52.04009781726712,7985600,54.37941331880877,51.27140796915172,NaN,NaN,NaN,NaN,NaN,NaN,0.017110160010058384,0.37147958901773137,0.354369429007673,77.35849056603773,68.92031865828092,-15839796,71391940.01859415,23.19398292328024,18.051705704016356,14.693929518831927,71.42857142857143,28.571428571428573
1999-05-20,54.992185,54.992185,53.28125,53.367185,NaN,NaN,53.21256108039216,53.86340177581936,NaN,NaN,53.2523436,54.09101525,54.09101525,56.21959788678111,51.96243261321889,5997200,48.55592868994544,51.09719279267173,NaN,NaN,NaN,NaN,NaN,NaN,-0.056091289355729324,0.28425531731301135,0.34034660666874067,47.012528301886775,62.211723270440245,-21836996,65997181.82029906,21.68245657712304,17.70850679972349,14.30279224557088,64.28571428571429,21.428571428571427
1999-05-21,53.53125,53.6875,52.59375,52.875,NaN,NaN,53.19932339096502,53.769268273360375,NaN,NaN,53.2835936,53.969140249999995,53.969140249999995,56.08309001237809,51.8551904876219,10471602,46.794331296839616,50.86788603830875,NaN,NaN,NaN,NaN,NaN,NaN,-0.13354511350862758,0.17341521478295618,0.30696032829158376,37.106918238993714,53.82597903563941,-32308598,60910975.13458477,20.751439072054225,19.647132635312087,13.386301230465927,57.142857142857146,14.285714285714286
1999-05-24,52.96875,53.0625,51.1875,51.53125,NaN,NaN,53.13390874818208,53.55612367589748,NaN,NaN,53.312968600000005,53.71640599999999,53.71640599999999,55.72449564313082,51.70831635686916,9569796,42.28393616969149,50.52727441272534,NaN,NaN,NaN,NaN,NaN,NaN,-0.26364449890923214,-0.022595295344956412,0.24104920356427573,10.062893081761006,31.394113207547164,-41878394,54850104.33458477,19.22726437144233,23.712751397974195,12.776873000297565,50,7.142857142857143
1999-05-25,51.46875,52.21875,49.625,49.84375,NaN,NaN,53.00488291492004,53.20256427819296,NaN,NaN,53.27984360000001,53.422656,53.422656,55.848534060588534,50.99677793941147,17771204,37.40762444322183,49.43286543367651,NaN,NaN,37.40762444322183,NaN,NaN,NaN,-0.44125750021865623,-0.3105226717090446,0.13073482850961166,3.4313725490196076,16.867061289924774,-59649598,40076452.81651248,17.330910298211705,27.315470076165333,13.732254392977513,42.857142857142854,100
1999-05-26,50.5,51.4375,48.9375,51.234375,NaN,NaN,52.935451231982,53.01511768026982,NaN,NaN,53.265781100000005,53.29374975,53.29374975,55.89100525491562,50.69649424508439,26772000,43.21889173825772,49.22369550944212,NaN,NaN,NaN,NaN,NaN,NaN,-0.4418958869288603,-0.42163503015146375,0.020260856777396558,32.52212389380531,15.338796508195307,-32877598,62498002.81651248,15.721413558955078,27.33260710506899,15.016581918462828,35.714285714285715,100
1999-05-27,51.03125,51.929685,50.375,51.1875,NaN,NaN,52.866904124845455,52.84105885357745,NaN,NaN,53.258281100000005,53.18437475,53.18437475,55.93824872615866,50.430500773841345,23334796,43.07372144845982,48.816762259080924,NaN,NaN,NaN,NaN,NaN,NaN,-0.4223072701153047,-0.5076232308667343,-0.08531596075142962,31.858407079646017,22.603967840823643,-56212394,63553384.569562145,16.654564262386586,25.732192168765245,15.997905661569103,28.571428571428573,92.85714285714286
1999-05-28,51.5,52.3125,50.84375,52.03125,NaN,NaN,52.83413337485152,52.763934200855786,NaN,NaN,53.2476561,53.099999750000016,53.099999750000016,55.88642636312129,50.313573136878745,12969796,46.553717935491555,48.52728847578601,NaN,NaN,NaN,NaN,NaN,NaN,-0.33326749648707077,-0.5019003313602681,-0.16863283487319733,43.80530973451327,36.06194690265486,-43242598,71556024.65466852,17.18358759460322,24.28546035338737,16.294405169582614,21.428571428571427,85.71428571428571
1999-06-01,51.9375,52.1875,50.59375,50.875,NaN,NaN,52.75730461505342,52.58403570553619,NaN,NaN,53.24078110000001,52.97187475000002,52.97187475000002,55.915656790429814,50.028092709570224,6960200,42.70132964874751,47.75891054030405,NaN,NaN,NaN,NaN,NaN,NaN,-0.33224043892249394,-0.5839333835263147,-0.2516929446038208,27.43362831858407,34.365781710914455,-50202798,67052365.83113911,16.124219361948786,23.75532051738217,16.358253672016918,14.285714285714286,78.57142857142857
1999-06-02,50.84375,52,49.57031,51.734375,NaN,NaN,52.71718972818858,52.503115638342265,NaN,NaN,53.26359360000001,52.92890600000002,52.92890600000002,55.918245878399745,49.93956612160029,11996602,46.26077811599401,46.99023718234662,NaN,NaN,NaN,NaN,NaN,NaN,-0.25704216495351234,-0.5729956507957112,-0.3159534858421989,39.60176991150443,36.94690265486725,-38206196,76425919.28893825,14.642197169478887,25.44347611937251,16.508671999122257,7.142857142857143,71.42857142857143
1999-06-03,52.125,52.125,50.6875,51,NaN,NaN,52.64984895453412,52.35996176802396,NaN,NaN,53.3073436,52.769531000000015,52.769531000000015,55.81286391739388,49.72619808260615,11147796,43.75912741159178,46.329104106962404,NaN,NaN,NaN,NaN,NaN,NaN,-0.2404203778793899,-0.6164789581914363,-0.37605858031204636,34.06453019438666,33.69997614149172,-49353992,70124991.1150252,14.313219824841141,24.035881084214026,16.394193559346657,0,64.28571428571429
1999-06-04,51.375,52.742185,51.375,52.5625,NaN,NaN,52.646423505336706,52.379251123450246,NaN,NaN,53.3492186,52.78671850000002,52.78671850000002,55.82128503090096,49.75215196909908,12987204,49.95955609190334,46.37728116548591,NaN,NaN,NaN,NaN,NaN,NaN,-0.1142553762660452,-0.5188778006446029,-0.40462242437855767,59.87099246286141,44.51243085625083,-36366788,79698457.03167878,15.735017873094892,22.417226222022865,16.579605659679938,28.571428571428573,57.142857142857146
1999-06-07,52.929685,53.992185,52.8125,53.65625,NaN,NaN,52.68602454434311,52.50087006407403,NaN,NaN,53.376093600000004,52.8210935,52.8210935,55.87861821461384,49.76356878538617,11491796,53.79928926808288,46.46083673336208,NaN,NaN,NaN,NaN,53.79928926808288,NaN,0.044301293352883964,-0.3492458076874527,-0.3935471010403367,77.93551605079374,57.29034623601393,-24874992,84645291.47116052,19.762354237950923,21.158011391750474,16.1513110423608,21.428571428571427,50
1999-06-08,53.78125,54.03125,52.03906,52.3125,NaN,NaN,52.671376522996326,52.48293005797174,NaN,NaN,53.3873436,52.76171850000001,52.76171850000001,55.81030940080521,49.713127599194806,8134800,48.8408168068035,46.2563187417028,NaN,NaN,NaN,NaN,NaN,NaN,0.05919210315858253,-0.31955697209210854,-0.37874907525069107,55.74195849990545,64.51615567118687,-33009792,78743591.43853311,18.226022716766266,22.531340185990675,16.180876402957583,14.285714285714286,42.857142857142854
1999-06-09,52.5,53.335935,52.46875,53.1875,NaN,NaN,52.691616659349414,52.55003195721253,NaN,NaN,53.3785936,52.703906,52.703906,55.67311979890359,49.734692201096415,8384398,51.9465906788525,46.082545695991634,NaN,NaN,NaN,NaN,NaN,NaN,0.12471586526666772,-0.2228542436673564,-0.3475701089340241,70.1935773702513,67.9570173069835,-24625394,84257695.05583508,17.474461675004246,21.602246781158023,16.044866256827618,7.142857142857143,35.714285714285715
1999-06-10,52.625,52.9375,51.94531,52.578125,NaN,NaN,52.68716600604159,52.55270748509705,NaN,NaN,53.36515610000001,52.55937475,52.55937475,55.24395388979462,49.87479561020539,9392398,49.68440829768866,46.163151382259,NaN,NaN,NaN,NaN,NaN,NaN,0.12352691965829937,-0.19316145936114992,-0.3166883790194493,71.47239263803681,65.80264283606452,-34017792,86846168.34131469,16.58076652030622,22.652529963819802,16.429692421214742,0,28.571428571428573
1999-06-11,52.9375,52.992185,51.3125,51.78125,NaN,NaN,52.65163988815761,52.47923534365924,NaN,NaN,53.351406100000005,52.42656225,52.42656225,54.9862562261561,49.866868273843906,16567602,46.81342145557229,46.164514965025624,NaN,NaN,NaN,NaN,NaN,NaN,0.06833871298395844,-0.23126498778950122,-0.29960370077345966,55.828220858895705,65.83139695572794,-50585394,79525613.77878064,15.431506196128773,23.693733576344496,17.742825009859228,78.57142857142857,21.428571428571427
1999-06-14,51.96875,51.96875,50.6875,50.804685,NaN,NaN,52.57921028470045,52.319754358548835,NaN,NaN,53.2962498,52.296484,52.296484,54.907708117611165,49.685259882388834,14136796,43.496316617444386,46.251113568436544,NaN,NaN,43.496316617444386,NaN,NaN,NaN,-0.02942528116072396,-0.3363853022243646,-0.3069600210636406,36.65639263803679,54.6523353783231,-64722190,67974761.87908891,14.600195806867905,25.045181656522548,18.878546439386643,71.42857142857143,14.285714285714286
1999-06-15,50.929685,51.867185,50.78125,51.5625,NaN,NaN,52.53933929314357,52.2476348958299,NaN,NaN,53.2174998,52.15624974999999,52.15624974999999,54.60370042142829,49.708799078571694,9147796,46.65515905738429,46.91165175516243,NaN,NaN,NaN,NaN,NaN,NaN,-0.0379988580013767,-0.35445859356536147,-0.31645973556398477,51.533742331288344,48.00611860940695,-55574394,71989292.58372593,13.915934620536413,23.871399747096483,19.163002734519605,64.28571428571429,7.142857142857143
1999-06-16,52.84375,54.210935,52.78125,54.210935,NaN,NaN,52.60489206596147,52.434615858131814,NaN,NaN,53.189530999999995,52.16054649999999,52.16054649999999,54.62206873771684,49.69902426228314,15060204,55.92821094434292,47.81946026988281,NaN,NaN,NaN,NaN,NaN,NaN,0.13052139053447992,-0.15330799739588485,-0.2838293879303648,100,62.730044989775045,-40514190,87049496.58372593,22.090006355239954,21.255051454045567,17.374245805964886,100,0
1999-06-17,53.5,55.0625,53.5,54.8125,NaN,NaN,52.69146492611985,52.66108101450021,NaN,NaN,53.185156,52.157421499999984,52.157421499999984,54.60527210344291,49.70957089655706,16278204,57.725772894801274,48.86603537319291,NaN,NaN,NaN,NaN,NaN,NaN,0.2702825618548024,0.05402381438813819,-0.21625874746666418,95.44808173060291,82.32727468729708,-24235986,98118675.30372593,24.1999856353714,19.871296268626548,16.546090748422134,100,21.428571428571427
1999-06-18,54.3125,55.21875,54.21875,55.0625,NaN,NaN,52.78444669372299,52.88978758454781,NaN,NaN,53.177031,52.242187249999986,52.242187249999986,54.95482845744502,49.529546042554955,5392800,58.483625483956814,49.718171626654716,NaN,NaN,NaN,NaN,NaN,NaN,0.36163950357626773,0.23579063200367045,-0.12584887157259725,97.2337494954359,97.56061040867961,-18843186,101826225.30372593,23.831744199814935,19.017949688762574,16.125263638703515,100,14.285714285714286
1999-06-21,55.4375,56.742185,55.34375,56.710935,NaN,NaN,52.93842662730248,53.253706386019445,NaN,NaN,53.1949997,52.433983999999974,52.433983999999974,55.76941939023076,49.09854860976919,10565204,63.171821903755664,51.18034964486958,NaN,NaN,NaN,NaN,63.171821903755664,NaN,0.5062891352057566,0.5070125474345986,0.0007234122288419242,99.56427015250544,97.41536712618142,-8277982,111919240.57132149,28.651517082324823,17.64711379564626,16.456187452617044,100,7.142857142857143
1999-06-22,56.375,57.09375,55,55,NaN,NaN,53.01927264191807,53.4200200635414,NaN,NaN,53.1862497,52.60742149999997,52.60742149999997,56.09435552063772,49.120487479362225,10862796,56.09183589294749,51.88256805750911,NaN,NaN,NaN,NaN,NaN,NaN,0.4612177390563844,0.5772455860493224,0.11602784699293801,67.3170731707317,88.03836427289103,-19140778,101056444.57132149,27.605138655720733,16.090198978838586,16.413851973781302,100,0
1999-06-23,55.00781,56,54.65625,55.867185,NaN,NaN,53.13095547948991,53.65308339082317,NaN,NaN,53.2098434,52.90859324999998,52.90859324999998,56.429037363388204,49.38814913661176,9607000,58.62305834534248,52.94427740991988,NaN,NaN,NaN,NaN,NaN,NaN,0.4630739821849409,0.6948703247241141,0.23179634253917325,80.85361951219511,82.57832094514409,-9533778,108764350.68480985,26.018590468533176,16.635685838472302,16.174175906684656,92.85714285714286,0
1999-06-24,55.84375,55.875,54.5,54.75781,NaN,NaN,53.1947536959805,53.75829544884001,NaN,NaN,53.248749600000004,53.08476499999998,53.08476499999998,56.60509168675317,49.5644383132468,14988796,54.30971656002159,53.2550031576426,NaN,NaN,NaN,NaN,NaN,NaN,0.36705137227027923,0.6906105578770223,0.32355918560674307,63.536546341463406,70.56907967479674,-24522574,99396298.6800971,24.46889421877985,16.32167669529646,16.349797219024477,85.71428571428571,42.857142857142854
1999-06-25,55.125,55.5625,54.1875,54.6875,NaN,NaN,53.25329276672637,53.84679112037906,NaN,NaN,53.271874600000004,53.25976499999998,53.25976499999998,56.733096107376205,49.786433892623755,8635602,54.038340948810486,53.27207827769457,NaN,NaN,54.038340948810486,NaN,NaN,NaN,0.28018797390862793,0.673794152992528,0.39360617908390005,62.4390243902439,68.94306341463414,-33158176,97041134.49827892,22.993996317919223,16.707783237621204,17.237148201286434,78.57142857142857,35.714285714285715
1999-06-28,55.15625,56.0625,54.703125,55.984375,NaN,NaN,53.36039403077631,54.05037053748582,NaN,NaN,53.3521871,53.45742124999998,53.45742124999998,57.07551565426658,49.83932684573338,7666200,58.188412977331254,53.93976371844656,NaN,NaN,NaN,NaN,NaN,NaN,0.2902308624198808,0.756394757108751,0.46616389468887026,82.6829268292683,69.55283252032521,-25491976,103826162.08448581,23.808959231659752,15.689339684697066,17.950976524498245,71.42857142857143,28.571428571428573
1999-06-29,55.9375,56.96875,55.65625,56.75,NaN,NaN,53.493319755059595,54.30747810534431,NaN,NaN,53.4965621,53.751171249999985,53.751171249999985,57.43626092742756,50.06608157257241,9000398,60.458367735601094,54.54774779392859,NaN,NaN,NaN,NaN,NaN,NaN,0.325921640599215,0.873565945437889,0.547644304838674,94.63414634146342,79.91869918699189,-16491578,109826427.41781914,26.47651982151344,14.764195916203713,19.225020591028727,64.28571428571429,21.428571428571427
1999-06-30,56.804685,59.9375,56.13281,57.625,NaN,NaN,53.655346431331765,54.62343257150199,NaN,NaN,53.6359371,54.04570249999998,54.04570249999998,57.972623395032215,50.11878160496775,19467602,62.93499817035774,55.49421849911925,NaN,NaN,NaN,NaN,NaN,NaN,0.3820542652058886,1.0252121363460347,0.6431578711401461,75,84.10569105691057,2976024,105629116.0477417,34.490989017440775,12.468905944507904,21.469268067910228,100,14.285714285714286
1999-07-01,57.8125,58.34375,56.8125,58.015625,NaN,NaN,53.826337747750124,54.94649851707323,NaN,NaN,53.733124600000004,54.39648374999998,54.39648374999998,58.42454953421145,50.36841796578851,6822600,64.01848278753823,56.72315145140254,NaN,NaN,NaN,NaN,NaN,NaN,0.416274418328488,1.163500894050756,0.7472264757222681,79.22297297297297,82.95237310481214,9798624,109527744.61917026,32.31365361938967,11.681773100209972,23.310562862378276,92.85714285714286,7.142857142857143
1999-07-02,58,58.8125,58,58.75,NaN,NaN,54.019422541956004,55.30873675354245,NaN,NaN,53.8162496,54.70585874999998,54.70585874999998,59.060211040316545,50.35150645968342,3302000,66.0290078336979,58.33262939542065,NaN,NaN,NaN,NaN,NaN,NaN,0.45595493020146316,1.317170138474097,0.8612152082726339,87.03071672354949,80.41789656550749,13100624,112321744.61917026,33.19726212629218,11.275048848506437,24.949708259234615,85.71428571428571,0
1999-07-06,59.0625,59.65625,58.0625,58.375,NaN,NaN,54.19022950109498,55.60076182463364,NaN,NaN,53.8774996,54.94179624999998,54.94179624999998,59.547217148184615,50.33637535181535,8794796,64.06058241034134,59.57587392063187,NaN,NaN,NaN,NaN,NaN,NaN,0.42514083683928905,1.3926412543217452,0.9675004174824562,78.16593886462883,81.47320952038376,4305828,106975888.2270134,34.54990911962692,10.502600150711082,26.880432836480527,78.57142857142857,0
1999-07-07,58.34375,58.71875,57.9375,58.46875,NaN,NaN,54.3580146186991,55.87390355562091,NaN,NaN,53.9151559,55.24960874999998,55.24960874999998,59.93321295036592,50.56600454963404,10520000,64.34674187162344,60.177197558294765,NaN,NaN,NaN,NaN,NaN,NaN,0.3807029642653097,1.4433791228140933,1.0626761585487836,77.18446601941747,80.79370720253193,14825828,110763088.2270134,33.34397629168624,10.694481840576586,30.416495165257658,71.42857142857143,0
1999-07-08,58.46875,59.492185,58.1875,59.25,NaN,NaN,54.54985718267169,56.195436550323684,NaN,NaN,53.9857809,55.55273374999998,55.55273374999998,60.44341639912322,50.66205110087674,11225000,66.72448685174939,60.81996284093391,NaN,NaN,NaN,NaN,NaN,NaN,0.3730624223390684,1.5290041864726192,1.1559417641335508,88.04347826086956,81.13129438163863,26050828,117820757.99021295,34.87598754238518,10.06280413353976,33.65888749378828,64.28571428571429,0
1999-07-09,59.46875,59.90625,59.03125,59.84375,NaN,NaN,54.75746082256691,56.54289497410238,NaN,NaN,54.1064059,55.91601499999998,55.91601499999998,60.94630210477508,50.88572789522488,4191200,68.44678352477155,61.531616986706396,NaN,NaN,NaN,NaN,NaN,NaN,0.3760701675241369,1.626029473538722,1.249959306014585,98.3695652173913,87.86583649922612,30242028,121413215.1330701,35.38520154301651,9.651086854502138,36.93793769805249,57.142857142857146,35.714285714285715
1999-07-12,60.0625,60.375,59.1875,59.53125,NaN,NaN,54.944668241289776,56.827500214664056,NaN,NaN,54.2295309,56.30351499999998,56.30351499999998,61.192062008720086,51.41496799127988,7816200,66.49599683207416,61.76905805301486,NaN,NaN,NaN,NaN,NaN,NaN,0.3269024839885928,1.658587411000326,1.3316849270117332,86.36363636363636,90.92555994729908,22425828,118122183.55412273,35.61589176222345,9.106529980201792,39.47415302523988,100,28.571428571428573
1999-07-13,59.25,59.46875,58.78125,59.25,NaN,NaN,55.11350478084704,57.05821447993414,NaN,NaN,54.340155900000006,56.72578074999998,56.72578074999998,61.070154916579185,52.38140658342077,6230000,64.70850006171885,62.38453406506996,NaN,NaN,NaN,NaN,NaN,NaN,0.2488589288613945,1.6427585880884763,1.3938996592270818,81.81818181818181,88.85046113306983,16195828,120387638.09957728,34.29955259336058,10.771922026839277,41.32043329862675,92.85714285714286,21.428571428571427
1999-07-14,59.84375,60.375,59,60.25781,NaN,NaN,55.31524224042166,57.36293786279756,NaN,NaN,54.47656210000001,57.16054624999998,57.16054624999998,61.06959411913423,53.25149838086573,6909400,68.02535384954216,63.056126601084216,NaN,NaN,NaN,NaN,NaN,NaN,0.238505306842705,1.692031292780463,1.453525985937758,98.10602020202019,88.76261279461278,23105228,126119274.33812273,36.449264597759054,10.039341567730926,43.806996337476285,85.71428571428571,14.285714285714286
1999-07-15,60.46875,60.8125,60.13281,60.8125,NaN,NaN,55.5308209760914,57.691467590150175,NaN,NaN,54.64093710000001,57.49062449999998,57.49062449999998,61.46204245482347,53.519206545176495,6539800,69.712585701163,64.15633153973718,NaN,NaN,NaN,NaN,NaN,NaN,0.24166051583125703,1.7556016307268294,1.5139411148955724,100,93.30806734006734,29645028,132659074.33812273,37.42470105558715,9.688577566787659,46.58541434659987,100,7.142857142857143
1999-07-16,60.84375,61.71875,60.82031,61.375,NaN,NaN,55.760004467225066,58.04228020061206,NaN,NaN,54.78468710000001,57.81874949999998,57.81874949999998,61.93271364020521,53.704785359794755,4913800,71.36285783966892,65.39379703194136,NaN,NaN,NaN,NaN,71.36285783966892,NaN,0.2530650198726283,1.8302723897363578,1.5772073698637294,95.10022271714922,97.73541430638981,34558828,133812759.58365944,40.41404254286648,9.225735720856562,49.942248834782866,100,0
1999-07-19,61.625,61.625,60.50781,60.75,NaN,NaN,55.95569056654957,58.30015827674425,NaN,NaN,54.95531210000001,58.10312449999998,58.10312449999998,62.20193994130706,54.0043090586929,6833000,66.99491087156451,66.02283259581516,NaN,NaN,NaN,NaN,NaN,NaN,0.19268191713724647,1.8180597662852875,1.625377849148041,84.02061855670104,93.04028042461675,27725828,129942342.9759204,38.00378655678134,10.343743457853769,52.56039076351669,92.85714285714286,0
1999-07-20,60.00781,60.09375,58.25,58.40625,NaN,NaN,56.0517909364888,58.31026225038765,NaN,NaN,55.06406210000001,58.187890249999974,58.187890249999974,62.23786380366376,54.13791669633619,14837398,53.71692461300933,65.54130094420147,NaN,NaN,NaN,NaN,NaN,NaN,-0.01965665549632556,1.6008070297776342,1.6204636852739598,40.699327239461944,73.2733895044374,12888430,117619758.19625938,33.22811709397336,20.39284397207506,52.24161502036441,85.71428571428571,0
1999-07-21,58.53125,59.19531,58.0625,58.6875,NaN,NaN,56.15515207623434,58.34618965511264,NaN,NaN,55.16781210000001,58.37226524999998,58.37226524999998,62.151643817188415,54.59288668281154,10980398,54.872757707719764,64.96542662544161,NaN,NaN,NaN,NaN,NaN,NaN,-0.14854066492974205,1.4347878541117822,1.5833285190415243,38.21656050955414,54.312168768572384,23868828,118755688.17712113,31.308263465771567,20.1709139210696,50.43726909557993,78.57142857142857,0
1999-07-22,58.6875,58.6875,57.03125,57.19531,NaN,NaN,56.19594258304868,58.23658206891143,NaN,NaN,55.22484330000001,58.43867149999998,58.43867149999998,62.08394549714775,54.7933975028522,15148398,48.02074599937637,63.8227311405729,NaN,NaN,NaN,NaN,NaN,NaN,-0.33119890168637345,1.1693298919335575,1.500528793619931,3.49994666666665,27.47194480522759,8720430,106608342.16308942,28.69754173941122,23.680968975613514,47.77169967584706,71.42857142857143,0
1999-07-23,57.625,57.867185,56.6875,57.28125,NaN,NaN,56.23850365822324,58.14559806234844,NaN,NaN,55.26109330000001,58.564843499999974,58.564843499999974,61.84851852186802,55.281168478131924,12115000,48.42022746965778,62.56496111457004,NaN,NaN,NaN,NaN,NaN,NaN,-0.43651909665792,0.9548799227975309,1.3913990194554509,11.801242236024844,17.839249804081888,20835430,106688599.7954235,26.97232061833894,24.009099611405617,44.66586268443801,64.28571428571429,100
1999-07-26,56.5,57.125,55.78125,55.875,NaN,NaN,56.22424861280272,57.929350627839064,NaN,NaN,55.28984330000002,58.62421849999997,58.62421849999997,61.658804661940806,55.58963233805913,10720000,42.64479514399417,61.03526202411667,NaN,NaN,42.64479514399417,NaN,NaN,NaN,-0.5820774111237104,0.663802255550813,1.2458796666745233,1.5789473684210527,5.626712090370858,10115430,97464413.74891186,24.920817244145052,26.77824386550717,41.10990450394446,57.142857142857146,100
1999-07-27,57,57.875,56.515625,57,NaN,NaN,56.25467023583006,57.84084104423534,NaN,NaN,55.36171830000002,58.67499974999997,58.67499974999997,61.561565293875006,55.78843420612493,13732796,47.98949604376785,59.86688732212699,NaN,NaN,NaN,NaN,NaN,NaN,-0.582360658278001,0.517928843827022,1.100289502105023,20.526315789473685,11.30216846463986,23848226,93518208.00178543,26.159370034688667,24.14164423028491,37.7227710758443,50,92.85714285714286
1999-07-28,57.6875,58.4375,56.94531,58.117185,NaN,NaN,56.32771003050339,57.86715951621293,NaN,NaN,55.436718300000024,58.74335899999998,58.74335899999998,61.50645062758023,55.980267372419725,10161796,52.70297578653184,58.86535081746859,NaN,NaN,NaN,NaN,NaN,NaN,-0.49074487670639155,0.4868584062220336,0.9776032829284251,39.34206315789472,20.48244210526315,34010022,99317321.38664928,27.00516226695054,22.3717743499127,34.44907092274501,42.857142857142854,85.71428571428571
1999-07-29,57.03125,57.5,56.3125,56.875,NaN,NaN,56.349172382248355,57.77266813371646,NaN,NaN,55.491718300000024,58.705858999999975,58.705858999999975,61.54787554506178,55.86384245493817,13033796,47.543692664947365,57.37227289890972,NaN,NaN,NaN,NaN,NaN,NaN,-0.4957821896073009,0.35787554591929904,0.8536577355266,18.42105263157895,26.09647719298245,20976226,98631332.12349139,24.651323552075343,23.478134721824897,30.54169424468164,35.714285714285715,78.57142857142857
1999-07-30,57.125,57.75,56.50781,56.59375,NaN,54.3661716,56.35876366137587,57.66039021621965,NaN,54.3661716,55.52609330000002,58.63476524999997,58.63476524999997,61.61029159803935,55.65923890196059,10947398,46.435300573799694,55.9393660233187,NaN,NaN,NaN,NaN,NaN,NaN,-0.49868111069878596,0.23030634715311749,0.7289874578519034,13.68421052631579,23.81577543859649,10028828,89198709.45435062,24.37667037470984,22.053268229159816,26.66517826639097,28.571428571428573,71.42857142857143
1999-08-02,56.6875,57.8125,56.21875,56.4375,NaN,54.4071880039604,56.361851360929755,57.54392448134159,NaN,54.419921599999995,55.58749960000003,58.51914024999998,58.51914024999998,61.643755360957336,55.39452513904262,9642398,45.79652948051208,54.58851098180393,NaN,NaN,NaN,NaN,NaN,NaN,-0.49097395989649284,0.11527000798128739,0.6062439678777802,11.052631578947368,14.385964912280704,386430,82203244.23866434,22.49071786184364,21.75028546338392,23.056101269176953,21.428571428571427,64.28571428571429
1999-08-03,57.210935,57.21875,55.25,56.07031,NaN,54.440121112792866,56.350418366383494,57.40358024502334,NaN,54.4674997,55.65140580000003,58.40390574999998,58.40390574999998,61.70622346154605,55.101588038453905,13005000,44.25581268721621,52.89068661306636,NaN,NaN,NaN,NaN,NaN,NaN,-0.4893658193227278,-0.00546330627562952,0.4839025130470983,12.681120772946848,12.472654292736669,-12618570,80035711.2100929,20.39192468482583,24.31243575158187,19.62470194312019,14.285714285714286,100
1999-08-04,56.07031,56.492185,55.00781,55.054685,NaN,54.45229069471776,56.29960529319198,57.1798759359735,NaN,54.51742155,55.721874500000034,58.23320249999998,58.23320249999998,61.843099844917504,54.62330515508246,13227602,40.22482364159645,50.784417894525895,NaN,NaN,NaN,NaN,NaN,NaN,-0.5319309647357895,-0.18101119287263856,0.35091977186315093,0.6984863521354683,8.144079568009895,-25846172,67643536.70482974,18.955633875484978,23.749209482830956,16.221399136943095,7.142857142857143,100
1999-08-05,55.0625,55.929685,53.75,55.929685,NaN,54.481546027495625,56.285098615027586,57.06081013254745,NaN,54.5617184,55.84359320000004,58.06718675,58.06718675,61.7787332022491,54.355640297750895,18695204,44.882706231438064,48.892978493937974,NaN,NaN,NaN,NaN,NaN,NaN,-0.47808408584603834,-0.24668533544439697,0.23139875040164135,27.67853968253967,13.686048935873997,-7150968,86338740.70482974,17.055896754208213,27.15236976596067,13.36491090757858,0,100
1999-08-06,55.53125,56.5625,54.9375,55.328125,NaN,54.49830996754522,56.24757023796768,56.89579250087627,NaN,54.59562465,55.92546820000004,57.84140549999999,57.84140549999999,61.641527186684584,54.0412838133154,12392204,42.43453015338128,47.13866558549631,NaN,NaN,NaN,NaN,NaN,NaN,-0.4597717196522322,-0.3433158991636489,0.11645582048858329,24.876847290640395,17.75129110843851,-19543172,79904327.08944511,18.685819304012156,25.13029548439069,10.328991868868128,0,92.85714285714286
1999-08-09,55.53125,55.6875,54.50781,54.617185,NaN,54.500663928583926,56.183633561968946,56.678782262697574,NaN,54.6261715,55.99406190000004,57.59570225,57.59570225,61.55896468958848,53.632439810411526,7983400,39.67984324370138,46.13601691626003,NaN,NaN,NaN,NaN,NaN,NaN,-0.4706241254109907,-0.4718243362751551,-0.001200210864164386,15.925355948513479,22.82691430723118,-27526572,73401289.51516712,17.65774652425337,25.751661083450017,9.95102664526927,0,85.71428571428571
1999-08-10,54.46875,54.867185,52.9375,54.125,NaN,54.493225038908996,56.10290283404859,56.435564904345426,NaN,54.6417965,56.03593690000005,57.33945225,57.33945225,61.49957334529913,53.17933115470087,16767204,37.84804995724685,44.919966362654826,NaN,NaN,37.84804995724685,NaN,NaN,NaN,-0.48415446354375563,-0.6063932902938589,-0.12223882675010328,20.652173913043477,20.484792384065784,-44293776,77270671.02005523,16.09756506955185,30.666491679758227,10.630986870810668,0,100
1999-08-11,55.09375,56,54.265625,55.90625,NaN,54.52120573120783,56.09519095820355,56.38515396107444,NaN,54.6886715,56.13656190000005,57.12187425,57.12187425,61.099901164150204,53.14384733584979,13101398,47.32543748840202,44.8703014690138,NaN,NaN,NaN,NaN,NaN,NaN,-0.35246519862751813,-0.562820325034501,-0.21035512640698284,53.97727272727273,30.18493419627656,-31192378,88955701.66870388,19.848394429291414,28.07112247870684,11.172552251257144,0,92.85714285714286
1999-08-12,56.125,56.5,55.125,55.25,NaN,54.53563730088688,56.06204621474459,56.277044060019726,NaN,54.735234,56.20687440000006,56.84374925000001,56.84374925000001,60.516884562433816,53.1706139375662,12715000,44.62554461965844,44.59925269401385,NaN,NaN,NaN,NaN,NaN,NaN,-0.29141068483600463,-0.5746184824519887,-0.283207797615984,42.04545454545455,38.89163372859025,-43907378,78552519.85052207,20.88307851248485,26.312459557415302,11.57909929996563,21.428571428571427,85.71428571428571
1999-08-13,56.40625,57.71875,56.3125,57.65625,NaN,54.59743161176041,56.124564010244804,56.40839700668452,NaN,54.8236715,56.33999940000006,56.65781175000001,56.65781175000001,59.7203624564695,53.59526104353051,14342602,54.80641295879005,45.46793968078499,NaN,NaN,NaN,NaN,NaN,NaN,-0.08172346378903717,-0.3853621273522805,-0.3036386635632433,85.79545454545455,60.6060606060606,-29564776,91620223.89496651,23.960761043532106,23.469411936720675,11.396468972101145,14.285714285714286,78.57142857142857
1999-08-16,57.625,58.3125,57.25,58.117185,NaN,54.66712969865625,56.20270600984305,56.57113872033361,NaN,54.900155850000004,56.451093100000065,56.52617100000001,56.52617100000001,59.05335377996082,53.9989882200392,11470602,56.45787500211088,46.0728238920952,NaN,NaN,NaN,NaN,NaN,NaN,0.0861725136680963,-0.1959230214781229,-0.2820955351462192,94.1760909090909,74.00566666666667,-18094174,98873638.82742767,25.483135877194197,22.350130598625856,11.57779351141191,7.142857142857143,71.42857142857143
1999-08-17,58.625,58.6875,57.34375,58.40625,NaN,54.74117168482147,56.289119499653125,56.74591122315898,NaN,54.96109335,56.54609310000007,56.52617100000001,56.52617100000001,59.05335377996046,53.998988220039564,11408398,57.50658150579582,46.415938586328345,NaN,NaN,NaN,NaN,NaN,NaN,0.20790841823090345,-0.022210012357589903,-0.23011843058849335,95.1086956521739,91.6934137022398,-6685776,105506428.3623114,25.63097323887219,20.98692875404265,11.619095293625108,100,64.28571428571429
1999-08-18,58.125,58.84375,57.53125,57.75,NaN,54.800752443537874,56.34640893103928,56.84153872571527,NaN,55.02109335,56.65484310000007,56.47929600000001,56.47929600000001,58.87578230620513,54.08280969379489,7035200,54.30863136275726,46.89914849331477,NaN,NaN,NaN,NaN,NaN,NaN,0.23352882588403895,0.06179260176655532,-0.17173622411748363,81.48148148148148,90.25542268091544,-13720976,100816295.02897806,24.803430374151354,19.721642746121926,12.260220121649045,100,57.142857142857146
1999-08-19,57.21875,57.625,56.69531,57.0625,NaN,54.845539523863856,56.37449093374362,56.86258265659953,NaN,55.05546835,56.73234310000008,56.47265550000001,56.47265550000001,58.861893956570015,54.08341704343,10157796,51.102478875546566,47.23251837201097,NaN,NaN,NaN,NaN,NaN,NaN,0.19503627660939374,0.07205912164425854,-0.1229771549651352,69.84126984126983,82.14381565830841,-23878772,98682337.3261309,23.573517339817524,22.67390176612231,12.041728684757603,92.85714285714286,50
1999-08-20,57.125,57.96875,56.8125,57.96875,NaN,54.90738527586655,56.43701089712623,56.967931927399576,NaN,55.10265585,56.84015560000008,56.507030500000006,56.507030500000006,58.96072742043515,54.053333579564864,6920800,54.88351296039937,47.88158862057435,NaN,NaN,NaN,NaN,NaN,NaN,0.2196416856289209,0.1515749520710159,-0.06806673355790499,85.18518518518519,78.83597883597884,-16957972,105603137.3261309,23.913987759225908,21.41991760264767,12.315151691547898,85.71428571428571,42.857142857142854
1999-08-23,58.5,59.8125,58.367185,59.8125,NaN,55.00451626050286,56.56938301880755,57.23884317240914,NaN,55.17609335,57.00078060000008,56.703905500000005,56.703905500000005,59.527187761367514,53.880623238632495,9652000,61.419746015375914,49.10758385830004,NaN,NaN,NaN,NaN,NaN,NaN,0.3418342682959,0.35922610181197,0.017391833516070015,100,85.00881834215168,-7305972,115255137.3261309,30.513352345749656,19.562048573767,13.250849188945887,100,35.714285714285715
1999-08-24,59.375,60.875,59.25781,60.21875,NaN,55.10776841376023,56.71249544944255,57.52264382265589,NaN,55.24265585,57.18906190000009,56.86484300000001,56.86484300000001,60.07741380746492,53.652272192535094,13891398,62.701942240205035,50.71309232962922,NaN,NaN,NaN,NaN,NaN,NaN,0.42627006254900435,0.5502294117023254,0.1239593491533211,91.73228346456693,92.3058228832507,6585426,117872374.66782854,33.177906692690144,18.080703237810727,14.552857097931222,100,28.571428571428573
1999-08-25,60.59375,61.75,59.9375,61.5,NaN,55.23434725705211,56.900240725935,57.90143964906961,NaN,55.30265585,57.38781190000009,57.033983750000004,57.033983750000004,60.800871166113254,53.267096333886755,11352000,66.48508493333932,52.25611937976503,NaN,NaN,NaN,NaN,66.48508493333932,NaN,0.5374832695788907,0.7958134361269344,0.25833016654804375,97.16312056737588,96.2984680106476,17937426,126092788.46093199,34.442287909604595,16.56653121963034,15.424715349927254,100,21.428571428571427
1999-08-26,61.5,61.71875,60.38281,60.47656,NaN,55.33815344998177,57.040488540604215,58.146689206301076,NaN,55.3513277,57.51312440000008,57.214061750000006,57.214061750000006,61.26683111701238,53.16129238298763,9753000,61.149606556769974,53.592910551435644,NaN,NaN,NaN,NaN,NaN,NaN,0.5113450953719664,0.8975115357630017,0.3861664403910353,85.54961702127659,91.48167368440647,8184426,117708628.00462407,32.29547037421112,15.533925028767271,16.87731811283817,92.85714285714286,14.285714285714286
1999-08-27,60.929685,60.9375,59.71875,59.875,NaN,55.42799199552668,57.15164585273738,58.311290234272406,NaN,55.399765200000004,57.61437440000008,57.378124250000006,57.378124250000006,61.580080302506154,53.17616819749386,9635398,58.193469056504526,54.9153123952073,NaN,NaN,NaN,NaN,NaN,NaN,0.42624587973202327,0.9189737900560644,0.4927279103240411,78.72340425531915,87.14538061465721,-1450972,110543844.87641895,30.431904972250972,17.781656806366243,17.419633448380342,85.71428571428571,7.142857142857143
1999-08-30,60.125,60.3125,58.875,59.03125,NaN,55.49934363917962,57.2253558192967,58.379857831008366,NaN,55.4353902,57.69374940000008,57.507811749999995,57.507811749999995,61.74559058208867,53.27003291791132,10141602,54.233276311631435,56.08568570623477,NaN,NaN,54.233276311631435,NaN,NaN,NaN,0.29222456651010686,0.8580086184616746,0.5657840519515678,63.67432150313152,75.98244759324243,-11592574,102606938.96337546,28.353689776500534,20.575700983660795,16.329793537664663,78.57142857142857,0
1999-08-31,59.4375,60.0625,58.125,59.6875,NaN,55.5822774285028,57.32191049304977,58.50439518043614,NaN,55.4741402,57.75328070000007,57.688671250000006,57.688671250000006,61.97409476605036,53.403247733949655,14590398,56.7013420647269,56.75539317597226,NaN,NaN,NaN,NaN,NaN,NaN,0.22962590582961828,0.8528164342385907,0.6231905284089724,68.86792452830188,70.42188342891752,2997824,111549440.96337546,25.796619221574062,22.211109198709934,15.637590309649395,71.42857142857143,0
1999-09-01,60.0625,60.625,59.6875,60.117185,NaN,55.67207757843344,57.43152910116547,58.6579942108708,NaN,55.52093705,57.85562440000007,57.94179625,57.94179625,62.17269742388371,53.710895076116294,10752000,58.287472744675604,57.73124518490206,NaN,NaN,NaN,NaN,NaN,NaN,0.2000928924168508,0.8733066439300359,0.6732137515131851,69.9712183908046,67.504488140746,13749824,110653383.61937545,27.331844088017053,21.21415958796711,15.716005725642471,64.28571428571429,0
1999-09-02,59,60.21875,58.875,59.90625,NaN,55.7559225768803,57.52857697955113,58.77687571459739,NaN,55.57312455,57.936405700000066,58.140624500000015,58.140624500000015,62.34829504578622,53.93295395421381,14583204,57.180103131203154,57.90079448293157,NaN,NaN,NaN,NaN,NaN,NaN,0.15149403151621887,0.8625812909084587,0.7110872593922398,63.52397476403103,67.45437256104584,-833380,118453702.03798011,25.560876598372495,23.757426263041747,15.903206770706392,57.142857142857146,0
1999-09-03,61.625,62.679685,61.40625,62.65625,NaN,55.89256272387277,57.72966219603932,59.14633993225478,NaN,55.671562050000006,58.094374500000065,58.50703075000001,58.50703075000001,62.94139894687673,54.072662553123294,14195398,66.19674185297006,58.5964278294215,NaN,NaN,NaN,NaN,66.19674185297006,NaN,0.2821073682452979,1.0637214696988622,0.7816141014535642,99.60839686684074,77.70119667389213,13362018,132126624.76106375,33.51354901228344,20.766599613300443,17.112762789962993,100,21.428571428571427
1999-09-07,62.53125,63.15625,62.28125,62.375,NaN,56.02092781844955,57.911832305998566,59.453831367278134,NaN,55.75999955,58.24812450000007,58.89492150000001,58.89492150000001,63.25701292519493,54.53283007480509,9009000,64.69628701148812,59.109978222685235,NaN,NaN,NaN,NaN,NaN,NaN,0.3241101983878414,1.186751849438366,0.8626416510505246,87.90810625079322,83.68015929388834,4353018,125048124.76106375,34.37292292863631,19.914790394427214,18.303511905903143,100,14.285714285714286
1999-09-08,62,62.625,61.03125,61.53125,NaN,56.13004310917332,58.05377025478293,59.65168076087069,NaN,55.85562455,58.359062000000065,59.26523400000001,59.26523400000001,63.17917467148269,55.35129332851732,14303398,60.281816846038765,59.536634328633916,NaN,NaN,NaN,NaN,NaN,NaN,0.2717356733099556,1.2023112426879692,0.9305755693780136,74.84886100164991,87.45512137309463,-9950380,119719407.85910296,31.81326452387942,24.27236166180596,18.44865638946681,92.85714285714286,7.142857142857143
1999-09-09,61.5625,62.5625,61.25,62.40625,NaN,56.254324433744145,58.22445573498752,59.914020688406815,NaN,55.984374550000005,58.472187000000076,59.59023400000001,59.59023400000001,63.412938955902824,55.767529044097195,12677602,63.09418986616824,60.39318511367832,NaN,NaN,NaN,NaN,NaN,NaN,0.2720200786431525,1.2706006676819541,0.9985805890388016,88.17733990147784,83.644769051307,2727222,129378533.1924363,29.842373097760415,22.7686433164282,19.27009326201222,85.71428571428571,0
1999-09-10,63.25,63.742185,62.53125,63.125,NaN,56.390377415254164,58.4166339414586,60.21982824189188,NaN,56.109062050000006,58.582187000000076,59.98398400000001,59.98398400000001,63.55109835615485,56.41686964384516,10251000,65.26963146394192,61.13505072107422,NaN,NaN,NaN,NaN,NaN,NaN,0.2947036736327395,1.366960181079726,1.0722565074469865,89.0125570014162,84.01291930151466,12978222,129180147.49460776,33.55997159499276,21.32077785528518,20.470084503914382,100,0
1999-09-13,63.0625,63.1875,62.03125,62.367185,NaN,56.50873004069467,58.571557512381794,60.42433840933075,NaN,56.2011714,58.669218200000074,60.21953075000001,60.21953075000001,63.76278293273703,56.67627856726299,7240800,61.175160232013425,61.1175803079769,NaN,NaN,NaN,NaN,NaN,NaN,0.23533491716275456,1.3664251539004297,1.1310902367376752,75.52154682461055,84.2371479091682,5737422,126146808.07493207,31.68213990865293,22.547438611885408,20.111146800451717,92.85714285714286,42.857142857142854
1999-09-14,62.125,63.148435,62,62.710935,NaN,56.6315459804829,58.733886041308,60.64210951320401,NaN,56.282343250000004,58.74843690000008,60.44921825,60.44921825,64.01307264331139,56.88536385668861,10022602,62.32954792621209,61.09098071412027,NaN,NaN,NaN,NaN,NaN,NaN,0.19741247369622816,1.3778558288579603,1.1804433551617322,81.64116011845792,82.05842131482824,15760024,128533125.26125084,29.89300141997916,21.427814883971667,19.185549318468073,85.71428571428571,35.714285714285715
1999-09-15,63.492185,63.492185,61.4375,61.5,NaN,56.72795101057235,58.8423610985116,60.72381336908934,NaN,56.344218250000004,58.81093690000008,60.60390575,60.60390575,64.06677014948549,57.14104135051451,16096000,56.011511605416814,60.34286833355437,NaN,NaN,NaN,NaN,NaN,NaN,0.07525381325416114,1.2745106217294335,1.1992568084752724,60.083475975955935,72.41539430634147,-335976,113416350.78730471,26.959630996678246,22.01154941595635,17.40409397182304,78.57142857142857,28.571428571428573
1999-09-16,61.46875,62.03125,60.19531,61.46875,NaN,56.821828218283784,58.94535674170723,60.794759714890354,NaN,56.3930464,58.87093690000008,60.789843250000004,60.789843250000004,64.01067766719282,57.56900883280719,15371000,55.85416492770168,59.96462250290664,NaN,NaN,NaN,NaN,NaN,NaN,-0.0181854951454139,1.176524939543505,1.1947104346889188,59.52714749469708,67.08392786303698,-15706976,119368538.08100712,24.63356236559302,25.950050710472,15.086819342887404,71.42857142857143,21.428571428571427
1999-09-17,62.03125,63.4375,61.9375,63.3125,NaN,56.95035637237717,59.11661726164028,61.03454450394842,NaN,56.468983900000005,58.95218690000008,61.102343250000004,61.102343250000004,64.0139220687807,58.19076443121931,14506398,62.54038005766177,60.27511614584644,NaN,NaN,NaN,NaN,NaN,NaN,0.03097374095648009,1.2334276108845188,1.2024538699280387,92.35052788896931,70.65371711987412,-1200578,131457203.08100712,28.87365276740505,23.598719593174327,13.930736216511344,64.28571428571429,14.285714285714286
1999-09-20,63.5,63.75,63.03125,63.460935,NaN,57.07927872143901,59.286982663144585,61.265629313096184,NaN,56.56546825,59.02453060000007,61.376952499999994,61.376952499999994,64.08330797084679,58.6705970291532,6187200,63.02590012685444,60.903160704076654,NaN,NaN,NaN,NaN,63.02590012685444,NaN,0.05867233561473628,1.2757942894464591,1.2171219538317228,94.86106666666666,82.24624735011103,4986622,132667699.17005059,29.376036055644946,22.78694824918896,13.697548906548805,100,7.142857142857143
1999-09-21,62.90625,63.03125,61.75781,61.9375,NaN,57.175481122994675,59.390924519491854,61.329616997563214,NaN,56.65109325,59.07265560000007,61.48320249999999,61.48320249999999,64.10093893814346,58.86546606185652,12265796,55.12837038806607,60.79080558431516,NaN,NaN,NaN,NaN,NaN,NaN,-0.03536075385180859,1.1729210115169622,1.2082817653687707,62.82051282051282,83.34403579204961,-7279174,123863457.5161368,27.005478506295965,26.981887480636495,13.16719799741263,92.85714285714286,0
1999-09-22,62.03125,62.921875,61.28125,62.59375,NaN,57.28277357600468,59.51652551872747,61.45001061684291,NaN,56.73984325000001,59.13953060000007,61.601952499999996,61.601952499999996,64.19483370332965,59.009071296670335,12441796,57.59347293614895,60.74123416942041,NaN,NaN,NaN,NaN,NaN,NaN,-0.06158053579182221,1.131306095628993,1.1928866314208153,76.28205128205128,77.98787692307694,5162622,131328535.11613679,24.91934801747961,27.141450204771793,12.571944690732847,85.71428571428571,7.142857142857143
1999-09-23,63.25,63.375,59.63281,60,NaN,57.33658003984617,59.53548530230678,61.31191436761978,NaN,56.805468250000004,59.13437440000008,61.52695249999999,61.52695249999999,64.21241417996923,58.84149082003075,19766000,46.678482524799584,59.991118411820146,NaN,NaN,NaN,NaN,NaN,NaN,-0.25118881895074563,0.8789006077323833,1.130089426683129,8.91846137778438,49.34034182678284,-14603378,115441481.69020171,20.944959568157557,29.838218529958272,13.561620232753395,78.57142857142857,0
1999-09-24,59.625,60.3125,58.625,60.078125,NaN,57.39086805885911,59.556765290451615,61.19441061832266,NaN,56.880312,59.119686900000076,61.50703074999999,61.50703074999999,64.22902859611042,58.785032903889565,23570796,47.004272374925264,58.62022773481694,NaN,NaN,NaN,NaN,NaN,NaN,-0.3621809391548889,0.6773632527395179,1.0395441918944068,28.353658536585368,37.85139039880703,8967418,132464834.35686839,19.439331850387592,31.986418485877895,13.626964591697831,71.42857142857143,100
1999-09-27,60.9375,61.375,60.3125,60.5,NaN,57.45243502799062,59.59375488690449,61.1282762737205,NaN,56.943437,59.10218690000008,61.53828074999999,61.53828074999999,64.19825882072351,58.87830267927647,12608796,48.82267914371165,57.486398601404346,NaN,NaN,NaN,NaN,NaN,NaN,-0.3953167755609396,0.5453982224432323,0.9407149980041719,36.58536585365854,24.619161922676113,21576214,124306201.65098603,22.948285502833727,30.19026275606947,12.69811175242897,64.28571428571429,92.85714285714286
1999-09-28,60.19531,61,58.90625,60.78125,NaN,57.51835215614922,59.640323322712156,61.09522615241379,NaN,57.029062,59.10281190000008,61.62578074999999,61.62578074999999,64.05527386827211,59.19628763172787,20622000,50.05309573845506,56.75577566514836,NaN,NaN,NaN,NaN,NaN,NaN,-0.3859901183889266,0.4582273500180136,0.8442174684069402,42.073170731707314,35.67073170731709,42198214,140619127.02412036,20.907095359146176,33.47899618299932,13.388874778640817,57.142857142857146,85.71428571428571
1999-09-29,60.78125,61.21875,59.5625,59.5625,NaN,57.558830331274976,59.63727142770384,60.949252233136285,NaN,57.0949995,59.12593690000008,61.61953074999999,61.61953074999999,64.06949393324021,59.16956756675976,15557000,45.00380217538783,55.46360511580691,NaN,NaN,45.00380217538783,NaN,NaN,NaN,-0.4453844578268288,0.2874868961234043,0.7328713539502331,18.29268292682927,32.317073170731724,26641214,125062127.02412036,20.364765827464613,31.12085153936363,13.920738939310143,50,78.57142857142857
1999-09-30,60.125,60.8125,59.375,60.1875,NaN,57.610883196002206,59.658849018774276,60.87670440140902,NaN,57.1618745,59.15593690000008,61.6230465,61.6230465,64.06456324590067,59.18152975409932,17604204,47.90606610505909,54.223350447315276,NaN,NaN,NaN,NaN,NaN,NaN,-0.42605929823983724,0.20029723115043652,0.6263565293902738,30.48780487804878,30.284552845528466,44245418,127358327.54585949,19.10684410166453,30.004220943899195,13.912725822568797,42.857142857142854,71.42857142857143
1999-10-01,59.375,60.210935,58.75,60.210935,NaN,57.662369370338794,59.68049944941058,60.81329779175102,NaN,57.220546350000006,59.216249400000066,61.63828075,61.63828075,64.04024024679153,59.23632125320848,19607398,48.01683977415702,53.28347041461125,NaN,NaN,NaN,NaN,NaN,NaN,-0.39582673612387287,0.13157310923543264,0.5273998453593055,30.945073170731693,26.575186991869927,63852816,146965725.5458595,17.89691454610433,30.81329160983193,14.603602805753045,35.714285714285715,64.28571428571429
1999-10-04,60.53125,61.78125,60.1875,61.5625,NaN,57.739599679837035,59.754303392570954,60.884650383012826,NaN,57.28148385,59.30187440000007,61.58359325,61.58359325,63.9397220239057,59.2274644760943,12434204,54.08134293558117,52.69431291528047,NaN,NaN,NaN,NaN,NaN,NaN,-0.27468214323201917,0.18404716631928153,0.4587293095513007,57.31707317073171,39.58331707317074,76287020,155986618.6438987,23.48022780309314,28.679661488180802,14.137432479835212,28.571428571428573,57.142857142857146
1999-10-05,61.78125,62.75,60.6875,62,NaN,57.82396404261254,59.84236992619562,60.99087415605922,NaN,57.35710885,59.42437440000007,61.56484325,61.56484325,63.901368562665105,59.2283179373349,19526398,55.87580843905662,52.68461983196903,NaN,NaN,NaN,NaN,NaN,NaN,-0.16061368716047375,0.2579622006007085,0.41857588776118226,65.85365853658537,51.37193495934961,95813418,161311999.91662598,25.5475252964403,26.155577530214824,13.499716586480716,21.428571428571427,50
1999-10-06,62.375,63.335935,61.429685,63.242185,NaN,57.93125554671922,59.975696007521286,61.20528471262501,NaN,57.455468200000006,59.54921810000007,61.65039,61.65039,64.09835791624293,59.20242208375707,19098204,60.58552322918894,53.02257399636097,NaN,NaN,NaN,NaN,NaN,NaN,-0.005240885625832248,0.4120247807288919,0.4172656663547242,90.09141463414633,71.08738211382115,114911622,178531692.0477736,25.96555089321424,24.048911097193994,13.587543207617605,14.285714285714286,42.857142857142854
1999-10-07,63.59375,63.898435,62.625,63.09375,NaN,58.033483159655475,60.09797263467731,61.38513854951786,NaN,57.54273385000001,59.64874940000007,61.684765000000006,61.684765000000006,64.1927947259907,59.17673527400932,22013602,59.7646111158624,52.824304786232446,NaN,NaN,NaN,NaN,NaN,NaN,0.07914160582943641,0.5161926736415197,0.43705106781208325,84.740780914148,80.22861802829325,92898020,172724454.62468567,26.962727749389348,22.731729800069235,13.477631912523025,100,35.714285714285715
1999-10-08,62.84375,63.9375,62,63.75781,NaN,58.14683616639497,60.241495668611535,61.61110725908759,NaN,57.63906195000001,59.78640560000007,61.71640550000001,61.71640550000001,64.31079490115998,59.122016098840035,22523204,62.23024002682073,52.76747192194433,NaN,NaN,NaN,NaN,NaN,NaN,0.1662764296354184,0.6448966048563562,0.47862017522093786,96.6176,90.4832651827648,115421224,191069909.43577212,24.742285112383975,23.516245371881244,12.75683440830361,100,28.571428571428573
1999-10-11,63.9375,64.6875,63.78125,64.65625,NaN,58.27573545022873,60.4146232894503,61.9011208534602,NaN,57.736874450000016,59.94765560000007,61.83085875000002,61.83085875000002,64.71569713792039,58.94602036207964,13016000,65.326148003081,53.495884608731096,NaN,NaN,NaN,NaN,65.326148003081,NaN,0.2651472170180864,0.8100541964935459,0.5449069794754595,99.48453608247422,93.61430566554077,128437224,203188254.26335832,27.025257406706583,22.55634620435869,13.397516356611693,100,21.428571428571427
1999-10-12,64.4375,64.5,63,63.1875,NaN,58.37299811458064,60.52336355260911,62.02363315313065,NaN,57.83507760000001,60.08265560000007,61.85468700000001,61.85468700000001,64.77585280109825,58.93352119890177,20182796,57.08795788909392,53.459776391084304,NaN,NaN,NaN,NaN,NaN,NaN,0.21451804920251083,0.8130545409785981,0.5985364917760873,75.25773195876289,90.45328934707906,108254428,188051157.26335832,25.062551081036588,24.34389638209057,13.196537340689165,92.85714285714286,14.285714285714286
1999-10-13,62.46875,63.21875,61.0625,61.3125,NaN,58.43120607270775,60.55431007995777,61.95590618616583,NaN,57.919452600000014,60.18749940000007,61.845312000000014,61.845312000000014,64.77216882089265,58.91845517910738,22570602,48.6528420694084,53.60080207284208,NaN,NaN,NaN,NaN,NaN,NaN,0.046424414449132034,0.6565670098375023,0.6101425953883702,44.329896907216494,73.02405498281789,85683826,170714318.045967,22.746452396249005,30.397962796601234,12.974063559322307,85.71428571428571,7.142857142857143
1999-10-14,61.53125,62.125,60.53125,61.69531,NaN,58.495841794040274,60.59905517486139,61.93108750176908,NaN,58.021093200000024,60.32031190000007,61.856640000000006,61.856640000000006,64.77933017990408,58.93394982009593,22130398,50.2684833156579,53.83395999718012,NaN,NaN,NaN,NaN,NaN,NaN,-0.04249957750770572,0.5570181235037381,0.5995177010114439,49.60522105263157,56.397616639537006,107814224,180911588.87216935,21.18788642512506,30.59909168261359,12.52938263792387,78.57142857142857,0
1999-10-15,60.125,61,59.50781,59.875,NaN,58.523151857524624,60.57066085427859,61.73526964445774,NaN,58.121405700000025,60.39921820000008,61.684765000000006,61.684765000000006,64.64878719546402,58.72074280453599,33703008,43.29274183639116,53.43896447522866,NaN,NaN,NaN,NaN,NaN,NaN,-0.21764113490827464,0.32746628237610054,0.5451074172843752,18.94736842105263,37.62749546030025,74111216,163795486.7052335,19.239325835262143,32.08771763364867,13.343948375302324,71.42857142857143,28.571428571428573
1999-10-18,59.9375,60.15625,57.41406,59.117185,NaN,58.53491489004889,60.513661801169626,61.485928249747474,NaN,58.20023380000002,60.47499940000007,61.467577500000004,61.467577500000004,64.51458970412371,58.4205652958763,24714796,40.75703136189171,52.774959876902706,NaN,NaN,40.75703136189171,NaN,NaN,NaN,-0.36933898528184655,0.083433685682067,0.45277267096391355,23.41567401394663,30.656087829210296,49396420,169780523.27518672,17.114494253852303,36.97649128572796,14.31563298923308,64.28571428571429,100
1999-10-19,59.75781,60.0625,58.4375,59.4375,NaN,58.55278786252317,60.47145937759434,61.29083984500962,NaN,58.282733800000024,60.57140570000008,61.342577500000004,61.342577500000004,64.50514937619195,58.180005623808064,26657204,42.295515080211466,52.58151079867582,NaN,NaN,NaN,NaN,NaN,NaN,-0.42874498613678347,-0.08315856170706581,0.34558642442971765,27.819573681779193,23.394205372259506,76053624,175932185.73672518,15.987659921950595,34.54192446558112,15.446216468706359,57.142857142857146,92.85714285714286
1999-10-20,60.34375,61.742185,59.75,61.25,NaN,58.60619800385934,60.50199038239457,61.28695033596109,NaN,58.374921300000025,60.713905700000076,61.27539,61.27539,64.3854433476468,58.165336652353204,22486398,50.17955972563317,52.7439032001454,NaN,NaN,NaN,NaN,NaN,NaN,-0.3309851257417553,-0.06814498274747649,0.2628401429942788,52.73900657735542,34.65808475769377,98540022,187307700.15951726,21.186277220193862,31.38568130542846,15.247044692199065,50,85.71428571428571
1999-10-21,60.25,62.25,59.8125,62.25,NaN,58.678352498832425,60.570539779163404,61.37866935158384,NaN,58.488671300000036,60.840780700000074,61.38789000000001,61.38789000000001,64.46789906251934,58.3078809374807,22454796,53.920286151958685,53.16557794141695,NaN,NaN,NaN,NaN,NaN,NaN,-0.19093895154525206,0.02416645356271374,0.2151054051079658,66.48765920939748,49.015413156177395,120994818,209762496.15951726,21.153017164579232,28.427157350348253,14.400951252795634,42.857142857142854,78.57142857142857
1999-10-22,62.617185,63.25,61.75,61.96875,NaN,58.74350888499416,60.62537155252954,61.434867508575856,NaN,58.59101505000003,60.97515570000008,61.482421250000016,61.482421250000016,64.51146301154215,58.45337948845789,16589398,52.72130662837701,53.06843249090237,NaN,NaN,NaN,NaN,NaN,NaN,-0.11306118021955996,0.07377892983351586,0.18684011005307583,62.62085065663565,60.615838814462876,104405420,198011672.57618392,23.829100513120782,26.755714975063704,14.10218687040752,35.714285714285715,71.42857142857143
1999-10-25,61.6875,62.679685,61.4375,62,NaN,58.807993857568526,60.67927855046956,61.48868965061625,NaN,58.70101505000003,61.06203070000008,61.557421250000004,61.557421250000004,64.55961065827738,58.55523184172263,13855398,52.84676891804355,52.85207252511572,NaN,NaN,NaN,NaN,NaN,NaN,-0.058031131628325516,0.11430119551766893,0.17233232714599445,63.050496051386965,64.05300197247338,118260818,196704584.81177685,22.641831238078026,26.676074168942275,14.602474846901666,28.571428571428573,64.28571428571429
1999-10-26,62.75,63.09375,61.375,61.5,NaN,58.8613009098939,60.71146370535311,61.48976682674804,NaN,58.790390050000035,61.129687000000075,61.59335875000001,61.59335875000001,64.57465818240719,58.61205931759282,13542398,50.53601650478417,52.13425061622967,NaN,NaN,NaN,NaN,NaN,NaN,-0.05397722830876983,0.10486079176003216,0.158838020068802,56.17616973536593,60.615838814462876,104718420,185131990.1572314,22.74198924324641,24.832450511438566,14.642611540702791,21.428571428571427,57.142857142857146
1999-10-27,61.34375,61.625,60.44531,61.40625,NaN,58.91169594138115,60.73871022671181,61.48181284324823,NaN,58.867890050000035,61.18968700000008,61.68554625,61.68554625,64.52037898746826,58.85071351253174,15225204,50.093729380481754,51.44347334941676,NaN,NaN,50.093729380481754,NaN,NaN,NaN,-0.05603774663650468,0.08879083677317112,0.1448285834096758,54.88723355111199,58.037966445954986,89493216,194710772.85163417,21.636687151453263,27.455760117189655,14.88113096481076,14.285714285714286,50
1999-10-28,62.375,63.75,61.8125,63.53125,NaN,59.0031722593736,60.84822159037017,61.67699733436744,NaN,58.98007755000004,61.30531200000008,61.852733750000006,61.852733750000006,64.70877400915602,58.996693490843995,14103796,58.87873591308684,51.20408019843577,NaN,NaN,NaN,NaN,NaN,NaN,0.07990051273414508,0.24470422432735717,0.16480371159321208,84.10312039420137,65.05550789355979,103597012,205629840.72260192,28.138796223309292,24.86963234797399,15.140180044147346,7.142857142857143,42.857142857142854
1999-10-29,65,66.25,64.78125,65.75,NaN,59.13677280869293,61.04044819466938,62.06490235014197,NaN,59.10570255000004,61.47906200000008,62.129687000000004,62.129687000000004,65.3466404918546,58.9127335081454,18998000,65.67318959293542,51.22886888342538,NaN,NaN,NaN,NaN,NaN,NaN,0.3010084208541939,0.5410642376609545,0.24005581680676058,94.341292494064,77.77721547979247,122595012,211693032.21196362,34.85726949321288,22.251355039691852,16.073060711293344,100,35.714285714285715
1999-11-01,65.75,66.53125,65.32031,65.40625,NaN,59.26092087188713,61.21165610860391,62.383125935842735,NaN,59.23398380000004,61.62781200000008,62.321874500000014,62.321874500000014,65.82671093386229,58.817038066137734,9681796,63.91127604834958,51.71624875194363,NaN,NaN,NaN,NaN,NaN,NaN,0.399689350281294,0.739667504658378,0.33997815437708406,87.66067176399746,88.70169488408764,112913216,203385463.7512966,34.298124127936006,21.18169675964471,17.657862252582472,100,28.571428571428573
1999-11-02,65.75,66.5625,65.19531,65.44531,NaN,59.38338402293887,61.377681751403756,62.67476251338152,NaN,59.37062440000004,61.74046820000008,62.49414,62.49414,66.24855420782957,58.73972579217043,12834796,64.02936758493652,52.81457200305278,NaN,NaN,NaN,NaN,NaN,NaN,0.4399814708931969,0.8899549929935802,0.44997352210038327,87.78819121074201,89.93005182293452,125748012,195244527.4196675,32.40412479600679,20.516891134390548,18.233907687832353,100,21.428571428571427
1999-11-03,66.375,67.125,66.1875,66.75,NaN,59.52925760664305,61.58836089840753,63.06288036924995,NaN,59.530077550000044,61.871093200000075,62.66953075,62.66953075,66.85081440298562,58.48824709701438,18752602,67.81751289130744,54.06807411559918,NaN,NaN,NaN,NaN,NaN,NaN,0.5213311808631794,1.1016374981793575,0.5803063173161781,96.13837589357982,90.52907962277312,144500614,198995047.81966752,32.47794543062164,19.119940866363894,18.78503253489432,100,14.285714285714286
1999-11-04,67.679685,67.8125,66.78125,67.5,NaN,59.687094089679825,61.8201898827837,63.485463191226145,NaN,59.68945255000004,61.99109320000008,62.88984325,62.88984325,67.57168870203357,58.207997797966435,20048602,69.78724642041303,55.9605387287436,NaN,NaN,NaN,NaN,NaN,NaN,0.5875632670458123,1.3147604011234435,0.7271971340776312,96.99474151892014,93.64043620774736,164549216,206892981.94087964,33.90649701168337,18.272420846069494,19.137178006153142,100,7.142857142857143
1999-11-05,68.875,69.21875,68.1875,68.1875,NaN,59.85541895919111,62.069888318752966,63.93327622063318,NaN,59.82921820000004,62.145312000000075,63.11132775,63.11132775,68.3253296155641,57.897325884435894,15134602,71.50870353496512,58.15708674110599,NaN,NaN,NaN,NaN,NaN,NaN,0.6355201445885057,1.5215973148132633,0.8860771702247576,90.43478260869566,94.52263334039856,179683818,191758379.94087964,37.341038468508984,16.96256528232029,19.194843684928724,100,0
1999-11-08,68.4375,69.804685,68.21875,69.5625,NaN,60.047638385741784,62.36371622782148,64.46939277104907,NaN,59.97671820000004,62.33906200000008,63.35664025,63.35664025,69.25505277301052,57.45822772698948,10890796,74.62300578219143,60.46619321981884,NaN,NaN,NaN,NaN,NaN,NaN,0.7119346615521647,1.7759954971649634,1.0640608356127987,97.59132185642807,95.00694866134798,190574614,199322952.06756824,37.26592172423368,15.81388892920876,19.458777127530066,100,0
1999-11-09,70.125,70.25,68.5,69.09375,NaN,60.2267693087964,62.62763912084809,64.90980774523487,NaN,60.11703070000004,62.540312000000085,63.65195275,63.65195275,70.05660702426465,57.24729847573534,14629796,71.74390527217759,62.006503616000586,NaN,NaN,NaN,NaN,NaN,NaN,0.6828936395734853,1.9176778850796552,1.23478424550617,88.92215568862275,92.31608671791552,175944818,194620517.6389968,36.4014021198379,14.657191085499408,21.114915394100553,100,0
1999-11-10,69.125,70.59375,68.8125,70,NaN,60.42029862941429,62.91675131218738,65.3945879599744,NaN,60.249921350000044,62.746562000000075,64.08632775000001,64.08632775000001,70.95872200194016,57.21393349805985,16561000,73.84493104465135,63.429692536907204,NaN,NaN,NaN,NaN,NaN,NaN,0.6754703421686994,2.079122173217044,1.4036518310483448,94.14934709176977,93.55427487894023,192505818,200140850.97233015,35.1318986889385,13.569242532606468,23.22948641566143,100,0
1999-11-11,70.75,71.34375,70.125,71.25,NaN,60.634748161505094,63.24354537837611,65.95224624950065,NaN,60.41242135000004,62.96921830000007,64.56406225,64.56406225,72.0096736143584,57.11845088564161,18501398,76.44642463295139,65.12434382294823,NaN,NaN,NaN,NaN,NaN,NaN,0.7023835456322032,2.281631263088599,1.5792477174563957,99.13978514356182,94.07042930798481,211007216,215795880.04925323,36.3081490202478,12.797519114436643,26.23606287112809,100,21.428571428571427
1999-11-12,71.625,72.25,69.375,72.1875,NaN,60.86351552464361,63.59428869687117,66.5460799400244,NaN,60.57562450000004,63.21484330000008,65.17968725,65.17968725,72.99934527930768,57.36002922069233,28646602,78.19792661985055,66.93514080164873,NaN,NaN,NaN,NaN,NaN,NaN,0.7278634739127607,2.4890770598473466,1.7612135859345859,99.47054941722315,97.58656055085162,239653818,243196977.6144706,35.753598229721206,11.314805660080294,29.360476172823493,100,14.285714285714286
1999-11-15,72.25,72.5,71.6875,72.046875,NaN,61.08496818752195,63.925762669542884,67.0699651838316,NaN,60.74851515000004,63.402655800000076,65.82617175,65.82617175,73.67194447630628,57.98039902369372,10909398,77.26973179984924,68.84469189415339,NaN,NaN,NaN,NaN,NaN,NaN,0.6806469862396498,2.612022318734148,1.9313753324944982,96.24108956762886,98.28380804280465,228744420,241938200.92216292,35.58382797321679,10.929417248323743,32.83269439146966,100,7.142857142857143
1999-11-16,72.3125,74.21875,72,73.875,NaN,61.338236144204686,64.31592883936473,67.7180637377524,NaN,60.94039015000004,63.63265580000007,66.54804675,66.54804675,74.56461942815255,58.53147407184744,19126398,80.50873875412879,71.0171925636996,NaN,NaN,NaN,NaN,NaN,NaN,0.7144306531944258,2.8244136489875302,2.1099829957931044,97.22921914357683,97.64695270947631,247870818,255138109.40103614,39.396940055568635,9.934332794500284,36.25203010005058,100,0
1999-11-17,73.875,74.19531,72.5,72.875,NaN,61.56668691362638,64.65157868880141,68.20920052463313,NaN,61.10929640000004,63.859530800000066,67.12929675,67.12929675,75.2105243093875,59.0480691906125,21683602,74.27393816562737,72.1168498674525,NaN,NaN,NaN,NaN,NaN,NaN,0.615099989732129,2.878857982958266,2.263757993226137,85.76158940397352,93.07729937172644,226187216,243047267.13229468,36.65109912172015,9.241941517433155,40.077511722856975,92.85714285714286,0
1999-11-18,73.375,75.109375,72.9375,75.109375,NaN,61.83485895494071,65.0616883480641,68.86635999847759,NaN,61.29289015000004,64.11359330000008,67.7722655,67.7722655,76.23556426779773,59.30896673220228,17738398,78.31487625153768,73.01982748592408,NaN,NaN,NaN,NaN,NaN,NaN,0.6425512394440935,3.066947042531254,2.4243958030871604,100,94.33026951585015,243925614,260785665.13229468,37.034411482298665,8.40998657002935,42.999956184115646,100,0
1999-11-19,74.78125,75.90625,70.15625,75.78125,NaN,62.11102511424881,65.48206331480668,69.52492095100354,NaN,61.47445265000003,64.36671830000007,68.4628905,68.4628905,77.16990965600336,59.755871343996645,17939796,79.36451687346857,74.12363040200401,NaN,NaN,NaN,NaN,NaN,NaN,0.6468482923243792,3.2329561684926347,2.5861078761682554,98.83296890842448,94.86485277079937,261865410,277945470.0018599,29.639895861317868,16.38855884076626,43.36764528932485,100,7.142857142857143
1999-11-22,75.9375,77.5,75.125,77.5,NaN,62.41575729020428,65.95335494952015,70.2844522890032,NaN,61.66929640000003,64.66937460000007,69.2378905,69.2378905,78.25951792984891,60.21626307015111,18841602,81.79246197984497,75.39242285878319,NaN,NaN,NaN,NaN,81.79246197984497,NaN,0.7017423032963288,3.4632857552886662,2.7615434519923374,100,99.61098963614154,280707012,296787072.0018599,32.695948034888964,15.051743149876248,44.402701271563615,100,0
1999-11-23,76.4375,76.5,74.25,74.96875,NaN,62.66433140326954,66.30689985346054,70.7305758805267,NaN,61.83148390000003,64.91453090000009,69.911328,69.911328,78.52348507364503,61.29917092635496,24047602,68.92961538274504,75.47185875102873,NaN,NaN,NaN,NaN,NaN,NaN,0.5126473887288179,3.4023526879033597,2.8897052991745418,76.38483965014578,91.73926951952346,256659410,288103215.7240821,29.187377042449075,16.325644652098443,44.572043406012924,92.85714285714286,0
1999-11-24,75.1875,77.742185,74.40625,77.4375,NaN,62.95686939528401,66.74339397685424,71.36933055857178,NaN,62.02210890000002,65.23328090000008,70.7128905,70.7128905,78.98698394478322,62.438797055216774,18617796,73.33420195848163,75.72521271803362,NaN,NaN,NaN,NaN,NaN,NaN,0.4984575023618012,3.512777177126793,3.014319674764992,96.8111455270372,91.06532839239435,275277206,303320128.2091095,30.040910986184915,14.594460450052676,44.90371579305419,100,0
1999-11-26,78.40625,78.78125,77.375,77.6875,NaN,63.24856505082294,67.17257460521289,71.97106098156495,NaN,62.21429640000002,65.55765590000009,71.42070299999999,71.42070299999999,79.5367655720626,63.30464042793737,8045200,73.7401756744776,75.88460358514166,NaN,NaN,NaN,NaN,NaN,NaN,0.4519070294175087,3.5792034615368777,3.127296432119369,89.64497041420118,87.61365186379476,283322406,298850572.6535539,32.054796494173914,13.924156946036359,45.03982647241045,100,0
1999-11-29,77.53125,78.1875,76.3125,76.40625,NaN,63.50911326763833,67.53467952265552,72.39345993570161,NaN,62.38585890000001,65.81953090000007,71.9535155,71.9535155,79.90805359520117,63.99897740479882,20485204,68.02426124659546,75.41326468974195,NaN,NaN,NaN,NaN,NaN,NaN,0.2887630351958337,3.488250226114161,3.1994871909183273,76.89969604863222,87.78527066329023,262837202,280413889.0535539,30.07161004329933,16.568577607691022,44.22102805263727,92.85714285714286,0
1999-11-30,76.5625,76.6875,73.9375,74,NaN,63.71685359897222,67.78822150215923,72.54646375134908,NaN,62.52742140000001,66.03031220000008,72.38320299999998,72.38320299999998,79.78593449409325,64.9804715059067,23697796,58.805160848827555,74.48906865950266,NaN,NaN,58.805160848827555,NaN,NaN,NaN,-0.011360262773719043,3.1852868624511785,3.1966471252248976,52.03761755485893,72.8607613392308,239139406,257793265.5990084,27.394591067398444,22.781836440349238,41.835763088599734,85.71428571428571,0
1999-12-01,74.3125,75.46875,73.75,75.09375,NaN,63.942138676220296,68.07471281580004,72.78906244169679,NaN,62.6830464,66.29343720000008,72.86562499999998,72.86562499999998,79.62669376028174,66.10455623971822,23205796,61.36806948423077,73.59786426232976,NaN,NaN,NaN,NaN,NaN,NaN,-0.15821885969389626,2.9988735506075272,3.1570924103014235,60.79734219269103,63.24488526539409,262345202,270872896.0717357,25.8459459716517,22.11065762644412,39.229579430237685,78.57142857142857,0
1999-12-02,75.375,77.625,75.328125,77.47656,NaN,64.21014701926543,68.44341270537652,73.23549078058281,NaN,62.865312,66.59109340000008,73.40195299999998,73.40195299999998,79.83106105428283,66.97284494571713,17229204,66.28871076832877,72.87231327199957,NaN,NaN,NaN,NaN,NaN,NaN,-0.11869013039770948,3.0087297473042867,3.127419877701996,86.12954152823927,66.3215004252631,279574406,285875158.64761823,30.72848180738617,20.291354250742135,37.270962986894254,71.42857142857143,7.142857142857143
1999-12-03,79.3125,80.1875,78.90625,79.125,NaN,64.50549064264632,68.86229848163626,73.7963964205273,NaN,63.053983900000006,66.97359340000008,73.98320299999997,73.98320299999997,80.27335941090458,67.69304658909537,21444602,69.21048439623277,72.23035311316974,NaN,NaN,NaN,NaN,NaN,NaN,-0.011004856221552561,3.1136638074250556,3.124668663646608,89.40809968847353,78.77832780313463,301019008,271753103.67200845,36.258046190540114,18.532584442791016,35.8730630238182,100,0
1999-12-06,79.429685,80.5,78.6875,79.84375,NaN,64.80921855071273,69.29294363921915,74.37233485666756,NaN,63.244296399999996,67.36890590000009,74.56601549999998,74.56601549999998,80.75944375969729,68.37258724030266,16018398,70.41451970762881,71.74069510658256,NaN,NaN,NaN,NaN,NaN,NaN,0.07444901827862616,3.217729936494891,3.1432809182162647,93.65558912386707,89.7310767801933,317037406,276171972.08580154,35.14096741805454,17.44394168479547,34.490852382724526,100,28.571428571428573
1999-12-07,80.09375,80.40625,78.835935,79.84375,NaN,65.10693204475803,69.70670075140663,74.89342201317541,NaN,63.42898389999999,67.75578090000009,75.08007799999997,75.08007799999997,81.23356281847022,68.92659318152973,23397000,70.41451970762881,71.01967946040399,NaN,NaN,NaN,NaN,NaN,NaN,0.09545041860745718,3.2625939414755862,3.167143522868129,93.65558912386707,92.23975931206924,317037406,282806968.9208314,33.31504128923462,16.537553749228433,32.62872347588576,92.85714285714286,21.428571428571427
1999-12-08,79.867185,80.492185,78.6875,78.875,NaN,65.37956705377272,70.0662418984103,75.27261991668252,NaN,63.61023389999998,68.11765590000009,75.56914049999997,75.56914049999997,81.28068222776666,69.85759877223329,19563000,66.3581822942675,70.45426832673543,NaN,NaN,NaN,NaN,NaN,NaN,0.012912416034215557,3.1832840429108984,3.170371626876683,84.29003021148036,90.53373615307152,297474406,267309013.51310092,31.302051358184958,16.035284371349118,30.66636707093583,85.71428571428571,14.285714285714286
1999-12-09,80,80.4375,77.25,79,NaN,65.64927859726237,70.4165853533746,75.62760849604608,NaN,63.81617139999999,68.50640590000009,76.01914049999996,76.01914049999996,81.3071271781247,70.73115382187522,28444398,66.62534242741093,69.6193016250121,NaN,NaN,NaN,NaN,NaN,NaN,-0.060424160111514524,3.0948414267372897,3.155265586848804,85.49848942598187,87.81470292044314,325918804,270097679.9836891,28.075342522498953,19.03115984201785,27.538627029566868,78.57142857142857,7.142857142857143
1999-12-10,79.90625,80.1875,78.125,79.5,NaN,65.92355030820767,70.77279769245794,75.99640768689883,NaN,64.02429639999998,68.8926559000001,76.43164049999996,76.43164049999996,81.44726752541037,71.41601347458955,20427602,67.72928248996053,68.78821345476152,NaN,NaN,NaN,NaN,NaN,NaN,-0.10007969311415499,3.0301659704561104,3.1302456635702653,85.18518518518519,84.9912349408825,346346406,276906880.6503558,26.193800423465284,17.755737167922252,26.85362631525494,71.42857142857143,0
1999-12-13,79.63281,81.335935,79.28125,80.992185,NaN,66.22193911398573,71.17355797902822,76.47219600243228,NaN,64.26226514999998,69.30828090000009,76.87187474999996,76.87187474999996,81.86571667672209,71.87803282327783,16209204,70.83025978404514,68.00519901220439,NaN,NaN,NaN,NaN,NaN,NaN,-0.05299876157769301,3.0639972115981493,3.1169959731758423,95.46858759005977,88.7174207337423,362555610,287692466.0664853,28.185953253845703,16.564743203209765,26.069039110622743,100,42.857142857142854
1999-12-14,80.75,81.21875,79,79.53125,NaN,66.48548982459987,71.50131060730162,76.76353447839111,NaN,64.48476514999997,69.66765590000009,77.24609349999996,77.24609349999996,81.84355250734728,72.64863449265263,27760000,64.31413619672153,67.67552192748842,NaN,NaN,64.31413619672153,NaN,NaN,NaN,-0.142361579136419,2.9390439992553183,3.0814055783917373,76.2101178035403,85.62129685959512,334795610,273225987.1932458,26.146419569578427,16.283358082838735,25.71090738864276,92.85714285714286,35.714285714285715
1999-12-15,78.625,81,77.9375,81,NaN,66.7729058676771,71.8738082305447,77.16700738521101,NaN,64.73601514999997,70.0476559000001,77.60234349999998,77.60234349999998,82.2039173176445,73.00076968235545,31796602,67.5465910622119,67.26212114918344,NaN,NaN,NaN,NaN,NaN,NaN,-0.1252700254545509,2.9248180465735487,3.0500880720280996,95.57160719146675,89.08343752835565,366592212,305022589.1932458,23.607227512277653,18.071283373335476,24.18781012663419,85.71428571428571,28.571428571428573
1999-12-16,82.125,83.25,81.75,83.125,NaN,67.09670971188152,72.31503143719,77.73443525328615,NaN,64.99726514999996,70.44531220000009,78.11484349999996,78.11484349999996,82.77898846443225,73.45069853556768,27217602,71.56039013671405,67.10642218220032,NaN,NaN,NaN,NaN,NaN,NaN,-0.00018504412155095906,3.049856766876161,3.050041810997712,98.6842105263158,90.15531184044096,393809814,327703924.1932458,29.0582308013043,16.781807655972084,23.28413368672047,100,21.428571428571427
1999-12-17,84.5,84.875,83.429685,83.78125,NaN,67.4270966482799,72.76468706710412,78.3103223720208,NaN,65.25390579999997,70.85906220000008,78.54843724999998,78.54843724999998,83.60979066907893,73.48708383092102,23892398,72.68397995327322,67.43925923267732,NaN,NaN,NaN,NaN,NaN,NaN,0.09229919208901283,3.1654158011089777,3.073116609019965,90.1685393258427,94.80811901454177,417702212,315434917.4994592,32.65628003610747,15.835368786570417,23.693902785344658,100,14.285714285714286
1999-12-20,84.40625,85.25,83.6875,84.875,NaN,67.77259968494762,73.2396012997667,78.93552976516168,NaN,65.53390579999997,71.28140600000008,79.00312474999996,79.00312474999996,84.59454225657507,73.41170724342484,15391398,74.49274173292355,68.55980072439846,NaN,NaN,NaN,NaN,NaN,NaN,0.18721159574434765,3.3071311037003994,3.1199195079560518,96.73913043478261,95.19729342898039,433093610,323438444.4594592,32.21101622428855,15.020825283119105,25.636922244096386,100,7.142857142857143
1999-12-21,85.125,88.75,84.640625,88.6875,60.11050744999999,68.18675612682985,73.84540124879545,79.86428883514628,60.11050744999999,65.85484329999997,71.76203100000008,79.56249974999997,79.56249974999997,86.51360729945401,72.61139220054594,26003398,79.57074474569922,69.85999181450335,NaN,NaN,NaN,NaN,NaN,NaN,0.4517480430862775,3.6846045618138987,3.2328565187276213,99.53434225844005,95.48067067302179,459097008,348650864.57352763,38.94556503571865,13.110736235646048,28.62547486810241,100,0
1999-12-22,89.1875,89.3125,87.4375,89.15625,60.399519813681586,68.60199362926886,74.44582669001916,80.74923751751331,60.300976199999994,66.18203079999995,72.28140600000008,80.27187474999997,80.27187474999997,88.04957016833117,72.49417933166876,22313602,80.09542909051433,70.84618598037375,NaN,NaN,NaN,NaN,NaN,NaN,0.5943141785919988,3.9757492419676197,3.381435063375621,98.70466321243524,98.32604530188598,481410610,367245532.90686095,38.4194807733797,12.339700311843586,30.834220269364895,100,0
1999-12-23,89.867185,90.75,89,89.65625,60.69063155682903,69.01890959700611,75.04231387864586,81.59752442060727,60.49269494999999,66.51789019999995,72.84828100000009,80.88281224999999,80.88281224999999,89.54342026714083,72.22220423285914,17542000,80.66583548832534,71.66442534409465,NaN,NaN,NaN,NaN,NaN,NaN,0.6535978729577083,4.198432404572756,3.544834531615048,91.89814814814815,96.71238453967449,498952610,362860032.90686095,40.85976923838215,11.650997132150447,32.496583481077714,100,28.571428571428573
1999-12-27,90.3125,93.57031,87.90625,89.6875,60.97915761098994,69.42818861488718,75.61663490301268,82.36799828531134,60.69081995,66.86421834999996,73.40812480000008,81.48281224999997,81.48281224999997,90.81172603599758,72.15389846400235,19282796,80.70305621096867,72.39932080861891,NaN,NaN,NaN,NaN,NaN,NaN,0.62616978576929,4.3275467638266605,3.7013769780573704,76.20872397644405,88.93717844567584,518235406,355705456.02000594,42.31460810906981,9.753568337990668,34.55952662035052,100,21.428571428571427
1999-12-28,89.75,90.5,88.5625,89.1875,61.25983763476118,69.81946210766169,76.14882569112983,83.01747463909122,60.87925745,67.19679649999995,73.99437480000007,82.12187474999999,82.12187474999999,91.71943562348815,72.52431387651183,15345398,78.11197124182077,72.94913877534691,NaN,NaN,NaN,NaN,NaN,NaN,0.5104999579362679,4.339501925477705,3.8290019675414375,73.14505668090861,80.41730960183362,502890008,350260314.79419947,39.91970335451852,9.201539896033104,36.62246975962332,92.85714285714286,14.285714285714286
1999-12-29,90,92.5,89.875,92.5,61.570685021479974,70.26858166988622,76.7900482130463,83.9205722925111,61.08206995,67.56851524999996,74.66203110000009,83.04687474999997,83.04687474999997,92.89770220612388,73.19604729387606,16512398,82.19134394549735,74.0800788932919,NaN,NaN,NaN,NaN,82.19134394549735,NaN,0.5877268307413313,4.563660505968102,3.9759336752267704,93.4418525138309,80.93187772372788,519402406,366772712.79419947,41.850347133620055,8.333165899096954,39.089485658925796,85.71428571428571,7.142857142857143
1999-12-30,93.625,93.75,91.5,91.5,61.868489150619475,70.689005795235,77.36690906743665,84.64242255036719,61.28175744999999,67.93734339999996,75.30328110000009,83.86718724999997,83.86718724999997,93.6645224907849,74.06985200921504,21887000,77.49572060886047,74.85653447768115,NaN,NaN,NaN,NaN,NaN,NaN,0.5052560346465951,4.607503718535014,4.102247683888419,85.7707509881423,84.11922006096063,497515406,344885712.79419947,42.735365102174875,7.795049197139674,42.657175930314075,100,0
1999-12-31,92.625,93.1875,91.375,91.375,62.162086273498886,71.09862944285412,77.91624596675287,85.28362040271317,61.475819949999995,68.30984339999995,75.90578110000007,84.56210924999996,84.56210924999996,94.4191645204202,74.70505397957973,14453204,76.90427832807816,75.51189132326098,NaN,NaN,NaN,NaN,NaN,NaN,0.3817019640859618,4.5793751389958715,4.19767317490991,84.9802371541502,88.06428021870782,483062202,330432508.79419947,40.468311895967446,7.747385123788063,46.13319047481314,92.85714285714286,21.428571428571427
2000-01-03,96.1875,96.1875,90,94.75,62.48634412152377,71.56697341428276,78.57639318374295,86.18518036435954,61.69347619999999,68.69828089999996,76.55578110000008,85.34335924999998,85.34335924999998,95.81075264767101,74.87596585232895,36358016,81.09872119160059,76.2453528523721,NaN,NaN,NaN,NaN,NaN,NaN,0.4613664489228988,4.774381236063533,4.313014787140634,92.12328767123287,87.62475860450849,519420218,349896901.19823986,41.77660484765773,6.4830174958101034,49.50204521465809,100,14.285714285714286
2000-01-04,92,93.5,87.9375,88.00781,62.740289055637966,71.892534534792,78.94625266673343,86.35876413918244,61.8805465,69.02585899999995,77.07656230000008,85.75156224999998,85.75156224999998,95.96285624067833,75.54026825932162,33782784,58.31461290449886,75.81681547435618,NaN,NaN,NaN,NaN,NaN,NaN,0.017521265689557808,4.334916369252582,4.317395103563024,55.179780821917845,77.42776854910034,485637434,316968145.97775996,35.003266324549024,10.340504377341665,51.72668926227698,92.85714285714286,7.142857142857143
2000-01-05,87.5,90.03125,84.25,86.1875,62.9735946371739,72.17560315786542,79.23022315039094,86.34245326878411,62.0674215,69.31117149999996,77.56031230000008,86.06874974999997,86.06874974999997,95.9138324084429,76.22366709155703,42498400,53.91085626527952,74.84283441743243,NaN,NaN,NaN,NaN,NaN,NaN,-0.4171195888159174,3.7959956175431273,4.213115206359045,30.735930735930737,59.34633307636051,443139034,302955160.03181404,30.48605157489633,17.23742558938517,52.76088521802102,85.71428571428571,0
2000-01-06,86.875,88,80,80.75,63.15047429252541,72.34539319434333,79.28982224253247,85.80983867175705,62.21882775,69.53749964999996,77.94531230000008,86.16249974999997,86.16249974999997,95.76449480254352,76.56050469745641,37009408,43.37394277571297,72.8295167487895,NaN,NaN,43.37394277571297,NaN,NaN,NaN,-1.0530966720562183,2.8967443662887717,3.94984103834499,4.633204633204633,30.182972063684428,406129626,272885016.03181404,25.56877147864739,23.025950053382417,51.22172134954423,78.57142857142857,100
2000-01-07,82.9375,88.5,82.5,88.5,63.402708379166945,72.66528639841574,79.65100568400179,86.06604451254209,62.39976525,69.83843714999996,78.48718730000007,86.63749974999998,86.63749974999998,95.69996685002674,77.57503264997321,28129398,56.4415649402391,71.66934424785849,NaN,NaN,NaN,NaN,NaN,NaN,-0.9379327714001913,2.777425074094751,3.715357845494942,52.50965250965251,29.29292929292932,434259024,301014414.03181404,22.815187388674126,19.709354154814644,49.265675725064,71.42857142857143,92.85714285714286
2000-01-10,91,93.9375,89.9375,92.25,63.689746106737424,73.0531025093382,80.1450838924723,86.65499265420475,62.60226525,70.18343714999996,79.06156230000006,87.27499974999998,87.27499974999998,96.02793846874282,78.52206103125714,29672204,61.11730974177645,70.71395624849085,NaN,NaN,NaN,NaN,NaN,NaN,-0.6111382527890608,2.951435029508616,3.562573282297677,75.67567567567568,44.272844272844274,463931228,305650695.90681404,30.390896529953963,17.774875992754026,48.53693093577679,64.28571428571429,85.71428571428571
2000-01-11,91.75,92.875,87,88.25,63.93412674249128,73.35403117251963,80.46292373982632,86.80689811570906,62.77539025,70.49531214999996,79.51156230000007,87.63789049999998,87.63789049999998,95.9072647380701,79.36851626192987,32512602,54.40831825821255,68.91664007081322,NaN,NaN,NaN,NaN,NaN,NaN,-0.6620228583662193,2.7350447093399026,3.397067567706122,50.965250965250966,59.716859716859716,431418626,286973243.6940481,27.275859799841605,21.07791921874302,45.90759335413164,57.142857142857146,78.57142857142857
2000-01-12,89,89.242185,86,86.5625,64.15928468535206,73.61558501068755,80.70212280885274,86.78362210468914,62.94195275,70.78124964999996,79.93468730000006,87.98945299999997,87.98945299999997,95.40402880916716,80.57487719083278,29047204,51.823736882119704,66.89723348449932,NaN,NaN,NaN,NaN,NaN,NaN,-0.7978747354308822,2.399724148417519,3.1975988838484013,40.54054054054054,55.727155727155726,402371422,268005077.28752285,25.709716311564577,21.63863994332615,42.85178632720353,50,71.42857142857143
2000-01-13,88.5,91.5,87.078125,91.25,64.42884404171672,73.96478134710958,81.11576505164282,87.20899142805209,63.135859,71.09562464999996,80.45078110000007,88.50195299999999,88.50195299999999,95.30497086928963,81.69893513071034,25163204,57.81798134011596,65.26524390248436,NaN,NaN,NaN,NaN,NaN,NaN,-0.5712047475408903,2.483592949422288,3.0547976969631785,69.4980694980695,53.66795366795367,427534626,290322972.0013038,27.432566083772326,19.77632671677002,40.037032132511136,42.857142857142854,64.28571428571429
2000-01-14,93,93.625,92,92.6875,64.71002469801805,74.33552825112722,81.56955857902938,87.73075414918998,63.331484,71.42031214999996,80.96953110000007,88.98007799999996,88.98007799999996,95.54422867563116,82.41592732436877,21898000,59.48289237337651,63.749517914084926,NaN,NaN,NaN,NaN,NaN,NaN,-0.3353010094774511,2.6356714351163646,2.9709724445938157,78.37837837837837,62.80566280566281,449432626,286954048.9243807,30.080461611466337,18.932279274546868,37.19489522996357,35.714285714285715,57.142857142857146
2000-01-18,92.0625,94.4375,91.4375,94,65.00146723833628,74.72492373130291,82.05702687004784,88.32782518260045,63.523984,71.74531214999996,81.49953110000007,89.49101549999997,89.49101549999997,95.94688154873926,83.0351494512607,16749000,60.99660094568167,62.526991464360705,NaN,NaN,NaN,NaN,NaN,NaN,-0.11318918860667093,2.829485958835477,2.9426751474421478,86.48648648648648,78.12097812097812,466181626,298817923.9243807,29.9160019739616,17.893419573630098,34.524287698632016,28.571428571428573,50
2000-01-19,93.492185,96,92.429685,95.28125,65.3027586090991,75.13197969701969,82.57562385553615,88.99005611759088,63.722343375,72.09335904999998,82.04140610000006,90.01132799999996,90.01132799999996,96.57175095453515,83.45090504546478,18995602,62.47059184008159,61.118366313973866,NaN,NaN,NaN,NaN,NaN,NaN,0.08689833615149833,3.051298067631521,2.9643997314800226,94.4015444015444,86.42213642213642,485177228,310165411.43728364,30.825880115760995,16.717708246573675,31.873213081720536,21.428571428571427,42.857142857142854
2000-01-20,95.5,96.875,94.00781,95.5,65.60322867269015,75.53530683173217,83.0824621357112,89.61005077305842,63.924687125,72.44960904999998,82.56015610000006,90.35195299999997,90.35195299999997,97.29814963772161,83.40575636227832,25955602,62.72956554279844,60.06364095211229,NaN,NaN,NaN,NaN,NaN,NaN,0.19468821341893605,3.2077599982536924,3.0130717848347564,91.85185185185185,90.91329424662759,511132830,311226288.8114304,30.809308489392713,15.818799707406143,29.230497545243022,100,35.714285714285715
2000-01-21,96.5,96.5625,95.0625,96.25,65.90817167097184,75.94549877565827,83.59883616960488,90.24242688990999,64.128593375,72.82179654999997,83.10328110000006,90.70664049999996,90.70664049999996,98.08348843046956,83.32979256953037,18696204,63.655583765925975,59.117305626244274,NaN,NaN,NaN,NaN,63.655583765925975,NaN,0.2724365899444656,3.3536175222653384,3.0811809323208728,96.29629629629629,94.18323084989753,529829034,322132407.8114304,29.903411187710233,15.353673786915959,26.67945773565473,92.85714285714286,28.571428571428573
2000-01-24,97.4375,97.625,90.96875,91.25,66.16032916678307,76.24855820584325,83.89888181001253,90.33838623372809,64.305780875,73.13742154999997,83.52828110000006,90.78632799999998,90.78632799999998,98.15048911090598,83.42216688909399,28337204,54.019528324594546,57.18307756431527,NaN,NaN,NaN,NaN,NaN,NaN,-0.04029266761333172,3.030815097804208,3.0711077654175396,63.829787234042556,83.9926451273969,501491830,296189897.10720503,26.21923730839769,21.039303994410357,22.238607291864504,100,21.428571428571427
2000-01-25,91.875,94.117185,89.40625,93.15625,66.42894529447678,76.58336398394536,84.2619158566787,90.60675421146827,64.494374625,73.46781219999997,83.96640610000006,90.95976549999997,90.95976549999997,98.37544942424192,83.54408157575803,33273398,56.710096133982255,57.06846922356409,NaN,NaN,NaN,NaN,NaN,NaN,-0.14053938108333108,2.895433539063376,3.035972920146707,74.64539007092199,78.25715786708695,534765228,315889101.1490502,23.9685113578667,22.080420310885923,18.646432691001053,92.85714285714286,14.285714285714286
2000-01-26,93.25,93.3125,89,89.5,66.65850802786507,76.8391389545603,84.46733092112267,90.5013490484713,64.668437125,73.76374969999998,84.31265610000005,90.97539049999997,90.97539049999997,98.37737601499902,83.57340498500093,23090000,50.59480476353209,56.8316084020107,NaN,NaN,NaN,NaN,NaN,NaN,-0.4570164913281607,2.4647023059865063,2.921718797314667,53.90070921985816,64.12529550827423,511675228,298153304.0476009,22.098389654009008,21.092624932792248,16.829819105866488,85.71428571428571,7.142857142857143
2000-01-27,91.75,92.5,87.625,90.5,66.89573680370721,77.10965105446999,84.70390617911785,90.5012205676645,64.856874625,74.04218719999999,84.68171860000005,90.87539049999997,90.87539049999997,98.24625896743738,83.50452203256255,30730204,52.11569801161418,57.45601949028935,NaN,NaN,NaN,NaN,NaN,NaN,-0.5942397419402132,2.1789191198894002,2.7731588618296135,52.892561983471076,60.479553758083746,542405432,303668981.6886266,20.181438192463787,21.709607606942722,16.71662273303184,78.57142857142857,0
2000-01-28,90,90.46875,84.75,85.75,67.08334141262554,77.28074707319335,84.74492946621127,90.04872337074407,65.017968375,74.27593719999999,84.91921860000006,90.58789049999997,90.58789049999997,98.28041772544827,82.89536327455167,35313600,45.025435327165546,56.6405816607841,NaN,NaN,45.025435327165546,NaN,NaN,NaN,-0.9775138508883847,1.5512665482191323,2.528780399107517,7.766990291262136,38.18675383153046,507091832,280705493.16403645,18.17842150878496,24.517441588381892,17.255429394101334,71.42857142857143,0
2000-01-31,85.875,90,83.5,90,67.31136786623127,77.53261346778359,84.95101066361475,90.04408304972083,65.208124625,74.56062469999999,85.26171860000005,90.51914049999996,90.51914049999996,98.20687642413714,82.83140457586279,36012192,51.39688004165875,55.94626525363283,NaN,NaN,NaN,NaN,NaN,NaN,-0.9183290827670012,1.3808690456487653,2.2991981284157665,46.017699115044245,35.559083796592496,543104024,316717685.16403645,16.21876308094839,23.94753115717093,16.75892998311347,64.28571428571429,100
2000-02-01,89.53125,92.5,88.4375,92.5,67.56200102179115,77.82899735951065,85.24704946112006,90.27797990212837,65.422968375,74.8615622,85.60953110000005,90.40664049999997,90.40664049999997,97.90699949735905,82.90628150264088,26416602,54.721228335142804,55.968615973413556,NaN,NaN,NaN,NaN,NaN,NaN,-0.694510079636836,1.4310605288697218,2.1255706085065578,63.716814159292035,39.16716785519947,569520626,343134287.16403645,19.284641242500825,22.327480378000413,16.365678786449344,57.142857142857146,92.85714285714286
2000-02-02,92.25,94.71875,92.09375,92.875,67.81387165839024,78.12693800585697,85.54618477637025,90.52531514954471,65.634062125,75.1590622,85.95140610000006,90.64999999999996,90.64999999999996,98.13907016090842,83.16092983909151,26169204,55.216040987682696,56.2109234095252,NaN,NaN,NaN,NaN,NaN,NaN,-0.5132640961418766,1.483990488329212,1.9972545844710887,66.3716814159292,58.70206489675516,595689830,332541990.3068936,22.217689476685333,21.323672717330926,15.898187497049777,50,85.71428571428571
2000-02-03,94.3125,96.625,92.28125,96.125,68.0955744279585,78.48333527306772,85.96104027533613,91.05861846863569,65.848905875,75.49664034999999,86.32390610000006,91.14687499999997,91.14687499999997,98.70405546380442,83.58969453619551,30578602,59.361049440405765,56.32114255954591,NaN,NaN,NaN,NaN,NaN,NaN,-0.18355765435386107,1.7678075165287623,1.9513651708826234,89.38053097345133,73.15634218289085,626268432,356080914.1486202,23.824862232931963,19.74198141772784,15.409169047285351,42.857142857142854,78.57142857142857
2000-02-04,97,98.242185,96.21875,96.90625,68.38224781673503,78.84814546568025,86.39026418610726,91.61553575733704,66.060468375,75.8385935,86.76265610000006,91.95468749999996,91.95468749999996,98.24084773872063,85.6685272612793,26636204,60.311990516899876,56.38036385551187,NaN,NaN,NaN,NaN,NaN,NaN,0.06478567751694397,2.0323472677788033,1.9675615902618593,90.93801224174024,82.23007487704025,652904636,347545010.13354677,25.794544284500315,19.002136293395896,14.867545487558866,100,71.42857142857143
2000-02-07,97.25,98.5,96.25,98.40625,68.68099410711578,79.23543466437965,86.86147931606384,92.26227044711446,66.275937125,76.207656,87.18203110000006,92.44999999999996,92.44999999999996,99.1187353561231,85.78126464387682,17760000,62.14361393308037,56.46229335461177,NaN,NaN,NaN,NaN,NaN,NaN,0.29483490673754265,2.336105223683788,2.041270316946245,99.375,93.23118107173052,670664636,363825010.13354677,25.204953231644417,18.22064832465065,14.220152017245955,100,64.28571428571429
2000-02-08,99.375,102.25,99.375,102.25,69.01501406624895,79.69116863142165,87.46495071543389,93.21348278548452,66.50425745000001,76.6154685,87.67328110000005,92.94999999999996,92.94999999999996,100.86656688533675,85.03343311466317,21984796,66.42025516210076,56.74441216332743,NaN,NaN,NaN,NaN,66.42025516210076,NaN,0.6502588472797877,2.8540938760459795,2.203835028766192,100,96.77100408058008,692649432,385809806.13354677,30.2944643751409,16.939010810008977,14.12023880545212,100,57.142857142857146
2000-02-09,102.0625,102.19531,98.75,99,69.3133721352415,80.07352172782915,87.91730558933844,93.76457966305742,66.7206637,76.97234350000001,88.12515610000005,93.48749999999997,93.48749999999997,101.51363893787047,85.46136106212947,27294204,60.22507517342838,56.56551999408672,NaN,NaN,NaN,NaN,NaN,NaN,0.6114446935398865,2.96814089569105,2.3566962021511637,82.66666666666667,94.0138888888889,665355228,362476668.6268376,28.339700788346978,16.998253682613733,13.610686373284636,92.85714285714286,50
2000-02-10,99.8125,102.25,98.554685,102.1875,69.64047788513959,80.51142228767411,88.47692105642321,94.56676255229004,66.96253870000001,77.35960915000001,88.68890610000005,94.26874999999997,94.26874999999997,102.48607164394217,86.05142835605777,26340204,63.792115774195665,56.575272280391694,NaN,NaN,NaN,NaN,NaN,NaN,0.7369970467285092,3.2779425105618003,2.540945463833291,99.66666666666667,94.11111111111113,691695432,387925872.67148876,26.402626825991128,16.19766244887409,13.025405707594688,85.71428571428571,42.857142857142854
2000-02-11,102.0625,102.0625,98,99,69.93261243354615,80.87753273742314,88.88959081891642,94.98897564254814,67.1906637,77.73023415,89.16703110000006,94.65624999999997,94.65624999999997,102.9976003103514,86.31489968964854,24875000,58.1737450583711,56.87200204709002,NaN,NaN,NaN,NaN,NaN,NaN,0.5504721081456792,3.22903559901539,2.6785634908697107,82.66666666666667,88.33333333333333,666820432,375297026.5176426,24.36984077026241,15.970424699177252,13.72973281232369,78.57142857142857,35.714285714285715
2000-02-14,99.992185,100,97.75,99.359375,70.22541604117256,81.24350981192961,89.30017059072361,95.40520415278165,67.41886682500001,78.09789040000001,89.60468740000005,94.98984374999996,94.98984374999996,103.52106098322513,86.4586265167748,22813796,58.6162877599947,57.00815859180519,NaN,NaN,NaN,NaN,NaN,NaN,0.4032197535904367,3.1825881828577565,2.7793684292673198,84.58333333333333,88.97222222222223,689634228,385119633.1287537,23.33044730434951,15.763171035114704,14.819491582931946,71.42857142857143,28.571428571428573
2000-02-15,98.9375,100.625,95.875,100.25,70.52416812036488,81.61987595426764,89.7295756655972,95.86661328108816,67.652929325,78.5003904,90.02718740000006,95.30234374999996,95.30234374999996,104.11874511935005,86.48594238064987,30571796,59.75279862585985,57.66230101054289,NaN,NaN,NaN,NaN,NaN,NaN,0.32128602013781515,3.180975954439589,2.8596899343017737,89.33333333333333,85.52777777777779,720206024,410864303.4445432,21.268143479908016,17.85907092778438,15.275502148975947,64.28571428571429,21.428571428571427
2000-02-16,99.90625,101.6875,99.3125,100,70.81745997986373,81.98383880665838,90.13233740420122,96.26026915907977,67.889960575,78.89960915,90.43031240000006,95.53828124999997,95.53828124999997,104.58923550627678,86.48732699372316,25309398,59.260825192229596,58.172667237729705,NaN,NaN,NaN,NaN,NaN,NaN,0.21106353603559835,3.1235193543462714,2.912455818310673,88,87.30555555555556,694896626,400207714.81296426,22.33444202913781,17.04764538924537,15.973816920465648,57.142857142857146,14.285714285714286
2000-02-17,101.1875,103.25,99.625,101.875,71.1264902288203,82.37772318672455,90.5928339765855,96.7950054296436,68.128398075,79.31335915000001,90.87093740000006,95.85703124999996,95.85703124999996,105.31979377009529,86.39426872990464,30076602,61.80109727416529,59.37092880537255,NaN,NaN,NaN,NaN,NaN,NaN,0.22401973494118232,3.192480486987151,2.9684607520459685,93.0379746835443,90.12376933895922,724973228,407467584.2612401,23.777734771207662,15.86295977803279,16.33948611235458,100,7.142857142857143
2000-02-18,102.625,103,98.4375,98.8125,71.40197291311064,82.70316431173991,90.91517382064097,96.98714776967753,68.361366825,79.69367165,91.26968740000005,95.98515624999996,95.98515624999996,105.53472611821779,86.43558638178213,25269000,55.692718828579245,59.67777443300973,NaN,NaN,NaN,NaN,NaN,NaN,-0.0021075407574908667,2.965826326099105,2.9679338668565958,70.042194092827,83.69338959212376,699704228,386352392.4804182,21.730843195059776,16.73795908553094,15.892137741675516,92.85714285714286,0
2000-02-22,99,99.9375,96.25,98.65625,71.67315974979611,83.01906699863615,91.2187454355178,97.14610988685111,68.589804325,80.08460915,91.66281240000006,96.35546874999997,96.35546874999997,105.71433442374568,86.99660307625426,37227008,55.391900269772,59.72567957119753,NaN,NaN,55.391900269772,NaN,NaN,NaN,-0.1807588520900012,2.7419853017440943,2.9227441538340955,58.8235294117647,73.96789939604534,662477220,397709784.7516047,20.21611115448946,19.70624991336298,15.461048138087435,85.71428571428571,0
2000-02-23,99.679685,105,99.15625,104.125,71.99606363288272,83.4370062659899,91.72487306549749,97.81076608810338,68.842929325,80.52398415,92.15531240000006,96.90390624999996,96.90390624999996,106.7228346528588,87.08497784714113,32167602,62.937498284781185,60.277212235276,NaN,NaN,NaN,NaN,NaN,NaN,0.03909839318930031,2.971617145320721,2.9325187521314207,93.12039312039312,73.99537220832828,694644822,420244308.0778079,27.03103279989032,17.45245463040397,16.85245002085991,100,0
2000-02-24,104.875,106.804685,102,106.5,72.33938638280429,83.89369921121782,92.30428980802701,98.63831217495067,69.10371057500001,80.9868748,92.66546870000006,97.75390624999997,97.75390624999997,107.80252767188972,87.70528482811022,48862400,65.65461652840614,60.72675274156172,NaN,NaN,NaN,NaN,65.65461652840614,NaN,0.2996827906820112,3.3071222404839347,3.0074394498019235,97.21231673190943,83.05207975468907,743507222,462909573.2629344,27.929505980420455,15.963309714497958,18.130362842785527,100,0
2000-02-25,106.1875,107.5,103.875,104.1875,72.65628303571171,84.29555665257985,92.77029805084948,99.1668062535268,69.34730432500001,81.41312479999999,93.15859370000005,98.43828124999996,98.43828124999996,108.27981113357096,88.59675136642896,32615796,60.96780812123935,60.77359685615739,NaN,NaN,NaN,NaN,NaN,NaN,0.2723055766093112,3.3478214205635624,3.075515843954251,71.50537634408602,87.27936206546285,710891426,435917190.36638266,27.362319242341858,14.9283576152277,19.147394275811614,100,50
2000-02-28,103.25,105.6875,100.5,103.75,72.96567325426184,84.68079315450896,93.20087459787499,99.60330089604805,69.593866825,81.8306248,93.61359370000005,99.33828124999997,99.33828124999997,107.52730350233357,91.14925899766637,38215808,60.093785857214705,60.627180565024126,NaN,NaN,NaN,NaN,NaN,NaN,0.18491224211854718,3.3066561466024353,3.121743904483888,67.74193548387096,78.81987618662212,672675618,445586250.2218043,24.87675068769074,19.482292964537013,18.867216872712422,92.85714285714286,42.857142857142854
2000-02-29,105.75,107.09375,104.9375,107,73.30432327163237,85.12275764649888,93.74201677050733,100.30774842975777,69.861835575,82.26820294999999,94.09109370000006,100.18828124999996,100.18828124999996,107.83483426094666,92.54172823905326,23975000,64.19960418553794,60.468562638126784,NaN,NaN,NaN,NaN,NaN,NaN,0.2993894519837945,3.495980719463631,3.1965912674798367,95.6989247311828,78.3154121863799,696650618,467476467.6131087,25.895770762466082,18.326668474154793,18.070115263236993,85.71428571428571,35.714285714285715
2000-03-01,107.25,108.5625,106.5,107.625,73.6458225425614,85.56834660399396,94.2864474853894,101.0046295316856,70.12812465,82.71351544999999,94.56796870000005,100.94453124999997,100.94453124999997,108.38906885395639,93.49999364604355,24466398,64.94652004222316,60.80580870018355,NaN,NaN,NaN,NaN,NaN,NaN,0.3661903870205907,3.654329251255575,3.2881388642349845,92.61083743842364,85.35056588449247,721117016,469700685.6131087,27.61365052744041,17.63192998310795,17.859105089327386,100,28.571428571428573
2000-03-02,108.0625,108.1875,104.75,105.13281,73.95912590034686,85.95576172074655,94.71179503498198,101.39778957628697,70.38316370000001,83.12726545,94.97312490000006,101.55742174999997,101.55742174999997,108.22101461986705,94.8938288801329,32739204,59.606269776729356,60.50681970036453,NaN,NaN,59.606269776729356,NaN,NaN,NaN,0.19984053579941818,3.5379395339842574,3.3380989981848392,72.96796059113305,87.09257425357981,688377812,444253347.6106303,25.854483271342126,19.75189930113526,17.103807510222286,92.85714285714286,21.428571428571427
2000-03-03,108,111.125,107,109.523435,74.31299962273147,86.42244832033573,95.29264366106112,102.17166056902154,70.656405875,83.5759373,95.38984360000006,102.22734349999998,102.22734349999998,109.25568053920898,95.19900646079097,32014796,65.05744630247257,60.998512646371786,NaN,NaN,NaN,NaN,NaN,NaN,0.3348663194986736,3.756681897558181,3.4218155780595074,89.49793442622955,85.02557748526208,720392608,451408130.6381504,28.32923891135124,17.642013234497973,17.277108085823052,100,14.285714285714286
2000-03-06,111.75,113.21875,110.25,111.5,74.68301952698289,86.91903350211126,95.92822626258814,103.06007384816235,70.94706995,84.05906230000001,95.83671860000005,102.95703099999996,102.95703099999996,110.62523617802931,95.2888258219706,23269000,67.20318759768492,61.61186263477823,NaN,NaN,NaN,NaN,NaN,NaN,0.4968873402544327,4.042924753377548,3.5460374131231154,90.09009009009009,84.18532836915087,743661608,447734078.0065715,30.20590394990409,16.47336693982659,17.995830386197614,100,7.142857142857143
2000-03-07,113.8125,113.875,108.75,109.75,75.03194470581889,87.37113184860411,96.47025660523174,103.69720967214688,71.23144495000001,84.54343730000001,96.23859360000006,103.52421849999996,103.52421849999996,111.43633124165932,95.6121057583406,39467392,63.48601750829054,61.87852112638041,NaN,NaN,NaN,NaN,NaN,NaN,0.428381863854407,4.081514742941124,3.653132879086717,76.59574468085107,85.39458973239022,704194216,423668595.0797422,27.48645584394226,17.62529858324648,18.934873610038544,100,0
2000-03-08,111,112,106.28125,111.5625,75.3954328181988,87.85016884170106,97.06210928737951,104.44628494146623,71.53160120000001,85.0421092,96.67609360000006,103.98984349999996,103.98984349999996,112.61146566823045,95.36822133176948,43508384,65.6078290228208,62.331878542851214,NaN,NaN,NaN,NaN,NaN,NaN,0.4453520737803234,4.209822971312121,3.764470897531798,86.87943262411348,84.52175579835153,747702600,460519958.57701,24.803052278900704,20.119076983197036,18.720767076801337,92.85714285714286,21.428571428571427
2000-03-09,111.21875,115,109.09375,115,75.78950811354011,88.38778926067728,97.76555598199208,105.45140066132659,71.85738245000002,85.5933592,97.19234360000006,104.78984349999996,104.78984349999996,114.33119405491252,95.2484929450874,30096796,69.2566170088331,62.86441566675607,NaN,NaN,NaN,NaN,69.2566170088331,NaN,0.6176958377519521,4.536590694721738,3.918894856969786,100,87.82505910165484,777799396,490616754.57701,27.348772266682897,18.148459169883253,18.739010748607566,100,14.285714285714286
2000-03-10,114.875,116.4375,113.50781,114.6875,76.17655280892777,88.908575611951,98.42916162975709,106.33102916977167,72.17464807500001,86.14906235000001,97.63609360000005,105.41484349999996,105.41484349999996,115.79333823246152,95.0363487675384,29668398,68.54465855094502,63.782411361210755,NaN,NaN,NaN,NaN,NaN,NaN,0.6376660973440265,4.715977478649819,4.0783113813057925,91.3312693498452,92.73690065798621,748130998,484841336.67839944,28.428605979374318,17.24609932476709,19.5607167259952,100,7.142857142857143
2000-03-13,110,114.125,109.53125,111.1875,76.52492044266978,89.34974243151632,98.92948862466858,106.79355020122199,72.47464807500002,86.66656235,98.02984360000006,106.02421849999996,106.02421849999996,116.25468625747462,95.7937507425253,37543808,60.983188850494585,64.18178911697666,NaN,NaN,NaN,NaN,NaN,NaN,0.3562125489079815,4.523577067440769,4.167364518532787,69.62025316455696,86.98384083813403,710587190,474369934.44710696,25.980220394688335,22.402780044497757,19.997636061729306,92.85714285714286,0
2000-03-14,112.75,113.375,105,107,76.82815506513077,89.69925248237737,99.24597926683843,106.8132120868199,72.749491825,87.12406235,98.34234360000006,106.40624974999996,106.40624974999996,116.17277836379479,96.63972113620513,39103808,53.39398232723197,63.50010940572315,NaN,NaN,NaN,NaN,NaN,NaN,-0.14409986708958122,3.9872396846708114,4.131339551760393,40.78431372549019,67.24527874663077,671483382,453942572.0590473,22.578797766734226,26.553278762842076,19.03738579893822,85.71428571428571,0
2000-03-15,106.5,107,101.875,102.96875,77.08826048736827,89.962014809459,99.39197027598202,106.4470728404561,73.00996057500001,87.53124985000001,98.50671860000004,106.54218724999996,106.54218724999996,116.03400287493847,97.05037162506144,51199616,47.2923413241872,62.188518319707505,NaN,NaN,47.2923413241872,NaN,NaN,NaN,-0.7450616349831547,3.200012508031449,3.9450741430146037,15.490196078431373,41.96492098949282,620283766,424596450.6931936,20.78542560276082,29.287350384376076,18.302873249689913,78.57142857142857,14.285714285714286
2000-03-16,105.375,109.25,101,108.5,77.40081510938451,90.32910362511328,99.74914791221802,106.64258971279362,73.29378870000001,87.99656235,98.91656240000003,106.96718724999997,106.96718724999997,115.99927600110391,97.93509849889602,55280384,54.90671899327449,61.75558338199573,NaN,NaN,NaN,NaN,NaN,NaN,-0.7656505013949606,2.988011016270903,3.7536615176658636,50.19607843137255,35.490196078431346,675564150,469825855.7841027,21.570576401729916,25.742735423669377,16.832656245402333,71.42857142857143,7.142857142857143
2000-03-17,108,111.0625,107.9375,110.8125,77.73326968541053,90.73471543451697,100.18300485683692,107.03972402586089,73.59285120000001,88.48468735,99.40906240000005,107.41406224999996,107.41406224999996,116.27696527195504,98.55115922804488,31422204,57.66061996996458,61.58178581862072,NaN,NaN,NaN,NaN,NaN,NaN,-0.6250616074959812,2.972334508295887,3.5973961157918684,63.56275303643725,43.08300918208036,706986354,496220507.1441027,23.284506415634688,24.53159227275959,16.150312715798766,64.28571428571429,0
2000-03-20,111,111.5,106.25,107.25,78.02696849451092,91.06175077244733,100.46014192127468,107.05975030911223,73.86628870000001,88.94218735,99.93906240000005,107.83593724999996,107.83593724999996,115.7761604565811,99.89571404341882,21164400,52.35592810713327,60.73580895587753,NaN,NaN,NaN,NaN,NaN,NaN,-0.7643236511849762,2.641991551810648,3.406315202995624,40.48582995951417,51.414887142441295,685821954,483118735.7155313,21.45798919262839,25.128646216095962,15.490543405306017,57.142857142857146,85.71428571428571
2000-03-21,106.125,111.875,103.5625,111.5,78.3600334846153,91.46646857893352,100.89307753220508,107.48263123205392,74.15550745000002,89.44312485,100.39906240000006,108.47812474999996,108.47812474999996,115.35047987727063,101.6057696227293,33431296,57.391987787945375,60.196199509143405,NaN,NaN,NaN,NaN,NaN,NaN,-0.5713729477073648,2.692099018361418,3.2634719660687828,68.01619433198381,57.35492577597838,719253250,513533674.1816967,18.92645884239956,25.97833158269397,15.036461180037985,50,78.57142857142857
2000-03-22,113.5,115.96875,111.125,114,78.7146600171067,91.91267712192493,101.40707449172645,108.10333301947736,74.46394495000003,89.94781235,100.83406240000005,108.97187474999996,108.97187474999996,115.94054686044024,102.00320263955967,24334192,60.065983761896945,60.22903622236966,NaN,NaN,NaN,NaN,NaN,NaN,-0.290691162204602,2.90010801331303,3.190799175517632,84.21052631578948,64.23751686909578,743587442,518086523.00750315,23.447583073646385,24.187633991657105,14.191646375208178,42.857142857142854,71.42857142857143
2000-03-23,114.48437,117.75,113.5625,116.375,79.08938976818025,92.39707955515414,101.99405196263913,108.89111082714618,74.77988245000002,90.45406235,101.39656240000005,109.46562474999996,109.46562474999996,117.03704829318748,101.89420120681244,19226896,62.47530617909457,60.04459764212837,NaN,NaN,NaN,NaN,NaN,NaN,0.02295029885954758,3.2194870490920664,3.196536750232519,91.7910447761194,81.33925514129754,762814338,524686800.7388464,24.598795169926706,22.728991239367385,12.813298160678057,100,64.28571428571429
2000-03-24,117.48437,120.5,115.01562,117.875,79.47531623814861,92.90159283128969,102.61683423861408,109.74671931979893,75.10636682500002,90.97874985,102.02281240000006,110.14999974999996,110.14999974999996,118.15154810963456,102.14845139036537,22062400,63.95446803555594,59.81254624483345,NaN,NaN,NaN,NaN,63.95446803555594,NaN,0.2849158781596932,3.5526815979321356,3.2677657197724423,86.53846153846153,87.51334421012344,784876738,525629657.5999684,26.601156430462353,20.947267635317555,11.561289760863302,100,57.142857142857146
2000-03-27,118,119.5,117.125,117.35937,79.852271996973,93.38590525047208,103.19497289592333,110.47173367029427,75.43425742500003,91.49789045,102.54499980000006,110.83046824999997,110.83046824999997,118.85391084990172,102.80702565009821,11752199,63.034634201448384,59.78030458005901,NaN,NaN,NaN,NaN,NaN,NaN,0.3714771687141698,3.7321121806651547,3.360635011950985,83.89420512820513,87.407903814262,773124539,516196922.07755154,25.66297270878118,20.20848826831797,10.849247273056523,92.85714285714286,50
2000-03-28,116.98437,117.8125,114.375,115,80.20200063381904,93.81390712670036,103.65791513529888,110.90299713026624,75.75523400000002,91.98039045,102.99124980000006,111.23046824999997,111.23046824999997,119.24783270185773,103.21310379814221,18334096,58.862845523654585,59.29852004440427,NaN,NaN,NaN,NaN,NaN,NaN,0.22505091224523266,3.6419486522575255,3.416897740012293,71.7948717948718,80.7425128205128,754790443,504529770.07755154,24.32571016499355,23.3241424827597,10.254608350738044,85.71428571428571,42.857142857142854
2000-03-29,115.375,115.4375,110,110.5,80.5034732643283,94.14432480735975,103.92623218881657,110.86461645119327,76.04992150000002,92.41039045,103.32124980000006,111.37421824999997,111.37421824999997,119.22930023661323,103.51913626338671,27189296,51.81866569627711,58.052952093507415,NaN,NaN,NaN,NaN,NaN,NaN,-0.19685446090723335,3.1708296638782514,3.3676841247854847,48.717948717948715,68.1356752136752,727601147,482340804.37640214,22.3424413154278,27.982395405889786,9.610708340165539,78.57142857142857,35.714285714285715
2000-03-30,107.25,112.75,103.5,107.25,80.7696078587131,94.40384312800609,104.05657602454926,110.52036726536534,76.31511682500002,92.80101545,103.56062480000006,111.48007774999996,111.48007774999996,119.04765912898397,103.91249637101596,42319696,47.40621380788141,56.54306318328859,NaN,NaN,NaN,NaN,NaN,NaN,-0.6890870797453097,2.5063252751038476,3.1954123548491573,32.05128205128205,50.85470085470084,685281451,474334375.40342915,19.438976290349736,33.47782734728752,9.75693065502548,71.42857142857143,28.571428571428573
2000-03-31,108.14062,110.625,104,109.5,81.05548240738263,94.70277692745151,104.27004363142969,110.42318943056864,76.58855432500002,93.20039045,103.84062480000006,111.47890599999997,111.47890599999997,119.04770602672436,103.91010597327558,31348896,50.54585688350639,55.79753947136086,NaN,NaN,NaN,NaN,NaN,NaN,-0.8470280866187663,2.1366272465756992,2.9836553331944655,43.58974358974359,41.452991452991434,716630347,495036476.53550464,17.668039101544935,30.427917281852118,11.123790717904429,64.28571428571429,21.428571428571427
2000-04-03,107.76562,109.125,100.75,103.5,81.2788109406425,94.87697936453168,104.23984584196185,109.76383805622876,76.83074182500002,93.54445295,103.98562480000004,111.07890599999996,111.07890599999996,119.40832573036192,102.749486269638,31536608,43.14866882426596,55.06573136400614,NaN,NaN,NaN,NaN,NaN,NaN,-1.3117272370022328,1.3439962869416746,2.6557235239439074,13.924050632911392,29.855025424645657,685093739,484210476.7743106,15.6412519873675,31.198220851169634,12.918361561698532,57.142857142857146,100
2000-04-04,103.625,103.9375,88.3125,100.75,81.47255411536247,94.99327680285778,104.10298914227707,108.90537728896888,77.05093715000002,93.85195295,104.17562480000004,110.62890599999996,110.62890599999996,120.09216625450767,101.16564574549224,66194128,40.24180507182338,54.56212163169443,NaN,NaN,NaN,NaN,NaN,NaN,-1.7339390523872469,0.4882997084598486,2.2222387608470955,38.640776699029125,32.05152364056135,618899611,523397400.5503106,12.814337896109329,39.9460929286927,15.378740268430077,50,100
2000-04-05,97.5,103.9375,96.25,99,81.64695656197578,95.07261785626653,103.9028719210113,107.9620080233528,77.27093715000002,94.12945295,104.29249980000006,110.00078099999996,110.00078099999996,120.71745501678532,99.2841069832146,37005104,38.465886462211785,53.38777645090424,NaN,NaN,NaN,NaN,NaN,NaN,-2.03961792661942,-0.32728364742717986,1.7123342791922402,33.20388349514563,28.589570275695365,581894507,512867492.9080342,11.694459096180006,36.45509846814926,18.422046520916748,42.857142857142854,92.85714285714286
2000-04-06,102.375,103.875,99.75,102.3125,81.85258385986657,95.21598185911274,103.84050439469713,107.42395964017634,77.50316372500001,94.43070295000001,104.54874980000005,109.36640599999996,109.36640599999996,120.32363513169864,98.40917686830127,30496896,43.54459890810086,52.379489232199695,NaN,NaN,NaN,NaN,NaN,NaN,-1.928506394353581,-0.6982987137497361,1.2302076806038449,43.49514563106796,38.44660194174755,612391403,520260679.81712514,11.035811229570886,34.401897662913626,21.908928674215108,35.714285714285715,85.71428571428571
2000-04-07,104.125,107.375,102.625,106,82.09285665728083,95.42952677279368,103.92519049686588,107.28834443635002,77.75937467500002,94.77023420000002,104.85874980000006,108.93203099999997,108.93203099999997,119.6981757734105,98.16588622658944,20645296,48.62768683570509,52.11318628424054,NaN,NaN,NaN,NaN,NaN,NaN,-1.5336562798901734,-0.686862669258872,0.8467936106313014,54.95145631067961,43.88349514563105,633036699,528953436.0276514,14.478490162415717,32.363434561505365,24.07337746173058,28.571428571428573,78.57142857142857
2000-04-10,107.625,107.6875,99.25,100,82.27103718805415,95.5200311931344,103.77126145777311,106.59421639479287,77.98593717500002,95.03148420000001,105.14374980000007,108.37265599999996,108.37265599999996,119.75672729257995,96.98858470741997,26985200,42.00114215960653,51.01384016793062,NaN,NaN,NaN,NaN,NaN,NaN,-1.5964011198391457,-1.1487077891676307,0.44769333067151496,36.310679611650485,44.919093851132665,606051499,506765604.9165403,13.086670244441093,33.09753899939795,26.046543428993754,21.428571428571427,71.42857142857143
2000-04-11,97.125,101.5,95.75,97.73437,82.42490119613322,95.56387948633966,103.53452061629181,105.75042150005069,78.19468715000002,95.28007790000001,105.29843720000007,107.90937449999997,107.90937449999997,120.19743167378671,95.62131732621323,34495600,39.7958615920143,49.565974298653295,NaN,NaN,NaN,NaN,NaN,NaN,-1.7007111336336966,-1.678195586370606,0.022515547263090685,29.27182912621359,40.17798834951454,571555899,496079407.96767074,12.224246670975116,34.92774100234722,29.374830747419367,14.285714285714286,64.28571428571429
2000-04-12,97.625,98.75,63.125,92,82.52017581109706,95.49330761532303,103.08218647447644,104.4408575476649,78.37093715000002,95.44898415000002,105.28843720000006,107.36093699999996,107.36093699999996,121.34424489358827,93.37762910641166,34824896,34.813534093564485,47.590133435401135,NaN,NaN,NaN,NaN,NaN,NaN,-2.043095908355014,-2.5313543381806767,-0.4882584298256628,50.326797385620914,38.63643537449497,536731003,517707501.2729339,8.490789070149004,52.22981962495696,34.2378665657212,7.142857142857143,100
2000-04-13,92.8125,96,88.25,89,82.5846516736732,95.36472726650476,102.52994386763423,102.97029968598254,78.52781215000002,95.58117165000002,105.21093720000006,106.38593699999997,106.38593699999997,122.47617342607165,90.29570057392829,46323808,32.51970437613021,45.34479317401359,NaN,NaN,NaN,NaN,NaN,NaN,-2.3375952210316884,-3.4102524561152734,-1.072657235083585,45.8980044345898,41.83221031547475,490407195,480349591.59551454,7.923825037100072,48.74222513458244,38.533756049976546,0,92.85714285714286
2000-04-14,86.0625,88.5,78,79.75,82.55644618438292,95.05552474637595,101.63661273557014,100.75884257303183,78.63648402500002,95.60367165000001,104.88343720000007,104.83281199999996,104.83281199999996,124.51078585808281,85.15483814191711,60840400,26.682060604669275,42.74818077424366,NaN,NaN,26.682060604669275,NaN,NaN,NaN,-2.9801752596915754,-4.797876309698054,-1.817701050006479,30.4,42.20826727340355,429566795,439789324.92884785,7.1899701200671515,52.85794118282462,43.116738466677994,0,85.71428571428571
2000-04-17,78.01562,90,78,89,82.6205611477224,94.9356133652596,101.14105929495955,99.63895280417165,78.787734025,95.74398415000002,104.72531220000008,103.92031199999997,103.92031199999997,124.72557714513536,83.11504685486457,55386192,38.55967423278171,41.29795425346702,NaN,NaN,NaN,NaN,NaN,NaN,-2.61982124364266,-5.092477604559804,-2.472656360917144,49.46236559139785,41.92012334199586,484952987,485944484.92884785,7.7110333074568365,47.67109140337904,48.12041113001244,0,78.57142857142857
2000-04-18,89.48437,93,87.375,91.75,82.71140133530724,94.87253191248217,100.7727824598631,98.88762396567911,78.95460902500001,95.88710915000001,104.59218720000007,102.93281199999997,102.93281199999997,124.07734787949799,81.78827612050195,36252608,41.58928682065821,40.56728433377996,NaN,NaN,NaN,NaN,NaN,NaN,-2.0585816574069766,-5.045883432675865,-2.987301775268888,57.68261964735516,45.848328412917645,521205595,506084822.70662564,9.86430732597975,45.42111885716138,51.91383132276617,0,71.42857142857143
2000-04-19,92.5,93.625,89.0625,89.0625,82.77459634689623,94.75748177560133,100.31355569673121,97.95189787370967,79.10757777500001,96.00085915000001,104.32843720000007,101.68593699999997,101.68593699999997,123.01322443762042,80.35864956237951,28077904,39.53745051218756,40.00522981265897,NaN,NaN,NaN,NaN,NaN,NaN,-1.7431686170964449,-5.1662625466394445,-3.4230939295429996,54.60526315789474,53.91674946554922,493127691,478006918.70662564,10.016127748328952,43.62266479151182,54.49407237306605,0,64.28571428571429
2000-04-20,90.375,90.96875,86.1875,86.875,82.81539638324553,94.60139302756963,99.78655351254568,96.89695521907065,79.24570277500001,96.10554665000001,104.08593720000007,100.21093699999997,100.21093699999997,121.35023088714017,79.07164311285977,21252000,37.89849388452535,39.10184674130318,NaN,NaN,NaN,NaN,NaN,NaN,-1.5624875002946403,-5.3762033049113,-3.8137158046166597,51.630434782608695,54.63943919595284,471875691,462866604.9811354,9.587698465061429,44.32877936900037,57.20156905102382,0,57.142857142857146
2000-04-24,83.4375,85.25,79.875,85,82.83713373266598,94.41126643296428,99.20668866891644,95.76391186487345,79.371484025,96.21554665000002,103.74218720000007,98.56718699999996,98.56718699999996,119.05944862108252,78.0749253789174,31245600,36.50176982136775,38.62706824109616,NaN,NaN,NaN,NaN,NaN,NaN,-1.4522211006462298,-5.628992180424447,-4.176771079778217,49.08835904628331,51.77468566226222,440630091,491205637.53927493,8.98195147127844,47.225551081927044,59.6891871495269,0,50
2000-04-25,86.5,90.5,86,90.4375,82.91275926766433,94.33257798874716,98.86279891719423,95.25663454440931,79.526015275,96.36898415000002,103.57093720000007,97.22109349999997,97.22109349999997,116.06980829083977,78.37237870916016,28614304,43.0559678818175,38.82807987038145,NaN,NaN,NaN,NaN,NaN,NaN,-0.9218930561168026,-5.329137399924221,-4.4072443438074185,61.29032258064516,54.00303880317903,469244395,519025099.76149714,13.370155466254394,44.82900736354669,59.87699784043334,28.571428571428573,42.857142857142854
2000-04-26,90.625,92.42187,87.125,87.375,82.9571596729612,94.19480416718781,98.41229699887289,94.506002683037,79.666640275,96.46796855000001,103.33124970000009,95.83984349999994,95.83984349999994,113.27010027353707,78.40958672646282,25679696,40.51920229301785,38.974745286867595,NaN,NaN,NaN,NaN,NaN,NaN,-0.6964281446375837,-5.277779524604398,-4.581351379966814,54.4179523141655,54.93221131369796,443564699,495769448.1499756,14.515812073630135,42.58754115574172,59.71521732490362,21.428571428571427,35.714285714285715
2000-04-27,83.5,92.48437,82.25,91.375,83.04091927820537,94.13896646090687,98.13632456754453,94.20781195131919,79.822226225,96.59046855000003,103.15374970000008,94.88359349999995,94.88359349999995,111.04401189546334,78.72317510453655,37032896,45.07133198242629,39.083797649319415,NaN,NaN,NaN,NaN,NaN,NaN,-0.22156523066990186,-4.858307918304192,-4.63674268763429,63.394109396914445,59.70079476390834,480597595,524773870.71477246,13.147906374049501,43.0630603856876,59.84343077366194,14.285714285714286,28.571428571428573
2000-04-28,93.5625,94.75,92.125,94.5,83.15493998190482,94.14611563989881,97.99372360411141,94.23563938452688,79.99066372499999,96.73703105000003,103.04374970000008,94.24609349999994,94.24609349999994,109.37809021446009,79.1140967855398,24826704,48.39418547396578,39.06711898062375,NaN,NaN,NaN,NaN,NaN,NaN,0.32938695712966304,-4.225008991222211,-4.554395948351874,70.40673211781206,62.739597942963975,505424299,544871678.7147725,14.895995780322119,41.66855371697846,60.49696612929625,7.142857142857143,21.428571428571427
2000-05-01,95.75,96.875,94.25,95.75,83.28026396218438,94.17787572623745,97.90573444316587,94.37986420504812,80.16253872499999,96.89609355000002,102.9212497000001,93.55859349999994,93.55859349999994,107.0123184048889,80.10486859511099,23203392,49.70482459543674,39.61738201175448,NaN,NaN,NaN,NaN,49.70482459543674,NaN,0.7787397444215278,-3.580971267824964,-4.359711012246492,85.01628664495114,72.93904271989253,528627691,548186449.0004867,16.640402647676254,40.56817695450072,60.389617681801994,0,14.285714285714286
2000-05-02,94.875,95.625,89.75,90,83.34712700733677,94.0951455138367,97.59570564147309,93.96273428075783,80.308788725,97.00734355000003,102.74499970000008,92.88359349999993,92.88359349999993,105.60941837371443,80.15776862628543,20304608,44.15014356627597,39.92840215277317,NaN,NaN,NaN,NaN,NaN,NaN,0.6923576280284802,-3.494263977210892,-4.186621605239372,75.43859649122807,76.9538717513304,508323083,529609892.7451676,15.624733570161334,42.66976900670162,60.264203324865115,0,7.142857142857143
2000-05-03,89.5,90.25,85.51562,89.375,83.40710584308466,94.00167728583993,97.27332502808198,93.52580720639995,80.463632475,97.11109355000002,102.55937470000008,92.31484349999992,92.31484349999992,104.59241198449452,80.03727501550533,26587296,43.580051269861606,40.554581951080095,NaN,NaN,NaN,NaN,NaN,NaN,0.6002030501782585,-3.436367792516549,-4.0365708426948075,60.264900662251655,73.5732612661436,481735787,546369551.7578535,14.854296730659684,44.975901378040746,58.71505320688753,0,0
2000-05-04,89,90.75,87.625,89.125,83.4640003123077,93.9051094187936,96.95378287011799,93.10668271055233,80.61581997499998,97.20734355000002,102.25937470000008,91.82109349999993,91.82109349999993,103.77351118289754,79.86867581710233,17749296,43.33898499168241,41.32738770933383,NaN,NaN,NaN,NaN,NaN,NaN,0.5318249403386459,-3.3717896672715,-3.903614607610146,58.94039735099338,64.88129816815768,463986491,545659579.9178535,14.893094482817734,43.45285093256647,57.06617784472603,78.57142857142857,7.142857142857143
2000-05-05,88.125,92.3125,88.03125,91.5,83.54396050820515,93.85748348970859,96.73990903207415,92.95366530954735,80.78734342499999,97.31242170000002,101.95937470000008,91.28046849999993,91.28046849999993,102.22112136175605,80.3398156382438,20569200,46.373812004453086,42.733941380746955,NaN,NaN,NaN,NaN,NaN,NaN,0.6482431844338135,-3.093310627067879,-3.7415538115016926,71.52317880794702,63.57615894039734,484555691,558421492.3266126,15.921075980685039,41.385165995076036,54.80778867636377,71.42857142857143,0
2000-05-08,90.5,90.75,87.75,88.25,83.5907867718051,93.74644421268465,96.4069714229732,92.50569718482855,80.94218717499999,97.39960920000001,101.64062470000007,90.39296849999992,90.39296849999992,99.05617150994085,81.729765490059,13901102,42.981211849752974,43.04976549624491,NaN,NaN,NaN,NaN,NaN,NaN,0.5139335300297065,-3.0991368989645594,-3.613070428994266,49.26470588235294,59.90942734709777,470654589,549154090.9932792,15.237140818838743,39.92953218507812,52.85109346226595,64.28571428571429,0
2000-05-09,88.5,89.125,84.75,85.5,83.6097839183543,93.583148287681,95.97924705344484,91.8384879291306,81.09031217499998,97.44460920000002,101.27562470000008,89.66796849999993,89.66796849999993,97.36717649117944,81.96876050882042,19796800,40.29497218824307,42.9573144510724,NaN,NaN,NaN,NaN,NaN,NaN,0.26025069370872655,-3.2877570618583576,-3.548007755567084,33.088235294117645,51.29203999480586,450857789,536144765.2789935,14.45686505567034,41.3962494535711,51.70234875250555,57.142857142857146,21.428571428571427
2000-05-10,84.375,85.4375,79.5,80,83.57386567041047,93.31417505426157,95.35260991409406,90.71101288826101,81.20531217499997,97.41335920000002,100.73562470000007,88.78124999999993,88.78124999999993,96.6433922812127,80.91910771878716,34814400,35.51434779322169,42.669949971146266,NaN,NaN,35.51434779322169,NaN,NaN,NaN,-0.23104620639680906,-3.8368155135630957,-3.6057693071662866,2.8776978417266186,28.41021300606572,416043389,507193843.1737303,13.44035157714553,44.63796774177002,51.063994467491106,50,100
2000-05-11,82.75,85.25,80.875,84.75,83.58556849956061,93.1445874294247,94.93682129001193,90.1432973750933,81.33847624999999,97.42304670000001,100.27812470000008,88.41874999999995,88.41874999999995,96.32227967034488,80.51522032965501,24707008,41.92282507501586,42.95740219903844,NaN,NaN,NaN,NaN,NaN,NaN,-0.19086274782867818,-3.8443477419521344,-3.653484994123456,30.215827338129497,22.060586824657907,440750397,526253535.0594446,12.6051708079228,41.86417331971751,50.29838455481877,42.857142857142854,92.85714285714286
2000-05-12,85.375,87.5625,84,84.6875,83.5965329921023,92.97712035161432,94.53488712177617,89.62369762508442,81.47753874999998,97.42117170000002,99.86921850000007,88.20312499999994,88.20312499999994,96.26517682863037,80.14107317136951,17830800,41.86387257279382,43.340409538426016,NaN,NaN,NaN,NaN,NaN,NaN,-0.12635167254027513,-3.8114245847988,-3.685072912258525,29.85611510791367,20.983213429256583,422919597,515304798.21733934,14.877254081909868,40.04570374317065,48.71159750156424,35.714285714285715,85.71428571428571
2000-05-15,84.8125,88.625,82.625,88.625,83.64656748969333,92.89093975059225,94.30312684249083,89.52858356555257,81.63769499999998,97.42054670000002,99.45124980000008,88.64687499999994,88.64687499999994,95.71465786929684,81.57909213070303,17946496,46.92733754786595,43.616935943143766,NaN,NaN,NaN,NaN,NaN,NaN,0.20558434072872167,-3.428092486347623,-3.6336768270763447,52.51798561151079,37.52997601918464,440866093,533251294.21733934,13.79074743989451,38.79474624439546,48.24698643908801,28.571428571428573,78.57142857142857
2000-05-16,90,91.5,88.0625,91.0625,83.72035786293021,92.85473302285776,94.17604343690294,89.67467084502375,81.81081999999998,97.4396092,99.04249980000007,88.74999999999994,88.74999999999994,95.89514695440361,81.60485304559627,23826896,49.83985943010277,44.282697167221265,NaN,NaN,NaN,NaN,49.83985943010277,NaN,0.5915414259037006,-2.8942500446967188,-3.4857914706004194,66.54676258992805,49.64028776978417,464692989,551013162.1446121,16.802254653079306,37.122047734298036,47.42716920247017,21.428571428571427,71.42857142857143
2000-05-17,89.25,90.5,87.75,89.1875,83.77475728717967,92.7821145471576,93.98041428251459,89.62827362168817,81.97640594999997,97.43492170000002,98.63124980000008,88.62187499999995,88.62187499999995,95.63798091336257,81.60576908663732,20336800,47.67261150329649,44.468502847283425,NaN,NaN,NaN,NaN,NaN,NaN,0.714563446438707,-2.592587162552036,-3.3071506089907428,55.75539568345324,58.273381294964025,444356189,551937562.1446121,16.082640062416022,35.93620983913209,46.35193209279738,14.285714285714286,64.28571428571429
2000-05-18,89,89.35937,85.375,85.6875,83.79378955297888,92.6416271303822,93.65520195771009,89.25296184819406,82.12957002499998,97.39492170000001,98.11374980000008,88.45312499999994,88.45312499999994,95.58019432669576,81.32605567330413,19061104,43.84033280274024,44.1432276564816,NaN,NaN,NaN,NaN,NaN,NaN,0.5610015064159062,-2.60589872597086,-3.1669002323867663,35.611510791366904,52.6378896882494,425295085,535866438.9947841,15.237304753516762,37.18044154495956,45.96129307338419,7.142857142857143,57.142857142857146
2000-05-19,83.75,85,81.3125,81.6875,83.77283144797411,92.42471372185979,93.18588031230969,88.53244167217558,82.25835909999998,97.31992170000001,97.4474998000001,88.19374999999994,88.19374999999994,95.88677646882428,80.5007235311756,28178096,39.893349622598215,43.44240801556457,NaN,NaN,NaN,NaN,NaN,NaN,0.20894460106141022,-2.9057194810600038,-3.114664082121414,13.565891472868216,34.97759931589612,397116989,513419481.16427565,14.345653386401802,40.43851163310961,46.375790773256384,0,50
2000-05-22,81.625,82.25,75.57812,82,83.75519133406392,92.2182837471695,92.74721833927794,87.91030437006361,82.39171847499998,97.21492169999999,96.7937498000001,88.04374999999993,88.04374999999993,96.08894460610061,79.99855539389925,43876896,40.345217442787195,43.170627578172514,NaN,NaN,NaN,NaN,NaN,NaN,0.02566774985135023,-3.082579394807226,-3.108247144658576,38.37536855264432,29.184256938959816,440993885,554008181.3334154,13.087857060589128,44.42872942766891,46.954101192147235,0,100
2000-05-23,81.375,82.625,74.625,75.125,83.66931878347623,91.8798028808889,92.0561509534239,86.69265633481946,82.49425754999999,97.0511717,96.0724998000001,87.27812499999993,87.27812499999993,97.00505885335423,77.55119114664564,31906896,34.24561866903581,42.50388239239924,NaN,NaN,34.24561866903581,NaN,NaN,NaN,-0.500961318526334,-3.734448792816494,-3.23348747429016,2.8268551236749118,18.25603838306248,409086989,526089647.3334154,11.756775526766912,41.121865995555005,47.324660961047925,14.285714285714286,100
2000-05-24,75,79.875,72.25,79.75,83.63032058662571,91.63960876443566,91.57355679838767,86.03145096959857,82.62238254999998,96.93492169999999,95.5274998000001,86.89687499999994,86.89687499999994,97.16159575545763,76.63215424454225,49469600,40.736722983160156,42.318006534647644,NaN,NaN,NaN,NaN,NaN,NaN,-0.48014521272712996,-3.8336689901990724,-3.3535237774719424,37.38317757009346,26.195133748804228,458556589,573937293.2350547,10.645465305997222,40.17904206344704,47.978941629098266,7.142857142857143,100
2000-05-25,80.25,82.25,76.5,77.5,83.56932237183342,91.35961651167456,91.02165261021561,85.2189318296368,82.73035129999998,96.76242169999999,95.0181248000001,86.20312499999993,86.20312499999993,97.02388593384968,75.38236406615017,29631504,38.73347015587691,41.77226783117793,NaN,NaN,NaN,NaN,NaN,NaN,-0.5549443828755267,-4.047204256066351,-3.4922598731908243,27.272727272727273,22.494253322165218,428925085,554612399.3220112,12.831189714411511,37.31460912505684,48.2924673916638,0,92.85714285714286
2000-05-26,77.75,79.25,75.75,77.6875,83.51079677609378,91.08888153124536,90.49874466471697,84.50165260776663,82.84253879999999,96.65921859999999,94.4018748000001,85.36249999999993,85.36249999999993,96.08620330156654,74.63879669843331,18199504,39.00266329379622,41.48808579146673,NaN,NaN,NaN,NaN,NaN,NaN,-0.5289318734553783,-4.153424715010047,-3.6244928415546687,28.246753246753247,30.96755269652466,447124589,556562346.179154,12.258321190950367,36.605352137872536,48.65438364696162,42.857142857142854,85.71428571428571
2000-05-30,80,85.9375,80,85.5,83.53058984299832,90.97821060983456,90.30271546217905,84.59673331178885,82.98175754999998,96.65234359999998,93.89562480000009,84.84999999999994,84.84999999999994,94.46098004888266,75.23901995111721,30882400,49.04821024865197,42.113317081495936,NaN,NaN,NaN,NaN,NaN,NaN,0.04671905428533529,-3.5660940236979997,-3.612813077983335,68.83116883116882,41.45021645021645,478006989,582893655.6528382,19.262160493800824,32.87905141277868,47.07458749914834,35.714285714285715,78.57142857142857
2000-05-31,84.46875,86.67187,82.75,83,83.52531034207297,90.82022624132298,90.01633446366223,84.44466347257087,83.10617162499997,96.67484359999999,93.4106248000001,84.49999999999993,84.49999999999993,93.84135629874075,75.15864370125911,29666800,46.414023306447724,42.89186533244065,NaN,NaN,NaN,NaN,NaN,NaN,0.2784699812188154,-3.2647256014598156,-3.543195582678631,55.84415584415584,50.97402597402597,448340189,557009081.9887443,19.235553144443383,31.25045460190422,44.93758890950903,28.571428571428573,71.42857142857143
2000-06-01,85.1875,88.375,84,87.5,83.56485949289811,90.75447918703937,89.91765468077352,84.7356479037546,83.251640375,96.66484359999998,92.93062480000009,84.40624999999993,84.40624999999993,93.58626395696234,75.22623604303752,28987808,51.46668870877831,43.5735698777094,NaN,NaN,NaN,NaN,NaN,NaN,0.7286112408641396,-2.6324315315984563,-3.361042772462596,79.22077922077922,67.96536796536797,477327997,574401766.7887442,20.083777378573846,29.121447012247092,42.412648808213355,21.428571428571427,64.28571428571429
2000-06-02,92.625,94.10937,91.875,93.25,83.6612290501827,90.80389544076135,90.04833488937064,85.54653857958749,83.42914037499999,96.67484359999999,92.51562480000011,84.61249999999993,84.61249999999993,94.37423972711967,74.85076027288018,32238704,57.040685853564696,44.65762796919304,NaN,NaN,NaN,NaN,NaN,NaN,1.3701496088469183,-1.6483557614039483,-3.0185053702508666,96.06864241741643,77.0445258274505,509566701,581841556.502856,25.60141573118732,26.711612317186496,39.2910209834199,100,57.142857142857146
2000-06-05,92.25,95.3125,91.875,93.625,83.76037104968337,90.85975889737993,90.18859626625806,86.31591585772202,83.61195287499999,96.72859359999998,92.06062480000011,84.71874999999993,84.71874999999993,94.81844832470377,74.61905167529609,23780608,57.38443621513516,45.40456358828369,NaN,NaN,NaN,NaN,57.38443621513516,NaN,1.7518786838846063,-0.8286570153951089,-2.5805356992797153,92.6829268292683,89.3241161558213,533347309,582273931.1937652,26.017742339901233,25.528393382647153,35.96245733375868,100,50
2000-06-06,93.1875,95,90.875,91.375,83.83613850192533,90.86996169149123,90.23512190287539,86.79773339508182,83.778984125,96.77671859999998,91.53062480000011,84.87499999999994,84.87499999999994,95.28045229675371,74.46954770324618,23199008,54.56331030944806,45.74195293680837,NaN,NaN,NaN,NaN,NaN,NaN,1.7792392051453199,-0.35648669284806545,-2.1357258979933853,82.92682926829268,90.55946617165914,510148301,564698925.1331592,24.609020445475895,25.458765016752814,33.39210867584087,92.85714285714286,42.857142857142854
2000-06-07,91.5625,93.4375,89.5625,93.4375,83.93167443722956,90.92080403423398,90.36070535766459,87.43009211935974,83.94710912499998,96.79859359999999,91.05218740000014,85.27187499999994,85.27187499999994,96.32757736066041,74.21617263933946,22520896,56.666360503670504,46.38436357969222,NaN,NaN,NaN,NaN,NaN,NaN,1.8542125275848123,0.1820397614876299,-1.6721727660971824,91.869918699187,89.15989159891599,532669197,587219821.1331592,23.33104562729883,25.895620407726344,31.038081532741703,85.71428571428571,35.714285714285715
2000-06-08,94.625,94.875,91.625,93,84.02190653238151,90.96197623157589,90.46420710834441,87.96055953656358,84.111015375,96.80171859999999,90.61218740000012,85.92187499999994,85.92187499999994,97.18796592309793,74.65578407690195,19308800,56.07347719113148,47.25815960743445,NaN,NaN,NaN,NaN,NaN,NaN,1.7913281209769412,0.5669873851239942,-1.224340735852947,89.97289972899729,88.25654923215899,513360397,584249236.5177746,24.267436871122403,24.73539299691277,28.11614721191514,78.57142857142857,28.571428571428573
2000-06-09,94.75,94.75,93,93.5625,84.11683781066627,91.0134717517427,90.58570879037012,88.49407767593847,84.27132787499998,96.79734359999999,90.27343740000013,86.36249999999994,86.36249999999994,98.09064456766322,74.63435543233666,17013008,56.70074568772638,48.45868789780075,NaN,NaN,NaN,NaN,NaN,NaN,1.7050685297376835,0.9069949263191575,-0.7980736034185261,92.41192411924119,91.41824751580849,530373405,578173162.2320603,23.652910173974902,24.10901620064194,24.782325056393784,71.42857142857143,21.428571428571427
2000-06-12,94.3125,94.3125,90.8125,91,84.18532698667954,91.01320498438146,90.60195550447325,88.73273694489671,84.42394507499999,96.75453109999998,89.94843740000013,86.67812499999994,86.67812499999994,98.54787877535347,74.80837122464641,16421301,52.988519210302236,49.36178088119468,NaN,NaN,52.988519210302236,NaN,NaN,NaN,1.4053633004246733,0.9586305221123155,-0.44673277831235775,81.30081300813008,87.89521228545618,513952104,563511286.3392031,22.429556016120017,26.094639504904944,21.42967922655014,64.28571428571429,14.285714285714286
2000-06-13,90.5,94.1875,89.35937,94.1875,84.28485109626482,91.07606231142341,90.74256509253313,89.25223818823989,84.595507575,96.74140609999999,89.64218740000015,86.95624999999994,86.95624999999994,99.24859390789717,74.6639060921027,25039392,56.779138076322525,50.97131798171516,NaN,NaN,NaN,NaN,NaN,NaN,1.3513339833703115,1.2424347009005317,-0.10889928246977981,95.1219512195122,89.61156278229448,538991496,588550678.3392031,20.829134304808925,26.380232332846244,18.30292765106065,57.142857142857146,7.142857142857143
2000-06-14,94.875,94.875,91.5625,92.15625,84.36317347341641,91.09745216664275,90.79800371635535,89.52881074174086,84.76113257499999,96.70046859999998,89.41531240000013,87.01093749999994,87.01093749999994,99.3853262948814,74.63654870511849,20239600,53.80197726539886,51.90455043044649,NaN,NaN,NaN,NaN,NaN,NaN,1.117993478122254,1.2885925651830377,0.1705990870607837,83.86581469648563,86.76285964137598,518751896,575566783.9995805,20.8254075008584,25.059115834478625,14.811352497906165,50,0
2000-06-15,91.875,93.8125,90.875,93.79687,84.45704110054659,91.15090598512508,90.91560631571397,89.93529257586077,84.93167942499998,96.72593729999998,89.27624980000013,87.24140599999994,87.24140599999994,99.9368904824665,74.54592151753339,18676496,55.81708011902895,53.12480828495735,NaN,NaN,NaN,NaN,NaN,NaN,1.016278320770069,1.44094698802337,0.424668667253301,92.25237060702875,90.41337884100886,537428392,594044530.2923601,19.874861199924087,24.98358206442664,12.137357512869622,42.857142857142854,7.142857142857143
2000-06-16,94.75,95.3125,93.0625,94.17187,84.55370606472026,91.21072705472656,91.04330293078401,90.33877614006451,85.10195284999998,96.73609349999998,89.17968720000013,87.66562449999995,87.66562449999995,100.68786786976042,74.64338113023948,21158496,56.28643143620884,54.35936315227254,NaN,NaN,NaN,NaN,NaN,NaN,0.9193102425510908,1.5738064704421646,0.6544962278910738,92.55098775510203,89.55639101953881,558586888,593750568.2546,21.572666391567864,24.077071727590198,8.970192422212843,35.714285714285715,0
2000-06-19,94.01562,98.25,92.6875,97.8125,84.68563436258374,91.34145523186069,91.30876163938072,91.05055936482027,85.29148409999998,96.81921849999999,89.08968720000013,88.47187449999994,88.47187449999994,101.90403322845,75.03971577154988,19986496,60.656122612730364,55.18849974970671,NaN,NaN,NaN,NaN,NaN,NaN,1.0367103519517622,1.9503841678307765,0.9136738158790143,97.1774193548387,93.99359257232317,578573384,610593121.0635889,24.32436423147206,21.956052950987836,7.470328009028099,100,0
2000-06-20,98.25,99.6875,97.1875,98.39062,84.82200237887643,91.48104265301197,91.58648157509128,91.74961275864692,85.47015594999999,96.89812469999998,88.93749960000014,89.29140549999994,89.29140549999994,103.04042853498085,75.54238246501903,20876192,61.31738892469174,56.25302586529557,NaN,NaN,NaN,NaN,NaN,NaN,1.0845128744059545,2.2693149088864573,1.1848020344805028,91.7330358565737,93.82048098883814,599449576,609810180.3588208,25.681056260515827,21.05817710512006,6.476921681368222,100,0
2000-06-21,96.8125,99.71875,96.6875,98.6875,84.95996752933537,91.6237447786949,91.86495288587201,92.41036392449007,85.65171844999999,97.02749969999999,88.91124960000013,90.46953049999993,90.46953049999993,103.1582510724785,77.78080992752136,20841008,61.67363045992266,56.98209313323445,NaN,NaN,NaN,NaN,61.67363045992266,NaN,1.0657671864871947,2.517011017589496,1.4512438311023015,90.04525367348239,92.98523629496493,620290584,616470708.6887177,24.37924307138736,20.82685463182188,5.72627235922792,100,0
2000-06-22,98.625,99,94.76562,94.76562,85.05753621063552,91.68596012961183,91.97870453740644,92.63467402691958,85.8178903,97.07515589999998,88.85187460000012,91.22031149999994,91.22031149999994,103.02956852560945,79.41105447439043,21406608,54.52936976052419,56.802713412302985,NaN,NaN,NaN,NaN,NaN,NaN,0.7346325430882772,2.369534509962648,1.6349019668743707,52.187003469319585,77.9884309997919,598883976,595064100.6887177,22.651846134880817,22.567106171262935,5.588071005680816,92.85714285714286,50
2000-06-23,95,95.5,91.4375,91.64062,85.12303953192273,91.68506230526307,91.96544632025325,92.540002214832,85.96406214999999,97.0665621,88.84468700000012,91.92734249999994,91.92734249999994,101.91958561517151,81.93509938482836,24801104,49.59908660508581,56.24661701158518,NaN,NaN,NaN,NaN,NaN,NaN,0.27423782333163116,1.9776992460389096,1.7034614227072784,22.021105510175317,54.75112088432578,574082872,572743046.0398463,21.106663756161552,26.616030455626515,6.3448710609751275,85.71428571428571,42.857142857142854
2000-06-26,93.0625,94.42187,92,94.1875,85.21323316842101,91.73461552694103,92.05258568024333,92.69690676580038,86.11937465,97.07968709999999,88.94843700000013,92.75234249999994,92.75234249999994,100.3411145991402,85.16357040085968,22073104,53.30468095786948,56.15671491504385,NaN,NaN,NaN,NaN,NaN,NaN,0.11830113145576848,1.851337837026989,1.7330367055712206,46.606360612314646,40.27148986393652,596155976,590544018.6831013,20.095976929732362,25.341529110264112,7.048253505103818,78.57142857142857,35.714285714285715
2000-06-27,93.76562,95.0625,92.39062,92.71875,85.28791492793921,91.75410333828873,92.07870977121418,92.6989870738194,86.271132475,97.04562459999997,89.20781200000012,93.11327999999995,93.11327999999995,99.9359839948114,86.2905760051885,14741500,50.977028864163444,55.75033408365049,NaN,NaN,NaN,NaN,NaN,NaN,-0.09517046537986085,1.6140736238463944,1.7092440892262553,32.42838857151684,33.68528489800227,581414476,579423286.3785068,20.27915682135899,24.145360735995148,7.297763079764093,71.42857142857143,28.571428571428573
2000-06-28,92.98437,95.5,92.5,93.89062,85.37351398338261,91.79641059891668,92.14976507430382,92.81247592393183,86.42703089999999,97.0154683,89.30562440000013,93.65781099999994,93.65781099999994,98.66065007240759,88.65497192759229,19233808,52.74987844981163,55.512934173556225,NaN,NaN,NaN,NaN,NaN,NaN,-0.16477817998490596,1.5032713642451228,1.6680495442300287,43.74055204075919,40.9251004081969,600648284,578020757.0991467,19.97161862018258,22.841664997685434,7.70838293059627,64.28571428571429,21.428571428571427
2000-06-29,92.9375,93.375,90.625,91.70312,85.43649513777682,91.79456326032427,92.13224958119386,92.70682297879546,86.5780465,96.94843699999997,89.30468680000013,93.86796699999994,93.86796699999994,98.1143975864831,89.62153641351678,21258400,49.17493355677438,54.97537616420251,NaN,NaN,NaN,NaN,NaN,NaN,-0.35457743138924713,1.2248277549934699,1.579405186382717,22.624423469358202,32.93112136054475,579389884,573430797.9776921,18.782757884769037,24.89981026765175,8.64041579674426,57.142857142857146,14.285714285714286
2000-06-30,91.8125,93.95312,91.3125,93.1875,85.5136195642666,91.82214616606042,92.17363195055881,92.7526017427197,86.73664025,96.857812,89.38718680000012,93.86484199999994,93.86484199999994,98.11317862605932,89.61650537394056,15065602,51.57329442534523,54.874288679562724,NaN,NaN,NaN,NaN,NaN,NaN,-0.37462186206679626,1.1111278587992217,1.485749720866018,36.95327326538848,34.43941625850196,594455486,579760174.2403729,18.936055784145083,23.672681549017966,8.894948274865891,50,7.142857142857143
2000-07-03,93.5,95.25,93.25,95.125,85.6092551904928,91.88754921227705,92.2893718740663,92.97854443388925,86.89570275,96.81906199999999,89.55218680000013,93.93984199999994,93.93984199999994,98.22142568928092,89.65825831071896,5186000,54.58568085531474,54.71761316377645,NaN,NaN,NaN,NaN,54.58568085531474,NaN,-0.25744559880126316,1.163942722364439,1.4213883211657021,49.48453608247423,36.35407760574031,599641486,584297924.2403729,20.68516190085894,22.73041415474743,8.391548603278633,42.857142857142854,0
2000-07-05,93.625,93.96875,90.875,91.25,85.66538200451775,91.87492447540028,92.24861219273038,92.81392115447123,87.034648075,96.70968699999999,89.67718680000013,93.93359199999995,93.93359199999995,98.23047106954662,89.63671293045327,16069500,48.13636394254466,54.3129264978583,NaN,NaN,48.13636394254466,NaN,NaN,NaN,-0.43075803666842605,0.8829407753301695,1.3136988119985955,6.8728522336769755,31.103553860513234,583571986,572124060.6040093,19.0063391778825,25.421049519949474,8.763817359556716,35.714285714285715,78.57142857142857
2000-07-06,91.5625,94.75,90.0625,94.5625,85.75391054178623,91.92814379271908,92.33935289105467,92.98045247309302,87.197773075,96.66531199999997,89.75968680000013,93.98984199999994,93.98984199999994,98.28872523734367,89.69095876265621,23457600,53.22411510459908,54.127714711113306,NaN,NaN,NaN,NaN,NaN,NaN,-0.3173865969375729,0.9169655658266294,1.2343521627642022,46.601941747572816,34.31977668790801,607029586,593705052.6040093,17.335202863367368,24.709935396685058,9.2032100975531,28.571428571428573,100
2000-07-07,95,97,94.4375,95.40625,85.84995372047491,91.99701718296227,92.45962336591528,93.21148080898892,87.361835575,96.62578074999998,89.92031180000012,94.11015449999994,94.11015449999994,98.42614587918428,89.7941631208156,16488500,54.449846549872966,53.99653007637503,NaN,NaN,NaN,NaN,NaN,NaN,-0.18709684422079165,1.0004811074882127,1.1875779517090044,55.33980582524272,36.27153326883084,623518086,589683467.2381556,20.80340976577238,23.49382125574029,9.245167975186954,21.428571428571427,92.85714285714286
2000-07-10,94.6875,95.875,94,94.25,85.93353627051994,92.04163070409173,92.52983421431075,93.31038739860902,87.533085575,96.56578074999997,89.97781180000013,94.14452949999995,94.14452949999995,98.45347151459906,89.83558748540084,12591102,52.42256429059309,53.408418767650936,NaN,NaN,NaN,NaN,NaN,NaN,-0.18024192089917657,0.9622755505850336,1.1425174714842101,43.36569579288026,48.435814455231935,610926984,580449992.4381557,20.026742289357998,23.487829653830115,9.447778738824699,14.285714285714286,85.71428571428571
2000-07-11,94.0625,95.75,92.8125,93.20312,86.00587043698242,92.06463049212952,92.55623757845542,93.30017145588435,87.69871055000002,96.49781194999997,89.9518742000001,94.25468549999994,94.25468549999994,98.34346051483112,90.16591048516875,14316398,50.58611587115362,52.641899263826794,NaN,NaN,NaN,NaN,NaN,NaN,-0.24372235803150377,0.8378645239448304,1.0815868819763341,32.5242200647249,43.74324056094929,596610586,569941098.3610561,18.840035057978014,24.491492329753502,9.672891495141537,7.142857142857143,78.57142857142857
2000-07-12,95.4375,97.75,94.625,96.96875,86.11495381571892,92.1617417695131,92.72927728126109,93.64955988865727,87.88105430000002,96.44874944999998,89.97624920000013,94.39374799999993,94.39374799999993,98.64969137956199,90.13780462043788,18217696,56.49044478822611,52.27167171584847,NaN,NaN,NaN,NaN,NaN,NaN,-0.04028124921002152,1.0312353204638072,1.0715165696738287,77.27272727272727,51.05421437677747,614828282,579049946.3610561,21.100595298922357,22.28978559304978,9.307353701796888,0,71.42857142857143
2000-07-13,97.9375,99.75,97.125,98.9375,86.24254133994062,92.29591519981977,92.97273699572143,94.15317323259467,88.07183555000002,96.44999944999996,90.1549992000001,94.73281049999994,94.73281049999994,99.29143502082907,90.17418597917082,19404304,59.23307416256737,52.6076506017087,NaN,NaN,NaN,NaN,NaN,NaN,0.20521551974507313,1.3280359693551702,1.122820449610097,91.61290322580645,67.13661685441954,634232586,586442062.1705799,23.941227860530866,21.043619630257083,9.7540607811447,100,64.28571428571429
2000-07-14,100.25,101.125,98.8125,100.625,86.38565038133424,92.46084757210058,93.27282574098726,94.76953768663327,88.27714805000001,96.46968694999995,90.37999920000011,95.07421699999995,95.07421699999995,100.27836980577092,89.87006419422897,17140192,61.47471599308062,53.45590984370833,NaN,NaN,NaN,NaN,NaN,NaN,0.44578616979652463,1.6800531618557528,1.2342669920592282,95.48022598870057,88.12195216241143,651372778,596170279.251661,25.634525666413815,20.040385140710466,9.804288582881751,100,57.142857142857146
2000-07-17,100.9375,102.0625,99.875,101.4375,86.53542002928117,92.63860306572235,93.59300904526226,95.40458171647772,88.48339805000002,96.44281194999998,90.62624920000012,95.43749849999993,95.43749849999993,101.3103803069824,89.56461669301747,12857898,62.54268625354918,54.11576736482831,NaN,NaN,NaN,NaN,62.54268625354918,NaN,0.6138016202594068,2.0015190173834867,1.38771739712408,94.79166666666667,93.96159862705791,664230676,601680806.9659467,26.432219730179014,19.1121814835498,10.127700690065131,100,50
2000-07-18,100.375,100.78125,98.35937,99.25,86.66193326282065,92.76952181689616,93.814851827801,95.77081202919413,88.67859337500002,96.37031194999996,90.7812492000001,95.50937349999995,95.50937349999995,101.53008639539432,89.48866060460558,20473904,57.88977720157874,54.609535103215116,NaN,NaN,NaN,NaN,NaN,NaN,0.534681260197486,2.0560689723709373,1.5213877121734514,76.5625,88.94479755178908,643756772,596265182.5830375,24.6986772594331,21.08800994227425,10.069342441029084,92.85714285714286,42.857142857142854
2000-07-19,98.3125,98.9375,95.65625,96.625,86.7610682552304,92.84586791953188,93.92505371690683,95.85216326450897,88.85390587500002,96.29468694999996,90.94874920000011,95.42109249999994,95.42109249999994,101.32078891995964,89.52139608004025,21262096,52.81228867167383,54.613992976205274,NaN,NaN,NaN,NaN,NaN,NaN,0.2756697072624079,1.8659748462514614,1.5903051389890535,54.6875,75.34722222222221,622494676,587557848.0306566,22.81716072362511,25.211512721787958,9.946601016602802,85.71428571428571,35.714285714285715
2000-07-20,97.875,100.1875,97.26562,100.1875,86.89466459099926,92.99124677261047,94.17063984565559,96.26505247741288,89.04484337500001,96.25906194999997,91.2424992000001,95.49609249999995,95.49609249999995,101.59476139966029,89.39742360033961,19338096,58.17400247924479,55.25678361352459,NaN,NaN,NaN,NaN,NaN,NaN,0.31172714115383426,1.9799640654313464,1.6682369242775121,84.375,71.875,641832772,606895944.0306566,23.740016807804952,23.31538079224382,9.010815284698925,78.57142857142857,28.571428571428573
2000-07-21,98.4375,99.51562,97.14062,97.3125,86.99832464482016,93.07681614344986,94.29385004778673,96.36480938432594,89.21519495000003,96.16218694999996,91.5887492000001,95.62343649999995,95.62343649999995,101.76200682189835,89.48486617810156,14369398,52.945564536043825,55.354802907145924,NaN,NaN,NaN,NaN,NaN,NaN,0.11930120924840493,1.8173634358380184,1.6980622265896135,60.416666666666664,66.49305555555556,627463374,594606387.8228587,22.202046949914916,22.070699983997276,8.23796649864036,71.42857142857143,21.428571428571427
2000-07-24,97.9375,99,94.3125,94.3125,87.0711025090508,93.10128513070828,94.29458141846176,96.16935134772346,89.37128870000002,96.02906194999997,91.7799992000001,95.75703049999996,95.75703049999996,101.6546403223283,89.85942067767161,18449904,48.08871881328594,54.890734189858144,NaN,NaN,NaN,NaN,NaN,NaN,-0.2144955041261032,1.4299428464319845,1.6444383505580877,35.416666666666664,60.069444444444436,609013470,576156483.8228587,20.049999771640916,25.779491464657923,8.7944582881526,64.28571428571429,14.285714285714286
2000-07-25,95.625,96.73437,93.8125,96.07812,87.16072457363737,93.16023235584277,94.36452410793385,96.16066264794027,89.53289025000002,95.93851504999996,92.00781160000011,95.85156149999996,95.85156149999996,101.70596084339061,89.9971621566093,18997200,50.94107291402809,55.091070544964104,NaN,NaN,NaN,NaN,NaN,NaN,-0.3147828955456342,1.250959731126045,1.5657426266716792,50.13016666666666,48.654500000000006,628010670,586620167.6157721,18.825100525848747,25.249995145692615,8.80435221313561,57.142857142857146,7.142857142857143
2000-07-26,95.5,96.125,93.25,95.625,87.24494621967082,93.20903963592508,94.4139545350737,96.10964715766025,89.68773400000002,95.79953069999996,92.14781160000011,95.99687399999996,95.99687399999996,101.6746282413367,90.31911975866322,20236896,50.17905558038967,54.87356629323485,NaN,NaN,NaN,NaN,NaN,NaN,-0.40433128654166306,1.0603285184946003,1.4646598050362634,30.405405405405407,38.65074624624625,607773774,599818143.267946,17.680529109760354,24.904359056495977,8.763161391211213,50,0
2000-07-27,93.9375,95.0625,91.5625,91.5625,87.28790695380346,93.17643489065924,94.30213278860022,95.67658552359737,89.82960900000002,95.60015569999996,92.15781160000012,95.88046799999995,95.88046799999995,101.81579993423514,89.94513606576476,25756608,43.846276899655734,54.11616846107648,NaN,NaN,NaN,NaN,NaN,NaN,-0.7118750521339057,0.5748159898688812,1.2866910420027868,0,26.84519069069069,582017166,574061535.267946,16.183222299161613,26.31304738136603,10.031977927540286,42.857142857142854,100
2000-07-28,92.1875,92.875,86,86.8125,87.28317653635267,93.05041637797292,94.0084216988512,94.83238690230237,89.95710900000002,95.37078069999998,92.11031160000012,95.63593699999997,95.63593699999997,102.56013695356026,88.71173704643968,36359504,37.83399962157335,53.074128127575065,NaN,NaN,37.83399962157335,NaN,NaN,NaN,-1.182184279499825,-0.19103930737199448,0.9911449721278305,5.058365758754864,11.821257054720093,545657662,546296095.8497642,14.019454429509103,33.61277809084043,12.402030212311008,35.714285714285715,100
2000-07-31,87.625,90.125,85.71875,89.5,87.30523448126458,92.98011110316158,93.83162084791586,94.32454053065453,90.09613245000003,95.15015569999997,92.18656160000009,95.45156199999995,95.45156199999995,102.80951988649267,88.09360411350724,27316000,42.627467755655246,52.50565326218232,NaN,NaN,NaN,NaN,NaN,NaN,-1.2525190464186633,-0.5745038358954986,0.6780152105231647,23.135755258126196,9.398040338960355,572973662,565862875.9916081,12.834989264480951,31.312207197472,14.459979708228747,28.571428571428573,100
2000-08-01,89.8125,89.98437,87.48437,88.40625,87.31618985956045,92.88953959616828,93.61886120682112,93.76089381344934,90.23878870000003,94.88421819999996,92.3209366000001,95.11562449999997,95.11562449999997,103.09021439110208,87.14103460889785,15711898,41.23396977837364,51.41590504719286,NaN,NaN,NaN,NaN,NaN,NaN,-1.30692630266288,-0.955642667805435,0.35128363485744474,16.44359464627151,14.879238554384193,557261764,561738565.6142001,12.20492913342062,29.77511410264382,17.253764259944766,21.428571428571427,92.85714285714286
2000-08-02,87.875,90.39062,86.6875,86.85937,87.31164438832104,92.77013029723425,93.35378312027912,93.10360583121607,90.37749962500001,94.60593689999996,92.41812400000009,94.89609299999996,94.89609299999996,103.50108252538907,86.29110347461086,23445200,39.27831197553125,49.990564890975996,NaN,NaN,NaN,NaN,NaN,NaN,-1.3744373341052603,-1.3667630327741307,0.007674301331129618,6.97893690248565,15.519428935627786,533816564,540469652.9200395,11.318606364375308,29.17554593043828,19.943498376093316,14.285714285714286,85.71428571428571
2000-08-03,84.25,90.8125,83.3125,90.8125,87.34647877251685,92.73136534085337,93.25412495869955,92.88540527586215,90.53437462500001,94.40218689999996,92.7318740000001,94.70859299999996,94.70859299999996,103.49597652594518,85.92120947405475,35590096,46.289135209350704,48.90588054928101,NaN,NaN,NaN,NaN,NaN,NaN,-1.0924921082763213,-1.357940834014272,-0.2654487257379507,40,21.14084384958572,569406660,576059748.9200395,9.770959050063563,31.339299404389788,22.816133164129546,7.142857142857143,100
2000-08-04,92,92.76562,89.125,90,87.3728819688102,92.67727889846023,93.12651221522114,92.61060477339909,90.67812462500002,94.23218689999996,92.9368740000001,94.43828049999996,94.43828049999996,103.45286082253476,85.42370017746516,22236192,45.13565049566395,47.662520852289205,NaN,NaN,NaN,NaN,NaN,NaN,-0.9079358678289993,-1.4003685605241998,-0.4924326926952005,38.28264758497317,28.420528162486274,547170468,564512213.2478079,12.698018703494643,29.248639086535622,24.486421641384343,0,92.85714285714286
2000-08-07,90.875,93.03125,90.25,92.26562,87.42156592931956,92.66912723710458,93.09275173619287,92.57774908069442,90.82820272500003,94.12515559999996,93.23218640000009,94.33906149999997,94.33906149999997,103.40329238694714,85.2748306130528,15046102,48.95536793533722,47.02434876184338,NaN,NaN,NaN,NaN,NaN,NaN,-0.5955881029199099,-1.236917821345088,-0.641329718425178,53.05552592592592,43.7793911702997,562216570,571274452.1831714,12.475925394459622,27.597817928403668,26.618515793823267,0,85.71428571428571
2000-08-08,92.0625,93.4375,91.5,92,87.46712248723678,92.65587719280548,93.04989872693041,92.52272535872352,90.97835897500003,93.96015559999996,93.5184364000001,94.27890549999996,94.27890549999996,103.38834981436018,85.16946118563975,14368301,48.52878954812704,46.71838453873289,NaN,NaN,NaN,NaN,NaN,NaN,-0.3796972297783482,-1.1159512556481133,-0.7362540258697651,51.48148148148148,47.60655166412686,547848269,564322048.4734939,12.793500508014874,26.565720718089608,28.761789642819586,7.142857142857143,78.57142857142857
2000-08-09,93.6875,94.4375,91.39062,91.60937,87.5083388803986,92.63515427809645,92.99340740430569,92.43573913408318,91.12640582500002,93.76812429999997,93.6406238000001,94.01093649999996,94.01093649999996,103.10340467134367,84.91846832865625,18466400,47.86819484994806,45.98225542235456,NaN,NaN,NaN,NaN,NaN,NaN,-0.24269346339132525,-1.0396208551089217,-0.7969273917175964,51.20538513570226,51.91413084770323,529381869,548507229.7632067,13.986359324787514,24.983395860502576,30.713003695109368,0,71.42857142857143
2000-08-10,91.8125,92.23437,89.6875,89.9375,87.53250963780756,92.58173538150048,92.87356789825448,92.19781159750383,91.26859332500003,93.59499929999997,93.7793738000001,93.56093649999997,93.56093649999997,102.52348908544633,84.59838391455361,15270801,45.042166641190875,45.417727001293635,NaN,NaN,45.042166641190875,NaN,NaN,NaN,-0.2435291671376425,-1.1013388506396495,-0.857809683502007,42.23107569721115,48.30598077146497,514111068,536234383.31133837,13.274602431103702,27.11503440351134,33.13947571125618,0,64.28571428571429
2000-08-11,89.25,91.10937,87.875,90.875,87.56576824837664,92.54793864127275,92.79519268655822,92.0718295405987,91.41593707500002,93.38874929999996,93.8468738000001,93.07343649999997,93.07343649999997,101.49004960723562,84.65682339276432,20825008,46.93406885944624,45.3352520045908,NaN,NaN,NaN,NaN,NaN,NaN,-0.16363722172923578,-1.0623562106635518,-0.898718988934316,56.3446077185966,49.92702285050334,534936076,554041333.9307914,12.410837262257598,28.997070748621596,35.10761553527059,0,57.142857142857146
2000-08-14,91.375,93,90.20312,92.9375,87.61921831555698,92.55565272758417,92.80077336551672,92.15427434625596,91.56296832500001,93.17812429999996,93.8406238000001,92.64843649999997,92.64843649999997,100.14036951470902,85.15650348529093,12466398,50.935742603400016,45.33487126811736,NaN,NaN,NaN,NaN,NaN,NaN,0.034833016545004813,-0.85517771825306,-0.8900107347980648,75.1219512195122,57.89921154510665,547402474,565950575.4743114,15.56387906053789,27.34035813064841,36.02698232194241,0,50
2000-08-15,92.75,93.98437,92,93.0625,87.67338032236735,92.56568930723597,92.8110371551043,92.24077202756492,91.69953082500002,92.94499929999996,93.8293738000001,92.33906149999997,92.33906149999997,99.199409182289,85.47871381771094,14048801,51.17604581615881,45.40608485638659,NaN,NaN,NaN,NaN,NaN,NaN,0.1734955785599912,-0.6731412615980759,-0.8466368401580671,82.97872340425532,71.48176078078804,561451275,566946197.7043542,16.987809306562422,26.19675823628505,36.3385012096283,0,42.857142857142854
2000-08-16,93.4375,94.6875,92,93.42187,87.73057922463235,92.58264338036001,92.8349913843159,92.35325754874921,91.83960892500001,92.70046799999996,93.8703112000001,92.17890499999996,92.17890499999996,98.77605673300607,85.58175326699384,15163398,51.90534818156166,45.981732805094154,NaN,NaN,NaN,NaN,NaN,NaN,0.2819644414839084,-0.49418128830318153,-0.77614572978709,88.87358241758241,82.32475234711664,576614673,567827734.1893848,17.515374479147077,24.69046449570306,35.850162351157394,0,35.714285714285715
2000-08-17,92.9375,95.875,92.875,95.4375,87.80726500349174,92.6391751946103,92.93705054571528,92.6469949250588,91.98956987500002,92.48124929999996,93.91031120000011,91.94140499999997,91.94140499999997,97.65042903991167,86.23238096008828,14370199,55.8855846788392,47.271131737755994,NaN,NaN,NaN,NaN,NaN,NaN,0.47087835161290814,-0.1875477902709548,-0.658426141883863,96.51741293532338,89.4565729190537,590984872,578006625.1477182,18.94214547095454,23.09413930996716,33.61748922821681,100,28.571428571428573
2000-08-18,95.9375,96.625,94.6875,95.14062,87.88023370992465,92.68870875511307,93.0234650341186,92.88448302743416,92.13152297500002,92.28265549999995,93.95312360000011,91.83281099999996,91.83281099999996,97.20152107639615,86.46410092360378,14637102,55.16147759727323,48.16641815501442,NaN,NaN,NaN,NaN,NaN,NaN,0.5516582667488916,0.031146691552251582,-0.52051157519664,88.8497276995305,91.4135743508121,576347770,570215834.0207402,19.792787771911495,22.10034545383325,31.021384893580883,100,21.428571428571427
2000-08-21,96,96.85937,94.375,95.75,87.95853984216421,92.74932838372469,93.13038797395708,93.15738940577376,92.27277297500002,92.13515549999994,93.99687360000009,91.90468599999997,91.90468599999997,97.4401612503191,86.36921074968085,13507102,56.40995937548643,49.25041741195105,NaN,NaN,NaN,NaN,NaN,NaN,0.6170053273254243,0.2507450839601404,-0.36626024336528396,91.81087587021948,92.39267216835778,589854872,571660019.6711304,18.682612907271558,21.56627433996489,28.543592989064276,100,14.285714285714286
2000-08-22,96,97.35937,95.26562,95.4375,88.03295735617253,92.80255950483905,93.22086295537054,93.37454279570007,92.40902297500003,92.01703049999995,94.08562360000009,91.87265499999997,91.87265499999997,97.31783883420577,86.42747116579416,14828301,55.55566843367956,50.413085730390215,NaN,NaN,NaN,NaN,NaN,NaN,0.6090152648833239,0.39500883773887097,-0.21400642714445295,86.31816198199316,88.99292185058103,575026571,559266286.6719711,18.93440860716723,20.521581815111315,25.681097700262644,100,7.142857142857143
2000-08-23,94.6875,97.4375,93.82812,97,88.12218166108623,92.88567713840659,93.3690644081011,93.71982443420482,92.54621047500002,91.89203049999995,94.1418736000001,91.94140499999997,91.94140499999997,97.60471105638531,86.27809894361464,21311808,58.90668003900499,51.314338932508385,NaN,NaN,NaN,NaN,NaN,NaN,0.6737478174637987,0.6281783446852955,-0.045569472778503234,95.42483660130719,91.18462481783995,596338379,575411602.919925,17.372128636882493,22.114456055105464,22.791480014386472,100,0
2000-08-24,97.4375,98.6875,96.0625,98.5625,88.22606542565254,92.99808947229953,93.57272854895987,94.18103163094722,92.69355422500004,91.84265549999995,94.2699986000001,92.29140499999997,92.29140499999997,98.641373621048,85.94143637895193,13514398,61.99278231380777,52.51841977666151,NaN,NaN,NaN,NaN,NaN,NaN,0.7791325013363293,0.9283461538919084,0.1492136525555791,98.84393063583815,93.5289764063795,609852777,587638915.3961154,19.20813303735065,20.77209656867069,20.252586560543076,100,35.714285714285715
2000-08-25,98.48437,99.95312,97.625,98.375,88.32704984927788,93.10456294809558,93.76105291958889,94.58045718990462,92.83542922500004,91.81890549999994,94.36156120000008,92.86952999999997,92.86952999999997,99.2243339348827,86.51472606511724,11697898,61.396912280575236,53.407101515607074,NaN,NaN,NaN,NaN,NaN,NaN,0.7910160020177911,1.137983655077818,0.34696765306002686,86.93405927412546,93.73427550375693,598154879,583477934.3076148,21.13456756363422,19.633794430555692,17.820162036689574,100,28.571428571428573
2000-08-28,98.25,99.84375,97.9375,98.4375,88.42765134331492,93.21016566199468,93.94444300117364,94.9477946003899,92.97136672500004,91.81328049999993,94.44687380000009,93.31640499999996,93.31640499999996,99.91295375584956,86.71985624415036,12272102,61.52965171512669,54.33573452753563,NaN,NaN,NaN,NaN,NaN,NaN,0.7578233502314731,1.2942468408493681,0.5364234906178951,87.45152391266191,91.07650460754184,610426981,577643656.3076148,20.160395984494848,18.72879912051097,15.583742814279448,92.85714285714286,21.428571428571427
2000-08-29,98.625,99.17187,97.85937,98.82812,88.53113859363019,93.32141228254925,94.13595974622565,95.31734940035277,93.10456982500006,91.77843669999994,94.46718620000009,93.83749849999997,93.83749849999997,100.4467479103924,87.22824908960753,11142301,62.39986648152949,55.37371107264859,NaN,NaN,NaN,NaN,NaN,NaN,0.7173304721482031,1.433086580803149,0.7157561086549459,90.68563650634371,88.35707323104369,621569282,582949513.9266624,19.494126374026113,18.306571038006155,13.792472018423123,85.71428571428571,14.285714285714286
2000-08-30,98.3125,99.5,97.76562,98.89062,88.63421801060899,93.43169362348887,94.32241701107955,95.65766088603345,93.23878855000004,91.70734289999994,94.47718620000009,94.43906099999997,94.43906099999997,100.57115851303722,88.30696348696272,10505699,62.545852234717835,56.62397432932909,NaN,NaN,NaN,NaN,NaN,NaN,0.6518098641324154,1.5305184388204651,0.8787085746880497,91.20310114488016,89.78008718796191,632074981,586072790.5548408,19.468299658170697,17.484274989544353,11.728316715558176,78.57142857142857,7.142857142857143
2000-08-31,99.625,101.875,99.5625,101.875,88.7659670851303,93.59888780916236,94.61859673613526,96.24978842069693,93.37878855000007,91.72609289999995,94.54093620000009,94.99218599999998,94.99218599999998,101.68599505552898,88.29837694447097,15469398,68.7792304431919,58.18434301388235,NaN,NaN,NaN,NaN,NaN,NaN,0.7590190074301049,1.8274823339756807,1.0684633265455759,100,93.96291255040796,647544379,601542188.5548408,24.087413678142976,16.140767969977986,10.278189037154883,100,0
2000-09-01,103,103.51562,101.1875,102.5,88.90262412905935,93.77514745650568,94.92767137393388,96.84504666634484,93.52691355000006,91.77374919999994,94.6956238000001,95.61718599999998,95.61718599999998,102.65520061151476,88.5791713884852,14007699,69.9087014024678,59.5395543566729,NaN,NaN,NaN,NaN,69.9087014024678,NaN,0.8165716545635349,2.0891778947499944,1.2726062401864595,91.1805009196205,94.12786735483355,661552078,603328439.1257392,26.900044386663456,15.161989458560852,10.310920670101341,100,0
2000-09-05,101.625,101.75,99.42187,99.51562,89.00822607802394,93.88882018013923,95.10759092789725,97.09938698383581,93.64894477500007,91.84890539999995,94.85312380000009,95.97968599999996,95.97968599999996,103.0366671727043,88.92270482729562,16286801,58.94329649831126,60.09435797682664,NaN,NaN,NaN,NaN,NaN,NaN,0.6077802356369966,2.0323315347327053,1.4245512990957088,65.26457107823981,85.48169066595342,645265277,588353323.9798367,24.762020333275387,18.515938491624848,9.818624143560445,92.85714285714286,0
2000-09-06,99.25,99.48437,95.75,96.0625,89.0784178583421,93.93186334488895,95.14503834248951,97.00063584251812,93.75035102500007,91.91953039999994,94.8906238000001,96.18281099999997,96.18281099999997,102.99968240185216,89.36593959814779,20829600,49.30636712079797,59.90871647248639,NaN,NaN,NaN,NaN,NaN,NaN,0.21169556140148593,1.6891707508475662,1.4774751894460803,29.955961212786477,62.13367773688227,624435677,571009854.1704713,22.41492319958119,26.003518325587187,9.133723999617583,85.71428571428571,0
2000-09-07,96.8125,99.42187,96.5625,98.25,89.1696773821397,94.0173710014258,95.26680154474482,97.11962290513544,93.85410102500008,92.10453039999994,95.0012488000001,96.51484249999996,96.51484249999996,103.04937672958995,89.98030827040996,16529801,54.39327862187172,59.80212318270299,NaN,NaN,NaN,NaN,NaN,NaN,0.07847121021109293,1.5755642022099465,1.4970929919988536,45.645212903225826,46.95524839808403,640965478,573990672.0742857,20.54407871246596,23.83315448039973,8.95761415925766,78.57142857142857,0
2000-09-08,97.76562,98,94.82812,94.875,89.22644676142188,94.03435375387282,95.25143677828424,96.90584929512255,93.95363227500007,92.16328039999995,95.0209364000001,96.76171749999996,96.76171749999996,102.62191189504128,90.90152310495864,22961104,46.62031908035444,59.1920404314945,NaN,NaN,NaN,NaN,NaN,NaN,-0.2381781490600463,1.1993703056737957,1.437548454733842,10.806503225806468,28.80255911393959,618004374,551708292.7142595,18.820892297723677,26.085421043500418,9.719676759592513,71.42857142857143,21.428571428571427
2000-09-11,94.5,96.125,92,92.78125,89.26181793792514,94.00953981815256,95.1545667085476,96.51303031463469,94.03035102500007,92.17359289999995,95.04249900000009,96.85702999999997,96.85702999999997,102.38366334913783,91.3303966508621,27175392,42.55728201828911,58.20256347740899,NaN,NaN,NaN,NaN,NaN,NaN,-0.5708862292654309,0.7239406681520535,1.2948268974174844,6.784263461281287,21.07865986343786,590828982,534826609.80516857,16.97272597552471,30.256370072687456,11.21691971948908,64.28571428571429,100
2000-09-12,93.5,94.6875,90.84375,91.3125,89.28222273456271,93.95613308908024,95.00389742585946,96.01774171324091,94.0984760250001,92.19609289999995,95.00499900000011,96.77577999999997,96.77577999999997,102.57173457416617,90.97982542583377,23873808,39.92843354932909,57.08633241424109,NaN,NaN,NaN,NaN,NaN,NaN,-0.8550312922239338,0.22603778213756698,1.0810690743615008,3.699138327650142,7.096635004912631,566955174,516775681.80516857,15.450244354290641,30.24066607023734,13.241773847617257,57.142857142857146,100
2000-09-13,90.25,93.75,90,93.4375,89.32356877700487,93.94586312692023,94.94247007582575,95.77200440721796,94.1836322750001,92.26171789999995,94.97124900000011,96.79452999999998,96.79452999999998,102.5445574934814,91.04450250651855,33706496,45.20252831647344,56.10746443406027,NaN,NaN,NaN,NaN,NaN,NaN,-0.8625491244516009,0.00288266879699961,0.8654317932486005,25.433535420498657,11.972312403143363,600661670,544864428.4718353,14.119539307774536,29.57397477611549,14.910353802309972,50,100
2000-09-14,95.25,95.9375,92.64062,93.375,89.36388152549237,93.93455890658518,94.88100066108748,95.5437182731972,94.28050727500009,92.34546789999995,95.0137490000001,96.79218649999997,96.79218649999997,102.54774591650227,91.03662708349768,28446896,45.077173387879,54.89920665363679,NaN,NaN,NaN,NaN,NaN,NaN,-0.8339234860999541,-0.17697256437634223,0.6569509217236119,24.971107503762315,18.03459375063704,572214774,529090624.2946981,18.0576409088137,27.344165674741305,16.0919426701338,42.857142857142854,92.85714285714286
2000-09-15,93.125,93.625,90.6875,91.375,89.38389265459195,93.88387457180131,94.74351043908405,95.14669748527366,94.36191352500009,92.35484289999995,94.9499990000001,96.58906149999999,96.58906149999999,102.79096217212232,90.38716082787765,24538704,41.1450185483191,53.45264281561849,NaN,NaN,NaN,NaN,NaN,NaN,-0.9058904672051246,-0.4754121622827938,0.43047830492233075,10.173414168199463,20.192685697486812,547676070,516038122.16703856,16.839371647855778,29.985107639983283,17.834319433334578,35.714285714285715,85.71428571428571
2000-09-18,91.8125,93,88.51562,89.8125,89.3881574042975,93.80325329315178,94.55013748068859,94.63867867715236,94.42359322500009,92.37921789999993,94.8381240000001,96.32265549999997,96.32265549999997,103.17425705849867,89.47105394150127,28948608,38.33177350251144,51.795651514717406,NaN,NaN,38.33177350251144,NaN,NaN,NaN,-1.0071493897758153,-0.8284584322974382,0.17869095747837693,8.645866666666677,14.596796112876154,518727462,503833354.22655183,15.158105688917273,31.826881978065913,20.105433224071582,28.571428571428573,100
2000-09-19,90.75,93.78125,89.875,93.5,89.42907126097116,93.7972482774458,94.5089556187008,94.53023308885213,94.4954682250001,92.40046789999995,94.82312400000012,96.21015549999997,96.21015549999997,103.16872639253407,89.25158460746587,27517696,47.46162337263838,50.72863414979661,NaN,NaN,NaN,NaN,NaN,NaN,-0.7841215415068944,-0.801460969405241,-0.017339427898346665,33.22920000000001,17.34949361162205,546245158,527388502.00255185,15.551450839538505,29.061445025109585,22.04408235771402,21.428571428571427,92.85714285714286
2000-09-20,93.375,95.23437,91.3125,94.6875,89.48139393499135,93.81487702442708,94.5159573591439,94.54521088991383,94.5696869750001,92.40234289999995,94.8528116000001,96.17265549999996,96.17265549999996,103.15551884653755,89.18979215346238,33083008,50.02740871590139,49.834459612738286,NaN,NaN,NaN,NaN,50.02740871590139,NaN,-0.5272855040363447,-0.6764463079437775,-0.14916080390743283,41.14586666666667,27.673644444444452,579328166,551245245.7026337,17.371271649407447,26.601632067012314,23.15993291951055,14.285714285714286,85.71428571428571
2000-09-21,93.75,94.48437,92.0625,92.39062,89.51034145802626,93.78667391503248,94.43261079604021,94.34001175754109,94.63242132500011,92.36874909999995,94.76124900000009,95.94218649999996,95.94218649999996,103.10261772981409,88.78175527018584,24138704,45.40820248746293,48.16510047304336,NaN,NaN,NaN,NaN,NaN,NaN,-0.48388611916370966,-0.7540184528620699,-0.27013233369836026,25.833333333333332,33.402800000000006,555189462,533647265.6527054,16.372381927532604,25.071974515560626,23.248296595618932,7.142857142857143,78.57142857142857
2000-09-22,87.625,93,87.5,92.9375,89.5444425380459,93.76985858998233,94.37397900011706,94.20643920920385,94.70273382500011,92.39812409999996,94.6412490000001,95.66093649999996,95.66093649999996,102.82946415718953,88.49240884281039,33577392,46.67079404059906,46.50524994719559,NaN,NaN,NaN,NaN,NaN,NaN,-0.3939547666496733,-0.7625757920104519,-0.36862102536077856,38.1578947368421,35.045698245614034,588766854,566461535.1072508,14.49205267788126,31.71965056314685,23.917810691493894,0,100
2000-09-25,93.625,94.25,90.0625,90.1875,89.55084111975688,93.6989207961213,94.20980335305364,93.82368309404158,94.75867132500011,92.40624909999997,94.43249900000009,95.25156149999997,95.25156149999997,102.6836480506863,87.81947494931363,20393104,41.47611317136883,45.25759399527113,NaN,NaN,NaN,NaN,NaN,NaN,-0.48907370528044314,-0.9799631569613325,-0.4908894516808894,22.42504195047383,28.805423340216425,568373750,547285929.8535194,15.813864106935352,28.989770160743905,24.98749933725566,0,92.85714285714286
2000-09-26,90.76562,92.5,88.9375,88.9375,89.54473822304288,93.60463523580206,94.00304635881625,93.35833232318048,94.8058588250001,92.40437409999997,94.18249900000009,94.77656149999997,94.77656149999997,102.54037784229453,87.01274515770541,25511008,39.33305778657071,44.54521475711204,NaN,NaN,NaN,NaN,NaN,NaN,-0.5983510958110257,-1.2388283214446716,-0.6404772256336458,12.057672160491602,24.213536282602515,542862742,521774921.85351944,14.658079180514601,29.17900487075719,26.82415105011095,0,85.71428571428571
2000-09-27,90.625,91.1875,88,89.5,89.54429306659469,93.52335533014262,93.82645630552933,92.99087210192519,94.8483979000001,92.38437409999997,93.98749900000011,94.31015549999996,94.31015549999996,102.16458743149028,86.45572356850965,28388800,40.81504302430001,43.575340785856916,NaN,NaN,NaN,NaN,NaN,NaN,-0.5937409494628126,-1.3826534124621617,-0.788912462999349,19.047619047619047,17.84344438619483,571251542,520104992.44175476,13.693716573614543,29.194318260637182,28.87632178127916,0,78.57142857142857
2000-09-28,88.71875,93,88.71875,92.45312,89.57323661817087,93.50216255132791,93.7725999798223,92.93965761602756,94.9130072500001,92.42640529999997,93.90406140000012,93.98828049999997,93.98828049999997,101.58902204713951,86.38753895286044,28755104,47.99729965707781,43.67369654133716,NaN,NaN,NaN,NaN,47.99729965707781,NaN,-0.36407293365563187,-1.2440036300688888,-0.8799306964132569,57.42747826086955,29.510923156326736,600006646,541513834.8239936,16.182537726292136,26.657508318393212,29.467341469412027,0,71.42857142857143
2000-09-29,92,92.125,88.6875,88.6875,89.56442331848757,93.40682269882637,93.57318429433907,92.53469022402494,94.95144475000008,92.45828029999997,93.6740614000001,93.32890549999998,93.32890549999998,100.34401465035587,86.31379634964408,27018000,41.141342128337705,43.57255797776919,NaN,NaN,NaN,NaN,NaN,NaN,-0.43332707700217044,-1.42158954266597,-0.9882624656637995,14.074074074074074,30.183057127520893,572988646,514495834.82399356,14.951883404579448,24.693361093395737,29.213458711585112,0,64.28571428571429
2000-10-02,90.25,90.25,86,86.75,89.53641910636331,93.2750044275625,93.30560843965911,91.98376734554638,94.96956975000008,92.52578029999995,93.4628114000001,92.54140549999997,92.54140549999997,98.75153722496455,86.33127377503538,24968096,38.12390264700791,43.44366291331768,NaN,NaN,NaN,NaN,NaN,NaN,-0.5686554343505308,-1.699081758601963,-1.1304263242514323,7.547169811320755,26.349574048754793,548020550,498340008.00046414,13.686775102899832,27.954469952552973,29.348656758402768,14.285714285714286,100
2000-10-03,88.0625,88.5,83.26562,83.375,89.47511145356367,93.0789647359276,92.91617281457444,91.16388474120863,94.96753850000009,92.51203029999995,93.2440614000001,91.73437449999997,91.73437449999997,98.2946492108063,85.17409978919365,35725808,33.5129606492072,42.608693794227236,NaN,NaN,NaN,NaN,NaN,NaN,-0.8287455038291103,-2.16635820403782,-1.33761270020871,0.8631710527561938,7.494804979383676,512294742,464107285.66831404,12.305751943871925,30.404812943917182,29.84908422200342,7.142857142857143,100
2000-10-04,83.5,86.85937,82.125,85.625,89.43680188686155,92.93136147383002,92.63024446890485,90.63637190871258,94.97128850000009,92.52140529999996,93.03499900000011,91.21249949999998,91.21249949999998,97.97017273168578,84.45482626831418,37675600,38.824982286722516,42.1621087155732,NaN,NaN,NaN,NaN,NaN,NaN,-0.7925362085988232,-2.328282960957239,-1.5357467523584156,26.69846071931756,11.702933861131504,549970342,482136922.0566825,11.204529426087113,29.839918623605467,31.63114572559972,0,100
2000-10-05,85.25,87.1875,84.5625,85.875,89.4013610720669,92.79163154365517,92.36533292110465,90.18290791740661,94.95722600000006,92.49390529999995,92.83999900000012,90.59374949999997,90.59374949999997,96.91254992264707,84.27494907735287,23442896,39.40428680569101,42.037770733956904,NaN,NaN,NaN,NaN,NaN,NaN,-0.698339340232921,-2.408670927649567,-1.7103315874166458,28.605493627840243,18.722375133304666,573413238,482136922.0566825,11.270250210985633,28.326326104099863,32.702583442175474,21.428571428571427,92.85714285714286
2000-10-06,85.5625,86.5625,81.25391,83,89.33766593702147,92.59773784972141,91.99806496341428,89.49882144908217,94.92644475000006,92.41328029999995,92.66874900000012,89.99999949999997,89.99999949999997,96.81059915467395,83.189399845326,36335504,35.268123399841926,41.818938583766226,NaN,NaN,NaN,NaN,NaN,NaN,-0.7705734827385649,-2.673548440839852,-1.9029749581012871,12.489503206618352,22.597819184592055,537077734,469704209.6376334,10.149077619122785,31.70855976388735,33.847574408760586,14.285714285714286,100
2000-10-09,82.5625,83.8125,79.375,82.625,89.27087324113072,92.40025789230118,91.63049378837843,88.84417178726483,94.89128850000006,92.34765529999996,92.58499900000011,89.49218699999997,89.49218699999997,96.88703832858458,82.09733567141537,28834400,34.75566580824443,40.91137018630951,NaN,NaN,NaN,NaN,NaN,NaN,-0.7820362730603012,-2.8805202994266637,-2.0984840263663624,20.49261729816506,20.529204710874552,508243334,483106113.8629855,9.314895693886113,32.58252274908177,35.651291581780846,7.142857142857143,100
2000-10-10,81.8125,83.3125,77.875,78.3125,89.16183470141797,92.12129238948334,91.10821952216752,87.84115542657294,94.83441350000007,92.27390529999995,92.36124900000011,88.84218699999998,88.84218699999998,97.6358323517221,80.04854164827786,35269600,29.45513750628976,39.44192224276583,NaN,NaN,NaN,NaN,NaN,NaN,-1.004307491185945,-3.3538683903487936,-2.3495608991628485,2.634055355501142,11.872058620094853,472973734,453512081.67907745,8.403437481775944,32.093635566257625,38.3304005337696,0,100
2000-10-11,76.875,80.45312,76.0625,77.0625,89.04144331135412,91.8230984807807,90.55740699188644,86.81461681451837,94.77378850000005,92.22765529999997,92.13437400000012,88.02343699999997,88.02343699999997,97.93179797303027,78.11507602696967,48462800,28.11662532745933,38.20680958847986,NaN,NaN,NaN,NaN,NaN,NaN,-1.1493269079167057,-3.7862195340587306,-2.636892626142025,5.498281786941581,9.541651480202594,424510934,427124888.31322026,7.744473148046363,32.81408692106754,41.246106832231185,0,100
2000-10-12,79.25,79.5625,74.3125,75.125,88.90297123860432,91.49244306531969,89.95221456083206,85.70131997504043,94.68691350000005,92.15890529999996,91.89968660000011,87.11093699999998,87.11093699999998,98.17398731498383,76.04788668501612,53223696,26.13424231418827,36.739913036593364,NaN,NaN,26.13424231418827,NaN,NaN,NaN,-1.279579330057575,-4.236366788713994,-2.956787458656419,4.075235109717869,4.069190750720197,371287238,390375193.4560774,7.034181599341757,32.86171008810255,43.2073628470542,7.142857142857143,100
2000-10-13,74.6875,81.625,74.625,81.25,88.82682227105602,91.28962241056088,89.610951244721,85.2773847393223,94.63566350000005,92.22015529999994,91.70843660000011,86.60468699999998,86.60468699999998,97.76710590773912,75.44226809226085,42410096,40.43249184807502,36.6653686563581,NaN,NaN,NaN,NaN,NaN,NaN,-0.8763017042177714,-4.052164588928633,-3.175862884710862,37.123745819397996,15.565754238685814,413697334,428241350.59893453,9.644360105440052,29.037611505856038,44.687862648674994,0,92.85714285714286
2000-10-16,81.125,82.3125,79.75,81.625,88.75516234796093,91.09824374896561,89.29777668610448,84.92953857367256,94.58691350000005,92.23890529999996,91.54093660000011,86.19531199999997,86.19531199999997,97.45722515826795,74.933398841732,27634000,41.18316558139353,36.797519213131146,NaN,NaN,NaN,NaN,NaN,NaN,-0.5247125581396102,-3.8317535823853746,-3.3070410242457644,39.130434782608695,26.776471903908188,441331334,441047350.59893453,10.398160369474905,27.763903262462303,45.57218396406853,14.285714285714286,85.71428571428571
2000-10-17,83.125,83.17187,78,78.25,88.65063336937426,90.84382308066927,88.86453054155136,84.2933920428466,94.50441350000003,92.24640529999995,91.26062420000011,85.43281199999998,85.43281199999998,96.67820955563847,74.1874144443615,52082400,36.70045750248066,36.50362024728691,NaN,NaN,NaN,NaN,NaN,NaN,-0.46207194707251187,-3.8846309580864045,-3.4225590110138926,21.070234113712374,32.441471571906355,389248934,394000111.96223253,9.493084806835233,28.292507587008224,46.54438876531604,7.142857142857143,78.57142857142857
2000-10-18,76.75,81.1875,74.5625,78,88.5446569179377,90.58948995035898,88.43847052031406,83.69402137209931,94.45437445000003,92.24953029999995,90.98062420000011,84.59843699999998,84.59843699999998,95.4425012045253,73.75437279547465,64770608,36.38452929199267,35.67413664978083,NaN,NaN,NaN,NaN,NaN,NaN,-0.38333904936270846,-3.9017328227172783,-3.51839377335457,20.70175438596491,26.96747442742866,324478326,396444285.849025,8.475403751274447,30.82187050918109,48.85966235550557,0,71.42857142857143
2000-10-19,82.39062,85.10937,81.4375,85.0625,88.51000859039603,90.48004460480732,88.30607951951743,83.82435266999462,94.44874945000004,92.24515529999995,90.84968680000013,84.23203099999998,84.23203099999998,94.47684250422077,73.98721949577919,42443696,49.58717814515941,36.27741065098238,NaN,NaN,NaN,NaN,NaN,NaN,0.1688932471591178,-3.307277214405673,-3.4761704615647906,67.45098039215686,36.407656297278045,366922022,437804427.130846,13.62210492661983,27.424290810579965,49.50639091203347,0,64.28571428571429
2000-10-20,84.5,87.875,84.39062,86.3125,88.48814283327766,90.39751896906856,88.22789993051674,84.06131908237609,94.47656195000003,92.27828029999993,90.77718680000012,83.90078099999998,83.90078099999998,93.39951189717843,74.40205010282153,40690896,51.505523686364114,37.23324072522211,NaN,NaN,NaN,NaN,51.505523686364114,NaN,0.6176317513302925,-2.704130772401925,-3.3217625237322173,84.58149779735683,57.578077525159536,407612918,442001298.36890846,17.237251189411698,25.916417981706214,48.495595293044296,0,57.142857142857146
2000-10-23,86.1875,87.5,84.125,86.1875,88.46525086478734,90.31415225680978,88.14788424696707,84.26381250310217,94.46499945000004,92.26515529999993,90.68343680000012,83.70078099999998,83.70078099999998,92.82257568399817,74.57898631600179,28988192,51.29531617834583,38.50340897730344,NaN,NaN,NaN,NaN,NaN,NaN,0.8888217421255256,-2.2107353460753103,-3.099557088200836,87.55760368663594,79.86336062538321,378624726,448443118.8133529,16.302254797633122,24.937542189096543,46.96439059930554,0,50
2000-10-24,86.4375,87,82.375,82.4375,88.4052732442422,90.15817894479375,87.9239476098311,84.08987797899721,94.41593695000003,92.15703029999993,90.47343680000013,83.37578099999998,83.37578099999998,92.18595516723556,74.56560683276439,31457200,45.319643028331186,38.96731331598977,NaN,NaN,NaN,NaN,NaN,NaN,0.8011467011058215,-2.098123711818559,-2.8992704129243805,59.90783410138249,77.34897852845842,347167526,417836113.4079475,15.093973248519077,25.893679202287718,45.60337159186845,85.71428571428571,42.857142857142854
2000-10-25,81.25,82,76.89062,77.875,88.30049440599103,89.91494767856021,87.52987123297498,83.49798483814033,94.36406195000004,91.99953029999992,90.16968680000012,82.79453099999996,82.79453099999996,91.44428644492614,74.14477555507379,48633200,39.318159756400746,38.96116138389761,NaN,NaN,NaN,NaN,NaN,NaN,0.43946025380289466,-2.349945095670762,-2.7894053494736566,26.267281105990783,57.91090629800308,298534326,387942388.4190056,13.77528322457538,32.26956299296613,45.39559836750812,78.57142857142857,35.714285714285715
2000-10-26,78.1875,80,73.625,79.875,88.21665864075729,89.7161368334402,87.22968020423086,83.15293866307934,94.33062445000003,91.88453029999991,89.89874940000013,82.16562499999996,82.16562499999996,89.66784081850906,74.66340918149086,69995120,42.88848361832759,39.50547282807516,NaN,NaN,NaN,NaN,NaN,NaN,0.3427907667422141,-2.360916891045889,-2.703707657788103,43.85964912280702,43.34492144339344,368529446,455192601.7523389,12.43108230384935,34.11928680312041,45.04446592509195,71.42857142857143,100
2000-10-27,80.85937,81.85937,77.48437,79.71875,88.13210233587414,89.51816877733248,86.93513392171201,82.82587307611941,94.27296820000004,91.74734279999991,89.58437440000013,81.71718749999997,81.71718749999997,88.65760003614396,74.77677496385597,51045392,42.67722242442984,40.07129830065984,NaN,NaN,NaN,NaN,NaN,NaN,0.27890822327643905,-2.3550723786925545,-2.6339806019689935,42.76315789473684,37.63002937451155,317484054,456286548.2560921,14.453726959612363,31.82417741121077,43.75877544363555,64.28571428571429,92.85714285714286
2000-10-30,78.1875,79.875,75.70312,76.76562,88.01900300914902,89.26564305896946,86.53632945419389,82.24870611648899,94.19335880000004,91.5849989999999,89.21687440000014,81.21796849999996,81.21796849999996,88.0743678131532,74.36156918684671,35494096,38.78831849798897,40.737954085781205,NaN,NaN,38.78831849798897,NaN,NaN,NaN,0.05979869352016198,-2.559232235068791,-2.619030928588953,22.039438596491216,36.2207485380117,281989958,438871820.310782,13.5198015402105,32.52669596209885,42.528708849880054,57.142857142857146,85.71428571428571
2000-10-31,78,82.5625,77.875,81.70312,87.95615840209281,89.11589012710868,86.34679182853922,82.19674553396622,94.13187440000003,91.4664051999999,88.93593680000012,81.13437449999996,81.13437449999996,87.92398252486021,74.34476647513972,43862400,47.41599674525154,42.11648061562351,NaN,NaN,NaN,NaN,NaN,NaN,0.2583072589456128,-2.2961468549069366,-2.5544541138525494,56.688561403508764,40.497052631578946,325852358,466651246.73766196,16.415256131946933,29.658982330432625,40.16680973797389,50,78.57142857142857
2000-11-01,80.3125,82.8125,79.1875,81,87.88694289560432,88.95517943152237,86.13711371761612,82.08276976882658,94.06046815000003,91.3664051999999,88.64718680000013,80.90312449999996,80.90312449999996,87.37269471031914,74.43355428968079,45185104,46.41275859476499,43.56494606423613,NaN,NaN,NaN,NaN,NaN,NaN,0.34760468342802175,-2.119948259567522,-2.467552942995544,51.75438596491228,43.49412865497076,280667254,466651246.73766196,15.881770333916984,27.99671347750696,37.51487403474334,42.857142857142854,71.42857142857143
2000-11-02,82.1875,83.25,81.0625,82,87.82836634937941,88.81745310614569,85.97487396398411,82.07488693370024,93.99296815000004,91.2445301999999,88.34718680000013,80.70937449999995,80.70937449999995,86.792293242779,74.62645575722091,26594000,48.09483216144501,44.1122560866197,NaN,NaN,NaN,NaN,NaN,NaN,0.4716664402047779,-1.8779698927395714,-2.3496363329443493,58.771929824561404,55.738292397660835,307261254,462852103.8805191,16.010419694923176,26.98574273266341,35.7571003932967,35.714285714285715,64.28571428571429
2000-11-03,82.875,83.9375,81.64062,83.0625,87.78094479366419,88.70349363869727,85.86066322029846,82.16894532096688,93.92703065000003,91.1535926999999,88.03718680000013,80.71249949999996,80.71249949999996,86.80018446690221,74.62481453309772,29836496,49.894461006867836,44.73449147415358,NaN,NaN,NaN,NaN,49.894461006867836,NaN,0.6139278654370908,-1.5822265011479857,-2.1961543665850765,66.2280701754386,58.91812865497078,337097750,469956080.9853221,16.541977286270228,25.955358877624136,34.08890542081086,28.571428571428573,57.142857142857146
2000-11-06,83.625,84.125,82,82.4375,87.7277761887521,88.57941455674286,85.7264215253848,82.19452195706528,93.88296815000004,91.0399989999999,87.71843680000012,80.70312449999997,80.70312449999997,86.77956674906682,74.62668225093313,23478608,48.822139744498855,45.60032592001202,NaN,NaN,NaN,NaN,NaN,NaN,0.6510473378021513,-1.3823451943323875,-2.0333925321345387,61.8421052631579,62.28070175438598,313619142,456145135.10296917,16.259108655999068,25.004136956677982,32.048932359245555,21.428571428571427,50
2000-11-07,81.4375,82.46875,80.25,82.125,87.6720271719486,88.45160436750042,85.58518930870304,82.18790081829715,93.82781190000003,90.91953029999989,87.39218680000013,80.89374949999997,80.89374949999997,86.8970092587681,74.89048974123185,24339200,48.26360902587491,46.44883161528933,NaN,NaN,NaN,NaN,NaN,NaN,0.6387791583365785,-1.2349185842138155,-1.873697742550394,59.64912280701754,62.573099415204695,289279942,472942611.1593072,15.615609656919634,27.136155031011956,29.911957301685216,14.285714285714286,42.857142857142854
2000-11-08,82.125,82.25,75.625,75.70312,87.55293356824762,88.19915913250041,85.19765717894998,81.57030264512599,93.75882750000004,90.69843649999991,86.92968680000013,80.82578049999996,80.82578049999996,87.02847999025482,74.6230810097451,40330096,38.51295146514287,45.657815423859574,NaN,NaN,NaN,NaN,NaN,NaN,0.20485660785322146,-1.6176269827338672,-1.8224835905870886,14.583298245614024,45.358175438596504,248949846,433563635.7931245,13.852636224719847,31.95410226705065,30.332758773832666,7.142857142857143,35.714285714285715
2000-11-09,74.75,76.9375,73,75.6875,87.43486955264316,87.95140350611426,84.824709838599,81.01003572654257,93.68476500000004,90.47140529999992,86.46562440000012,80.85390549999997,80.85390549999997,86.95725888493574,74.7505521150642,64953696,38.49258129423445,44.72831953870745,NaN,NaN,NaN,NaN,NaN,NaN,-0.06223815910107788,-1.900281289463436,-1.8380431303623581,18.53448275862069,30.922301270417435,183996150,457276889.8883626,12.919085414277662,34.29343624666964,32.12993002720348,0,100
2000-11-10,74.25,75.6875,71.75,71.75,87.27880119888552,87.63058363470606,84.31197611943826,80.12812756210994,93.61476500000005,90.20203029999992,85.86312440000015,80.37890549999996,80.37890549999996,87.6516809978008,73.10613000219912,49227008,33.65954231836895,43.468621405851955,NaN,NaN,NaN,NaN,NaN,NaN,-0.4609103203128313,-2.4141810307533973,-1.953270710440566,0,11.039260334744926,134769142,408049881.8883626,12.044919035520282,34.12106681832823,34.04992049609244,0,100
2000-11-13,70.95312,74.1875,68.26562,70.0625,87.10749471929462,87.28270079045446,83.75317313436224,79.16949636571852,93.51507750000005,89.95499909999994,85.21437440000014,79.80078049999996,79.80078049999996,88.31731991260244,71.28424108739748,75015504,31.815824943796684,42.504062971242355,NaN,NaN,31.815824943796684,NaN,NaN,NaN,-0.7765133382598925,-2.9239123832654315,-2.147399045005539,11.3300772161333,9.954853324918018,59753638,378558386.7597075,10.855250689685695,36.562448414934465,36.04032545260514,0,100
2000-11-14,73,76,72.75,75.84375,86.9954176574111,87.05618691341576,83.44299967811274,78.85275861660247,93.43179625000005,89.79703039999993,84.74093700000016,79.68046799999996,79.68046799999996,88.34788844783401,71.01304755216592,44828000,43.27873098402458,42.78696091607262,NaN,NaN,NaN,NaN,NaN,NaN,-0.5450977872067737,-2.8287712790140063,-2.2836734918072326,47.78326769394516,19.704448303359513,104581638,419076002.1443229,12.750949286111338,33.038928880508074,36.33610351120304,57.142857142857146,92.85714285714286
2000-11-15,75.5625,78.0625,74.79687,77.375,86.89969210858114,86.86448024186296,83.20503890642205,78.71201970073557,93.35429625000005,89.62890539999994,84.36718700000016,79.64921799999996,79.64921799999996,88.34510857943671,70.95332742056321,37757104,45.8742493687671,43.00022989824687,NaN,NaN,NaN,NaN,45.8742493687671,NaN,-0.2529354633034382,-2.59984282093653,-2.346907357633092,57.43843706374398,38.850593991274174,142338742,440935402.48530453,15.47284101700307,31.25487791228048,35.420648662212855,50,85.71428571428571
2000-11-16,75.375,77,72.875,72.875,86.76014293337137,86.587460831133,82.79993934146432,78.15611306257027,93.23804625000004,89.43046789999993,83.85968700000016,79.03984299999996,79.03984299999996,87.84043632698858,70.23924967301134,33888000,40.071137565014055,42.81408097971717,NaN,NaN,NaN,NaN,NaN,NaN,-0.32233766464832536,-2.7498294384434985,-2.427491773795173,29.06406177290664,44.76192217686528,108450742,407047402.48530453,14.324940270567094,32.104579816935406,35.47484447909336,42.857142857142854,78.57142857142857
2000-11-17,73.1875,75.1875,71,72.82812,86.62151583950698,86.3149986364571,82.40888760258336,77.64868515184929,93.11765560000003,89.21984289999993,83.41874940000017,78.36562399999997,78.36562399999997,86.89621310187339,69.83503489812655,49911296,40.014348138143504,42.901654525442495,NaN,NaN,NaN,NaN,NaN,NaN,-0.3298009398340769,-2.8397429485877694,-2.5099420087536926,28.768463836543418,38.42365422439804,58539446,400715253.20459765,13.333629875636316,32.98147205342433,35.556594158640415,35.714285714285715,71.42857142857143
2000-11-20,70.9375,72.0625,69.25,69.85937,86.45472831871587,85.98914460405202,81.91674965738402,76.90684561357793,92.97492120000004,89.00140539999992,82.96031180000017,77.54921749999997,77.54921749999997,86.05449790235348,69.04393709764646,46860192,36.48776754039302,42.12106672509545,NaN,NaN,NaN,NaN,NaN,NaN,-0.48376609316714303,-3.1146496252126212,-2.630883532045478,10.049257915504892,22.62726117498501,11679254,374160977.7905816,12.53537956891181,33.93497440254386,36.79271372448141,28.571428571428573,64.28571428571429
2000-11-21,70.1875,71.125,68.4375,69.75,86.2885121165396,85.6675773841698,81.43962221983955,76.22524126942766,92.81242120000005,88.76703039999992,82.52906180000016,76.91484249999996,76.91484249999996,85.75320013717797,68.07648486282196,42124192,36.36062856175929,41.40305743702362,NaN,NaN,NaN,NaN,NaN,NaN,-0.5379031254077478,-3.303262438805163,-2.7653593133974153,9.359634487602928,16.05911874655044,-30444938,373181345.41848856,11.95639217886206,33.763966231852834,38.2275364655208,21.428571428571427,57.142857142857146
2000-11-22,68.4375,70.125,66.5,66.625,86.0928552795591,85.29049664388921,80.85865664259094,75.31093257710121,92.65054620000005,88.48203039999994,81.99281180000018,76.35234249999996,76.35234249999996,86.243891012375,66.46079398762492,56618800,32.83962760985011,40.313399969052554,NaN,NaN,NaN,NaN,NaN,NaN,-0.7178563441614836,-3.66267974359927,-2.9448233994377864,0.7092198581560284,6.7060374204213105,-87063738,320467290.2460748,11.20464154170149,35.001604817574545,40.082917193220915,14.285714285714286,100
2000-11-24,68.375,70.625,68.17187,70.4375,85.9370806001605,84.99637789846567,80.44998383307757,74.84679614118681,92.49179620000004,88.27390539999995,81.53406180000016,75.88046749999997,75.88046749999997,85.9535661840032,65.80736881599674,19980000,40.41983326702871,39.63664084477832,NaN,NaN,NaN,NaN,40.41983326702871,NaN,-0.5228640835205915,-3.598403503838526,-3.0755394203179343,22.340425531914892,10.803093292557952,-67083738,337393028.9553972,11.294696327334055,32.568253648676674,41.9650271280147,7.142857142857143,92.85714285714286
2000-11-27,72.5625,72.9375,68.75,69.5625,85.77414944991014,84.6907565539416,80.0230236827608,74.34352984202617,92.34460870000004,88.02390539999995,81.09781180000016,75.37265499999997,75.37265499999997,85.6426444407586,65.10266555924133,35415600,39.32286041755094,38.95812089285347,NaN,NaN,NaN,NaN,NaN,NaN,-0.4010386629428382,-3.576837748996482,-3.175799086053644,19.17808219178082,14.075909193950581,-102499338,315720796.1195763,14.487544782370424,30.20113711614459,42.96281928792029,0,85.71428571428571
2000-11-28,68.9375,69.9375,65.3125,65.45312,85.57195015190108,84.30981325584375,79.45165491088783,73.49682414278558,92.17507742500005,87.72437409999993,80.61062420000015,74.80702999999997,74.80702999999997,85.9193799394048,63.69468006059513,48807392,34.5767439808602,37.98048767535242,NaN,NaN,NaN,NaN,NaN,NaN,-0.5369556173570116,-3.8469936077499085,-3.310037990392897,0.8302287822878135,14.116245501994511,-151306730,269881315.6711611,13.33475087202626,33.712079948946844,44.13177147229102,0,100
2000-11-29,65.8125,66.75,62.5,62.9375,85.34673174242943,83.88659913196565,78.8040409928138,72.49117422442505,91.98851492500006,87.41124909999994,79.99937420000016,73.86874899999997,73.86874899999997,85.64282107649525,62.09467692350468,66173872,32.028270091165695,37.517296148639765,NaN,NaN,32.028270091165695,NaN,NaN,NaN,-0.724361637421091,-4.2154900371692605,-3.4911283997481695,2.8112449799196786,7.606518651329439,-217480602,217331476.14174935,12.361364687685487,36.081857204974696,44.80666558559599,0,100
2000-11-30,61.75,64.25,60.5,62.98437,85.1242206803157,83.4726936046,78.18366173819365,71.58576429828933,91.80343677500007,87.10906159999995,79.36531160000015,72.96796749999997,72.96796749999997,85.17067773574922,60.765257264250714,74865504,32.128643164843155,37.062729139397526,NaN,NaN,NaN,NaN,NaN,NaN,-0.7690327810289497,-4.4524193760343564,-3.6833865950054068,14.14587900355871,5.929117588588735,-142615098,241662565.3004053,11.559559991230543,37.20085295746457,45.329069900816606,28.571428571428573,100
2000-12-01,64.0625,66.76562,62.125,64,84.91402942976529,83.0870957114396,77.62743970924488,70.8633105555951,91.61406177500007,86.77937409999996,78.79749920000015,72.06796749999997,72.06796749999997,84.12763180286076,60.00830319713917,57110400,34.38957265004089,37.11487416308837,NaN,NaN,NaN,NaN,NaN,NaN,-0.6583219528773117,-4.5062890361020465,-3.847967083224735,19.9288256227758,12.295316535418065,-85504698,230702033.2059869,14.95295831232395,34.24095042427213,44.713999498953875,21.428571428571427,92.85714285714286
2000-12-04,64.125,65.35937,61.75,63.6875,84.70282018170792,82.70294530131208,77.08077540692156,70.17990002649081,91.43843677500007,86.42687409999995,78.21249920000015,71.09921749999998,71.09921749999998,82.56883366501114,59.62960133498883,49076000,34.01411680537949,37.27189501034429,NaN,NaN,NaN,NaN,NaN,NaN,-0.5392820645792509,-4.522069663948798,-3.9827875993695474,18.14946619217082,17.40805693950178,-134580698,234313759.87296757,14.018689181145117,32.75070636555969,43.70239367999166,14.285714285714286,85.71428571428571
2000-12-05,66.0625,71,65.5,70.6875,84.56336425950187,82.46501569138512,76.83005872429719,70.22824288111073,91.29859302500006,86.12749909999994,77.82249920000014,70.51171749999997,70.51171749999997,80.73395024156316,60.289484758436785,76517184,47.769908200382,37.592693382941256,NaN,NaN,NaN,NaN,NaN,NaN,0.04663384918660807,-3.9244952878862875,-3.9711291370728956,58.00711743772242,32.028469750889684,-58063514,302135809.32751304,21.59080037250111,28.82169286399844,41.56216246169195,7.142857142857143,78.57142857142857
2000-12-06,70.59375,72.29687,67.75,68,84.39855466487995,82.17857973710026,76.48378191157965,70.0160292733859,91.11796802500007,85.79312409999994,77.40374920000014,69.80546749999998,69.80546749999998,78.56828467529743,61.04265032470252,63346800,43.979227049545806,37.45733464585402,NaN,NaN,NaN,NaN,NaN,NaN,0.27612402423528914,-3.6259741067787843,-3.9020981310140734,45.45454545454545,40.537043028146236,-121410314,245754988.12171653,22.106220195328426,26.67852583245938,39.81915844668462,0,71.42857142857143
2000-12-07,67,68.98437,65.5,66.5,84.22045959358762,81.86811281161313,76.09226105230202,69.68116934258724,90.91796802500006,85.46562409999993,76.94374920000014,69.34531149999998,69.34531149999998,77.7814689633775,60.90915403662245,41471296,41.977051081113096,37.59347132557538,NaN,NaN,NaN,NaN,NaN,NaN,0.3453373304575864,-3.47042646794209,-3.8157637983996766,40.851063829787236,48.10424224068504,-162881610,228087878.24431545,20.82806976788181,28.869593461875976,38.23966295617096,0,64.28571428571429
2000-12-08,71.09375,74,67.625,68,84.05906198569123,81.59349671633366,75.7749174816235,69.52105797662655,90.73703052500007,85.17937409999993,76.45468680000015,68.96093649999997,68.96093649999997,76.8915782014577,61.03029479854225,65840496,44.688817503133,37.9273619945032,NaN,NaN,NaN,NaN,NaN,NaN,0.5011298223190161,-3.1893515205009066,-3.690481342819923,55.55555555555556,47.28705494662942,-97041114,169993322.95019782,26.270181405522703,25.457610897667042,35.32171663418085,0,57.142857142857146
2000-12-11,72.05859,74.78125,70.95312,74.375,83.96270315996296,81.45055618729735,75.72001875685396,69.98333816932879,90.59015552500006,84.92124909999995,76.16843680000014,69.09218649999997,69.09218649999997,77.2856481141107,60.89872488588924,51822800,54.43542392191825,39.20933745032642,NaN,NaN,NaN,NaN,54.43542392191825,NaN,1.0129905054411559,-2.424243211018478,-3.437233716459634,97.15536105032822,64.52066014522366,-45218314,210817012.41842383,24.747990959857667,22.830302921035532,32.320331005688494,100,50
2000-12-12,73.5,73.875,71.3125,71.65625,83.84025088971457,81.25660953012314,75.56065527619302,70.1426631055832,90.41343677500006,84.66468659999992,75.86656180000014,69.17187399999997,69.17187399999997,77.43226112773364,60.91148687226631,31047696,50.35976398547452,40.20927569487752,NaN,NaN,NaN,NaN,NaN,NaN,1.1385445592286856,-2.0140530174237767,-3.1525975766524623,78.11816192560175,76.94302617716183,-76266010,188099186.0769604,23.565180553234526,21.739146878302158,29.20124974255012,92.85714285714286,42.857142857142854
2000-12-13,73.4375,73.5,68.3125,68.73437,83.68994361718009,81.00864439091278,75.29295781438152,70.00853995267052,90.21898362500008,84.40890529999993,75.57374920000012,68.81640499999997,68.81640499999997,76.48869662234497,61.14411337765498,51659104,46.34383448502515,41.17386190024716,NaN,NaN,NaN,NaN,NaN,NaN,0.9998290953789319,-1.9028112074287975,-2.9026403028077294,57.65860831509846,77.64404376367614,-127925114,144842366.87868762,21.67540948947753,24.633500021808814,25.978829733452162,85.71428571428571,35.714285714285715
2000-12-14,68.51562,69.6875,65.25,65.375,83.50770537223302,80.69906727426104,74.90401829224892,69.56725043336856,90.02019457500008,84.10187409999993,75.16874920000014,68.21640499999998,68.21640499999998,74.93524438923265,61.49756561076731,41511600,42.17916518807063,41.29952846603586,NaN,NaN,NaN,NaN,NaN,NaN,0.6725479089603286,-2.0619554166073186,-2.734503325567647,34.13566739606127,56.63747921225382,-169436714,105669448.56882846,20.184275952681876,27.686608565878096,23.633969394419672,78.57142857142857,28.571428571428573
2000-12-15,64.25,65.625,62.5625,63.875,83.31235507002175,80.36591742724598,74.47150777098426,69.0251313444763,89.79195240000008,83.78437409999994,74.72874920000014,67.76640499999998,67.76640499999998,74.38167980444345,61.151130195556505,59023600,40.432008035332515,41.3787532958774,NaN,NaN,NaN,NaN,NaN,NaN,0.36136177820491433,-2.2828011028115043,-2.6441628810164186,23.632385120350108,38.475553610503276,-228460314,97237505.71168561,19.202463384016394,30.608487062424267,22.75798891535544,71.42857142857143,21.428571428571427
2000-12-18,65.15625,65.96875,62.5625,64,83.12019233300661,80.04183985442923,74.06086040741626,68.54654740690714,89.55445240000009,83.50874909999992,74.34874920000014,67.32499899999998,67.32499899999998,73.70429937602242,60.94569862397753,42734496,40.6526250188372,41.81274479859005,NaN,NaN,NaN,NaN,NaN,NaN,0.1794566948262557,-2.419842012483599,-2.599298707309855,24.50765864332604,27.425237053245798,-185725818,90572492.57407093,18.700861457872687,28.923299105742174,21.19741405726871,64.28571428571429,14.285714285714286
2000-12-19,63.45312,65.85937,58.75,59.125,82.88143420033988,79.62764500582666,73.47514039143915,67.64925717767788,89.30132740000006,83.23187409999993,73.87874920000013,66.78828049999998,66.78828049999998,73.97901034761792,59.597550652382054,80489680,35.18026808010481,42.0378875120857,NaN,NaN,NaN,NaN,NaN,NaN,-0.2313791047883127,-2.8885225882952454,-2.6571434835069327,2.3391812865497075,16.82640835007528,-266215498,18574037.53493245,16.641476145473245,31.64366718203584,19.919159677098314,57.142857142857146,100
2000-12-20,57.3125,58.375,54.75,55.73437,82.61131415854545,79.15451084729544,72.77942390550037,66.51450601789904,89.02218675000007,82.89421779999994,73.42718660000013,66.08749899999998,66.08749899999998,74.59782495659634,57.57717304340362,81399376,31.95803902676505,42.02570150222298,NaN,NaN,31.95803902676505,NaN,NaN,NaN,-0.6689111653007864,-3.4932824401329157,-2.8243712748321292,4.914171606864267,10.58700384558,-347614874,-18617281.22196693,15.509577381645133,35.710040778986446,18.9800615854033,50,100
2000-12-21,55.01562,58.75,54.25,56.0625,82.3471468534853,78.69724330576484,72.12385826214741,65.51907687333723,88.72749925000008,82.57078029999994,73.00718660000013,65.55937399999998,65.55937399999998,75.11721493558912,56.00153306441083,85869120,32.6014053544784,41.897975266825654,NaN,NaN,NaN,NaN,NaN,NaN,-0.8613926120009201,-3.9011120398332793,-3.039719427832359,8.82800608828006,5.360452993898008,-261745754,-35314054.555300266,14.422930613219254,33.98656716184156,19.06611273251304,42.857142857142854,100
2000-12-22,57.625,60.75,57.625,60.5,82.12976230767947,78.33690185416553,71.66802068323966,65.04106955206701,88.45656175000008,82.30718659999994,72.71468660000012,65.06249899999997,65.06249899999997,74.58746696254573,55.537531037454215,57243008,40.75931165386464,42.37977489886031,NaN,NaN,NaN,NaN,NaN,NaN,-0.6259772047192942,-3.822190933731477,-3.196213729012183,30.441400304414003,14.72785933318611,-204502746,12770072.164699733,16.481024172061158,31.50999908916988,18.44213785462807,35.714285714285715,92.85714285714286
2000-12-26,60.59375,61.92187,58,60.875,81.91827213546375,77.99112161942958,71.24476497017145,64.64430102329872,88.20499925000007,82.00781159999991,72.30718660000014,64.62812399999997,64.62812399999997,74.08472570991788,55.171522290082066,37078896,41.404769263917444,41.925122117684275,NaN,NaN,NaN,NaN,NaN,NaN,-0.39253773434427597,-3.6868858969425276,-3.2943481625982516,32.267884322678846,23.845763571790968,-167423850,30053929.647094633,17.306579940135812,29.568618849746436,19.286098709775988,28.571428571428573,85.71428571428571
2000-12-27,59.6875,62.1875,58.9375,61.5625,81.71572713909097,77.66580237944088,70.86506830467452,64.35079616393693,87.97781175000007,81.72343659999991,71.90593660000015,64.43359299999997,64.43359299999997,73.97400353005854,54.893182469941415,33952496,42.638705425595084,41.829370573116364,NaN,NaN,NaN,NaN,NaN,NaN,-0.15173633287774546,-3.4840185786954336,-3.332282245817688,35.61643835616438,32.77524099441908,-133471354,50947773.339402325,16.83056430851303,28.027549466040757,20.399561795833314,21.428571428571427,78.57142857142857
2000-12-28,60.78125,62.48437,60.25,61.4375,81.51395373472191,77.34444985707572,70.4953597437069,64.07333938641914,87.77015550000007,81.41515539999992,71.56968660000013,64.35859299999997,64.35859299999997,73.9682021950741,54.748983804925835,30996304,42.463612196583995,41.86412493850714,NaN,NaN,NaN,NaN,NaN,NaN,0.02955016294619739,-3.2953445421349414,-3.324894705081139,35.007610350076106,34.29731100963978,-164467658,52898663.4030534,16.698889202278703,26.986216614807162,20.925842663657154,14.285714285714286,71.42857142857143
2000-12-29,61.5625,62.23437,58,58.375,81.28371538910278,76.96881718663857,70.02005151846349,63.53064039723636,87.51953050000007,81.07890539999991,71.17718660000013,64.12812449999997,64.12812449999997,74.07373183345459,54.18251716654535,49190608,38.31256787450094,41.40867853646199,NaN,NaN,NaN,NaN,NaN,NaN,-0.023501207027263327,-3.3542712138652178,-3.3307700068379544,20.091324200913242,30.238457635717907,-213658266,12420793.307393365,15.521911990792908,28.82935707824345,22.956828086354815,7.142857142857143,64.28571428571429
2001-01-02,58.5625,58.6875,52.4375,53.4375,81.00663861906196,76.50285050967544,69.36975538048453,62.5693889308329,87.23265550000008,80.69718669999992,70.54468660000013,63.59999949999997,63.59999949999997,74.58426317269411,52.615735827305826,62512896,32.7533701223454,39.85996040792107,NaN,NaN,32.7533701223454,NaN,NaN,NaN,-0.34025452657989863,-3.7560881650628275,-3.415833638482929,4.664723032069971,19.921219194353107,-276171162,-30087975.972606637,13.958106041428014,34.89144591330242,25.729833864550702,0,100
2001-01-03,52.1875,65.25,52.15625,62.4375,80.82187107061358,76.22432871740465,69.09790222830867,62.556828080277384,87.00859300000008,80.42218669999991,70.06718660000013,63.53749949999997,63.53749949999997,74.5332792895952,52.541719710404735,118227184,47.661207453592496,39.667206369929495,NaN,NaN,NaN,NaN,47.661207453592496,NaN,0.08454781139911827,-3.310148874234031,-3.394696685633149,48.16983894582723,24.308628726270147,-157943978,37349486.97727402,20.655371016564224,28.42935138751453,26.573211545439026,0,100
2001-01-04,61.625,63.625,60.23437,61.3125,80.6277479753836,75.92904498042634,68.79259233700245,62.43832064406049,86.75765550000007,80.1265616999999,69.56968660000013,63.06874949999998,63.06874949999998,73.59461716287053,52.54288183712943,58452608,46.280082592881385,39.6626526633478,NaN,NaN,NaN,NaN,NaN,NaN,0.3055274809708175,-3.0127873344196274,-3.318314815390445,52.228163992869874,35.02090865692236,-216396586,16069622.840827439,19.640950821422763,27.03313787195286,27.248222021941626,0,92.85714285714286
2001-01-05,61.3125,61.3125,56,56.625,80.3889146621957,75.54678666398226,68.31543185319843,61.88467105891187,86.47078050000007,79.76343669999989,69.05343660000013,62.49999949999998,62.49999949999998,73.12736601439401,51.87263298560595,68776368,40.95476208491398,39.57519529883662,NaN,NaN,NaN,NaN,NaN,NaN,0.1591241449741183,-3.119409634172797,-3.2785337791469154,32.35294117647059,44.2503147050559,-285172954,-36524070.33564314,18.13789536468488,31.063997440274505,28.005331923811912,0,85.71428571428571
2001-01-08,56.3125,57.5,53.51562,57.25,80.15867670535793,75.18447405677469,67.88149334915144,61.44327381520598,86.17515550000007,79.40531169999988,68.64093660000013,62.03749949999999,62.03749949999999,72.7331898555245,51.34180914447547,55546608,41.914478533974496,39.68108604873961,NaN,NaN,NaN,NaN,NaN,NaN,0.12879562618914253,-3.1175392464104874,-3.24633487259963,36.87782805429864,40.486311074546364,-229626346,12051991.682296917,17.08205306987289,32.88539068209872,28.628806328662428,7.142857142857143,78.57142857142857
2001-01-09,57.75,59.125,56.625,57.25,79.93072967346383,74.82933595664053,67.46457204134158,61.04391440423398,85.87203050000008,79.04359299999989,68.18843660000013,61.49999949999998,61.49999949999998,72.02216253956841,50.97783646043155,53307904,41.914478533974496,39.771218442678,NaN,NaN,NaN,NaN,NaN,NaN,0.13263083398898434,-3.0805463301133997,-3.213177164102384,37.1721914425328,35.46765355776734,-229626346,-14601960.317703083,18.895558534041392,31.640808234101442,28.89703076617926,0,71.42857142857143
2001-01-10,56.125,60.375,55.75,60.1875,79.73427962696171,74.53939861096448,67.17919666717133,60.96235112764027,85.58617115000008,78.6910929999999,67.79781160000012,60.79062449999998,60.79062449999998,69.50236754495154,52.07888145504842,74232496,46.64191319914104,40.58990737975201,NaN,NaN,NaN,NaN,NaN,NaN,0.344840250785837,-2.782126850620088,-3.126967101405925,61.33651551312649,45.128845003319306,-155393850,53611684.65526989,19.465690809833188,29.42233490152182,28.132475673481757,0,64.28571428571429
2001-01-11,59.26562,63.6875,59.1875,61.9375,79.55719724261382,74.28985606421271,66.97363993512539,61.05522244881738,85.32085865000006,78.35906179999989,67.50124920000013,60.30468699999998,60.30468699999998,67.48804464436712,53.12132935563284,65401296,49.28979077684319,41.82788964761473,NaN,NaN,NaN,NaN,NaN,NaN,0.599960780145802,-2.3770161262236726,-2.9769769063694747,74.70167064439141,57.73679253335024,-89992554,68145305.98860322,23.171347221032896,27.408700814767556,25.91380435456054,57.142857142857146,57.142857142857146
2001-01-12,62.75391,64.625,61.5,62.73437,79.38980592676693,74.06103455799068,66.80739405531655,61.21514126321573,85.08203050000007,78.0289054999999,67.12187420000012,60.004686999999976,60.004686999999976,66.18606126846888,53.82331273153107,60792704,50.494508071456224,43.105968413113146,NaN,NaN,NaN,NaN,NaN,NaN,0.8064093619261161,-1.9689652039618295,-2.7753745658879456,80.78755131264916,72.27524582338903,-29199850,55378643.61195035,23.503840077394642,26.074148082618688,23.397487717874025,50,50
2001-01-16,62.5625,62.92187,60.5625,61.98437,79.21661750958516,73.82189268555523,66.61825585706885,61.288401142909464,84.85570235000006,77.69437419999988,66.74156160000013,59.835155499999985,59.835155499999985,65.58930189554967,54.0810091044503,32137200,49.3072129926215,43.716532794452924,NaN,NaN,NaN,NaN,NaN,NaN,0.8709733344134989,-1.686657897871072,-2.557631232284571,75.0596276849642,76.84961654733492,-61337050,61976292.799657226,22.60877416287427,26.594383378593868,21.739208493170025,42.857142857142854,42.857142857142854
2001-01-17,64.5,65.60937,63.14062,63.875,79.06396459904202,73.62492451356404,66.51067719600732,61.5347438912038,84.62757735000008,77.36312419999987,66.37906160000013,59.835155499999985,59.835155499999985,65.58930189554967,54.0810091044503,61377904,52.348919058473626,44.49825777977836,NaN,NaN,NaN,NaN,NaN,NaN,1.009755945630951,-1.295436300245882,-2.305192245876833,87.1080463119336,80.98507510318233,40854,37114605.621546924,25.66319113446877,25.017987782930156,19.961648323503624,100,35.714285714285715
2001-01-18,64.125,66.75,62.6875,66.5625,78.93957191646449,73.48507452319643,66.51270946283056,62.01357780632725,84.44288985000009,77.04312419999987,66.04906160000012,59.963280499999975,59.963280499999975,66.17832543478774,53.74823556521221,54874192,56.357640753881554,45.47818173179883,NaN,NaN,NaN,NaN,NaN,NaN,1.236335091656691,-0.759773381305969,-1.9961084729626601,98.71520342612419,86.96095914100734,54915046,86923487.5907777,25.824347835636296,23.347706697868844,18.538490656633062,100,28.571428571428573
2001-01-19,68.14062,68.3125,65.5625,66.3125,78.813929409833,73.34304334451927,66.504858111347,62.42299896762942,84.27070235000008,76.72249919999987,65.72656160000011,60.322655499999975,60.322655499999975,67.10735569908252,53.53795530091743,56280400,55.886644553033214,46.43696975725948,NaN,NaN,NaN,NaN,NaN,NaN,1.3157835063366403,-0.35137909004185985,-1.6671625963785002,87.62088974854932,91.14804649553571,-1365354,61341487.590777695,27.26280739187467,22.264112721250346,17.57735230374219,100,21.428571428571427
2001-01-22,65.875,67,64.75,66.375,78.69015896794411,73.20506228819215,66.49976563639223,62.79938001833138,84.10757735000008,76.40187419999987,65.41156160000011,60.85468699999997,60.85468699999997,67.78401804613277,53.92535595386717,35771392,55.98567832140797,47.699334789181414,NaN,NaN,NaN,NaN,NaN,NaN,1.3157924950016113,-0.02242197762648601,-1.3382144726280973,88.00773694390716,91.44794337286022,34406038,77239884.03522214,26.191729540994903,22.808121746563266,15.927401475425151,92.85714285714286,14.285714285714286
2001-01-23,65.90625,68.40625,65.3125,67.76562,78.58145708766607,73.0973505597131,66.54940698398468,63.27235525468077,83.93484295000007,76.09124919999987,65.2528116000001,61.439842999999975,61.439842999999975,68.6235179861792,54.256168013820755,49829200,58.232481464643456,49.51927131363128,NaN,NaN,NaN,NaN,58.232481464643456,NaN,1.3477684776531036,0.34649612443828204,-1.0012723532148216,96.05766153846153,90.56209607697268,84235238,106432587.61760592,27.25073949512895,21.55420185898751,13.700214025944447,100,7.142857142857143
2001-01-24,68.0625,69.125,66.75,67.125,78.46746248977884,72.97908619219403,66.57197925912254,63.63927380185403,83.74046795000008,75.77359299999988,65.0815616000001,61.77109299999997,61.77109299999997,69.35092288641967,54.19126311358028,53866608,56.7941747487235,50.171626120426346,NaN,NaN,NaN,NaN,NaN,NaN,1.2654036905442627,0.5804822599655068,-0.6849214305787559,87.18719129139018,90.41752992458629,30368630,69576487.4070796,27.3817044091968,20.61713276040852,13.575593819287517,100,0
2001-01-25,66.875,67.67187,64.39062,64.5,78.32848276351238,72.8111834953189,66.4907251705295,63.72124772548698,83.56296795000007,75.39984299999988,64.9365616000001,61.95234299999997,61.95234299999997,69.61075047199164,54.293935528008305,57076192,51.21237066159014,50.5239324110484,NaN,NaN,NaN,NaN,NaN,NaN,0.9861674156379834,0.5477878389687234,-0.43837957666926,70.37037986133979,84.53841089706384,-26707562,16305548.820236228,25.718140011992013,23.733101221760357,12.731040354057347,92.85714285714286,14.285714285714286
2001-01-26,63.5625,65.9375,63,65.54687,78.20130253700977,72.66733570333238,66.45371124227344,63.89511651353584,83.40203045000007,75.03031169999987,64.8462490000001,62.15156149999998,62.15156149999998,69.96476713673479,54.33835586326516,45679808,53.18830842339155,51.39775714951109,NaN,NaN,NaN,NaN,NaN,NaN,0.8302564233822045,0.5994409525584956,-0.23081547082370885,77.07705238773096,78.21154118015365,18972246,49836316.20812384,24.295087752101583,25.03934708449405,10.962257897903479,85.71428571428571,7.142857142857143
2001-01-29,64.75,67.25,64.25,67,78.08984679037286,72.55511123395947,66.47513433081174,64.1908197027229,83.27703045000007,74.70515549999988,64.6693740000001,62.42968649999998,62.42968649999998,70.51277147245342,54.34660152754654,31507808,55.860614654921484,52.393909729578716,NaN,NaN,NaN,NaN,NaN,NaN,0.7838506826988081,0.7489978825498014,-0.03485280014900677,84.11214953271028,77.18652726059368,50480054,76092822.8747905,25.41113313099151,23.602946485612435,8.966675631569554,78.57142857142857,0
2001-01-30,67.14999,67.74001,66,66.75,77.97701249395124,72.4401585362573,66.48591337666227,64.43455115960644,83.16578045000007,74.41203049999987,64.45687400000011,62.84843649999997,62.84843649999997,70.91564057866994,54.78123242133,42830000,55.27597466037111,53.34830231003561,NaN,NaN,NaN,NaN,NaN,NaN,0.6980370457998755,0.8376935071008376,0.1396564613009621,82.24299065420561,81.14406419154894,7650054,70185024.47133309,25.50626865267803,22.786467968021988,7.567529044255356,71.42857142857143,7.142857142857143
2001-01-31,67.25,68,64.3,64.3,77.84092281739451,72.2789672781136,66.40019128345982,64.42173676345345,83.08853045000006,74.07253049999987,64.2853740000001,63.391561499999966,63.391561499999966,70.21857437108116,56.564548628918764,59310496,49.77767758792016,53.5722854806627,NaN,NaN,NaN,NaN,NaN,NaN,0.45003196763279635,0.7021964208419575,0.2521644532091612,51.446540880503115,72.60056035580634,-51660442,10874528.471333086,23.634070826440936,24.486407889359825,6.23931718063601,64.28571428571429,0
2001-02-01,64.55,65.61,63.60001,65.14999,77.71464487891298,72.13779941122026,66.35116378214767,64.49109421455313,82.96928040000007,73.77528039999987,64.1318114000001,63.52718599999996,63.52718599999996,70.38071765971232,56.67365434028759,45153808,51.57726730184044,53.73567666101964,NaN,NaN,NaN,NaN,NaN,NaN,0.3229412107909981,0.6558409666979088,0.33289975590691073,53.576525547445286,62.42201902738467,-6506634,35360369.747041084,22.660965021213954,24.91211007902921,5.9789209712319975,57.142857142857146,0
2001-02-02,64.94,65.3,60,61.55,77.55380264131185,71.92814001693867,66.16288284951442,64.2109900036433,82.81828040000008,73.46296789999987,63.9656240000001,63.53906099999997,63.53906099999997,70.37800962008606,56.70011237991387,47438304,44.331831027415014,53.29548544358813,NaN,NaN,NaN,NaN,NaN,NaN,-0.006423860441636786,0.3248699303548648,0.33129379079650156,16.986301369862982,40.66978926593713,-53944938,15668998.275342934,20.288801710250677,29.414695379634747,6.920084815125448,50,100
2001-02-05,61.19,61.89999,60.12,61.5,77.39406331154755,71.72164219482107,65.98002469855307,63.9528004794868,82.68046790000008,73.16484289999987,63.8006240000001,63.78281099999997,63.78281099999997,69.93132854719603,57.63429345280391,36015200,44.23887796353158,52.93346151293884,NaN,NaN,NaN,NaN,NaN,NaN,-0.21873798229235664,0.05787131293105574,0.2766092952234124,16.438356164383563,29.00039436056395,-89960138,35497905.26470799,19.548668745108326,28.34165094748927,7.652967335380739,42.857142857142854,92.85714285714286
2001-02-06,61.49001,63.12,61.16,61.60001,77.23690855222867,71.52121383452759,65.80825941625687,63.72872519572615,82.55409295000008,72.84646799999987,63.70012420000009,64.00031149999998,64.00031149999998,69.48049783688172,58.520125163118244,42399008,44.48959310159467,52.37208108744749,NaN,NaN,NaN,NaN,NaN,NaN,-0.3364851437672626,-0.14399713448566587,0.1924880092815967,17.534356164383535,16.98633789954337,-47561130,12135619.213769246,21.31910017434448,27.16645700346323,8.4234626319826,35.714285714285715,85.71428571428571
2001-02-07,60.50999,61.2,58.58,60.60001,77.07136727310201,71.30495237245773,65.60401434110955,63.430752319942705,82.43209300000008,72.51871809999987,63.50337440000009,64.16781199999997,64.16781199999997,68.97606382428332,59.359560175716624,61951808,42.43505103413997,51.377610393180234,NaN,NaN,NaN,NaN,NaN,NaN,-0.4582202164420834,-0.38028726127100754,0.07793295517107585,19.15609293504029,17.70960175460247,-109512938,45713026.23520416,19.946665453741875,30.917232443871768,9.60430481099478,28.571428571428573,100
2001-02-08,60.89999,61.5,58.58,58.78999,76.88946302162836,71.05713133537937,65.33679770028172,62.98877495613864,82.27385545000007,72.19286799999988,63.28792420000009,64.09793649999997,64.09793649999997,69.16896917914802,59.026903820851935,48146608,38.93063137141165,50.16646659449298,NaN,NaN,NaN,NaN,NaN,NaN,-0.6267224884149447,-0.705470155347605,-0.07874766693266036,1.9913703176861521,12.893939805703333,-157659546,4491285.505012535,19.33901763147132,28.974982312027198,10.30798854701089,21.428571428571427,92.85714285714286
2001-02-09,58.25,58.60001,56,56.39999,76.68558766817932,70.76689091289661,64.98633465321186,62.36127162698258,82.11898040000007,71.85874289999987,63.10686160000009,63.821060999999965,63.821060999999965,69.84824202866174,57.793879971338185,55403104,34.83933916204208,48.65601379739542,NaN,NaN,NaN,NaN,NaN,NaN,-0.8512889086799275,-1.1428588027825697,-0.2915698941026422,3.047542857142876,8.065002036623106,-213062650,-33865201.31354573,18.164822728104987,32.83037860099313,11.868942466462164,14.285714285714286,100
2001-02-12,56.25,57.94,55.62,57.08,76.49050719386908,70.49586337006697,64.67628231387022,61.85829337679376,81.94750540000007,71.49454289999987,62.989711600000085,63.53834249999996,63.53834249999996,70.23605803341403,56.840626966585894,50540304,36.87212807262759,47.13027426939427,NaN,NaN,NaN,NaN,NaN,NaN,-0.9013619824048826,-1.4182723721087456,-0.5169103897038629,10.810810810810816,5.283241328546614,-162522346,-20794433.037683636,17.228095644081705,31.982026738311703,13.17675999982716,7.142857142857143,100
2001-02-13,57.64999,59.17999,54.98,55.3,76.27965637601963,70.19495518452109,64.30858496822825,61.23369400757531,81.75150540000007,71.10066789999988,62.83602420000008,63.20412399999998,63.20412399999998,70.78724187241043,55.621006127589524,58908800,33.891631260104106,45.494378305921465,NaN,NaN,NaN,NaN,NaN,NaN,-0.9943787986333378,-1.7598838879955352,-0.7655050893621974,2.4577572964669754,5.438703654806889,-221431146,-70726632.61720642,18.35132890566627,29.060377225966793,13.783485117461137,0,100
2001-02-14,55.39999,57.75,54.125,57.45,76.09229661108411,69.94257983433256,64.03962085182714,60.87334219733004,81.56000540000007,70.75126169999986,62.70502420000009,62.88287399999998,62.88287399999998,70.8592669251806,54.90648107481935,63039600,40.181336650169484,44.706447305105705,NaN,NaN,NaN,NaN,NaN,NaN,-0.8563660162670852,-1.835962609696054,-0.9795965934289688,23.963963963963984,12.41084402374726,-158391546,-18121173.306861497,16.91504672179037,28.631936683265092,15.33425008733217,28.571428571428573,100
2001-02-15,58.8,60.49001,58.3,58.39999,75.91625375923253,69.71401369899924,63.818458857637836,60.63778484520337,81.40200535000007,70.40588659999986,62.599274000000094,62.474748499999976,62.474748499999976,70.49147468301183,54.458022316988114,67767808,42.77220949169129,43.962440238555686,NaN,NaN,NaN,NaN,42.77220949169129,NaN,-0.6554132187774515,-1.7988631169007832,-1.1434498981233316,30.810738738738756,19.077486666389905,-90623738,-79700787.53430305,21.748658743037417,26.741713153456896,15.961993057696144,21.428571428571427,92.85714285714286
2001-02-16,55.96001,56.87,54.53,55.13,75.70942536361828,69.425221348524,63.47773498086772,60.113233907564954,81.23078035000007,70.05531159999987,62.28812400000009,61.91562349999998,61.91562349999998,70.33351007688998,53.497736923109976,66756192,36.854988980849384,42.604895547550534,NaN,NaN,NaN,NaN,NaN,NaN,-0.6933605625175723,-2.010150601270297,-1.3167900387527247,7.243243243243262,20.672648648648664,-157379930,-112223034.91891831,19.94362222308716,32.60736960459087,17.41977170285372,14.285714285714286,85.71428571428571
2001-02-20,55.74001,55.84,52.3,52.99001,75.48336152915442,69.09977161885026,63.066451648284676,59.434831630654,81.05010540000006,69.69583669999986,61.98792420000009,61.24637399999997,61.24637399999997,70.24778179905658,52.244966200943345,55293008,33.58084556336813,41.05524346919317,NaN,NaN,NaN,NaN,NaN,NaN,-0.8053623549634181,-2.3234929824569974,-1.5181306274935793,4.394968152866247,14.14965004494942,-212672938,-145960829.1053138,18.43630230648656,34.903988577253024,19.222698846956536,7.142857142857143,100
2001-02-21,51.55,54.07001,50.92,51.5,75.24472111592901,68.75126128976412,62.61286530913626,58.67913338011552,80.85010540000006,69.31583669999986,61.68792420000009,60.43309299999997,60.43309299999997,69.86059988002634,51.0055861199736,72319632,31.48360616870802,39.74852408210659,NaN,NaN,NaN,NaN,NaN,NaN,-0.9145929333075264,-2.6613717941279873,-1.7467788608204609,3.948264125255265,5.195491840454923,-284992570,-191648554.18438348,17.19121094016472,35.505412424712354,21.578611407850627,0,100
2001-02-22,51.45,52.16,48.89,51,75.00348010980036,68.39975116521433,62.157458826425035,57.947787343914044,80.66385540000007,68.90130549999986,61.34792420000009,59.626842999999965,59.626842999999965,69.37969153634808,49.87399446365185,103867184,30.788720233563268,38.26362786294393,NaN,NaN,NaN,NaN,NaN,NaN,-0.9510958532739624,-2.935648677412914,-1.9845528241389514,12.858013406459476,7.067081894860329,-388859754,-161473072.5941693,15.984387068887674,37.370915458324234,24.103701163151204,0,100
2001-02-23,50.09,51.60001,48.23,51.17999,74.76643045696653,68.05876579560612,61.72696985283974,57.30323521592223,80.49225535000006,68.52623039999987,60.88402400000009,58.96084249999997,58.96084249999997,69.1030395598256,48.818645440174336,93314320,31.37589689819748,37.33820399657126,NaN,NaN,NaN,NaN,NaN,NaN,-0.8945378294994044,-3.102725111013207,-2.2081872815138026,19.811887172599057,12.206054901437932,-295545434,-91419146.88759872,14.829024913378255,36.085302329063,25.77430407270288,0,100
2001-02-26,52.08099,52.60001,50.25,52.14999,74.5413912484395,67.7437405323268,61.351402015473475,56.81244995726297,80.35300530000006,68.18023029999986,60.49389880000009,58.290998499999965,58.290998499999965,68.37424142934539,48.207755570654534,78335008,34.59624367542237,36.649444404563454,NaN,NaN,NaN,NaN,NaN,NaN,-0.7301604488896136,-3.1208878426258195,-2.390727393736206,26.32632639355276,19.66540899087043,-217210426,-43085985.94370457,16.256421866983725,34.2274146665674,27.00550770421685,7.142857142857143,92.85714285714286
2001-02-27,51.53999,52.08,48.89999,49,74.28724805193761,67.37257735346884,60.86703330898432,56.06840710419031,80.17425530000007,67.83648029999986,60.09921140000009,57.39099849999998,57.39099849999998,67.41731273665678,47.36468426334318,66727312,29.718924550067598,35.594396650882956,NaN,NaN,NaN,NaN,NaN,NaN,-0.768084871528703,-3.3508334831470847,-2.5827486116183818,5.80256217030899,17.3135919121536,-283937738,-105616205.18417247,15.098643656153222,34.74812747011988,28.959777375176454,0,85.71428571428571
2001-02-28,49.45,50.21001,46.86,47.45,74.02021075788848,66.97807087122193,60.34087514000454,55.24760642760075,79.98806780000007,67.45473029999985,59.740711400000094,56.42599849999997,56.42599849999997,66.37831408945917,46.47368291054078,102211680,27.653056528116224,34.53853990045268,NaN,NaN,27.653056528116224,NaN,NaN,NaN,-0.8269618395836713,-3.616450911097971,-2.7894890715142995,4.030054644808766,12.052981069556838,-386149418,-171825072.53585178,13.992425363463285,36.66380916474696,30.61598398062818,7.142857142857143,100
2001-03-01,46.97,49.2,45.75,48.8,73.76926338716322,66.61810907179179,59.888291801180834,54.633548672591154,79.78894280000007,67.08398029999985,59.4392114000001,55.65099849999997,55.65099849999997,65.44269275034259,45.859304249657356,101703184,32.08143507739567,34.049311593737265,NaN,NaN,NaN,NaN,NaN,NaN,-0.7089289908512146,-3.6756503100783178,-2.966721319227103,20.691980534612917,10.174865783243556,-284446234,-93705235.55034485,12.940888122853856,36.32639139367847,32.58185148857785,0,100
2001-03-02,47.2,49.63,45.64999,46.7,73.49991748281334,66.22369107037018,59.371103887409035,53.877972608534854,79.56713030000007,66.72098029999987,59.0932114000001,54.72849899999998,54.72849899999998,64.23908057570695,45.21791742429301,95924368,29.097742607623502,33.639197554135926,NaN,NaN,NaN,NaN,NaN,NaN,-0.704755120838878,-3.847665220275701,-3.142910099436823,7.075529547803848,10.59918824240851,-380370602,-139015888.6884827,12.758414670065173,33.22441326951609,33.70679566723338,28.571428571428573,100
2001-03-05,47.5,48.36,47.09,47.55,73.241709348656,65.85391500957077,58.90753118594201,53.275308550579155,79.35894280000008,66.37023029999986,58.861711400000104,54.028498999999975,54.028498999999975,63.488454407303664,44.56854359269629,43869104,31.860137964886533,33.28119826072585,NaN,NaN,NaN,NaN,NaN,NaN,-0.5822962662965798,-3.870780432307548,-3.288484166010968,12.803284631691838,13.5235982380362,-336501498,-151105799.23966414,12.287138129715416,31.99715369646381,34.74439708952677,21.428571428571427,92.85714285714286
2001-03-06,49.3,50.66,49.10001,49.39999,73.00447831036092,65.52809471235155,58.53468643355213,52.90623059338114,79.17750525000007,66.08110519999985,58.7350238000001,53.42349849999998,53.42349849999998,62.431639682407614,44.415357317592346,60815296,37.56191807484869,33.54336160463618,NaN,NaN,NaN,NaN,NaN,NaN,-0.326973973902283,-3.697201633388822,-3.370227659486539,25.26950772303542,15.049440634177037,-275686202,-188532006.21463153,16.564316555416276,29.777884744967025,35.167660273716365,14.285714285714286,85.71428571428571
2001-03-07,50.39999,50.42999,48.97,49.42,72.76980688438718,65.20912253982974,58.17724774988342,52.574208632106746,79.01616775000006,65.80468019999985,58.6021738000001,52.81449799999998,52.81449799999998,61.15102084301816,44.4779751569818,55187600,37.62271730186954,33.36060307975761,NaN,NaN,NaN,NaN,37.62271730186954,NaN,-0.11779967772876532,-3.5174772566474957,-3.3996775789187303,25.404345816245534,21.15904605699093,-220498602,-209699619.776368,16.00316690081198,29.070768752282316,35.40099161826286,7.142857142857143,78.57142857142857
2001-03-08,49.35001,49.81,48.10001,48.5,72.52831626862213,64.87824882616974,57.797747838123286,52.186188762382294,78.84866775000008,65.53843019999985,58.3621738000001,52.209497499999976,52.209497499999976,59.931780185199656,44.487214814800296,48927392,35.892207374628754,32.86917435711028,NaN,NaN,NaN,NaN,NaN,NaN,-0.00823606667200627,-3.4099726622587383,-3.401736595586732,25.401136006117632,25.358329848466195,-269425994,-235737442.21621844,15.347372672302747,29.964363054803062,36.96968648162972,0,71.42857142857143
2001-03-09,47.25,47.37,44.95,45.10001,72.25539779828759,64.48660053258222,57.29979733466747,51.51131459453636,78.69854280000008,65.17693029999984,58.046674000000095,51.52499849999997,51.52499849999997,59.219664219844624,43.83033278015531,79986816,30.338396847246898,32.40370349042439,NaN,NaN,NaN,NaN,NaN,NaN,-0.12509840523289428,-3.5581096021278498,-3.4330111968949555,1.3775022956840646,17.394328039349073,-349412810,-305807876.1764171,14.059287900948018,34.896710149762036,38.28865474886225,0,100
2001-03-12,44,44.95,41.8,42.3,71.95733413860313,64.04726190817465,56.71156998820992,50.63404653791385,78.51129280000008,64.78368029999984,57.661424000000096,50.81999899999998,50.81999899999998,59.15587294339264,42.484125056607326,80650000,26.677387673936693,31.910599355465006,NaN,NaN,26.677387673936693,NaN,NaN,NaN,-0.3391795790136518,-3.85698567066202,-3.517806091648368,4.07497630401279,10.28453820193816,-430062810,-360854701.57324255,12.9695850794108,39.590385196491724,39.701193779434796,0,100
2001-03-13,42.78,44.74001,42.13,44.45,71.6836293213036,63.65919731593357,56.23072410631933,50.045089724779196,78.34604280000009,64.44568029999985,57.3216740000001,50.18849899999998,50.18849899999998,58.44498011171659,41.93201788828337,80001376,33.33013913276096,32.04249456718308,NaN,NaN,NaN,NaN,NaN,NaN,-0.286302013442826,-3.875683608451901,-3.589381595009075,24.537014317579388,9.99649763909208,-350061434,-298631954.0488113,12.166395127469434,37.13860286200589,40.83650795311757,0,92.85714285714286
2001-03-14,42.7,45.19,42.31,43.75,71.40568276089262,63.264955784924986,55.7412839452872,49.44555737003832,78.1763553000001,64.10318029999985,57.029174000000104,49.61099899999997,49.61099899999997,57.971670069246656,41.250327930753286,97182880,32.30249281285239,32.15062117998944,NaN,NaN,NaN,NaN,NaN,NaN,-0.2500996129386732,-3.9020061111824162,-3.651906498243743,18.055538837464066,15.555843153018749,-447244314,-298631954.0488113,12.403448150682268,34.59286481222397,41.345936466145574,14.285714285714286,85.71428571428571
2001-03-15,45.2,45.319,42.05,42.14999,71.11458134038622,62.84683765057004,55.208292025864175,48.75074143003467,77.95960525000011,63.674055199999856,56.80342380000011,48.84599849999997,48.84599849999997,56.99481813183327,40.697178868166674,74099808,30.02382067261749,32.05404430673373,NaN,NaN,NaN,NaN,NaN,NaN,-0.28311318050743095,-4.005797973878032,-3.722684793370601,3.240645147550839,15.277732767531433,-521344122,-368198730.6618915,11.444506181797843,32.533308297043625,41.78909122657699,7.142857142857143,78.57142857142857
2001-03-16,41.88,42.8,40.56,41.10001,70.81592888923811,62.4162074000637,54.65502606406558,48.02210034145994,77.7501053000001,63.22193029999985,56.3766740000001,47.980999499999974,47.980999499999974,55.541071269775564,40.420927730224385,77770816,28.598126420213234,31.625607359933074,NaN,NaN,NaN,NaN,NaN,NaN,-0.3220324483279535,-4.125225353780543,-3.8031929054525895,4.687586805555515,8.66125693019014,-599114938,-408472208.85103464,10.826819054733626,34.36753495634073,42.96696395591026,0,100
2001-03-19,41.44,43.25999,40.75,43.25999,70.54174044257903,62.036876362438676,54.20816190469046,47.56856602322566,77.52890525000011,62.79265519999984,56.0156238000001,47.38749899999998,47.38749899999998,54.45726973886937,40.31772826113058,53233808,35.39458604720036,32.03101175258542,NaN,NaN,NaN,NaN,NaN,NaN,-0.15702695708531067,-3.999476601809228,-3.842449644723917,26.732574257425753,11.55360207017737,-545881130,-355238400.85103464,11.285396534046322,32.26605151859612,43.59229550212172,0,92.85714285714286
2001-03-20,43.44,43.81,40.2,40.35001,70.24132521429466,61.607433464172566,53.66470496725162,46.881084497204164,77.2644053000001,62.371780299999855,55.690124000000104,46.75549899999997,46.75549899999997,53.96740489817801,39.54359310182193,104988192,31.099677013329398,32.277198930100646,NaN,NaN,NaN,NaN,NaN,NaN,-0.1960503447010722,-4.0875125756002575,-3.8914622308991853,1.4341300191204085,10.951430360700558,-650869322,-451501230.70038676,11.627165371003203,29.4745100883537,43.497085430855016,28.571428571428573,100
2001-03-21,40.52,41.8,39.71001,40.35001,69.94389919226188,61.1864943856741,53.142560066575086,46.259077402232336,76.99803035000012,61.99653039999985,55.3521242000001,46.19799949999997,46.19799949999997,53.57853903530479,38.81745996469515,96083008,31.099677013329398,32.20707335409591,NaN,NaN,NaN,NaN,NaN,NaN,-0.17475444667853823,-4.109905289247358,-3.9351508425688198,5.844754196122559,11.337152824222906,-650869322,-488738861.3349448,11.032082505514714,29.165897435318396,43.32884669136498,21.428571428571427,100
2001-03-22,40.60001,42.8,39.49001,42.8,69.67381064308515,60.822405387937984,52.736969475729005,45.92964145916259,76.75515535000012,61.62578039999985,55.063124200000104,45.78799949999997,45.78799949999997,52.96416854707521,38.61183045292473,130194192,38.39848892667333,32.87141237688518,NaN,NaN,NaN,NaN,NaN,NaN,0.039982983748987344,-3.885172112882586,-3.925155096631573,29.632882392911718,12.303922202718226,-520675130,-358544669.3349448,12.571873913139092,26.82436487620652,42.73380184385544,14.285714285714286,100
2001-03-23,43.55,43.83,41.5,42.8,69.40640954215893,60.46552607332535,52.347284398249435,45.63158036781377,76.50196785000013,61.25659289999986,54.715374200000106,45.36899999999997,45.36899999999997,52.20757264055754,38.530427359442406,95267632,38.39848892667333,33.33843744558424,NaN,NaN,NaN,NaN,NaN,NaN,0.20826516067860634,-3.664823645783315,-3.8730888064619213,29.632882392911718,21.703506327315328,-520675130,-347505072.49374324,14.386705260614482,25.28546713930162,41.51695475818584,7.142857142857143,92.85714285714286
2001-03-26,43.47,43.5,41.55,41.81,69.13181840243595,60.09610971543772,51.9340575591024,45.267620332783885,76.24601785000013,60.90703669999985,54.31282420000011,44.852000499999974,44.852000499999974,51.09970831584408,38.604292684155865,57662704,36.58237510906885,33.26847009088568,NaN,NaN,NaN,NaN,NaN,NaN,0.27495428930740706,-3.5293959448276624,-3.8043502341350695,21.2065287139465,26.824097833256644,-578337834,-389791055.4270763,13.679394041802876,24.04232673595423,41.442599180834854,0,85.71428571428571
2001-03-27,41.8,43.72,41.42,43.25,68.87428787106843,59.76252338443895,51.59350628227485,45.075466015375895,75.99445535000014,60.522505499999845,53.9231368000001,44.56450049999997,44.56450049999997,50.545748622437294,38.58325237756265,69925184,40.95670465307746,33.50661204454339,NaN,NaN,NaN,NaN,40.95670465307746,NaN,0.4289211557584376,-3.2681987894370224,-3.69711994519546,36.43404693221602,29.091152679691408,-508412650,-348443990.10533714,13.437568674529146,22.629153460486677,41.192132362897965,0,78.57142857142857
2001-03-28,41.89999,42.2,39.67999,39.7,68.58399644946576,59.36524569365798,51.12709427120525,44.56351687105438,75.73795535000016,60.10950549999984,53.477449400000104,44.17700049999998,44.17700049999998,50.361024727973096,37.99297627202686,77963008,34.61733964251668,33.415550063678246,NaN,NaN,NaN,NaN,NaN,NaN,0.31009307934218633,-3.309503596017727,-3.6195966753599134,2.6648510975268342,20.101808914563115,-586375658,-425168876.2009951,12.235405127454596,24.965072638638812,41.33215858204938,0,71.42857142857143
2001-03-29,39.38,40.61,38.45,38.95,68.28913081315267,58.96098340269446,50.64956116253054,44.02889621666825,75.46176785000016,59.67900549999984,52.97894940000011,43.68450049999998,43.68450049999998,49.88625933295677,37.482741667043186,79633008,33.43973064194236,33.63707390615649,NaN,NaN,NaN,NaN,NaN,NaN,0.2044942756090835,-3.363978830848559,-3.5684731064576427,7.2790799242975694,15.45932598468014,-666008666,-467934750.8676617,11.56145999540019,26.726520642896993,41.121038213591376,0,100
2001-03-30,39.3,39.98,38,39.14999,67.99918911351931,58.568686503631206,50.19859758752934,43.564238481747466,75.19673655000017,59.23988039999984,52.430699200000106,43.306999999999974,43.306999999999974,49.64620308557633,36.967796914423616,63658304,34.08365117068135,34.166092727352535,NaN,NaN,NaN,NaN,NaN,NaN,0.17288304611670702,-3.352369298811759,-3.525252344928466,15.712392403333817,8.55210780838607,-602350362,-457647183.1333584,10.965221882831667,26.520274716357093,40.4673067245723,21.428571428571427,100
2001-04-02,39.17,39.85001,37.3,37.39999,67.69471947059871,58.14950439464841,49.69669140762623,42.977167197771514,74.91475215000018,58.78950529999984,51.85244900000011,42.79949949999997,42.79949949999997,49.32124867933844,36.2777503206615,69702192,31.23599833157671,34.01651124155366,NaN,NaN,NaN,NaN,NaN,NaN,0.06446506596542267,-3.4446710124716873,-3.50913607843711,1.2469135802469795,8.079461969292788,-672052554,-521883104.66533643,10.233269481015087,26.58239415790019,40.021566480553176,14.285714285714286,100
2001-04-03,37.2,37.75,34.62,34.66,67.36601579427435,57.684365693764285,49.10701723477815,42.18505603607899,74.61719280000017,58.31485529999983,51.21814900000011,42.06249999999997,42.06249999999997,48.76306227194279,35.36193772805715,88979312,27.378963613871292,33.66483058448358,NaN,NaN,NaN,NaN,NaN,NaN,-0.14973622576121048,-3.696306360638623,-3.5465701348774124,0.37386671651555403,5.777724233365448,-761031866,-608588185.0487231,9.403526993428327,31.36957404228337,40.497183644165794,7.142857142857143,100
2001-04-04,34.711,35.81,33.60001,34.05,67.0345131495552,57.21635845230361,48.5165459706692,41.410288794547654,74.29838030000016,57.89832409999983,50.54383660000011,41.29399999999997,41.29399999999997,47.968476440904006,34.61952355909593,76426192,26.591718273733633,33.419680413134735,NaN,NaN,26.591718273733633,NaN,NaN,NaN,-0.2827393972547845,-3.899994381445893,-3.6172549841911086,4.398733527598752,2.0065046081204265,-837458058,-653891139.2620544,8.857432942310531,32.22813168780103,41.135020658163036,0,100
2001-04-05,36,37.96001,35.71001,37.31,66.73874684955962,56.82217313641641,48.07707357966257,41.01978509982883,73.99297720000018,57.51454909999983,49.94753660000011,40.73449999999997,40.73449999999997,46.741632324177985,34.72736767582195,86971808,37.01496293094413,34.020883021044085,NaN,NaN,NaN,NaN,NaN,NaN,-0.11025813477525448,-3.7550776526601766,-3.644819517884922,36.265822351732545,13.679474198615615,-750486250,-617170482.3003473,13.453161848877503,29.01737740038126,40.032117156803515,35.714285714285715,92.85714285714286
2001-04-06,36.89999,37.10001,35.5,36.3,66.43587374657892,56.41579347034876,47.615227556930705,40.57028175698799,73.68103970000017,57.160049099999824,49.38353660000011,40.294499499999965,40.294499499999965,46.247033375431954,34.341965624567976,86117632,35.34070803949314,34.01703459192213,NaN,NaN,NaN,NaN,NaN,NaN,-0.02759702399863828,-3.67931579788322,-3.6517187738845815,26.392889924623578,22.35248193465162,-836603882,-617171020.5321835,12.816614584132136,28.193390768099935,39.26931486201569,28.571428571428573,85.71428571428571
2001-04-09,36.78999,37.39,35.85001,37.05,66.14347699288162,56.03231241152997,47.200904907639305,40.23501682775104,73.39246160000017,56.829924099999836,48.81359920000012,40.03199949999997,40.03199949999997,46.07004417424372,33.99395482575622,51630192,37.59789769755698,34.48119321222411,NaN,NaN,NaN,NaN,NaN,NaN,0.10681531129725919,-3.5181996347630076,-3.6250149460602668,33.724275390298516,32.127662555551545,-784973690,-588338723.687347,13.066513258553222,27.02188109955632,38.65424806620829,21.428571428571427,78.57142857142857
2001-04-10,37.89999,40.46001,37.78,39.8,65.88135284369872,55.710880482588784,46.91067334263384,40.19358665367951,73.13325850000018,56.46948659999984,48.26959920000011,39.79949949999997,39.79949949999997,45.487098075687626,34.11190092431231,94167872,45.157676176214494,35.48533600957304,NaN,NaN,NaN,NaN,NaN,NaN,0.3940100687463186,-3.1325023601273685,-3.526512428873687,60.60602209777331,40.24106247089847,-690805818,-540552572.0531069,20.005077834265172,24.58573057124035,36.16577518775731,14.285714285714286,71.42857142857143
2001-04-11,42.16,42.5,40.45,41,65.63377719351267,55.419575918577124,46.678882231158006,40.27038792475765,72.86732100000017,56.10573659999983,47.75459920000012,39.661999499999965,39.661999499999965,45.08787288666924,34.23612611333069,92773376,48.11169055866121,36.179136126143604,NaN,NaN,NaN,NaN,NaN,NaN,0.6620952571971941,-2.6988933573771945,-3.3609886145743886,72.33623884285323,55.55551211030835,-598032442,-583545112.150668,23.970607602641138,22.830640417379293,33.755666178404525,7.142857142857143,64.28571428571429
2001-04-12,40.3,42.8,40,42.8,65.40657543039315,55.169683326130055,46.52676920248514,40.51130336049501,72.61772725000017,55.80498659999983,47.32459920000012,39.69449999999996,39.69449999999996,45.1869736649479,34.202026335052025,79520816,52.26513493208785,37.16961084081608,NaN,NaN,NaN,NaN,NaN,NaN,0.9409310187168614,-2.1848248411783118,-3.125755859895173,90.90908192597027,74.61711428886561,-518511626,-504024296.150668,22.200657213045588,22.331551289626812,31.814371470397116,0,57.142857142857146
2001-04-16,41.94099,42.42999,40.06,40.25,65.15626124700616,54.874244052345304,46.280621390622976,40.486417326162154,72.34952415000018,55.47920539999983,46.82659940000012,39.65199949999996,39.65199949999996,45.11337901145359,34.19061998854633,65200704,46.57708335877305,37.8835185729378,NaN,NaN,NaN,NaN,NaN,NaN,0.9321365900604528,-1.960585122319607,-2.8927217123800597,65.71142856860533,76.3189164458096,-583712330,-558770834.7238098,20.59785044929452,20.719294449273683,29.8730767623897,7.142857142857143,50
2001-04-17,39.951,42.7,39.89999,41.25,64.9183880007673,54.60445704140778,46.08334212040247,40.55913948557528,72.09725855000016,55.193111699999825,46.42059940000012,39.55149999999996,39.55149999999996,44.813958322885426,34.2890416771145,94431632,48.92459508734987,38.452653603957266,NaN,NaN,NaN,NaN,NaN,NaN,0.9679503277188424,-1.6827838027315067,-2.650734130450349,83.15215560016917,79.92422203158158,-489280698,-562143043.7100922,19.791535490916054,19.194257536146658,28.162154882383362,0,42.857142857142854
2001-04-18,43.72099,51,43.2,45.55,64.72566772215269,54.42516086237,46.06242674313179,41.03445953456811,71.85907105000017,54.95111169999982,46.101599400000126,39.811499499999954,39.811499499999954,45.68448387304973,33.93851512695018,129098880,57.56042931187753,40.09144572319732,NaN,NaN,NaN,NaN,NaN,NaN,1.2382383205172998,-1.1029362298037242,-2.341174550321024,68.67814291847293,72.51390902908247,-360181818,-613451572.9408616,33.92458236649622,15.042326575994123,28.472309207087182,100,35.714285714285715
2001-04-19,46.10001,48.75,45.58,48.3,64.56222824233028,54.30387054826366,46.150174713989365,41.726415769371144,71.62494605000016,54.76786169999982,45.835599200000125,40.20899899999996,40.20899899999996,47.15254647028211,33.265451529717815,109699120,61.98705607343975,42.1305403968757,NaN,NaN,NaN,NaN,NaN,NaN,1.5395817161844512,-0.41669740509045994,-1.956279121274911,84.4827497027297,78.77101607379059,-250482698,-534897313.5086851,31.515080472011643,13.973941592186376,28.39754984777346,92.85714285714286,28.571428571428573
2001-04-20,48.17999,49.44,47.31,48.39999,64.40140995136181,54.18696202255547,46.23840276442115,42.36199426752627,71.41069600000017,54.54748659999982,45.59159880000013,40.48899849999996,40.48899849999996,48.233355288531776,32.74464171146814,80571120,62.141678270099405,44.134685189691275,NaN,NaN,NaN,NaN,62.141678270099405,NaN,1.6719666525293524,0.13367919438677944,-1.538287458142573,85.0574052054053,79.40609927553596,-169911578,-533006729.19995254,31.55767858952575,13.296956183418128,28.341457221990133,85.71428571428571,21.428571428571427
2001-04-23,46.99001,47.72,44.89,45.14999,64.20985353393533,54.00801208151477,46.19571991091444,42.62751767061901,71.16363345000016,54.30336149999983,45.318798800000124,40.60649799999996,40.60649799999996,48.55613071504359,32.65686528495633,79313008,54.39663505837664,45.7890163844627,NaN,NaN,NaN,NaN,NaN,NaN,1.4739125769036916,0.3041032629870415,-1.16980931391665,66.37923355128368,78.63979615313956,-249224586,-597746882.8183835,29.059309308309285,17.702604226663986,26.904183009889284,78.57142857142857,14.285714285714286
2001-04-24,45.10001,46.42,43.75,44.3,64.0117455385728,53.81577421851448,46.12137795362368,42.78680170198862,70.90810220000016,54.09183029999982,45.07679900000013,40.73099799999996,40.73099799999996,48.82873640625224,32.633259593747674,88875184,52.551857212102696,47.5870802129078,NaN,NaN,NaN,NaN,NaN,NaN,1.2289317385899028,0.36635535932072827,-0.8625763792691744,61.49423074381077,70.97695650016657,-338099770,-650006822.4738144,27.289458852415905,19.224859489106972,24.294469917665797,71.42857142857143,7.142857142857143
2001-04-25,43.89999,45.58,43.10001,45.10001,63.82356906555217,53.643184828048845,46.081324308383536,43.007107254180184,70.66235225000015,53.91345539999981,44.83719920000012,40.82349849999996,40.82349849999996,49.07502689673467,32.571970103265244,68399312,54.128668318070325,49.55400521607471,NaN,NaN,NaN,NaN,NaN,NaN,1.069878576181284,0.4747718409574304,-0.5951067352238535,61.93554838709676,63.26967089406372,-269700458,-608084218.6596377,25.7223972231645,19.62593647480501,21.191658065793884,64.28571428571429,0
2001-04-26,45.89999,46.25,43.87,43.95,63.62582210967603,53.45124057402808,45.99774296295673,43.09690656330588,70.41608665000014,53.72311169999982,44.610199200000125,41.03599849999996,41.03599849999996,49.3792381844461,32.69275881555382,71105312,51.48021867530511,50.58723776924335,NaN,NaN,51.48021867530511,NaN,NaN,NaN,0.8461368554436339,0.46256433408068887,-0.383572521362945,54.51612903225808,59.31530272105519,-340805770,-674409341.6176206,25.85846881416749,18.526437617911775,19.753951794491844,57.142857142857146,7.142857142857143
2001-04-27,45.14999,45.47,44.241,45.14999,63.44198298420662,53.286859374542374,45.96449774872313,43.29243831918151,70.15699285000014,53.53461159999981,44.364199000000134,41.345997999999966,41.345997999999966,49.8159423289863,32.87605367101363,56462000,54.0089263064116,51.9206819311661,NaN,NaN,NaN,NaN,NaN,NaN,0.7416215032097697,0.5434543576492672,-0.19816714556050255,61.386047119503075,59.27924151295263,-284343770,-647350766.5484583,24.89907073073372,17.83907175447976,18.255667316158426,50,0
2001-04-30,46.25,47.57001,45.3,46.14999,63.26992335252297,53.14553522851183,45.97177195465556,43.564586098307075,69.89305530000014,53.359236499999824,44.11919900000014,41.69599799999996,41.69599799999996,50.35054215530455,33.04145384469537,73852000,56.06390939367781,53.2396827666033,NaN,NaN,NaN,NaN,NaN,NaN,0.7028605964157112,0.6804085999591365,-0.022451996456574724,63.313086232980346,59.73842079491382,-210491770,-665895995.6707969,28.59994641345585,16.772121683147382,17.631169077602994,42.857142857142854,0
2001-05-01,46.2,48.08,45.39999,48.05,63.118481329114786,53.04463354081853,46.05327109368867,43.99176837465878,69.63018030000013,53.13286149999982,43.97759900000014,42.228498499999965,42.228498499999965,51.068772180271566,33.388224819728364,54476896,59.74436788422211,54.28158931717527,NaN,NaN,NaN,NaN,NaN,NaN,0.763179787070749,0.9315227373818615,0.16834295031111254,73.4234473662636,66.04086023958233,-156014874,-612638727.1199483,27.96272987761819,15.655416304624307,18.91284058347137,35.714285714285715,0
2001-05-02,48.8,49.39999,47.5,48.98,62.977799922854935,52.964145747931035,46.168044776289115,44.466838053262705,69.36789280000013,52.94266149999982,43.897398800000126,42.944498499999966,42.944498499999966,51.532858956693836,34.356138043306096,77552192,61.446735750726255,55.23409254517992,NaN,NaN,NaN,NaN,61.446735750726255,NaN,0.8187952184696441,1.1918369733981677,0.37304175492852365,81.80181819656015,72.84611726526802,-78462682,-569372131.4842243,29.97079275010871,14.898093751682934,21.138340675867976,28.571428571428573,21.428571428571427
2001-05-03,47.89999,47.901,46.2,46.8,62.81682678929419,52.8420834558928,46.1928273340817,44.68904395295197,69.10564280000013,52.74566149999981,43.80339880000013,43.58199849999996,43.58199849999996,51.28166524500293,35.882331754997,67121120,55.51976714447761,55.46656627463633,NaN,NaN,NaN,NaN,NaN,NaN,0.6682078374785976,1.2083015517767706,0.540093714298173,62.16219625027362,72.46248727103244,-145583802,-589141491.3431313,27.848086980501574,17.15492260646755,22.81455975589213,21.428571428571427,14.285714285714286
2001-05-04,45.3,48.2,45.11,48.2,62.67138572671415,52.75016101122166,46.271539987647124,45.023420719337494,68.86351780000012,52.54766149999981,43.74739880000013,44.12649849999996,44.12649849999996,51.50867578844983,36.744321211550094,72670880,58.30147026622346,56.30402248231137,NaN,NaN,NaN,NaN,NaN,NaN,0.6232148234803334,1.3191122436485898,0.6958974201682564,74.77479750018244,72.91293731567207,-72912922,-516470611.3431313,25.671660979972742,18.571076746058452,23.939932667869268,14.285714285714286,7.142857142857143
2001-05-07,48,48.60001,47.10001,47.2,62.51744159012993,52.640256832781624,46.30795018420998,45.23071398416249,68.59858030000012,52.27591149999982,43.66779900000012,44.67149849999997,44.67149849999997,51.22488755133081,38.11810944866913,45558192,55.62554104748676,56.782661479464004,NaN,NaN,NaN,NaN,NaN,NaN,0.4921820953430325,1.311125039347047,0.8189429440040146,51.898673289459914,62.94522234663865,-118471114,-555954985.185691,25.71074429573227,17.8421027477235,25.1209928193249,7.142857142857143,0
2001-05-08,48.3,48.35001,46.99001,48.2,62.3749794847555,52.55233095490476,46.38214821620174,45.51350312852797,68.35301780000013,52.04134899999982,43.588799200000125,45.22899849999997,45.22899849999997,50.93656363305831,39.52143336694162,56891200,57.71560657800129,56.79374556990142,NaN,NaN,NaN,NaN,NaN,NaN,0.440603838461743,1.3696977420811933,0.9290939036194503,80.44160952935265,69.03836010633167,-61579914,-511614151.2327494,24.761697347845335,17.482063457127197,23.597506396976932,0,35.714285714285715
2001-05-09,47.05,47.95,46.44,46.55,62.21751700232012,52.43347291619378,46.38873063909579,45.61221711628721,68.11420530000014,51.81950529999981,43.53979920000012,45.56649849999997,45.56649849999997,50.72158131195373,40.41141568804622,60981008,53.258202895843056,56.170256057215944,NaN,NaN,NaN,NaN,NaN,NaN,0.2714088879399149,1.268355013544344,0.9969461256044291,54.41633188695881,62.25220490192379,-122560922,-563710509.060564,23.55019038913317,18.15571030171541,21.767028926775883,7.142857142857143,28.571428571428573
2001-05-10,47.92,48.05,45.72,45.77,62.0538601167249,52.301522957457266,46.36446669246458,45.627244057593195,67.86266470000014,51.62345529999981,43.50619920000012,45.80499849999997,45.80499849999997,50.51509941825045,41.094897581749485,61115808,51.24344724348442,55.391810983886295,NaN,NaN,NaN,NaN,NaN,NaN,0.09226632311133631,1.1122790294935996,1.0200127063822633,42.380928193422896,59.07962320324478,-183676730,-622203321.0090617,22.014570741385032,18.98680162312531,19.386576245654847,0,21.428571428571427
2001-05-11,45.84,46.42,45.09,45.55,61.889642603125644,52.16782943354722,46.33252682217185,45.61988748067956,67.61228970000013,51.44020529999982,43.44119920000012,45.94249849999997,45.94249849999997,50.44987326920888,41.43512373079106,48757392,50.6613104413003,55.12500208266655,NaN,NaN,NaN,NaN,NaN,NaN,-0.04819266625607033,0.9597718735621754,1.0079645398182457,38.888853615408266,45.22870456526332,-232434122,-637233795.234626,21.166149561761625,20.080602965830444,17.83983388852551,50,14.285714285714286
2001-05-14,45.3,45.36,44.11,44.82001,61.71979551254728,52.02232805862549,46.27321243698864,45.54370867299579,67.37857725000013,51.248405399999804,43.40359940000011,46.17099899999997,46.17099899999997,49.89640711833092,42.44559088166903,43047392,48.6849753328778,54.848796234150484,NaN,NaN,48.6849753328778,NaN,NaN,NaN,-0.1894789771652876,0.7711158183616362,0.9605947955269238,27.301673973568242,36.19048526079981,-275481514,-631378661.1643537,20.255924309546362,22.143709115278057,16.919439275385077,42.857142857142854,7.142857142857143
2001-05-15,44.89999,46.3,44.58,45.14999,61.55492182585527,51.88624215647449,46.229164498283204,45.50621165652,67.17026470000013,51.10865529999982,43.355599200000114,46.36599849999997,46.36599849999997,49.38126168455675,43.35073531544319,69004128,49.64131882113334,54.52827127008356,NaN,NaN,NaN,NaN,NaN,NaN,-0.255800705273186,0.6408439139354414,0.8966446192086274,23.14633480349881,29.778954130825117,-206477386,-654648297.3983998,22.058830370415496,20.9829953322951,16.137716695739016,35.714285714285715,0
2001-05-16,44.31,47.52,44.06,47.14999,61.41158917087163,51.79245498505915,46.2652753022721,45.66276197494667,66.95851465000014,51.02281149999982,43.31059920000011,46.44599799999997,46.44599799999997,49.45531191120252,43.43668408879741,80090368,55.10285874718322,54.78703127521771,NaN,NaN,NaN,NaN,NaN,NaN,-0.16449959412839632,0.6910201265481319,0.8555197206765283,57.86508963499932,36.10436613735547,-126387018,-591687546.1982149,23.405036504443025,18.843246321459343,15.729029265540772,28.571428571428573,0
2001-05-17,47.45,48.78999,47.25999,47.89999,61.27714539802714,51.71537647050353,46.32938176100653,45.87583131066604,66.75598335000014,50.941186399999815,43.280199000000124,46.425997499999966,46.425997499999966,49.390744369493106,43.461250630506825,73781808,56.98676306822167,54.99973390106128,NaN,NaN,NaN,NaN,NaN,NaN,-0.05858684803822234,0.7822861606287503,0.8408730086669727,71.91005975666621,50.97382806505478,-52605210,-603743397.178607,26.07848723040488,17.91092462880747,15.875308612639463,21.428571428571427,92.85714285714286
2001-05-18,47.64,48.38,47.09,48.03999,61.14543240899204,51.64259654039455,46.39646443704549,46.08194166203118,66.56188645000015,50.81658629999982,43.270998800000115,46.407997499999965,46.407997499999965,49.32862980828006,43.48736519171987,41091392,57.346550319360716,55.09135111003862,NaN,NaN,NaN,NaN,NaN,NaN,0.012136822947555359,0.8560440373514169,0.8439072144038615,74.53178751271071,68.10231230145875,-11513818,-584313220.9831342,25.029447648299975,17.720517515832164,15.23448080870964,14.285714285714286,85.71428571428571
2001-05-21,48.17,51.14999,47.64999,51.05,61.04498034522098,51.630861955436245,46.578956027749584,46.555090075171066,66.36307395000013,50.71833629999982,43.38999860000012,46.702997999999965,46.702997999999965,50.19228342371615,43.21371257628378,85420496,64.26704531205796,55.414399497741265,NaN,NaN,NaN,NaN,64.26704531205796,NaN,0.24022688274397552,1.144190817833831,0.9039639350898554,98.5897018190434,81.67718302947344,73906678,-503773408.0660144,30.72077299662371,15.856769436294396,15.49850528237354,100,78.57142857142857
2001-05-22,51.31,51.95,50.17999,50.89999,60.94403516765659,51.61638924344741,46.74840834038685,46.968890068011916,66.16757390000014,50.61171119999982,43.56199840000012,47.032997499999965,47.032997499999965,50.78900370076307,43.27699129923686,77228816,63.71223719213964,55.57622102927079,NaN,NaN,NaN,NaN,NaN,NaN,0.3527816688420842,1.3449410211424606,0.9921593523003764,86.69188846641318,86.60445926605576,-3322138,-518172355.8505803,31.50510514697544,14.997700821394721,15.634568749626803,100,71.42857142857143
2001-05-23,50.44901,50.45,48.64,48.64999,60.82170636001821,51.55764866436924,46.822980170175605,47.128994823439356,65.94949575000014,50.48383609999982,43.64599820000013,47.21049649999996,47.21049649999996,50.91956697845517,43.50142602154475,65610368,55.91517254919163,55.604464272464654,NaN,NaN,NaN,NaN,NaN,NaN,0.25220035917692485,1.3074098012715325,1.0552094420946077,58.174778200253485,81.15212282857003,-68932506,-583058472.3850331,29.32084152443299,18.682181854592365,15.520388749168474,92.85714285714286,64.28571428571429
2001-05-24,48.97,49.99001,48.27,49.89999,60.71303256539117,51.524823740322326,46.94364722232558,47.39289912596894,65.73899570000015,50.39908599999981,43.76899800000013,47.50799599999997,47.50799599999997,51.07502383506799,43.94096816493195,61738000,58.922782257705876,55.648843700427676,NaN,NaN,NaN,NaN,NaN,NaN,0.2460891200034383,1.3628208420989054,1.1167317220954671,74.01761723700886,72.96142796789184,-7194506,-527782824.0690347,27.744294452309042,18.834311107502224,15.74037204623674,85.71428571428571,57.142857142857146
2001-05-25,49.96001,50.02,48.64999,48.99001,60.59638557469076,51.47462940883079,47.023896743018696,47.5450049234957,65.52589890000014,50.35461109999981,43.90579840000012,47.69999699999997,47.69999699999997,51.15013680588889,44.249857194111044,36188496,55.93125205552729,55.67068020100199,NaN,NaN,NaN,NaN,NaN,NaN,0.1611044877044765,1.3181123317260628,1.1570078440215863,62.48428390367548,64.89222644697928,-43383002,-546008221.3910398,26.617600598977585,18.003933991084274,15.82872569261041,78.57142857142857,50
2001-05-29,48.5,48.5,46.10001,46.12,60.45234193713164,51.368597143309394,46.98844981191992,47.409290168877064,65.30681140000014,50.19143609999982,44.00619820000013,47.69849749999997,47.69849749999997,51.15135565668245,44.245639343317485,66603312,47.70486622608321,54.95562731872213,NaN,NaN,NaN,NaN,NaN,NaN,-0.09431314984652861,1.0391164067134255,1.1334295565599541,26.108998732572815,54.203633291085715,-109986314,-611502028.5957032,24.19434973820589,24.3976931226336,14.627727340397675,71.42857142857143,42.857142857142854
2001-05-30,45.438,45.85001,44.08,44.42999,60.2929155496975,51.231198982055744,46.888118054589725,47.12554729565068,65.07458635000015,50.02261099999981,44.02959820000013,47.51749699999996,47.51749699999996,51.246183388016554,43.78881061198337,81392000,43.63500062618448,54.26825572803224,NaN,NaN,43.63500062618448,NaN,NaN,NaN,-0.3676456765845224,0.6738724608293012,1.0415181374138236,4.689353612167228,31.09421208280517,-191378314,-660706203.5777656,22.628324092694623,29.227771264579122,14.61286240732501,64.28571428571429,35.714285714285715
2001-05-31,44.53999,45.85001,44.3,44.73,60.13806066860598,51.10246236854969,46.803485974017576,46.897399934160134,64.83354885000016,49.90366099999982,44.11719800000012,47.304996999999965,47.304996999999965,51.15840096016013,43.4515930398398,67973184,44.53954925609025,53.78940587178979,NaN,NaN,NaN,NaN,NaN,NaN,-0.510041999869224,0.40396563757729353,0.9140076374465176,8.491761723700819,13.096704689480285,-123405130,-690965477.1900907,21.490138345373683,27.757638852517708,14.99442727798281,57.142857142857146,28.571428571428573
2001-06-01,45.53999,46.23,44.33,46.05,59.99788096046065,51.00241360877643,46.77393750444826,46.81669517852583,64.59848635000014,49.79166099999981,44.231197800000125,47.26749699999996,47.26749699999996,51.1542818126928,43.380712187307125,61868800,48.458772940778395,53.63208176460966,NaN,NaN,NaN,NaN,NaN,NaN,-0.49664952911386495,0.2931957260541864,0.7898452551680514,25.22179974651451,12.80097169412752,-61536330,-640819186.6637748,21.39732197588739,26.029306967469868,15.504055714522377,50,21.428571428571427
2001-06-04,46.338,46.89999,45.28999,45.83,59.85690702055557,50.89998957691947,46.73692034741108,46.72272420914242,64.36052700000016,49.67746099999981,44.291797800000126,47.148996999999966,47.148996999999966,51.059277595580916,43.238716404419016,41679504,47.85182892957206,53.57257130723067,NaN,NaN,NaN,NaN,NaN,NaN,-0.4834609533721659,0.18551906345284408,0.66898001682501,22.433460076045574,18.715673848753635,-103215834,-654539250.9680732,22.484289251337994,24.62983842004599,15.511311356325066,42.857142857142854,14.285714285714286
2001-06-05,46.30099,48.36,46.2,47.85001,59.73743540841074,50.83959394173294,46.780570922022406,46.83008476065267,64.12258955000016,49.554086099999815,44.39279800000012,47.18149749999996,47.18149749999996,51.103720439891134,43.25927456010879,68143120,53.598587364872685,53.8552333460692,NaN,NaN,NaN,NaN,NaN,NaN,-0.3270374315733532,0.26018322735831845,0.5872206589316716,48.03561470215456,31.89695817490488,-35072714,-618574195.5688142,25.421899557453404,22.575737347265896,15.756331773261865,35.714285714285715,7.142857142857143
2001-06-06,48.08,48.89,47.07001,47.48,59.615470876983764,50.77306732902536,46.80799951331564,46.891981450114315,63.884286450000154,49.40951109999982,44.506198000000126,47.14549749999996,47.14549749999996,51.0428042713755,43.24819072862442,61160896,52.45822705194518,53.66633108212362,NaN,NaN,NaN,NaN,NaN,NaN,-0.24081710841636084,0.28619927341122064,0.5270163818275815,43.20203303684875,37.890369271682964,-96233610,-652179604.1748838,25.646393160970725,21.20565964826926,15.662091017020566,28.571428571428573,0
2001-06-07,47.138,49.49001,47.075,48.7,59.50685922646651,50.73201649082684,46.882195610832675,47.06417369296057,63.649036450000146,49.26916739999982,44.61519800000012,47.252997499999964,47.252997499999964,51.19699892244007,43.308996077559854,65357200,55.79760521117366,53.581391235191624,NaN,NaN,NaN,NaN,55.79760521117366,NaN,-0.10109900736919908,0.40064262261608263,0.5017416299852817,58.70393900889456,49.980528915965955,-30876410,-629582344.3589823,25.582442184771715,19.513386314171296,15.297163958181395,21.428571428571427,57.142857142857146
2001-06-08,48.72,48.77,46.95,47.35001,59.38589555257132,50.66504606526591,46.90054127315296,47.0913961983929,63.40859900000015,49.12282379999982,44.76819820000012,47.33199799999996,47.33199799999996,51.2168672220251,43.447128777974825,56389392,51.48787026726623,53.16291408861345,NaN,NaN,NaN,NaN,NaN,NaN,-0.09895412204152121,0.3780489774333802,0.4770030994749014,41.550317662007586,47.81876323591697,-87265802,-661184570.7612684,24.026321934387813,18.744204999400168,14.958090573225535,14.285714285714286,50
2001-06-11,46.89999,48.47,45.49001,46.05,59.25320007443628,50.57365901446857,46.867186713421475,46.99221560806976,63.15384900000014,48.94457379999982,44.910198200000124,47.35699799999996,47.35699799999996,51.201904926342834,43.51209107365709,48870096,47.66951315983618,51.977376077740466,NaN,NaN,NaN,NaN,NaN,NaN,-0.17973475822576174,0.2523346516926992,0.43206940991846093,25.03176620076236,41.762007623888174,-136135898,-691687648.7115166,21.69893944243182,21.674357578557142,12.682682893317125,7.142857142857143,42.857142857142854
2001-06-12,44.87,46.8,44.23,45.8,59.11933738712845,50.47913111319196,46.825336254071615,46.87867126444407,62.89003650000015,48.736948799999816,45.04319840000013,47.40599749999997,47.40599749999997,51.143816703787806,43.66817829621213,78444368,46.94845398173393,50.779962991282915,NaN,NaN,NaN,NaN,NaN,NaN,-0.24083801327110926,0.13102189332957437,0.37185990660068363,27.001569858712678,31.194551240494206,-214580266,-674289481.4897268,19.907885730046853,23.932125701483834,10.802806100744778,0,35.714285714285715
2001-06-13,46.274,46.75,44.52,44.55,58.97436885591325,50.36172257629707,46.73610738136293,46.656893048782734,62.620911500000155,48.51932379999982,45.186198600000125,47.37599799999997,47.37599799999997,51.194521654004966,43.55747434599497,68526688,43.41255215539333,49.88691867744018,NaN,NaN,NaN,NaN,NaN,NaN,-0.34967347870390353,-0.06523194177919578,0.28444153692470775,7.912457912457887,19.981931323977644,-283106954,-740972402.0995926,18.4823329081961,22.21840733936035,9.87544172507116,0,28.571428571428573
2001-06-14,44.02499,44.39999,42,42.25,58.80795722550615,50.2010944064694,46.560181601701636,46.23718894889866,62.339974000000154,48.27807379999983,45.33799860000013,47.13099849999997,47.13099849999997,51.55660343629747,42.705393563702465,91025504,37.77505297921165,48.37636658611916,NaN,NaN,NaN,NaN,NaN,NaN,-0.5489328043598031,-0.40172446852504606,0.14720833583475698,3.1172069825436397,12.67707825123807,-374132458,-813034180.4174023,16.984602767447896,28.426162649982217,10.308783230526833,7.142857142857143,100
2001-06-15,41.8,43.10001,41.28101,42.60001,58.6466841187847,50.05057788356902,46.404880754576084,45.89079095376545,62.05883345000015,48.02641769999982,45.50899880000013,46.86599949999997,46.86599949999997,51.69225922614266,42.039739773857285,84583872,39.07171686100502,47.172114072224716,NaN,NaN,NaN,NaN,NaN,NaN,-0.6240539744986923,-0.6328591322886084,-0.008805157789916113,16.067730539651556,9.03246514488436,-289548586,-774950512.9253738,15.989239108848865,29.076695064169222,11.004272640134618,0,100
2001-06-18,42.64,43.17,41.39999,42.03,58.48134397829928,49.89175455914191,46.23331680341624,45.523096577216364,61.77453035000015,47.77546769999983,45.60339880000012,46.56549999999997,46.56549999999997,51.793626876823815,41.33737312317613,63415392,37.69411679224061,46.45706054123597,NaN,NaN,NaN,NaN,NaN,NaN,-0.6747209596692065,-0.8522063573764243,-0.17748539770721775,9.124010232671452,9.436315918288884,-352963978,-793222283.0092039,15.292906049296187,27.39434995501064,12.999316097862396,50,92.85714285714286
2001-06-19,43.32001,43.56,41.25999,41.82001,58.31555956060476,49.73191803321831,46.060245948380306,45.17042166510052,61.47425540000015,47.54866779999983,45.71379900000013,46.10400049999997,46.10400049999997,51.29660779346906,40.91139320653088,73378688,37.174118211323474,45.99556894017446,NaN,NaN,37.174118211323474,NaN,NaN,NaN,-0.6828910274952346,-1.031099182076261,-0.3482081545810264,6.80460071785976,10.665447163394257,-426342666,-830867619.542245,15.417509482755875,25.34244496478304,13.829548810970724,42.857142857142854,100
2001-06-20,41.3,42.97,41.28,42.77,58.16087737592213,49.594058270184284,45.93121669550265,44.94181007794809,61.17560540000016,47.320899099999835,45.82819900000013,45.69750099999997,45.69750099999997,50.588821061104724,40.80618093889521,83583680,41.13072060930238,45.75208117968962,NaN,NaN,NaN,NaN,NaN,NaN,-0.588412901914481,-1.0837242819741277,-0.4953113800596467,18.347586032597757,11.425398994376323,-342758986,-767067059.0688719,14.554838288625588,23.924434015323083,14.659781524079053,35.714285714285715,92.85714285714286
2001-06-21,42.67,44.23,42.3,43.35001,58.013505561236336,49.47041374998261,45.829992903522154,44.790210070524466,60.89477735000016,47.08439919999982,45.89919920000013,45.432501999999964,45.432501999999964,50.228627373690124,40.636376626309804,67204128,43.471458204988046,45.395844412847445,NaN,NaN,NaN,NaN,NaN,NaN,-0.45681972402507554,-1.0663360350909912,-0.6095163110659156,25.39507801925143,16.849088256569647,-275554858,-761146828.0623641,17.821089891559037,22.384063194066986,14.772823782970983,28.571428571428573,85.71428571428571
2001-06-22,43.621,44.2,42.59,43.25,57.86660500838821,49.34723724008197,45.72881671122717,44.64352339714118,60.63071485000017,46.84939919999982,45.94419920000013,45.10000249999997,45.10000249999997,49.5183243669676,40.681680633032336,51868608,43.15284332333576,45.060202583830566,NaN,NaN,NaN,NaN,NaN,NaN,-0.35121798541213267,-1.0485387928310814,-0.6973208074189488,24.179892636955913,22.640852229601702,-327423466,-770489620.8077059,16.846659842083366,21.160136714913076,15.258201276475534,21.428571428571427,78.57142857142857
2001-06-25,43.61,43.8,42.64999,43.36,57.72226067994654,49.22867808681302,45.635921938237864,44.521283073603925,60.35626485000017,46.63999919999982,45.95539920000014,44.81850199999997,44.81850199999997,48.91529197071049,40.72171202928944,39194400,43.64211544715118,44.34902601827903,NaN,NaN,NaN,NaN,NaN,NaN,-0.253240150625321,-1.0138709957006,-0.760630845075279,25.51646290045466,25.030477852220667,-288229066,-761287196.529656,16.16667754284902,20.306049403220772,15.645303312730878,14.285714285714286,71.42857142857143
2001-06-26,42.53999,43.89,42.481,43.50999,57.58084505129035,49.115436738559296,45.552552058306965,44.42496944754641,60.09943980000016,46.42359919999983,46.02059900000014,44.68800149999997,44.68800149999997,48.77691674296362,40.59908625703632,55150800,44.345505577774,43.76954591298108,NaN,NaN,NaN,NaN,NaN,NaN,-0.16204773715282172,-0.9631905165163062,-0.8011427793634844,27.338937207929035,25.6784309151132,-233078266,-735884949.4153905,15.34922184831831,19.885737383561374,15.887934488521712,7.142857142857143,64.28571428571429
2001-06-27,43.681,44.14999,43,43.78999,57.44362261296906,49.009982347696734,45.48343197758904,44.364495214446755,59.85448350000016,46.24599909999983,46.07139880000013,44.65600149999997,44.65600149999997,48.76247234588941,40.54953065411053,53286496,45.70776468383593,43.04884301817124,NaN,NaN,NaN,NaN,NaN,NaN,-0.07122247726244102,-0.8901708759415357,-0.8189483986790946,33.68837058805515,28.847923565479615,-179791770,-715960723.6264356,15.658102713381764,19.039547508788253,15.622743501374861,0,57.142857142857146
2001-06-28,44.40199,46.36,44.35001,44.35001,57.31333791035245,48.917705667544325,45.43898405689927,44.36311567021373,59.619671050000164,46.07449919999982,46.047399000000134,44.63700199999997,44.63700199999997,48.74544329666636,40.528560703333575,89940624,48.42679344502277,42.83019467372527,NaN,NaN,NaN,NaN,NaN,NaN,0.03264400032527193,-0.7781433982725048,-0.8107873985977767,42.8573608080987,34.62822286802763,-89851146,-805901347.6264356,22.19202439236321,17.27080675626959,15.631358804291313,0,50
2001-06-29,45.09,46.52,44.7,45.7,57.197782309254414,48.853988723632554,45.449219976236556,44.490437987336236,59.38098355000017,45.91549909999983,45.995399000000134,44.61950199999997,44.61950199999997,48.706645888848726,40.53235811115121,59719600,54.36053130650125,43.30812454134421,NaN,NaN,NaN,NaN,54.36053130650125,NaN,0.1895792457350256,-0.5738133414289948,-0.7633925871640204,80.14444017249075,52.2300571895482,-30131546,-799995013.5605016,21.037754728633505,15.92553737458761,16.61520522477775,0,42.857142857142854
2001-07-02,45.65199,46.48,45.19,45.45,57.080888952943425,48.7865830063329,45.44925056540375,44.58182484568517,59.14135855000017,45.76399899999983,45.93639920000014,44.60050199999997,44.60050199999997,48.66844809995678,40.532555900043164,50873008,53.14117805628112,43.750461975240434,NaN,NaN,NaN,NaN,NaN,NaN,0.26901044843458544,-0.4271295266207886,-0.6961399750553741,76.32062600978873,66.44080899679273,-81004554,-830361072.5992608,20.038494979277505,15.169099784618437,16.9474300743258,0,35.714285714285715
2001-07-03,45.25,45.69,44.8,45.64,56.96704926186936,48.724274431950064,45.45673093538792,44.68260343181039,58.91268355000015,45.63249909999983,45.94619940000014,44.49000149999997,44.49000149999997,48.31146650705431,40.66853649294563,24758304,53.985940643272585,44.50570401008895,NaN,NaN,NaN,NaN,NaN,NaN,0.323166346619445,-0.2921820417810679,-0.6153483884005129,83.26999378328173,79.91168665518707,-56246250,-808384600.509373,19.355422721807596,16.145759389458433,16.937546288801443,0,28.571428571428573
2001-07-05,44.87,45.189,43.45,43.45,56.832551259263695,48.619833354089664,45.37803560458839,44.565212628780834,58.68087105000015,45.502999199999834,45.929199400000144,44.28850149999998,44.28850149999998,47.87590839330554,40.701094606694426,44376304,44.11414104955548,44.958496015113504,NaN,NaN,NaN,NaN,NaN,NaN,0.2060186305674565,-0.3578251001911923,-0.5638437307586488,41.635091948494406,67.07523724718828,-100622554,-852760904.509373,17.751865922352337,19.915181041701924,15.548086091526235,78.57142857142857,21.428571428571427
2001-07-06,43.00999,43.11,41.49001,41.64999,56.68148099797749,48.48181665400868,45.231837737741785,44.287572378420755,58.42162100000015,45.348699099999834,45.86019900000015,43.936000999999976,43.936000999999976,47.0780618829498,40.793940117050155,53427696,37.96865354376983,44.87970577816814,NaN,NaN,NaN,NaN,NaN,NaN,0.01206089724707926,-0.5487676091997997,-0.560828506446879,7.414434573318311,44.10650676836482,-154050250,-895636235.6107252,16.439192780414917,25.837104482499758,15.061590149724035,71.42857142857143,14.285714285714286
2001-07-09,41.89799,42.69,41.5,42.00999,56.535496012922984,48.353661670760985,45.105490767634265,44.07065977095211,58.15823345000015,45.21579899999983,45.82139880000014,43.668999999999976,43.668999999999976,46.49710902197363,40.84089097802632,45536704,39.77567261928355,45.02838833724264,NaN,NaN,NaN,NaN,NaN,NaN,-0.08205297916089405,-0.6633947303979966,-0.5813417512371025,14.258528025612115,21.10268484914161,-108513546,-902142244.3620527,15.68102582873126,24.645510770601298,14.624494635371844,64.28571428571429,7.142857142857143
2001-07-10,42.75999,42.88,40.39999,40.5,56.37593883866504,48.19814361787463,44.92488328655057,43.73059693562334,57.89878035000013,45.04629899999983,45.728399000000145,43.39149999999998,43.39149999999998,46.31807746184299,40.46492253815697,58598400,35.150393236298214,44.883836553312264,NaN,NaN,35.150393236298214,NaN,NaN,NaN,-0.22780443326127675,-0.8660972928136985,-0.6382928595524218,1.634147656621435,7.769036751850621,-167111946,-956014513.4319355,14.210155627472137,26.49425418159941,15.04085668981119,57.142857142857146,100
2001-07-11,40.42,41.10001,39.87,41,56.222944422359916,48.05560612049097,44.77096629492113,43.47054008461159,57.63909285000014,44.87229909999983,45.625399200000146,43.151499999999984,43.151499999999984,46.0356178270252,40.26738217297477,77386496,37.73243314521861,44.64110173444914,NaN,NaN,NaN,NaN,NaN,NaN,-0.26948871012597253,-0.9751537472098875,-0.7056650370839149,16.992481203007543,10.961718961747032,-89725450,-891212343.5186499,13.532189726387376,27.285953832035393,15.708392426985125,50,100
2001-07-12,42.63,43.83,42.3,43.60001,56.097343084824,47.96737649434264,44.72504644021834,43.48287055274382,57.40615540000015,44.756999199999825,45.53639940000014,43.10400049999998,43.10400049999998,45.92502560165865,40.2829753983413,70337008,49.08493547075062,45.04206439628932,NaN,NaN,NaN,NaN,49.08493547075062,NaN,-0.10912858626627675,-0.8420757699167609,-0.7329471836504842,56.09037593984957,24.905668266492853,-19388442,-842021490.3812906,22.299741140862007,24.40135492018448,15.219171925310928,42.857142857142854,92.85714285714286
2001-07-13,43.38,44.42999,42.89999,43.14999,55.9685137008954,47.871982702375455,44.663279520994095,43.451167642958694,57.177217850000154,44.65859899999983,45.41979920000014,43.14899999999999,43.14899999999999,45.94267901524218,40.355320984757796,62472800,47.471670518751786,45.35055205310475,NaN,NaN,NaN,NaN,NaN,NaN,-0.02493435200954386,-0.764115123662414,-0.7391807716528701,49.32315789473687,40.80200501253133,-81861242,-884078342.6688721,23.280527795161056,22.98650947117008,14.453904508021443,35.714285714285715,85.71428571428571
2001-07-16,43.37,43.86,41.89999,42.35001,55.833006201384,47.76263670826901,44.5725630691904,43.34629548648644,56.94146790000014,44.56709909999983,45.33079940000014,43.136499999999984,43.136499999999984,45.94210446966535,40.330895530334615,53371392,44.661560242897146,45.42336953851517,NaN,NaN,NaN,NaN,NaN,NaN,-0.01516982185927318,-0.7581430489769616,-0.7429732271176884,37.29338345864659,47.568972431077675,-135232634,-912941498.6620765,21.55620376611475,25.062883199229404,14.180530020745122,28.571428571428573,78.57142857142857
2001-07-17,41.82899,43.39999,41.53999,43.3,55.708299672017,47.674267664540906,44.522658635104506,43.34188639253535,56.695702300000136,44.490099099999824,45.23279940000014,43.19999999999998,43.19999999999998,45.959667632198816,40.44033236780115,59775504,48.5560264705726,45.72412103085792,NaN,NaN,NaN,NaN,NaN,NaN,0.059145311138014134,-0.6690415881951708,-0.7281868993331849,51.578947368421005,46.06516290726815,-75457130,-859592825.463109,20.039332742260726,24.66121844494268,13.99943147063303,21.428571428571427,71.42857142857143
2001-07-18,42.27901,42.85001,41.14,41.64999,55.56841599368847,47.55497503752029,44.41000496313962,43.18075340277008,56.46051475000014,44.39479909999983,45.12179920000015,43.191498999999986,43.191498999999986,45.96910734031747,40.4138906596825,64711296,42.907829839954346,45.52412568486638,NaN,NaN,NaN,NaN,NaN,NaN,0.003963059321293483,-0.7232330751815681,-0.7271961345028616,26.766766917293285,38.54636591478696,-140168426,-885705383.6229324,18.418438520335222,24.164324792852387,14.267145614445914,14.285714285714286,64.28571428571429
2001-07-19,42.46001,43.35001,41.75,42.64,55.43977503852739,47.45764879915355,44.34059300380081,43.12925307869674,56.239964750000134,44.29969919999982,45.01059920000015,43.18499899999998,43.18499899999998,45.967127149493,40.402870850506964,76495504,46.89905822824955,45.41500174081115,NaN,NaN,NaN,NaN,NaN,NaN,0.038977976527041935,-0.6784736638440592,-0.7174516403711011,41.65413533834588,39.99994987468673,-63672922,-877100171.3024093,19.12373844547244,22.613962997815815,13.97370056035306,7.142857142857143,57.142857142857146
2001-07-20,41.49001,42.14,41.36,41.64999,55.30256324709925,47.34264565461586,44.23507916051451,42.988370880725626,56.03133970000013,44.226199099999825,44.91259900000016,43.099997999999985,43.099997999999985,45.95956810059002,40.24042789940995,49006400,43.615423743413736,44.64749405773347,NaN,NaN,NaN,NaN,NaN,NaN,0.0022421026420136325,-0.714649012068584,-0.7168911147105976,26.92874432677769,31.78321552747229,-112679322,-889667171.4665115,18.178053671080477,23.002388749152946,13.822599653929235,0,50
2001-07-23,42.24001,42.39999,40.55,40.61,55.156368587924135,47.20932593868287,44.092919193435506,42.761859368275566,55.806264700000135,44.15779909999982,44.80939900000015,42.96799799999998,42.96799799999998,46.02462408903859,39.91137191096137,55316608,40.41431673432046,43.738432534736276,NaN,NaN,NaN,NaN,NaN,NaN,-0.08073473888575311,-0.817809538317789,-0.7370747994320359,12.714776632302438,27.099218765808672,-167995930,-941395655.7685454,16.87889635692288,24.487619749028774,14.148521821243506,0,42.857142857142854
2001-07-24,40.381,40.89999,39.31,40.14999,55.007051388044296,47.06953710821391,43.93829451918313,42.51310990463028,55.57763965000013,44.07129899999982,44.70139880000014,42.80749749999998,42.80749749999998,46.09344060818084,39.52155439181912,70420368,39.049123343032726,42.67151701329057,NaN,NaN,39.049123343032726,NaN,NaN,NaN,-0.15114776048811296,-0.9260095000421771,-0.7748617395540641,14.28797414526281,17.97716503478098,-238416298,-937410015.030981,15.831646881906758,27.80704014571534,15.462889272433415,0,100
2001-07-25,40.14101,40.72,39.39999,40.5,54.862702618014005,46.9394472644869,43.80345943999948,42.32138515180834,55.36513965000013,44.00929899999981,44.61499860000014,42.65699799999998,42.65699799999998,46.07357984625954,39.24041615374042,68844880,40.69076778848355,42.426990351785435,NaN,NaN,NaN,NaN,NaN,NaN,-0.15795677585268608,-0.9723077093699217,-0.8143509335172356,23.242232894986106,16.74832789085045,-169571418,-891513254.5149242,14.999590022065767,26.345597841089504,17.01281012476529,0,92.85714285714286
2001-07-26,40.45,41.89,39.98,41.10001,54.72576040290939,46.82381484340795,43.69744181490146,42.20506370877898,55.15751470000013,43.94479909999981,44.53399900000014,42.52249899999998,42.52249899999998,45.96179830948148,39.083199690518484,69152688,43.500139715275665,42.82209650689299,NaN,NaN,NaN,NaN,NaN,NaN,-0.10822866108705154,-0.94963675987605,-0.8414080987889985,34.961201096095834,24.163802712114915,-100418730,-879564683.785207,18.501128302591262,24.351300542448932,16.40010739386634,35.714285714285715,85.71428571428571
2001-07-27,41.64,42.25999,40.89999,41.95,54.59863840885059,46.72730365838997,43.628914684905325,42.1807719269905,54.975702200000136,43.870299199999806,44.42999920000014,42.40249849999998,42.40249849999998,45.744469623480285,39.06052737651967,47484896,47.30792334576729,43.36011441592755,NaN,NaN,NaN,NaN,NaN,NaN,-0.009471183797686855,-0.853247078536107,-0.8437758947384202,51.56260070820458,36.5886782330955,-52933834,-853726615.59556,18.97864366549204,23.015352121231746,15.498881897565285,28.571428571428573,78.57142857142857
2001-07-30,42.13,42.3,41.39999,41.7,54.470293748066005,46.6277530908971,43.55327097177178,42.13498412441998,54.798889700000124,43.793099199999816,44.30599940000014,42.202498499999976,42.202498499999976,45.19127226028679,39.213724739713165,39455200,46.319150903378684,44.15788282071901,NaN,NaN,NaN,NaN,NaN,NaN,0.04466271263735777,-0.787947503941723,-0.8326102165790807,46.67977867144278,44.4011934919144,-92389034,-866877764.4139062,18.43179987564901,22.14934487574243,13.997594661339678,21.428571428571427,71.42857142857143
2001-07-31,41.84,42.78,41.5,41.75999,54.34382306400565,46.5313617425625,43.48294622778073,42.099270398284744,54.63206465000012,43.72569909999981,44.18039940000014,42.01799799999998,42.01799799999998,44.6115508543276,39.42444514567236,55701904,46.60753148032312,44.791818416083615,NaN,NaN,NaN,NaN,NaN,NaN,0.08767066704258752,-0.7230218827758463,-0.8106925498184339,47.85146064738412,48.697946675677166,-36687130,-899951640.2561561,19.470827318539026,20.942425658519532,11.850891345237205,14.285714285714286,64.28571428571429
2001-08-01,42.63699,43.5,42.41,43.10001,54.231944327050364,46.46341418330384,43.46792912080894,42.194578931781436,54.44131470000012,43.70569909999982,44.02139960000014,41.890998499999974,41.890998499999974,43.95797000735553,39.82402699264442,53861104,52.71781384391463,45.051309728452466,NaN,NaN,NaN,NaN,NaN,NaN,0.2029392535240333,-0.5570184829133922,-0.7599577364374255,74.0237773901902,56.18500556967237,17173974,-885620633.4836057,21.08935377301777,19.395251541386425,11.828349993118573,7.142857142857143,57.142857142857146
2001-08-02,43.799,44.004,42.82001,43.91,54.12923841334837,46.41285152620871,43.485265233718394,42.35795236684987,54.25273970000013,43.72179909999983,43.88159980000014,41.91399849999998,41.91399849999998,44.058627019865156,39.7693699801348,53163392,55.99595001102909,45.6601868350437,NaN,NaN,NaN,NaN,55.99595001102909,NaN,0.3231690185316529,-0.3559964632728594,-0.6791654818045123,97.99744354495097,73.29089386084176,70337366,-840898797.3210707,22.19242004979158,18.399177566399928,12.450451032857858,0,50
2001-08-03,43.53,43.53,42.56,43.17999,54.020290667941914,46.34883446628379,43.47329365592552,42.43624166524512,54.07738965000012,43.709098999999824,43.77219980000014,41.99049849999997,41.99049849999997,44.200165734272936,39.78083126572701,51510000,52.4654464864407,46.2176072810111,NaN,NaN,NaN,NaN,NaN,NaN,0.3411899413307099,-0.25267805514112496,-0.5938679964718349,82.44546229228798,84.82222774247639,18827366,-826562024.3313805,20.87594469886933,18.45024236748124,12.353749480379715,92.85714285714286,42.857142857142854
2001-08-06,42.539,42.85001,42.35001,42.5,53.90566091005194,46.272619922396984,43.43512527726177,42.44231388760273,53.89988965000012,43.69659899999982,43.62420000000014,42.01499899999997,42.01499899999997,44.23582554887938,39.79417245112055,31099104,49.34456175496222,46.273931229896064,NaN,NaN,NaN,NaN,NaN,NaN,0.29661817404870494,-0.2230952789109537,-0.5197134529596587,67.95909671921603,82.80066751881833,-12271738,-839002909.8955401,20.08700851704126,18.709128980207478,11.86888718962025,85.71428571428571,35.714285714285715
2001-08-07,42.10001,42.82001,41.94,42.28,53.78998269204148,46.19355814175546,43.38982624678091,42.42685542211675,53.68597715000013,43.69789909999982,43.489999800000135,42.10399899999997,42.10399899999997,44.21477783071731,39.99322016928264,38353600,48.34262700267626,46.66213102723335,NaN,NaN,NaN,NaN,NaN,NaN,0.24383048129922863,-0.21492535133562285,-0.4587558326348515,63.2722624627184,71.22560715807414,-50625338,-847719973.9470849,19.256071531533202,19.862536497504525,11.015806322078642,78.57142857142857,28.571428571428573
2001-08-08,41.85001,42.64999,40.3,40.5,53.65774405828982,46.080814416176146,43.27649972729931,42.243345381915155,53.456914650000115,43.69189899999982,43.377599800000134,42.07899899999997,42.07899899999997,44.25240348886216,39.90559451113778,76057312,41.075467901402355,46.246160289601406,NaN,NaN,NaN,NaN,NaN,NaN,0.08854912917285113,-0.3480694211687876,-0.4366185503416387,25.3515125692373,52.19429058372392,-126682650,-910831305.4109974,17.208837676791113,25.170376094900977,11.760387787289474,71.42857142857143,21.428571428571427
2001-08-09,40.41,40.88,39.98,40.67,53.528512774127734,45.973669576251865,43.17428405171894,42.0935029645899,53.22932715000012,43.66599909999982,43.302400000000134,41.932498499999966,41.932498499999966,44.070768415184425,39.79422858481551,66830688,41.972650329622844,46.12881933147349,NaN,NaN,NaN,NaN,NaN,NaN,0.0014094651173170991,-0.43485671894499234,-0.43626618406230944,28.973157221985527,39.19897741798041,-59851962,-875188271.8109974,16.485943462368976,25.606627879527167,12.471319546567432,64.28571428571429,14.285714285714286
2001-08-10,40.429,40.75,39.23,40.28,53.39668677637522,45.86092364404886,43.060782716357416,41.92078839653372,53.01853965000012,43.66529899999982,43.213400000000135,41.78899899999997,41.78899899999997,43.96604354528772,39.61195445471222,68480880,40.45100208175763,46.13143971343329,NaN,NaN,NaN,NaN,NaN,NaN,-0.0741934079920119,-0.5290079440523243,-0.4548145360603124,21.994134897360787,25.439601562861203,-128332842,-849057409.705734,15.315776098300077,27.291365005328817,13.165145553021665,57.142857142857146,100
2001-08-13,40.59,41.34,40.2,41.10001,53.27433178357546,45.766648126344926,42.98388966865713,41.842619025435276,52.83466470000012,43.67279899999982,43.114400200000134,41.726498999999976,41.726498999999976,43.90729987402851,39.54569812597144,48420608,44.968504724337,46.55425266924073,NaN,NaN,NaN,NaN,NaN,NaN,-0.061212903324223356,-0.5313306652155916,-0.4701177618913682,39.170716380393806,30.046002833246703,-79912234,-821023576.6424363,17.29152371300707,25.81159260158566,12.616900098180974,50,92.85714285714286
2001-08-14,41.49001,41.7,40.53999,40.60001,53.148219129012524,45.664338460476706,42.890404191454884,41.72427530872715,52.63828975000011,43.65079909999982,43.00980040000014,41.59149949999997,41.59149949999997,43.69901163666514,39.4839873633348,51157104,42.83469740731348,46.707390499157164,NaN,NaN,NaN,NaN,NaN,NaN,-0.07749095094208486,-0.5669814505689743,-0.48949049962688945,28.697318810222043,29.954056695992207,-131069338,-866886848.0339593,18.062278201748995,24.36395762805646,11.717693834519384,42.857142857142854,85.71428571428571
2001-08-15,40.62,40.92999,39.07001,39.10001,53.00843595359947,45.53435175828905,42.741761281986065,41.47434527932457,52.435196050000116,43.61379919999982,42.834800400000134,41.464000499999976,41.464000499999976,43.83410665462435,39.0938943453756,58797904,37.14086471033332,46.25315657023271,NaN,NaN,NaN,NaN,NaN,NaN,-0.1748954164115728,-0.7081097701413555,-0.5332143537297827,0.608027174761077,22.825354121792305,-189867242,-923788025.0584008,16.46749038891609,29.190811624350125,12.733014411769291,35.714285714285715,100
2001-08-16,38.649,39.59,38.041,39.56,52.874620670479075,45.416047763075404,42.61698632975132,41.292026681293656,52.24916795000011,43.591299199999824,42.67640040000013,41.31000049999997,41.31000049999997,43.753560976065486,38.86644002393446,68197376,39.7842525920596,45.715751516396445,NaN,NaN,NaN,NaN,NaN,NaN,-0.19256164093971484,-0.7739164049044263,-0.5813547639647114,25.473754821398714,18.259700268793942,-121669866,-858232251.7440045,15.25915191309707,31.923363369088896,14.569159507251646,28.571428571428573,100
2001-08-17,38.44099,38.8,37.71001,37.75999,52.72422633544943,45.26444265885609,42.426515885447344,40.95564223545617,52.02945230000012,43.53639909999982,42.45760020000014,41.115500499999975,41.115500499999975,43.99943238861803,38.23156861138192,56641808,33.79519300380562,44.82118309499837,NaN,NaN,NaN,NaN,NaN,NaN,-0.30311242144744577,-0.9602452907740187,-0.6571328693265729,0.7940908708149363,8.958624288991572,-178311674,-909679594.5400296,13.943238016405232,30.7132835130709,16.59720510036625,21.428571428571427,100
2001-08-20,37.85001,38.64999,37.52,38.28,52.58050269032058,45.12613686363122,42.26390741935137,40.700819165412724,51.81585230000012,43.522199099999824,42.276200000000124,40.99900049999997,40.99900049999997,44.1326374611347,37.865363538865246,49921296,36.75716026455564,44.11758515101498,NaN,NaN,NaN,NaN,NaN,NaN,-0.3173370766475112,-1.053804215135962,-0.7364671384884507,11.721159777914846,12.663001823376165,-128390378,-892449526.4394625,13.194744627865662,29.967213711415262,19.112776788557085,14.285714285714286,100
2001-08-21,38.28999,38.64999,36.64999,36.69,52.422388235690526,44.95908464850981,42.045322814670925,40.31883638775437,51.58930230000012,43.49959909999982,42.08900000000013,40.82600099999998,40.82600099999998,44.468705845601086,37.18329615439887,56401600,32.03741736892333,42.64041397422989,NaN,NaN,32.03741736892333,NaN,NaN,NaN,-0.4043733361647124,-1.2419338086943412,-0.8375604725296288,0.544056915886642,4.353102521538808,-184791978,-946594498.4234629,11.969966706488353,31.223416140292294,21.997808121713984,7.142857142857143,100
2001-08-22,37.45,37.84,36.53999,37.69,52.27579730797221,44.815142378242285,41.87452584154658,40.068471017492044,51.36243980000011,43.48499919999983,41.92680000000013,40.685500999999974,40.685500999999974,44.576000031765055,36.79500196823489,65213200,37.47513568468611,41.31749866520539,NaN,NaN,NaN,NaN,NaN,NaN,-0.3662745162110317,-1.2954036177934185,-0.9291291015823868,16.45219391674683,9.572470203516106,-119578778,-896430382.6612769,11.239651117253395,29.834656918847593,24.564002910451382,0,100
2001-08-23,37.679,38.46001,37.299,37.32001,52.12698350391279,44.6667239153068,41.6959173771722,39.80671282534995,51.13685235000011,43.484199399999824,41.782200200000126,40.496500999999974,40.496500999999974,44.646686671529,36.34631532847095,54614000,36.317330679944035,40.1640618218842,NaN,NaN,NaN,NaN,NaN,NaN,-0.3383354033530366,-1.3520483557736824,-1.0137129524206459,12.361608996484973,9.785953276372815,-174192778,-949067758.6184173,13.57664829122071,28.180990767005948,26.621567287494997,0,92.85714285714286
2001-08-24,37.86,39.39,37.75,39.3,51.999351827256945,44.56045215460765,41.60195983296937,39.75845446103091,50.9227273500001,43.53059939999983,41.72320020000012,40.36400099999997,40.36400099999997,44.48924125581118,36.23876074418877,58447392,45.9424526188398,39.92105402644688,NaN,NaN,NaN,NaN,NaN,NaN,-0.16748744409890248,-1.223072257544274,-1.0555848134453716,43.949063856484436,24.254288923238747,-115745386,-897035324.276954,16.59220798366424,25.470312167026144,27.875519757273622,0,85.71428571428571
2001-08-27,39.28,39.89999,38.83,39.35001,51.8734877294733,44.457275082239185,41.51364807481371,39.71955498855177,50.74096180000011,43.58359949999983,41.65820020000012,40.24650149999998,40.24650149999998,44.34662826903754,36.14637473096242,50918800,46.16378149023823,39.76542220412988,NaN,NaN,NaN,NaN,46.16378149023823,NaN,-0.038808197915556786,-1.1040950608398177,-1.065286862924261,45.990507364975365,34.10039340598159,-64826586,-898461539.8827076,18.17133869175883,24.175820817835582,28.777581300533402,0,78.57142857142857
2001-08-28,39.32001,39.44,38.011,38.12,51.73663710529943,44.33178448655128,41.38056383658572,39.567216418213505,50.55312430000011,43.591699499999834,41.58000020000012,40.064501999999976,40.064501999999976,44.202716166540014,35.92628783345994,65266800,41.64725478270319,39.806264124222785,NaN,NaN,NaN,NaN,NaN,NaN,-0.0249044971653003,-1.0964174843808863,-1.071512987215586,30.620289495562886,40.18662023900756,-130093386,-953771613.2207067,16.93354048690387,26.433051375491285,29.00034649940247,0,71.42857142857143
2001-08-29,38.37,38.45,37.13,37.56,51.59557603957506,44.197689744243334,41.23073780377844,39.37605294981222,50.382174300000116,43.60429949999983,41.494800000000126,39.787501499999976,39.787501499999976,43.8160922796822,35.75891072031775,59040496,39.74089478936391,39.64685301420429,NaN,NaN,NaN,NaN,NaN,NaN,-0.04085350436761681,-1.1225798676751069,-1.08172636330749,19.767597349617525,32.12613140338526,-189133882,-974346331.5237371,15.858901915964783,28.991170091814855,29.544076186531544,21.428571428571427,64.28571428571429
2001-08-30,36.8,37.31,35.75,36.17,51.442087720773316,44.03872559089198,41.03227749774791,39.07071457363963,50.212711800000115,43.59549949999983,41.36280000000013,39.400501499999976,39.400501499999976,43.25390678807191,35.54709621192804,76090496,35.408415591107584,39.28666826487215,NaN,NaN,NaN,NaN,NaN,NaN,-0.1275530848278994,-1.2411677193423643,-1.1136146345144649,7.05882352941179,19.1489034581974,-265224378,-1009465021.9852754,14.50004613931479,33.03990877470698,30.322039509047773,14.285714285714286,100
2001-08-31,36.03799,37.03,35.94,36.63,51.294703763352686,43.892018153448575,40.859639164502894,38.838265566626326,50.01664305000012,43.56379949999983,41.228399800000126,39.073001999999974,39.073001999999974,42.69210930320533,35.45389469679462,54299696,37.824145211044346,38.77635687106552,NaN,NaN,NaN,NaN,NaN,NaN,-0.13569942132357737,-1.2832389111689366,-1.1475394898453593,14.789915966386591,13.8721122818053,-210924682,-995018313.8751833,13.736710392887272,31.300566486818926,31.6957376440557,7.142857142857143,92.85714285714286
2001-09-04,36.51801,37.5,35.35001,35.47,51.13724402441385,43.725245516746625,40.64828076589494,38.51747836980477,49.80711805000013,43.508499499999836,41.072799800000126,38.72150199999997,38.72150199999997,42.30635768693012,35.136646313069825,74060320,34.33663885215498,38.169352688554206,NaN,NaN,NaN,NaN,NaN,NaN,-0.19725839086542996,-1.3941124784271466,-1.1968540875617166,2.1503661303445782,7.999701875380983,-284985002,-1060812085.847704,12.355095664750571,30.912430522111283,33.69834419284017,0,100
2001-09-05,35.49001,35.91,34.14999,35.33,50.97995801422068,43.55900303126649,40.439720735859844,38.213909001251935,49.61939305000013,43.43379949999983,40.91219980000013,38.374001999999976,38.374001999999976,41.857684083100274,34.89031991689968,95447120,33.93002257073408,37.94000682143997,NaN,NaN,NaN,NaN,NaN,NaN,-0.2235247322531404,-1.476260002878142,-1.2527352706250017,20.521913043478186,12.487398380069786,-380432122,-1028272937.506956,11.34881717233937,33.947950271208974,35.27154988017191,0,100
2001-09-06,34.74001,35.52,33.78,33.89999,50.81000808373092,43.367735446488936,40.183260707002596,37.803059572561274,49.42475240000013,43.37029939999984,40.71999980000013,38.04400149999997,38.04400149999997,41.89105527037315,34.19694772962679,88601008,30.019568803296536,37.2425294079569,NaN,NaN,NaN,NaN,NaN,NaN,-0.308109379449264,-1.6378719949365816,-1.3297626154873177,1.9606241186668825,8.210967764163216,-469033130,-1104654135.2196915,10.443238720760812,32.935818413489386,36.45245169476315,50,100
2001-09-07,33.621,35.10001,33.35001,33.7,50.63975924707688,43.17629514061787,39.92901518908093,37.41229199422211,49.24395555000013,43.29479939999984,40.51820000000013,37.69550149999997,37.69550149999997,41.783154848088984,33.60784815191096,95522496,29.507382937848845,36.93625726038856,NaN,NaN,NaN,NaN,NaN,NaN,-0.34561349748835335,-1.7617794873477592,-1.416165989859406,5.343375094275174,9.275304085473415,-564555626,-1161968724.5053594,9.612463265491355,32.2703730766797,37.63423098676766,42.857142857142854,100
2001-09-10,33.49001,34.32001,33.342,34.10001,50.47518462770298,42.99656672199177,39.70042675029344,37.096836566200956,49.065705600000136,43.18029949999984,40.31320000000013,37.38650199999997,37.38650199999997,41.5789443020663,33.194059697933646,80367872,32.006229090853736,36.59690503369557,NaN,NaN,NaN,NaN,NaN,NaN,-0.31256410275121493,-1.8068711182984245,-1.4943070155472096,11.558572062476435,6.287523758472832,-484187754,-1117757807.6285186,9.173263354529086,30.833339148125443,38.72579338234589,35.714285714285715,100
2001-09-17,31.25,32.8,31.09,31.2,50.28339174583529,42.762971341358266,39.36707668165448,36.53523308370563,48.88858060000014,43.009299499999834,40.02320000000013,36.891501499999976,36.891501499999976,41.52755623890688,32.25544676109307,97736880,25.068246931494443,36.09910714530779,NaN,NaN,NaN,NaN,NaN,NaN,-0.4469128070744526,-2.0529480243902754,-1.6060352173158228,1.2485825750085913,6.0501765772534,-581924634,-1202920352.189922,7.9667839407536665,36.618130460517364,40.13203808011203,28.571428571428573,100
2001-09-18,31.53,32.5,30.37,30.5,50.0865420767225,42.520140225687804,39.019348184334696,35.96044898049557,48.68889310000014,42.83029959999983,39.72420000000013,36.386500999999974,36.386500999999974,41.47497353585274,31.29802846414721,66274192,23.731039855890444,35.117386014679525,NaN,NaN,NaN,NaN,NaN,NaN,-0.5377225125033176,-2.2781883579449698,-1.7404658454416522,1.3641147577279618,4.723756465070996,-648198826,-1261104736.7157438,7.241024916914222,36.361660693588114,41.66880325299443,21.428571428571427,100
2001-09-19,30.64,31,28.25999,29.97,49.88637747894417,42.271622597456364,38.66447178494902,35.389930029972184,48.49093060000014,42.67849969999984,39.41080000000014,35.93000049999998,35.93000049999998,41.570980265972295,30.289020734027655,116627504,22.741886338833467,34.14771141888591,NaN,NaN,NaN,NaN,NaN,NaN,-0.5844078408761866,-2.4709756465368855,-1.886567805660699,14.690807560137454,5.767834964291335,-764826330,-1232160364.6167223,6.429596269681652,40.91641696016855,44.373510811735564,14.285714285714286,100
2001-09-20,29.3,30.09,28.8,28.97,49.6782543199497,42.008224130180004,38.28429642083337,34.77850812235579,48.308515000000135,42.52519969999984,39.12120000000013,35.40050049999998,35.40050049999998,41.544775383019854,29.256225616980103,90830688,20.966165262993982,32.36369089346835,NaN,NaN,NaN,NaN,NaN,NaN,-0.6296518607958244,-2.6736326316554795,-2.043980770859655,6.099742268041239,7.384888195302217,-855657018,-1299051181.3609087,6.083930191430091,38.716680492512005,48.06872820697631,7.142857142857143,92.85714285714286
2001-09-21,27.41,28.97,27.2,28.19,49.46444084412931,41.73459592958238,37.888441659232065,34.151031158321906,48.13477750000013,42.35609959999984,38.852000200000134,34.92200099999998,34.92200099999998,41.713252144235824,28.130749855764133,112285184,19.67566814288388,30.471682797228755,NaN,NaN,19.67566814288388,NaN,NaN,NaN,-0.6561457402172719,-2.864162946131245,-2.208017205913973,8.088235294117665,9.62626170743212,-967942202,-1285729210.3778577,5.63618919493472,42.51993210163552,52.52678737666565,0,100
2001-09-24,29.08,30,28.59,29.61,49.26688421881459,41.4945049210758,37.563796888281786,33.71855200038649,47.96790565000013,42.212699599999844,38.60400040000013,34.48850099999997,34.48850099999997,41.47116829639095,27.505833703608992,85674496,28.325028455927907,29.52009520245909,NaN,NaN,NaN,NaN,NaN,NaN,-0.5276041926212449,-2.867522446690529,-2.339918254069284,21.422222222222217,11.870066594793707,-882267706,-1247449116.4204109,9.47990038964116,39.3322064227912,55.33053378666159,0,92.85714285714286
2001-09-25,29.71001,30.42999,28.95,29.7,49.07218885345325,41.26095036818321,37.25541269658446,33.33583276225444,47.79640565000013,42.05819969999984,38.38800040000013,34.13900099999997,34.13900099999997,41.34217185512257,26.93583014487737,83856000,28.847981793565722,28.7420299884735,NaN,NaN,NaN,NaN,NaN,NaN,-0.3923027794349858,-2.8302967283630167,-2.437993948928031,24.271844660194173,17.927434058844685,-798411706,-1246315352.9760633,10.692065140572772,36.89642898624858,57.17225679980572,0,85.71428571428571
2001-09-26,29.95,30,28.41,28.67,48.86918199919003,41.011624618318194,36.91872984573801,32.89146773727783,47.62131815000014,41.883399799999836,38.14140040000014,33.68800099999997,33.68800099999997,41.07258913855506,26.303412861444883,59735600,26.46788787451524,28.10342086585976,NaN,NaN,NaN,NaN,NaN,NaN,-0.33043878319808817,-2.851042427925641,-2.520603644727553,14.271844660194196,19.988637180870196,-858147306,-1286514781.9068809,9.97720479479332,36.700253779573046,58.47596758493014,14.285714285714286,78.57142857142857
2001-09-27,28.39999,28.78999,27.42,28.48,48.66630456636227,40.76347363577724,36.5877992635522,32.47132795277518,47.41028065000014,41.687699799999834,37.83900020000014,33.24600049999997,33.24600049999997,40.765112230521744,25.726888769478204,70034000,26.04107392062771,27.261772916544285,NaN,NaN,NaN,NaN,NaN,NaN,-0.2634869756593683,-2.8499623643017635,-2.5864753886423952,12.427184466019428,16.990291262135933,-928181306,-1248174209.8297124,9.394386733894882,38.77766792099212,60.047256359692604,7.142857142857143,71.42857142857143
2001-09-28,28.84,29.92,28.31,28.98,48.47042093883628,40.53013752417769,36.28945419439329,32.13882052870135,47.215180650000136,41.48769979999983,37.55560040000014,32.730000499999974,32.730000499999974,39.92594291778447,25.534058082215477,84805120,29.27331476807838,26.900106910538817,NaN,NaN,NaN,NaN,NaN,NaN,-0.15222122279809813,-2.776751917140018,-2.62453069434192,20.436280137772695,15.71176975466211,-843376186,-1262396186.475675,13.579353762669829,36.10820909948684,60.222347982849115,0,64.28571428571429
2001-10-01,28.85001,28.98,27.85001,28.73,48.27399883994239,40.29647143459001,35.993005010299434,31.814170954539318,47.02633065000013,41.30699979999983,37.283200200000145,32.19899999999997,32.19899999999997,38.91382217188601,25.48417782811393,53450704,28.600279105513607,26.519410948737352,NaN,NaN,NaN,NaN,NaN,NaN,-0.06652938704066624,-2.707692428142753,-2.6411630411020868,18.389423076923084,17.08429589357174,-896826890,-1232596445.758536,12.907731815216868,36.33568268869609,60.05695754060347,0,57.142857142857146
2001-10-02,28.64999,29.41,28.39999,28.82001,48.080426811684255,40.06921477251892,35.71171108832691,31.529012768392715,46.830430700000136,41.113199899999834,36.99360040000014,31.734000499999972,31.734000499999972,38.018569311308376,25.44943168869157,74170880,29.231154690442963,26.463095654962096,NaN,NaN,NaN,NaN,NaN,NaN,0.020491383100961436,-2.615548812225885,-2.6360401953268466,20.506429738696546,19.777377651130777,-822656010,-1245078326.6048644,14.255897198163787,34.684420715693946,59.33484784431034,0,50
2001-10-03,28.429,31.61,28.33,31,47.910472316045606,39.88962636118191,35.52693810447095,31.478630599974363,46.61355570000013,40.951199899999835,36.78060060000014,31.406000499999976,31.406000499999976,37.09676200054359,25.71523899945636,136211872,42.48586454125642,27.390130055205496,NaN,NaN,NaN,NaN,NaN,NaN,0.23711426802160052,-2.339647360299846,-2.5767616283214467,53.37071155798936,30.755521457869666,-686444138,-1159530626.5073032,21.499138648124323,29.927877695043076,56.641375903812,0,42.857142857142854
2001-10-04,31.64999,33.2,30.94,31.3,47.74519398454267,39.7195347500694,35.361175825864244,31.461618161881567,46.411774450000124,40.78219989999983,36.55380060000014,31.162500499999975,31.162500499999975,36.417089582894086,25.907911417105865,127386880,44.03919377297999,28.249627532500227,NaN,NaN,NaN,NaN,NaN,NaN,0.4030965169149687,-2.0728909821777357,-2.4759874990927044,68.33333333333331,47.40349154333975,-559057258,-1246334075.710843,26.01142826208383,27.163704450502102,52.928925388881666,0,35.714285714285715
2001-10-05,31,31.89999,30.25999,31.75999,47.58613722847757,39.561920002543275,35.21995285230094,31.490034527416658,46.22690255000013,40.63429979999984,36.35600060000014,30.918999999999972,30.918999999999972,35.5521657686826,26.285834231317345,96560192,46.428303718979066,29.775345874463415,NaN,NaN,NaN,NaN,NaN,NaN,0.5379285819930386,-1.8035767716014064,-2.341505353594445,75.99983333333327,65.90129274155198,-462497066,-1166259770.1498673,24.260346479366955,28.126397828243554,48.865882813939926,92.85714285714286,28.571428571428573
2001-10-08,31.13,32.35001,30.96001,31.86,47.42965825107978,39.40940673516618,35.08818999534796,31.525269334329355,46.05932755000013,40.49519979999984,36.18100060000013,30.738499999999977,30.738499999999977,34.90631477996453,26.570685220035422,67779632,46.95851331321134,31.434451121414906,NaN,NaN,NaN,NaN,NaN,NaN,0.6219690650129985,-1.564044022328197,-2.1860130873411956,77.66666666666661,73.99994444444441,-394717434,-1146268192.0726297,24.73013085953507,26.498175033637622,44.34195195726455,85.71428571428571,21.428571428571427
2001-10-09,31.86,32.02,30.87,31.09,47.26707458688993,39.244666007737145,34.93139823082451,31.483815112012273,45.895402550000135,40.350599799999834,35.99980080000013,30.526499999999977,30.526499999999977,34.13194588644601,26.921054113553943,57547504,43.39723264905377,32.909833000716354,NaN,NaN,NaN,NaN,NaN,NaN,0.6128292283965981,-1.4199765518454477,-2.032805780242046,64.8333333333333,72.83327777777772,-452264938,-1181797520.6291516,23.517154833900577,25.582379619818223,39.43954001114554,78.57142857142857,14.285714285714286
2001-10-10,30.871,32.53999,30.75101,32.5,47.12013852134874,39.111108265009676,34.8360492805961,31.58059462515396,45.73790255000014,40.227399699999836,35.83980080000013,30.45650050000001,30.45650050000001,33.84508336220973,27.067917637790295,73838880,50.76120795849484,35.03805033610927,NaN,NaN,NaN,NaN,NaN,NaN,0.6834906433215813,-1.1784424760900691,-1.8619331194116504,88.3333333333333,76.94444444444441,-378426058,-1111259758.373565,23.938508788353992,23.63986984770777,34.281519315109676,71.42857142857143,7.142857142857143
2001-10-11,33.192,35.25,33.14,34.7,46.99655505347462,39.023759586494634,34.83071401469037,31.877680851329774,45.61577755000014,40.12289979999983,35.711800600000124,30.50650050000001,30.50650050000001,34.107874350916155,26.90512664908386,117223008,59.594179658970745,37.889372587258336,NaN,NaN,NaN,NaN,NaN,NaN,0.8493238895566133,-0.8002782574658838,-1.649602147022497,92.97573435504474,82.04746700723712,-261203050,-1055148271.1318585,32.26942949952474,21.000156890294743,30.321744922857885,100,0
2001-10-12,34.33,34.8,33.14,34.55,46.87270873453458,38.935170287752165,34.81970562195742,32.13218743691741,45.50985570000014,39.99689989999983,35.56380060000013,30.529000000000014,30.529000000000014,34.22429217248688,26.83370782751315,111900688,58.8194086446701,40.06754260073992,NaN,NaN,NaN,NaN,NaN,NaN,0.9142084521615672,-0.5068415818205381,-1.4210500339821053,91.06002554278413,90.78969774372074,-373103738,-976952609.6378826,30.085545384600053,19.57893842579365,27.464429659843507,92.85714285714286,21.428571428571427
2001-10-15,34.12,34.55,33.66,34.39999,46.748602080459605,38.845364737499644,34.80324618580222,32.34816863340147,45.40154315000014,39.861899899999834,35.417800400000125,30.688999500000012,30.688999500000012,34.746048846022575,26.63195015397745,78295680,58.00720470473725,42.15034423725217,NaN,NaN,NaN,NaN,NaN,NaN,0.9103346754152937,-0.2831316897129881,-1.1934663651282817,89.14418901660284,91.05998297147725,-451399418,-925050491.3385558,28.954146687784455,18.842651775949015,25.042335176318346,85.71428571428571,14.285714285714286
2001-10-16,34.66901,35.10001,34.07001,34.96001,46.63130265677344,38.76842701992539,34.809393786358996,32.59691543022038,45.27384320000013,39.73110009999983,35.28180080000013,30.912000000000013,30.912000000000013,35.37315394041529,26.450846059584734,81141808,60.21583340986413,44.56091177549138,NaN,NaN,NaN,NaN,60.21583340986413,NaN,0.9068051923856342,-0.059959874646239086,-0.9667650670318733,96.29642401021708,92.16687952320137,-370257610,-865966650.561857,30.048569460352876,17.999046688008146,22.74432501630519,78.57142857142857,7.142857142857143
2001-10-17,35.87,36,32.3,32.45,46.49019516765132,38.643309653194194,34.71686853983511,32.58292348448511,45.13171820000012,39.54510009999983,35.068800600000124,31.036000000000012,31.036000000000012,35.523316177859826,26.548683822140198,141490128,48.02413800810201,46.1311306388824,NaN,NaN,48.02413800810201,NaN,NaN,NaN,0.7056875924086577,-0.08465557652105105,-0.7903431689297088,56.44166434560046,80.62742579080681,-511747738,-995984606.021316,25.612500133937267,22.40418634929513,18.864691836225173,100,0
2001-10-18,32.7,33.53999,32.39999,33.33,46.359247952052804,38.538095600655694,34.66248153827295,32.65407362881986,44.990555700000115,39.36940019999983,34.85720060000013,31.25400000000001,31.25400000000001,35.74228770023532,26.765712299764694,94346128,51.715234767729335,47.73412492457175,NaN,NaN,NaN,NaN,NaN,NaN,0.6060026193184054,-0.03283989478170213,-0.6388425141001075,67.2392236064093,73.32577065407563,-417401610,-936395922.6155624,24.41646189141334,21.35796815402868,16.10330820279548,92.85714285714286,7.142857142857143
2001-10-19,32.869,33.75,32,33.55,46.23179274854979,38.43932143034568,34.61885481128186,32.739399949884636,44.85111820000011,39.218400299999836,34.66460080000013,31.52200000000001,31.52200000000001,35.88481267992148,27.159187320078537,73418496,52.621099597856,49.44989781688192,NaN,NaN,NaN,NaN,NaN,NaN,0.5316184420244005,0.025680538430393085,-0.5059379035940074,68.05736636245108,63.912751438153634,-343983114,-879758797.1298484,22.666624010970217,21.46536753028612,12.899462343619751,85.71428571428571,0
2001-10-22,33.44,34.5,33.22,34.45,46.11456097990751,38.360324966378435,34.61223305397669,32.902314240371815,44.7314932000001,39.06390039999984,34.50360080000013,31.76400000000001,31.76400000000001,36.21184964674879,27.316150353251228,74105504,56.23814153166081,51.37896830554034,NaN,NaN,NaN,NaN,NaN,NaN,0.5191760002966854,0.14303209677684947,-0.37614390351983595,79.79139504563237,71.69599500483093,-269877610,-811442785.629848,24.58637456750779,20.318374829697348,10.596809214056375,78.57142857142857,7.142857142857143
2001-10-23,34.82201,35.401,34,34.63,46.000286741301466,38.286457145262034,34.61292979695799,33.066855741288784,44.6374557000001,38.92030029999984,34.35060080000014,32.010500000000015,32.010500000000015,36.519500940350504,27.50149905964953,104050816,56.94608069480227,52.41184088793647,NaN,NaN,NaN,NaN,NaN,NaN,0.49907766669470865,0.24770317984854984,-0.2513744868461588,76.13244576228966,74.66040239012439,-165826794,-821914709.2958007,26.94017815402226,19.11445623563143,10.639848269580598,71.42857142857143,0
2001-10-24,34.60001,35.67999,34.32001,35.38,45.894612246363145,38.228903538425165,34.643010981391015,33.28715519449938,44.5021682000001,38.81290029999984,34.248200800000134,32.34600000000001,32.34600000000001,36.80915656011349,27.882843439886525,90165008,59.85983404737505,53.54188662182183,NaN,NaN,NaN,NaN,NaN,NaN,0.5104729256641964,0.38671667023408673,-0.12375625543010971,89.19862508950338,81.70748863247515,-75661786,-771527640.3094915,26.565359954466256,17.999524551352238,11.857998051472356,64.28571428571429,7.142857142857143
2001-10-25,34.705,36.82001,34.23,36.8,45.804118592170475,38.20060841885239,34.72759878604235,33.62171184264229,44.3796057000001,38.73660039999984,34.17080080000014,32.762000000000015,32.762000000000015,37.257105613896385,28.266894386103644,118522688,64.72717827530468,54.84894909013081,NaN,NaN,NaN,NaN,64.72717827530468,NaN,0.582604763722441,0.6044996992229414,0.021894935500500534,99.6702916460701,88.33378749928772,42860902,-654836326.6955987,28.42992662944217,16.07631574243501,13.31351249196911,100,0
2001-10-26,36.5,37.06,36.00999,36.00999,45.70666457632798,38.15722983630086,34.7778886375701,33.849166905247785,44.276530650000105,38.64940029999983,34.08540060000014,33.11349950000001,33.11349950000001,37.46791678525216,28.759082214747863,93816880,60.34318335059027,55.804996949943586,NaN,NaN,NaN,NaN,NaN,NaN,0.5466582934281896,0.7052178022857376,0.15855950885754796,83.35692400843875,90.74194691467075,-50955978,-748653206.6955987,28.18149642364331,15.359796992769317,15.170363520738931,100,14.285714285714286
2001-10-29,36,36.158,34.03999,34.03999,45.590578262135665,38.07570033459193,34.74895143609676,33.86734053331942,44.16048060000011,38.52930019999984,33.94420020000014,33.37899900000001,33.37899900000001,37.252970258556275,29.505027741443737,92131504,51.05664308949397,56.35209769568932,NaN,NaN,NaN,NaN,NaN,NaN,0.36830465669839507,0.6189403297305418,0.25063567303214673,52.13164072220754,78.38628545890548,-143087482,-840784710.6955987,25.69384572758489,22.21433542578052,15.388697274303905,92.85714285714286,7.142857142857143
2001-10-30,33.71001,34.09,32.84,33.38,45.469079970970135,37.98271616955051,34.69526706605375,33.820927149193764,44.04113060000011,38.40480019999984,33.79980000000014,33.60699850000001,33.60699850000001,36.869335436016186,30.344661563983834,96075872,48.37089272189056,56.181360893074725,NaN,NaN,48.37089272189056,NaN,NaN,NaN,0.1928048962496544,0.49164179334421476,0.29883689709456035,27.272727272727312,54.253764001124544,-239163354,-853851029.2875988,24.328902593546285,26.134034538335914,15.599373430791598,85.71428571428571,0
2001-10-31,34.03999,34.96001,33.67999,33.89999,45.353964647875905,37.90187010678713,34.66407973013008,33.828456944508645,43.909693050000115,38.26529999999984,33.69579960000014,33.75199800000001,33.75199800000001,36.78788723251632,30.7161087674837,106165008,50.57679666550113,55.53726210782689,NaN,NaN,NaN,NaN,NaN,NaN,0.10315800320002472,0.42778440109459126,0.32462639789456654,37.54920948616604,38.98452582703364,-132998346,-923522386.0008992,26.401556246738235,24.37163406507962,14.373862558576876,78.57142857142857,42.857142857142854
2001-11-01,34.44,35.563,33.782,35.34,45.25432320859356,37.85114000566263,34.690586407379875,33.972413425984016,43.77670555000011,38.143899999999846,33.61139960000014,33.95399800000001,33.95399800000001,36.844551349119705,31.06344465088032,92676192,56.1626721945937,55.34749521853572,NaN,NaN,NaN,NaN,NaN,NaN,0.13049987156737397,0.487751237353784,0.35725136578641004,66.00790513833996,43.60994729907777,-40322154,-854054269.0329036,26.965684466811236,22.52747089480632,13.503302273919685,71.42857142857143,35.714285714285715
2001-11-02,35.271,35.85001,34.89,35.60001,45.158260390597604,37.80656317386733,34.726250077678706,34.12742262350935,43.641033750000105,38.01290009999985,33.56820000000014,34.145999,34.145999,36.93651472439985,31.355483275600157,64913104,57.10537004279733,55.28307845696859,NaN,NaN,NaN,NaN,NaN,NaN,0.1541324443122738,0.5499169211767523,0.3957844768644785,71.14644268774695,58.23451910408431,24590950,-822949721.193777,27.089006264603483,21.579588670539856,12.800809458272795,64.28571428571429,28.571428571428573
2001-11-05,36.25999,37.16,36.16,36.75999,45.07469551108917,37.78583895260263,34.8060045844364,34.378143326032266,43.51491185000011,37.906999899999846,33.537799800000144,34.39099850000001,34.39099850000001,37.19604938940229,31.58594761059773,64281504,61.122131345518284,55.34781402380103,NaN,NaN,NaN,NaN,NaN,NaN,0.2312839277953735,0.6848893866086954,0.45360545881332187,92.24786821705436,76.46740534771375,88872454,-810094706.0238563,30.99037041393993,20.09959458375391,12.532135483930572,100,21.428571428571427
2001-11-06,36.60899,38.2,36.39,38.19,45.006191078143004,37.79384214166001,34.938710287007524,34.741177294981576,43.38648685000011,37.82839989999985,33.56779980000014,34.74599850000001,34.74599850000001,37.587014999799855,31.90498200020017,107185312,65.42104057654596,56.59044992154711,NaN,NaN,NaN,NaN,NaN,NaN,0.35464116034991033,0.8969069092507098,0.5422657489007995,99.83870967741927,87.74434019407352,196057766,-704093762.1122546,33.07954387058388,18.513103987279273,14.071556426758239,100,14.285714285714286
2001-11-07,37.61,38.84,37.5,38.14,44.93787076890775,37.80069675271625,35.064251060066056,35.06487469545952,43.244374350000115,37.751799899999845,33.576799800000146,35.02799850000001,35.02799850000001,38.03602545069972,32.0199715493003,92542368,65.14978142229208,57.55006039687303,NaN,NaN,NaN,NaN,NaN,NaN,0.4052335917318971,1.0488077385656709,0.6435741468337738,89.76608187134498,93.9508865886062,103515398,-708237450.2316577,33.9487666876607,17.41704106341905,15.893173259044568,100,7.142857142857143
2001-11-08,38.55099,39.39999,37.25,37.75,44.86634966672956,37.799692856622855,35.1695745479066,35.32060091493957,43.10156185000012,37.68379989999985,33.585399600000144,35.18049850000001,35.18049850000001,38.40781053420638,31.95318646579365,105882192,62.95702476791869,58.288340766163216,NaN,NaN,NaN,NaN,NaN,NaN,0.3849447015504188,1.1247550237717974,0.7398103222213785,74.84767507267537,88.15082220714653,-2366794,-764871882.0095172,33.215363158769,15.80064633953814,18.236506640096547,100,0
2001-11-09,37.59801,38.08,37.12,37.73,44.79534121233424,37.79831280005607,35.26998338916516,35.55006749446913,42.95833685000012,37.638599899999846,33.55399960000015,35.33949850000001,35.33949850000001,38.735806035270286,31.943190964729737,74112688,62.84021874560989,58.75991771001672,NaN,NaN,NaN,NaN,NaN,NaN,0.3440275181328689,1.1698447198874646,0.8258172017545957,74.542796559141,79.71885116772044,-76479482,-744799695.676184,31.796402011491114,15.704142671251484,19.977470229943382,92.85714285714286,42.857142857142854
2001-11-12,37,38.35001,36.3,38,44.72772587688813,37.802306605995554,35.37704286409986,35.78339439975779,42.809508750000134,37.59259979999986,33.52699940000014,35.51949900000001,35.51949900000001,39.07539868307882,31.963599316921208,112981312,63.816226672467,59.25064242270707,NaN,NaN,NaN,NaN,NaN,NaN,0.3100488807222691,1.213378302657432,0.903329421935163,78.65865649185437,76.01637604122358,36501830,-670398282.3236245,28.95206844976375,17.877500757393364,20.452927893246066,85.71428571428571,35.714285714285715
2001-11-13,39.03,39.5,38.63,39.36,44.6743156691579,37.833152019738215,35.533237261586144,36.12402350454276,42.67068375000014,37.565899799999855,33.55179940000014,35.73949850000001,35.73949850000001,39.6558880917152,31.823108908284826,97911376,68.32862056730207,59.855555745558995,NaN,NaN,NaN,NaN,NaN,NaN,0.35105499529259887,1.3421481660509116,0.9910931707583127,97.89789789789788,83.69978364963107,134413206,-603998613.5420156,32.09391830764749,16.700309497126014,21.333425707945803,100,28.571428571428573
2001-11-14,39.96001,40.24001,38.74001,39.64,44.62422297593245,37.86893118766419,35.69428678073963,36.458878408872025,42.54638375000013,37.544099699999855,33.593399400000145,36.098998500000015,36.098998500000015,40.06129186976625,32.13670513023378,88629504,69.1807756897163,60.173669846588396,NaN,NaN,NaN,NaN,NaN,NaN,0.3671872891548835,1.4500772822019172,1.0828899930470337,91.89176771382745,89.48277403452657,223042710,-586273894.4687352,33.23550815885339,15.594461846625974,21.931316286786572,100,21.428571428571427
2001-11-15,39.162,40.11,38.95,39.48,44.57303667766446,37.90083354038371,35.84274612267141,36.74660427469374,42.41604940000014,37.51119969999985,33.65959940000014,36.40649850000001,36.40649850000001,40.41577617036577,32.39722082963426,86342624,68.05396298524477,60.72443982049229,NaN,NaN,NaN,NaN,NaN,NaN,0.33796680639563226,1.5053485010415741,1.1673816946459419,89.72960847350204,93.17309136174246,136700086,-593717224.1239083,31.49846130690092,14.779420574228316,22.40847915214854,92.85714285714286,14.285714285714286
2001-11-16,39.48,39.67999,38.92,39.37,44.52126516843397,37.92992594552462,35.981069804135274,36.99645148662767,42.277899400000145,37.47139959999985,33.71439940000014,36.697498500000016,36.697498500000016,40.67997699085122,32.71502000914881,64034096,67.24305582537433,61.88061215876946,NaN,NaN,NaN,NaN,NaN,NaN,0.2842724563455401,1.5227222650778671,1.238449808732327,88.24312399577838,89.95483339436929,72665990,-581920471.823273,30.378233628629058,14.394185678723215,24.43974946194634,85.71428571428571,7.142857142857143
2001-11-19,39.78999,40.49001,39.49001,40.49001,44.48115317670826,37.98062067927661,36.15789098828683,37.32917134504408,42.14659945000014,37.44379969999985,33.81479960000014,36.999499000000014,36.999499000000014,41.16623591467525,32.83276208532478,69180320,71.02839013608484,63.4990048312119,NaN,NaN,NaN,NaN,71.02839013608484,NaN,0.29590155721243105,1.608326755247866,1.312425198035435,100,92.65757748976013,141846310,-512740151.82327294,32.61923751823434,13.625132452456862,27.118048827359015,100,0
2001-11-20,40.08,40.23,38.48,38.62,44.42283324460171,37.9932816559246,36.254444282863815,37.45210740742083,42.01819945000013,37.396399699999854,33.88059960000014,37.198999000000015,37.198999000000015,41.273897171993674,33.124100828006355,85209312,58.80895722045015,64.08701629942254,NaN,NaN,NaN,NaN,NaN,NaN,0.1563740042332138,1.5078927033269522,1.3515186990937385,72.12273088442026,86.78861829339955,56636998,-584315973.9032729,29.5662403463939,17.052943276940944,28.7497273505322,92.85714285714286,0
2001-11-21,38.47,38.95,37.98,38.64,44.365292615302195,38.006087959767676,36.34799548745739,37.56524003528551,41.88564950000013,37.34769979999985,33.97539980000014,37.36199900000001,37.36199900000001,41.39338392532265,33.33061407467737,60827104,58.89041506648427,64.28185507598616,NaN,NaN,NaN,NaN,NaN,NaN,0.04967826870495129,1.4136165349749277,1.3639382662699764,66.96416613541764,79.69563233994596,117464102,-562368049.7795615,28.194791288391407,18.652944050287097,29.56404589573257,85.71428571428571,0
2001-11-23,38.75999,39.42999,38.57001,39.28,44.314692688781776,38.031313940762374,36.46297605657671,37.72855050811546,41.77429950000013,37.30259989999985,34.08699980000014,37.48599900000001,37.48599900000001,41.59247405874804,33.379523941251975,27042800,61.51327870269245,64.5967056945501,NaN,NaN,NaN,NaN,NaN,NaN,0.008607771803377462,1.3746979810241982,1.3660902092208207,72.05526084235379,70.38071928739721,144506902,-544758375.135965,29.36611589686532,17.861879308082134,30.49537891787698,78.57142857142857,0
2001-11-26,39.58,40.36,39.00999,40.25,44.27424798541081,38.07524831817302,36.61148679945605,37.96868855496161,41.66804950000014,37.26159979999985,34.209999600000145,37.697999500000016,37.697999500000016,41.91410912287516,33.48188987712487,75256128,65.14319522646585,64.88392454318921,NaN,NaN,NaN,NaN,NaN,NaN,0.03186309662094211,1.4059190799969983,1.3740559833760562,94.27185137982968,77.76375945253369,219763030,-481766117.89247787,32.01020499828079,16.66691950505449,31.224212242879013,71.42857142857143,0
2001-11-27,40.05,40.97,39.2,40.2,44.23370820446145,38.11732260890226,36.75221280732052,38.18119440687003,41.56104945000013,37.20659979999985,34.389999600000145,38.006000000000014,38.006000000000014,42.00248817339442,34.00951182660561,100259120,64.80390616312069,64.83984351365883,NaN,NaN,NaN,NaN,NaN,NaN,0.029050878202812935,1.4103695811295722,1.3813187029267593,83.51177730192728,83.27962984137024,119503910,-468738096.64953977,32.221922887135854,15.228443486194513,31.765612991256997,100,28.571428571428573
2001-11-28,39.73,40.37,38.69,38.75,44.17914394372054,38.12985087407252,36.83055740311187,38.2353663681205,41.45179940000013,37.13959979999985,34.55499960000014,38.27450000000002,38.27450000000002,41.667769915594846,34.88123008440519,101523504,55.73757541505505,64.16754308457047,NaN,NaN,NaN,NaN,NaN,NaN,-0.07936349233931739,1.2821143375026125,1.3614778298419299,52.46252676659533,76.7487184827841,17980406,-563009921.7923967,29.609745522828508,16.454901825959833,31.506545314434042,92.85714285714286,21.428571428571427
2001-11-29,39.035,40,36.74001,39.95,44.13706290945466,38.16589343102157,36.952888485342775,38.39866480925188,41.35759945000014,37.08269979999986,34.75459960000014,38.57700050000001,38.57700050000001,41.38457009166868,35.769430908331344,83820192,60.6447446488708,64.00238021892419,NaN,NaN,NaN,NaN,NaN,NaN,-0.07898629095959597,1.262744966142435,1.341731257102031,78.15845824411144,71.37758743754468,101800598,-481760909.2131923,25.32021074380557,22.736556602587925,29.352804187016947,85.71428571428571,14.285714285714286
2001-11-30,39.73,40.03999,39.36,39.64999,44.0924154178183,38.19528148189243,37.05865717219208,38.51783863694218,41.273849450000135,37.04469969999986,34.96819940000014,38.79250000000002,38.79250000000002,41.2073113218387,36.377688678161334,66020816,58.88700530747786,63.72000783048619,NaN,NaN,NaN,NaN,NaN,NaN,-0.10598752163062786,1.2092468550637463,1.3152343766943742,71.73426124197012,67.45174875089229,35779782,-491470966.4319158,24.707552914184966,22.0199787911421,27.343770876970876,78.57142857142857,7.142857142857143
2001-12-03,39.28999,39.60001,38.87,38.97,44.04144611017832,38.210622442647036,37.13361179289043,38.560901623900065,41.183299450000135,37.01789979999987,35.18379940000013,38.960999500000014,38.960999500000014,40.88080369940724,37.04119530059279,60391904,54.99615010912672,63.09000236167618,NaN,NaN,54.99615010912672,NaN,NaN,NaN,-0.17274144287007154,1.0993075731067847,1.2720490159768563,52.718564346487824,67.53709461085644,-24612122,-535317369.9593193,23.78167793204213,23.548942001225424,25.689703687783425,71.42857142857143,0
2001-12-04,39.34,40.84,38.44,40.83,44.009491422514856,38.26249130516888,37.278568193169235,38.77700623114768,41.11094945000013,37.00609989999986,35.408199400000136,39.16450000000002,39.16450000000002,40.96720417984782,37.36179582015222,79390368,62.328364803307664,62.661412664248004,NaN,NaN,NaN,NaN,NaN,NaN,-0.09842228895268046,1.1490211547860056,1.247443443738686,96.69029950425413,73.71437503090401,54778246,-456588588.3593196,26.861744349054838,20.94777942152419,24.319834761850235,64.28571428571429,78.57142857142857
2001-12-05,41.20799,43.14999,41.12,42.85001,43.997954293932615,38.35333325952197,37.4970561071626,39.16491135199076,41.03794950000013,37.02959999999986,35.671199600000136,39.397500500000014,39.397500500000014,41.755307143909114,37.03969385609091,115730192,68.35780937098488,62.602629355767185,NaN,NaN,NaN,NaN,NaN,NaN,0.07085859127123184,1.3360166828277258,1.265158091556494,95.3201102031519,81.57632468463127,170508438,-375062252.53216827,34.36004191504872,18.787434342459907,23.832209711043216,100,71.42857142857143
2001-12-06,42.709,43.24001,42.36,42.91,43.98712887807259,38.44356428408589,37.709328416685636,39.52158646132497,40.96049955000013,37.048699999999855,35.95599960000013,39.636000500000016,39.636000500000016,42.37150634281223,36.9004946571878,77684320,68.51895628135247,62.635843162632014,NaN,NaN,NaN,NaN,68.51895628135247,NaN,0.16554025986635534,1.472083416389438,1.3065431565230827,94.92292307692304,95.64444426144301,248192758,-355642275.9900839,33.384561444618335,18.027951957351984,23.38520275837562,100,64.28571428571429
2001-12-07,42.48801,42.60001,41.14,41.73,43.96466988426092,38.50864221905449,37.86700181210973,39.7319115602464,40.89349955000013,37.02999989999986,36.220999600000134,39.83500050000002,39.83500050000002,42.57181533116011,37.09818566883993,81629184,61.84687913896569,62.25040197074569,NaN,NaN,NaN,NaN,NaN,NaN,0.12899065362279982,1.4677814735515824,1.3387908199287826,76.76907692307691,89.00403673438393,166563574,-371297639.86556447,30.696669358939406,22.125952434270967,21.994117722714584,92.85714285714286,57.142857142857146
2001-12-10,41.325,42.23,40.88,41,43.93517068143245,38.55797603649895,37.98986448614464,39.85268188784198,40.83354950000013,37.00849999999986,36.461399600000135,39.99850050000002,39.99850050000002,42.60012802254401,37.39687297745603,69086000,58.07901610963114,61.325446683141855,NaN,NaN,NaN,NaN,NaN,NaN,0.04052777036350186,1.38945053288316,1.348922762519658,65.53830769230773,79.07676923076922,97477574,-428101684.3100091,28.792561104549353,21.948132030581018,20.02381045906621,85.71428571428571,50
2001-12-11,41.46001,42.25999,41.13,41.23,43.90825356022417,38.61088740211283,38.11692862394289,39.98385504138084,40.78219950000013,36.99729989999987,36.711399600000135,40.16000050000002,40.16000050000002,42.6436780394684,37.676322960531635,66045120,58.928025623471676,61.333951569071964,NaN,NaN,NaN,NaN,NaN,NaN,-0.014663392405147135,1.3305935220132241,1.3452569144183713,69.07676923076922,70.4613846153846,163522694,-482457299.0931494,27.24246214485344,20.660032581004128,19.088081129247623,78.57142857142857,42.857142857142854
2001-12-12,41.5,41.94,40.60001,41.56,43.88488785315726,38.66928567137792,38.25195103084709,40.13396408505886,40.73499950000013,36.979899899999864,36.966199400000136,40.27000050000002,40.27000050000002,42.79670857179159,37.743292428208456,76091120,60.174304532964236,61.42565795953482,NaN,NaN,NaN,NaN,NaN,NaN,-0.039692086180042496,1.2956418066933182,1.3353338928733607,74.15369230769237,69.58958974358974,239613814,-449522658.76837033,25.526668290601055,21.84987941484403,18.18758046995699,71.42857142857143,35.714285714285715
2001-12-13,40.71001,41,39.75999,39.75999,43.84384409342435,38.69088377689519,38.31108981395113,40.09834750552944,40.67789950000012,36.96099989999986,37.14139920000014,40.276000000000025,40.276000000000025,42.79725994694664,37.75474005305341,79566320,51.07116692650111,60.679792832664006,NaN,NaN,NaN,NaN,NaN,NaN,-0.18034527906310927,1.109902294044474,1.2902475731075833,46.46123076923083,63.23056410256411,160047494,-529088978.76837033,23.395088976731916,23.92225194384548,16.52723519388279,64.28571428571429,28.571428571428573
2001-12-14,39.87199,40.46001,39.57001,40.11,43.80669141587784,38.7189850882438,38.38163531144324,40.099457266907585,40.61769955000013,36.93569989999986,37.31759920000014,40.30750000000002,40.30750000000002,42.80381142289555,37.81118857710449,69999008,52.57358414204864,59.78196346949135,NaN,NaN,NaN,NaN,NaN,NaN,-0.24847609824675332,0.9796524502991417,1.228128548545895,51.84600000000002,57.486974358974386,230046502,-514146943.3303479,22.39913695101821,23.81258122611748,14.494242465041825,57.142857142857146,21.428571428571427
2001-12-17,40.02,41.24001,40.02,40.8,43.77677408835667,38.76019330431818,38.476473142367034,40.16617562244019,40.576699550000136,36.927199999999864,37.49839940000013,40.379000000000026,40.379000000000026,42.8455465169093,37.91245348309075,62448800,55.47608501795954,59.11569053055126,NaN,NaN,NaN,NaN,NaN,NaN,-0.24531607365418484,0.921483456478164,1.1667995301323488,62.4613846153846,53.58953846153846,292495302,-496743833.9197696,24.85505318038089,22.404563042501003,12.306528128759277,50,14.285714285714286
2001-12-18,41.16,41.5,40.16,41.25999,43.75173146061182,38.809694228985144,38.585630666195776,40.27034842030303,40.54574950000013,36.93369989999986,37.68639920000014,40.41749900000003,40.41749900000003,42.913633423478124,37.92136457652193,50841200,57.35002144957881,59.230865247302965,NaN,NaN,NaN,NaN,NaN,NaN,-0.21175755892718162,0.9021025814733719,1.1138601404005535,69.5381538461539,61.281846153846146,343336502,-464115165.8779783,24.49861105658616,20.940011072597358,10.826121775368678,42.857142857142854,7.142857142857143
2001-12-19,40.56,41.32001,40.32001,40.50999,43.719475326675386,38.843363452173556,38.661095738109665,40.29317142789322,40.504299450000126,36.937299899999864,37.87479900000014,40.511998500000026,40.511998500000026,42.86794349598105,38.156053504019,79590688,53.40337882773908,58.713624831507836,NaN,NaN,NaN,NaN,NaN,NaN,-0.2376411490271262,0.8168087041166459,1.054449853143772,43.124701823537954,58.37474676169213,263745814,-513464576.0654986,23.27581751119111,19.89483711065598,11.001508128881923,35.714285714285715,0
2001-12-20,40.10001,40.3,38.67999,38.78999,43.67042572143484,38.842306552130516,38.666150415046545,40.15001129190339,40.46474940000012,36.920199799999864,38.00059880000014,40.51949800000003,40.51949800000003,42.85240151967273,38.18659448032732,83034816,45.645483805051256,57.76780186704879,NaN,NaN,45.645483805051256,NaN,NaN,NaN,-0.3607865399386636,0.6034666782204425,0.9642532181591061,7.291443142826897,39.98476627083956,180710998,-585223128.6350253,21.191302185871542,26.13909508040882,11.337375709226412,28.571428571428573,14.285714285714286
2001-12-21,39.422,39.71001,39.14999,39.48,43.628729943112106,38.854934145157635,38.69806608504472,40.086200692674495,40.42439940000013,36.903999699999865,38.09619880000014,40.529498000000025,40.529498000000025,42.84269470415224,38.21630129584781,56203904,48.85535045989928,57.32917332067541,NaN,NaN,NaN,NaN,NaN,NaN,-0.3838147449636651,0.4844847869545248,0.8682995319181899,21.666621527871797,24.02758883141219,236914902,-575187075.6369185,20.21130384169213,24.93028451877058,12.048947723793999,21.428571428571427,7.142857142857143
2001-12-24,39.53999,39.63,39.14999,39.32001,43.58585710785726,38.8641435680258,38.722456042493945,40.01323015051502,40.373999500000124,36.87769979999987,38.19159900000014,40.48299850000002,40.48299850000002,42.85347916773984,38.1125178322602,13660398,48.145399600359646,56.316104377607694,NaN,NaN,NaN,NaN,NaN,NaN,-0.3962544837109817,0.3729814272794627,0.7692359109904444,14.03546475673367,14.331176475810755,223254504,-579170421.6256688,19.69943445593303,24.298902717607458,11.912082370267076,14.285714285714286,0
2001-12-26,39.37399,40.3,39.16,39.69,43.54709236051539,38.880497160738166,38.7603989427883,39.98244632665645,40.32534950000012,36.85759979999986,38.297399200000136,40.45749850000003,40.45749850000003,42.850473487359295,38.06452351264076,37693504,49.95651262659262,55.00172603872254,NaN,NaN,NaN,NaN,NaN,NaN,-0.36668023567478825,0.3108856163969591,0.6775658520717474,22.149244959451952,19.28377708135244,260948008,-581815579.8011073,22.076370961269767,22.82070306938429,9.937590674261555,7.142857142857143,78.57142857142857
2001-12-27,39.85001,40.202,39.60001,40.00999,43.51189731215206,38.902863355575036,38.80940251365934,39.98506953364155,40.28289945000013,36.840099799999855,38.39839880000013,40.52049800000003,40.52049800000003,42.793688728500165,38.2473072714999,34249808,51.53315823934101,53.78845475000743,NaN,NaN,NaN,NaN,NaN,NaN,-0.31467791038205317,0.28421846409418094,0.5988963744762341,33.928398324498474,23.371036013561366,295197816,-569414326.2092532,21.338173112131457,22.057615968193698,7.922480880116615,0,71.42857142857143
2001-12-28,40.29201,40.802,40.23,40.33,43.4802366423794,38.93112348714781,38.869033787633484,40.017920054247114,40.25904940000012,36.81239969999986,38.55599880000013,40.53949800000003,40.53949800000003,42.79961224316118,38.27938375683888,38242896,53.12372336246463,53.16537219454307,NaN,NaN,NaN,NaN,NaN,NaN,-0.2506256576267626,0.28561430244278085,0.5362399600695434,46.08966480446925,34.05576936280656,333440712,-594285580.2512112,23.79975396170116,21.0598549345128,7.199784641005912,0,64.28571428571429
2001-12-31,40.31,40.45,38.91,38.91,43.43476165091294,38.93070520027359,38.870640305765505,39.912403858604534,40.24209940000012,36.762399699999854,38.667598800000135,40.50249850000004,40.50249850000004,42.842466104503394,38.16253089549668,46173008,45.921991803769714,52.29701331555297,NaN,NaN,45.921991803769714,NaN,NaN,NaN,-0.2928506153638746,0.17017669086470022,0.4630273062285748,6.424860335195523,28.814307821387747,287267704,-640458588.2512112,21.740489930212174,26.65405326090858,6.961506183812456,7.142857142857143,57.142857142857146
2002-01-02,39.57001,40.14999,38.92999,40.11,43.40167944543122,38.9540575725454,38.91924264671588,39.93122253873744,40.220399400000126,36.73169979999986,38.79879880000013,40.55949850000003,40.55949850000003,42.80082691728401,38.31817008271605,61704304,51.86111135540897,51.79223372497706,NaN,NaN,NaN,NaN,NaN,NaN,-0.23160482265561733,0.17352127790905314,0.40512610056467047,43.865202867475936,32.12657600238024,348972008,-582799456.5740967,20.223190207759778,24.793828963074034,6.705208083113084,0,50
2002-01-03,40.31,41.55,40.25999,41.5,43.38275726189459,39.004472274079156,39.02044881743291,40.08062991600054,40.20914940000012,36.72169979999986,38.93979880000013,40.592998500000036,40.592998500000036,42.86925386267893,38.31674313732114,85762816,57.66147640816573,51.61274600177716,NaN,NaN,NaN,NaN,NaN,NaN,-0.09606294342235489,0.2850474212867269,0.3811103647090818,98.25784579147816,49.51596966471654,434734824,-503684869.34751666,26.404457417379472,22.803467581048093,6.673574361424292,0,42.857142857142854
2002-01-04,41.95,42.28999,40.92999,41.67,43.36571490107972,39.05725500132511,39.124352785376715,40.23199849542906,40.206749450000125,36.715599799999865,39.08059880000013,40.53399800000003,40.53399800000003,42.62698163684464,38.441014363155425,86868368,58.322893827308654,52.13072649469199,NaN,NaN,NaN,NaN,58.322893827308654,NaN,0.0013023512306903906,0.3827383037474448,0.3814359525167544,82.82576177285318,74.98293681060242,521603192,-496018735.87151647,28.518545825859043,21.082137798313596,7.664892253151827,100,35.714285714285715
2002-01-07,42.118,42.22,40.11,41.21001,43.34426510106898,39.09988381318006,39.20614326438155,40.32514244824534,40.20729945000012,36.72269989999986,39.197199000000126,40.44899850000003,40.44899850000003,42.26943860836018,38.62855839163988,75096192,55.78350127936328,52.360006290214464,NaN,NaN,NaN,NaN,NaN,NaN,0.029427794287589903,0.41822069537624174,0.38879290108865183,70.08365650969517,83.72242135800884,446507000,-492814868.95026547,25.324557747929667,23.073436398147418,7.778652433921655,92.85714285714286,28.571428571428573
2002-01-08,41.108,41.77,40.84,41.49001,43.32581480155585,39.14721304460223,39.295706665778354,40.43608221507912,40.19844955000013,36.73089999999986,39.29099920000013,40.43699900000003,40.43699900000003,42.226405118283836,38.64759288171622,66932320,57.01050929762224,52.46960802447608,NaN,NaN,NaN,NaN,NaN,NaN,0.05983801871534339,0.46359042448283105,0.40375240576748767,77.83988919667581,76.91643582640806,513439320,-466184442.01865333,24.046241539249973,21.908750798056214,7.740516912016049,85.71428571428571,21.428571428571427
2002-01-09,42.03999,42.60001,40.89999,41.11,43.30376689308266,39.18608011302595,39.366855423983125,40.50026486126206,40.20224950000012,36.73919999999986,39.39299940000013,40.442499000000026,40.442499000000026,42.23945345132964,38.645544548670415,85104368,54.78836100995646,52.28663227878877,NaN,NaN,NaN,NaN,NaN,NaN,0.047829466382828145,0.4635392387460229,0.41570977236319473,61.98973474625135,69.97109348420744,428334952,-530262271.12654644,26.285801007874987,19.928472603783412,8.163698167516943,100,14.285714285714286
2002-01-10,41.174,41.53999,40.67999,41.38,43.28462493394751,39.22952407118385,39.44580227010143,40.58404916018949,40.20739945000012,36.74199989999987,39.53979960000013,40.449999000000034,40.449999000000034,42.26123348513737,38.6387645148627,75530816,56.09771964614835,52.479085194389434,NaN,NaN,NaN,NaN,NaN,NaN,0.051236261351032375,0.4797550990519852,0.42851883770095284,68.87745470686387,69.56902621659701,503865768,-482834188.2703603,25.05217604583507,20.19377121898228,8.371277057273392,92.85714285714286,7.142857142857143
2002-01-11,41.35699,41.60001,40.47,40.85001,43.26039990972913,39.26161290145744,39.50086923990138,40.60937876398096,40.19764950000012,36.744499899999866,39.689199800000125,40.414499500000026,40.414499500000026,42.164102545886614,38.66489645411344,60821808,52.861510863409684,52.9945156985579,NaN,NaN,NaN,NaN,NaN,NaN,0.012956236859591075,0.44471413377544167,0.4317578969158506,52.57465426922963,61.147281240781616,443043960,-502748579.06506133,23.49207802360874,20.09346346052006,8.181551437262565,85.71428571428571,0
2002-01-14,40.49001,40.67999,39.7,39.96001,43.22756020913481,39.27544254697313,39.518874759905245,40.5475341197923,40.18344955000012,36.75309989999987,39.81040020000013,40.42450050000003,40.42450050000003,42.16126367964603,38.68773732035403,71298880,47.867608266269634,52.92396268472721,NaN,NaN,NaN,NaN,NaN,NaN,-0.07245010335825797,0.3411952677180281,0.4136453710762861,28.455478440437833,49.969195805510445,371745080,-536213559.15016484,21.991154790336022,23.087535717815545,7.608581222620797,78.57142857142857,35.714285714285715
2002-01-15,40.036,40.75,39.56,40.34,43.198828266755356,39.29652289257763,39.55107574971288,40.52776896552637,40.176099550000124,36.76089989999987,39.91040020000013,40.43600050000002,40.43600050000002,42.16731886938722,38.70468213061282,66891008,50.03785166798617,53.05913783241482,NaN,NaN,NaN,NaN,NaN,NaN,-0.10170424049096105,0.28651507046258473,0.3882193109535458,38.75328251142968,39.92780507369904,438636088,-515415514.6459629,20.529498015768713,22.334956278760824,7.162744462283446,71.42857142857143,28.571428571428573
2002-01-16,39.53799,39.94,38.77,38.78,43.15485982629013,39.28629471648698,39.520837485018255,40.36131477833338,40.15374955000012,36.77109999999987,39.97400000000013,40.33500050000003,40.33500050000003,42.20010845938868,38.469892540611376,90940816,42.259882855301186,52.50937856303687,NaN,NaN,NaN,NaN,NaN,NaN,-0.21780353946306896,0.1159648866247096,0.33376842608777857,0.2610959240314784,22.489952291966322,347695272,-604801786.7827153,18.758072288253295,24.749565660998584,8.027977797288965,64.28571428571429,100
2002-01-17,39.48,39.97701,39.00999,39.64999,43.11998549966037,39.29349660328921,39.525902289527345,40.29356956134925,40.15349950000012,36.78479989999987,40.03180000000013,40.25450050000003,40.25450050000003,42.091735776761354,38.4172652232387,74828880,47.19000847832945,52.19915358010747,NaN,NaN,NaN,NaN,NaN,NaN,-0.22667688308479167,0.050422322231788996,0.27709920531658067,22.976180218850622,20.66351955143726,422524152,-580583112.0268672,17.72158656963416,23.112118893536085,8.85250065829531,57.142857142857146,92.85714285714286
2002-01-18,38.83,39.45,38.22,38.59,43.07491101707669,39.279565977481504,39.48920023895764,40.13132484122075,40.15169950000012,36.80379989999987,40.039800000000135,40.15850100000003,40.15850100000003,42.12817794106201,38.188824058938046,81983504,42.43573416807907,51.435725780508506,NaN,NaN,NaN,NaN,NaN,NaN,-0.29052809221593584,-0.08606090995333915,0.2044671822625967,8.447469298015408,10.561581813632502,340540648,-613243207.1162976,16.331488963564148,25.63260799455125,9.999411306082745,50,100
2002-01-22,39,39.02,37.33,37.39999,43.01844414128488,39.242346651194744,39.40727042566519,39.871197713485444,40.14294950000012,36.80089979999987,40.02499980000013,40.08900100000003,40.08900100000003,42.32677184799818,37.85123015200188,81764816,37.82805985323958,50.85758778404206,NaN,NaN,37.82805985323958,NaN,NaN,NaN,-0.39312657681798513,-0.28694103875988475,0.1061855380581004,1.3280809713834363,10.917243496083154,258775832,-688235574.0371966,14.849040903968309,28.086195661268974,11.476367050820455,42.857142857142854,100
2002-01-23,37.64999,38.69,37.35001,38.42999,42.97278788117259,39.22626038087406,39.368945703090084,39.73393983601064,40.14809950000013,36.81199959999987,40.03859960000013,40.03650050000003,40.03650050000003,42.37591927699861,37.69708172300145,74961008,43.54213326186495,50.26337506307463,NaN,NaN,NaN,NaN,NaN,NaN,-0.3720608540851864,-0.35889052954838263,0.013170324536803793,20.87263591530184,10.216062061566895,333736840,-642365248.3409154,13.78089480683581,26.065852362809427,12.953322795558163,35.714285714285715,92.85714285714286
2002-01-24,38.94,39.51401,38.35001,38.94,42.93266063857386,39.22059185848051,39.3521243029689,39.65832651829534,40.16949950000012,36.80839959999987,40.06279960000013,40.01750000000003,40.01750000000003,42.385880687338194,37.64911931266186,77212624,46.179816963926086,49.44325653134323,NaN,NaN,NaN,NaN,NaN,NaN,-0.30692564702573755,-0.37048673424536815,-0.0635610872196306,30.550226659911456,17.583647848865578,410949464,-641305233.1076509,17.37539444925813,24.42240148693633,13.634883597033012,28.571428571428573,85.71428571428571
2002-01-25,38.472,39.14999,38.36,38.83,42.8918381446577,39.21285736623337,39.33164884010738,39.57943827845769,40.193399500000126,36.80319949999987,40.07939960000013,39.97450000000003,39.97450000000003,42.39574164018313,37.55325835981692,58828192,45.684068132572634,48.54048326743351,NaN,NaN,NaN,NaN,NaN,NaN,-0.25645108025236285,-0.38412493753508414,-0.1276738572827213,28.462944093085216,26.628602222766173,352121272,-630134437.1710951,16.609962231808495,23.346529915779616,13.768255455920755,21.428571428571427,78.57142857142857
2002-01-28,39.15401,39.39,38.42,39.05,42.85361089943722,39.20963246789212,39.32060378755415,39.52901558527124,40.202099500000124,36.81249949999987,40.07319960000013,39.92650050000003,39.92650050000003,42.38086058241146,37.472140417588605,47785392,46.91157522513679,47.90677426356019,NaN,NaN,NaN,NaN,46.91157522513679,NaN,-0.19616714603557855,-0.37288278982719447,-0.17671564379161592,32.63750922673769,30.550226659911456,399906664,-615848082.8618171,17.05766188933044,22.06141978382937,14.349671348564755,14.285714285714286,71.42857142857143
2002-01-29,39.132,39.408,37.515,37.98,42.8051172586468,39.18528331011208,39.26803109000301,39.38149029143588,40.210499500000125,36.81669949999987,40.03999960000013,39.80900050000003,39.80900050000003,42.39625172168952,37.22174927831055,83329312,41.94637270778294,46.830764507143094,NaN,NaN,NaN,NaN,NaN,NaN,-0.21477275550885316,-0.4451815881776824,-0.23040883266882922,12.3339424403369,24.478131920053272,316577352,-658239064.0852723,15.288942199051602,24.731069082550963,15.702688767476142,7.142857142857143,64.28571428571429
2002-01-30,38.00101,38.85001,36.85001,38.27,42.75999171378464,39.167158888129656,39.22889261588524,39.27563407320389,40.21659950000012,36.837699499999864,40.01579960000013,39.77700050000003,39.77700050000003,42.4230989509529,37.13090204904716,101371808,43.68606224191837,46.037743166568944,NaN,NaN,NaN,NaN,NaN,NaN,-0.1945679324838291,-0.4736187482736156,-0.2790508157897865,29.89452631578959,24.955325994288064,417949160,-615663918.4433517,13.675522010858888,25.63000690539067,16.89254996206025,0,100
2002-01-31,38.578,38.75,38.02,38.50999,42.71770313951813,39.154145642820154,39.200700356438766,39.20271559004161,40.210149450000124,36.85649939999987,39.99859940000013,39.697000000000024,39.697000000000024,42.39424342248868,36.99975657751137,69653008,45.15090723211062,45.25582799413768,NaN,NaN,NaN,NaN,NaN,NaN,-0.15384471415410494,-0.47135670848241773,-0.3175119943283128,34.94694736842115,25.725138708182545,487602168,-591812056.8819269,13.13084352449815,24.609196631709082,18.298013522388803,7.142857142857143,92.85714285714286
2002-02-01,38.401,38.88,37.7,38.14,42.6721538545478,39.13406355088312,39.1591042640294,39.10150458146622,40.195849450000125,36.883199399999874,39.95159920000013,39.52900000000003,39.52900000000003,42.17416806274292,36.88383193725714,61202192,43.28168285602042,44.57155456503845,NaN,NaN,NaN,NaN,NaN,NaN,-0.1409725969038852,-0.49372774045816925,-0.35275514355428406,33.07675147885001,32.63940838768692,426399976,-607371936.203961,12.279470694061782,24.77190326685458,20.149366597070088,0,85.71428571428571
2002-02-04,37.961,38.07001,36.61,36.92,42.61491849281101,39.090220708291376,39.07129625367531,38.8937422403742,40.16644945000013,36.89909939999987,39.91759920000013,39.29150000000003,39.29150000000003,41.97774069661613,36.605259303383924,82754624,37.734326275987854,43.84774870858975,NaN,NaN,NaN,NaN,NaN,NaN,-0.20015613525871967,-0.6029503126276836,-0.40279417736896395,7.487922705314063,25.17054051752841,343645352,-654984426.3281655,11.26003247695592,28.629823571792244,23.08595463115672,7.142857142857143,100
2002-02-05,36.59,37.33,36.19,36.31,42.552182985419854,39.03516683287967,38.9630101260802,38.647671550814756,40.14674945000013,36.923199499999875,39.870999200000135,39.046499500000024,39.046499500000024,41.87802213387332,36.214976866126726,86839312,35.298255643398875,42.79492042111922,NaN,NaN,NaN,NaN,NaN,NaN,-0.2620152924716053,-0.7303132929584706,-0.46829800048686526,3.1687267791741895,14.577800321112756,256806040,-723541777.9071122,10.556780655717276,29.1427263602875,26.129136639881576,0,100
2002-02-06,36.84,36.89,35.7,36.06,42.48758414974404,38.97625263816918,38.849166591724114,38.40122664121335,40.120799450000135,36.94679949999988,39.80659920000013,38.77499900000002,38.77499900000002,41.65811493247895,35.89188306752109,98524320,34.320343675596305,42.22781047971173,NaN,NaN,NaN,NaN,NaN,NaN,-0.2987371716847088,-0.8417194650927513,-0.5429822934080425,8.417095120189096,6.357914868225784,158281720,-762454744.6298013,9.864215604557296,29.93218585164872,28.7473841521923,7.142857142857143,100
2002-02-07,35.996,36.55,35,35.19,42.414971372134644,38.90127733840345,38.705669862636896,38.09539553252636,40.068999450000135,36.957699399999875,39.70539920000013,38.47899900000002,38.47899900000002,41.551765036019475,35.40623296398057,97704880,31.092139116404127,41.07796266814564,NaN,NaN,31.092139116404127,NaN,NaN,NaN,-0.35666453957353683,-0.9888129678749635,-0.6321484283014267,4.209117835361414,5.2649799115749,60576840,-836206170.1781886,9.032970525640987,31.215523387571615,31.741156402591393,0,100
2002-02-08,35.46001,36.24001,34.97,36.17,42.352832353506436,38.84719263863309,38.606231828808,37.912024529428614,40.00834945000013,37.00739939999987,39.624799200000126,38.21849900000002,38.21849900000002,41.14315009510754,35.2938479048925,80470368,38.14952645434047,40.771804974307166,NaN,NaN,NaN,NaN,NaN,NaN,-0.3059708599063701,-1.0146120031843893,-0.7086411432780192,26.40839258716426,13.011535180904923,141047208,-764607748.798577,8.407785884606863,29.2185431861823,34.10862502162776,21.428571428571427,100
2002-02-11,36.14,39.17,35.98,36.63,42.29588874799891,38.80328783390768,38.52873254140376,37.789926955197316,39.94949950000013,37.06869939999987,39.582399200000125,38.007498500000025,38.007498500000025,40.74523387254575,35.269763127454304,57618800,41.19400706442401,41.01222977510605,NaN,NaN,NaN,NaN,NaN,NaN,-0.22234087412989223,-0.9865672359403845,-0.7642263618104923,36.53160974557723,22.3830400560343,198666008,-798745533.1245956,21.56601559720269,24.61094835957288,32.37744901936193,14.285714285714286,92.85714285714286
2002-02-12,36.312,36.98,36.03999,36.33,42.23652667090439,38.75431183719664,38.44250773585852,37.65088629279757,39.905399550000126,37.13229939999987,39.509999200000124,37.82599800000003,37.82599800000003,40.502519110707205,35.14947688929285,51465392,39.81745761759276,40.7461815148009,NaN,NaN,NaN,NaN,NaN,NaN,-0.17044573648713113,-0.9772835324194062,-0.8068377959322751,29.929511598786082,30.95650464384252,147200616,-818454926.0736922,20.53822395290477,23.438041525289705,30.6462730170961,7.142857142857143,85.71428571428571
2002-02-13,36.722,37.14999,36.61,36.95,42.183924415472504,38.718582889925415,38.383978020726815,37.584135217293046,39.86864955000013,37.21209939999987,39.45599940000013,37.65649800000003,37.65649800000003,40.09335612965404,35.219639870346015,60978096,43.98354626245366,40.589305036124294,NaN,NaN,NaN,NaN,43.98354626245366,NaN,-0.08206108469295781,-0.9094141517984724,-0.8273530671055146,44.61469130238853,37.02527088225061,208178712,-802644368.0615805,20.546473748586752,22.433665863152967,29.75563654304955,0,78.57142857142857
2002-02-14,37.14999,37.57001,36,36.88,42.13114904815437,38.68217530794669,38.32499849050223,37.517074720408,39.82754950000013,37.29899939999987,39.41419940000012,37.56149800000003,37.56149800000003,39.963646210260976,35.15934978973908,77498496,43.61643377001727,40.44161686737034,NaN,NaN,NaN,NaN,NaN,NaN,-0.01928593606673268,-0.8514604871889304,-0.8321745511221977,43.037404236142464,39.19386904577235,130680216,-793266122.5376412,18.878388202104063,23.766706307988294,29.370138943929458,14.285714285714286,71.42857142857143
2002-02-15,36.838,36.91,35.64,35.78,42.067953535237415,38.62470648996755,38.22519462812959,37.35163903275009,39.78669950000013,37.36069939999987,39.31319940000012,37.36799850000003,37.36799850000003,39.688113810937665,35.04788318906239,79829632,38.21812603950031,39.82065621125345,NaN,NaN,NaN,NaN,NaN,NaN,-0.04154134209240623,-0.8841012287377055,-0.8425598866452992,18.25146462370441,35.30118672074513,50850584,-855495520.7108694,17.63142289787882,24.069210407961055,29.55921126260708,7.142857142857143,64.28571428571429
2002-02-19,35.375,35.46001,34.32001,34.67999,41.99444146025993,38.54659329214641,38.086166995653926,37.097196267726275,39.73434950000013,37.41049929999988,39.14979900000012,37.172498000000026,37.172498000000026,39.697666049865475,34.647329950134576,72417120,33.72317859190363,39.233285202976354,NaN,NaN,NaN,NaN,NaN,NaN,-0.11583154435418075,-0.9873493170880252,-0.8715177727338445,7.422283344913973,22.90371740158695,-21566536,-882178053.2413963,16.2986052282213,29.084198001752842,29.886300991354428,0,100
2002-02-20,34.908,35.17,33.92999,35.14999,41.926337465630475,38.4793338210148,37.97102279974593,36.91174805175235,39.67934950000013,37.475299199999874,38.99459880000012,37.05999800000002,37.05999800000002,39.730879105564725,34.38911689443532,106536320,37.12579985403517,38.764695032413265,NaN,NaN,NaN,NaN,NaN,NaN,-0.1183833597636531,-1.0194969724384109,-0.9011136126747578,23.282398316033838,16.318715428217406,84969784,-779080079.3244116,15.244562232435227,29.237388398614115,29.960804890427507,57.142857142857146,100
2002-02-21,34.78999,34.95,33.48,33.48,41.84229430676848,38.38033711168777,37.79490425857942,36.58491490396641,39.60649950000013,37.52529919999987,38.82959880000013,36.812498500000025,36.812498500000025,39.82521876415474,33.79977823584531,109293184,31.02995645145559,37.756055690937906,NaN,NaN,31.02995645145559,NaN,NaN,NaN,-0.21213651648694587,-1.16628425828344,-0.9541477417964942,0,10.234893886982602,-24323400,-888373263.3244116,13.937307743090866,29.040868571842893,30.298529033321042,50,100
2002-02-22,33.619,34.2,33.09,33.64999,41.76077884102949,38.28666687185237,37.632358601380226,36.3053982464458,39.52984945000013,37.57199909999987,38.68259860000013,36.54799800000003,36.54799800000003,39.69310226028477,33.40289373971529,99812688,32.24940997020981,36.96803619909429,NaN,NaN,NaN,NaN,NaN,NaN,-0.2402314845838498,-1.2544370975263064,-1.0142056129424566,9.21036184210525,10.830920052713028,75489288,-887475848.3458171,13.131286911078913,29.393311518242065,30.621738839394144,42.857142857142854,100
2002-02-25,34.008,35.25,33.955,35.00999,41.69360681276054,38.22178218132064,37.52952061701237,36.18202603249858,39.47089940000013,37.63479899999987,38.55819840000012,36.35699750000003,36.35699750000003,39.38641050255885,33.3275844974412,88992320,41.20591554823677,37.21600686139779,NaN,NaN,NaN,NaN,NaN,NaN,-0.149209193141,-1.2007171043687066,-1.0515079112277066,31.578782894736825,13.596381578947359,164481608,-831470473.0920717,17.455619983042165,26.971927037069776,29.04141405578014,35.714285714285715,92.85714285714286
2002-02-26,35.23199,35.42999,34.37,34.88,41.625809730046505,38.15560827674003,37.425617847717774,36.058023553213,39.40429940000013,37.69539889999987,38.42459840000012,36.14849750000003,36.14849750000003,38.97503353728503,33.32196146271504,94679808,40.652729839797274,37.598469303997675,NaN,NaN,NaN,NaN,NaN,NaN,-0.08304565300667477,-1.15531497748605,-1.0722693244793753,29.440789473684205,23.409978070175427,69801800,-835042436.5274993,17.42923738937428,25.47469866835218,27.036821411787635,28.571428571428573,85.71428571428571
2002-02-27,35.397,35.50999,34.06,34.39999,41.55391102626495,38.081239597992706,37.306965775258256,35.90011559576414,39.34029935000013,37.72939879999987,38.31739840000012,35.96949700000003,35.96949700000003,38.762652324732294,33.17634167526777,95150880,38.592393500371884,37.903615720053075,NaN,NaN,NaN,NaN,NaN,NaN,-0.058079679550243624,-1.1448689239171799,-1.0867892443669362,21.545888157894726,27.52182017543858,-25349080,-885571839.563934,16.111693236817104,25.16512340967139,25.001596798291395,21.428571428571427,78.57142857142857
2002-02-28,34.51401,34.97,33.75,33.78,41.4765586777449,37.99606653664632,37.168653391914795,35.698199824738985,39.26819935000014,37.75419879999987,38.190798400000126,35.74499700000003,35.74499700000003,38.48368870957242,33.00630529042765,95705120,36.05092952248893,38.25781503477342,NaN,NaN,NaN,NaN,NaN,NaN,-0.06904512158410858,-1.1730956463470719,-1.1040505247629633,11.348684210526281,20.7784539473684,-121054200,-976570150.383606,15.078849753663109,25.18081076593987,22.857169835823697,14.285714285714286,71.42857142857143
2002-03-01,34.15401,35.75,34.09,35.74001,41.41947859139918,37.95139214978203,37.112628160859316,35.702181746192416,39.21414940000014,37.79399899999987,38.08959860000013,35.60649800000003,35.60649800000003,38.03439258257587,33.17860341742419,85998320,47.762671333640995,38.94446824043774,NaN,NaN,NaN,NaN,NaN,NaN,0.06285008829891181,-1.0254879143893234,-1.0883380026882352,43.58569078947361,25.493421052631536,-35055880,-891606918.5966182,17.537614373161993,22.655273833097276,19.816006950529278,7.142857142857143,64.28571428571429
2002-03-04,35.702,37.23,32.74001,37.14999,41.37699611785292,37.9355228002814,37.1140933310217,35.84006824655504,39.17104935000014,37.84689889999987,38.00739860000012,35.55699750000003,35.55699750000003,37.810354537868605,33.303640462131455,105721312,54.25329489099898,39.877274513764526,NaN,NaN,NaN,NaN,NaN,NaN,0.24212854458998234,-0.7856773219507573,-1.0278058665407397,91.303933747412,48.74610291580397,70665432,-789653437.7824869,20.584680437378893,18.17981716362595,19.788130256904235,0,100
2002-03-05,36.938,37.87,36.81,37.42,41.33762302215289,37.9253144279986,37.126089670981635,35.99053793735932,39.13039935000014,37.91019889999987,37.94559880000013,35.58199750000003,35.58199750000003,37.905296542334426,33.25869845766563,91438192,55.39624805365543,40.99004525919757,NaN,NaN,NaN,NaN,NaN,NaN,0.3684057466883027,-0.5672986831803613,-0.935704429868664,91.22805307612694,75.37255920433752,162103624,-775851446.5372036,22.487661005517758,17.310415040238922,20.246325477716947,100,92.85714285714286
2002-03-06,37.08,37.95,36.60001,37.60001,41.30043284282799,37.91887275615704,37.144674781923534,36.14382099094415,39.094299350000135,37.96119899999987,37.92179920000013,35.64649800000003,35.64649800000003,38.11420028028848,33.17879571971158,86833504,56.182243834548686,41.861380800061504,NaN,NaN,NaN,NaN,NaN,NaN,0.4482598689052447,-0.37537959373710805,-0.8236394626423528,93.28232875686892,91.9381051934693,248937128,-734041769.4766036,21.103474775365232,17.202359419479073,20.660131304469026,100,85.71428571428571
2002-03-07,38.12,38.33,37.00999,37.67999,41.26440853593418,37.91414240454997,37.16566753557359,36.29012280133042,39.05694935000014,37.99099889999987,37.88579900000013,35.727497500000034,35.727497500000034,38.34591916775153,33.109075832248536,85502192,56.548615512101215,42.785108067353214,NaN,NaN,NaN,NaN,NaN,NaN,0.4874254631511845,-0.21435763370337213,-0.7017830968545566,88.37189333075726,90.96075838791769,334439320,-732746939.2722268,21.571215222705202,16.155242734697104,20.866781921856962,100,78.57142857142857
2002-03-08,38.231,39.03,38.13,38.67,41.23859352562638,37.929109881687594,37.224660965551095,36.51677777263228,39.01454940000014,38.03219889999988,37.872798800000126,35.901497500000026,35.901497500000026,38.80130982326379,33.00168517673626,84446880,60.90598961297902,44.405669751173114,NaN,NaN,NaN,NaN,60.90598961297902,NaN,0.5560001985416715,-0.006782848677467257,-0.5627830472191387,94.27662047157469,91.97694751973363,418886200,-715857563.2722268,23.473735100135716,15.140202639420124,21.305607972149854,100,71.42857142857143
2002-03-11,38.35001,39.19,38.06,38.53,41.21164234626691,37.941008695911606,37.27585073160792,36.708513222857775,38.96769945000015,38.07349899999988,37.84959880000012,36.01949750000003,36.01949750000003,39.13728547710042,32.90170952289964,71055184,59.98982822376832,46.28185901059202,NaN,NaN,NaN,NaN,NaN,NaN,0.5660313776979111,0.1447561749032502,-0.4212752027946609,89.76742599600934,90.80531326611377,347831016,-727804895.0952356,22.97447464896422,14.328677532868028,20.948775976950024,100,64.28571428571429
2002-03-12,37.57899,38,37.32001,38,41.17968570600555,37.94217684054702,37.3042487421331,36.831511963537984,38.91749950000015,38.10389889999988,37.80939900000013,36.08799750000003,36.08799750000003,39.31472467163247,32.86127032836759,82664816,56.52347096548108,47.66740694712387,NaN,NaN,NaN,NaN,NaN,NaN,0.5126637501015411,0.21955448483226547,-0.2931092652692756,81.55035899280469,88.53146848679624,265166200,-645140079.0952356,21.63708764766146,17.0546242432503,19.547791317444315,92.85714285714286,57.142857142857146
2002-03-13,37.41,37.66,36,37.08,41.13889281340848,37.92510403182332,37.295454673814156,36.85517749082008,38.847649500000145,38.15019889999988,37.74439900000013,36.12549750000003,36.12549750000003,39.37991664788975,32.87107835211031,71383008,51.01317760982677,49.094779887007526,NaN,NaN,NaN,NaN,NaN,NaN,0.39629924461946997,0.20226479050506185,-0.19403445411440812,67.28677098724185,79.53485199201863,193783192,-623639173.0711391,19.605556096277773,21.65020995834955,17.39162332192235,85.71428571428571,50
2002-03-14,37.069,37.39999,36.72,36.86,41.09631676551387,37.90401286287632,37.27837801993909,36.85563677740865,38.77744955000015,38.18549889999988,37.70339900000013,36.12099750000003,36.12099750000003,39.371089944862305,32.870905055137754,70726192,49.763841388461195,50.345810702596914,NaN,NaN,NaN,NaN,NaN,NaN,0.2903186547223523,0.16886386428853228,-0.12145479043382003,63.87591298591163,70.9043476553194,123057000,-665242387.1449932,18.953954971107297,20.930653670338113,15.01409404998351,78.57142857142857,42.857142857142854
2002-03-15,36.899,37.33,36.59599,37.23,41.057845951926666,37.890666073512435,37.276480842686574,36.89129041765544,38.72034960000015,38.22229889999987,37.64579900000013,36.13849750000003,36.13849750000003,39.40845717102836,32.8685378289717,63973296,51.89751597972597,51.109496447703286,NaN,NaN,NaN,NaN,NaN,NaN,0.2333929063039224,0.17028634244608298,-0.06310656385783943,69.6123559881488,66.9250133204341,187030296,-618700269.4668148,18.2488992078878,20.780529016685552,13.947424726523346,71.42857142857143,35.714285714285715
2002-03-18,37.63499,37.94,37.05,37.44,41.02184748474332,37.88174199284882,37.28289335865965,36.94354847311683,38.65804965000015,38.25219889999987,37.564599000000136,36.22149750000003,36.22149750000003,39.534827835199316,32.90816716480074,78950368,53.11468490348202,51.99963609510934,NaN,NaN,NaN,NaN,NaN,NaN,0.19945514811674026,0.18621237128808588,-0.013242776828654365,72.86817498941859,68.78548132115968,265980664,-628458180.1185001,20.57850758678674,19.81791052735033,12.742465043629485,64.28571428571429,28.571428571428573
2002-03-19,37.60899,37.88,37.22,37.38,40.98561019633791,37.87180650784192,37.28670146224162,36.98511528520094,38.59999960000014,38.27969889999987,37.47879900000013,36.35649800000003,36.35649800000003,39.6273440532621,33.08565194673796,58947600,52.704342507030134,53.00763245272778,NaN,NaN,NaN,NaN,NaN,NaN,0.1640195223598252,0.19178162612112715,0.02776210376130194,71.93794098905587,71.47282398887442,207033064,-658825125.573045,19.844376409565918,19.110913388508138,11.310278069299226,57.142857142857146,21.428571428571427
2002-03-20,36.879,37.08,36.03999,36.06,40.93659914960818,37.83592915125099,37.23859552254587,36.897009067562756,38.549699600000146,38.28649889999988,37.37579880000013,36.401998500000026,36.401998500000026,39.6294747003969,33.174522299603154,61823296,44.55003325895268,53.614711291046625,NaN,NaN,NaN,NaN,NaN,NaN,0.04871856620603899,0.08866031151885068,0.03994174531281169,51.472792981074456,65.4263029865163,145209768,-718269436.4614404,18.40846957041049,24.099942133714844,10.47435183939778,50,14.285714285714286
2002-03-21,36.14999,37.14,35.89999,37.02,40.897628013791184,37.81977213835493,37.230023149112704,36.908722489699635,38.51264965000014,38.28869889999987,37.28639860000013,36.578998500000026,36.578998500000026,39.52179593579615,33.6362010642039,92291872,50.54310664578476,53.81331381334261,NaN,NaN,NaN,NaN,NaN,NaN,0.03479706889257664,0.08343808142853248,0.048641012535955847,66.35653698687912,63.25575698566982,237501640,-643840363.3743521,17.170330856919755,23.238371401507887,10.637488909968516,42.857142857142854,7.142857142857143
2002-03-22,36.944,37.14,36.47,36.67999,40.85566146639027,37.797202195021164,37.208453221696516,36.886938443061574,38.47239960000014,38.295398899999874,37.19779840000013,36.730498500000024,36.730498500000024,39.3486026702209,34.11239432977915,58930192,48.5419961146874,53.40536390074892,NaN,NaN,NaN,NaN,NaN,NaN,0.0021051295287608726,0.05127242444690694,0.049167294918146066,23.708134625730473,47.179154864561355,178571448,-665831000.0965018,16.52364727758739,22.363148127069604,11.266981050671154,35.714285714285715,0
2002-03-25,36.69,36.901,35.52,35.56,40.80296831747097,37.752901161456386,37.14380799731626,36.760563353246184,38.41994960000014,38.310598999999876,37.08139840000013,36.75799900000003,36.75799900000003,39.31405607763191,34.20194192236814,87435184,42.56396271273866,52.48877209068343,NaN,NaN,NaN,NaN,NaN,NaN,-0.0904192932265264,-0.06385682161501194,0.026562471611514465,1.0899182561307685,30.384863289580125,91136264,-748201148.0936055,15.24881561318135,25.945126863685157,12.192477739150684,28.571428571428573,100
2002-03-26,35.427,36.42,35.39999,35.89,40.75408306058071,37.716012029546356,37.094639056245036,36.67765255769893,38.370249600000136,38.33569899999988,36.982198200000134,36.808499000000026,36.808499000000026,39.251557572387,34.36544042761305,92457504,44.724002605768376,51.6703262886277,NaN,NaN,NaN,NaN,NaN,NaN,-0.12285421607539461,-0.1270052984827288,-0.004151082407334184,12.9289896332727,12.575680838377982,183593768,-751825990.580405,14.367132624785416,25.12526822216176,13.410827639584578,21.428571428571427,100
2002-03-27,35.63699,36,35.39999,35.61,40.702898154505284,37.67430882104049,37.036417916784444,36.5759713617276,38.30904955000014,38.35279909999988,36.895198000000136,36.86899950000002,36.86899950000002,39.1231048205424,34.61489417945764,64537008,43.23815842877948,50.719579354104724,NaN,NaN,NaN,NaN,NaN,NaN,-0.1545746775775615,-0.19736942937928603,-0.042794751801724554,5.541146329429136,6.520018072944203,119056760,-771185694.7018701,13.859485197294507,24.237493457975646,14.331193874456156,14.285714285714286,92.85714285714286
2002-03-28,36.02,36.37,35.89999,36.06,40.65670016291817,37.64234230973276,36.99812701808702,36.526831232039264,38.251949550000134,38.359999099999875,36.809598000000136,36.98299950000003,36.98299950000003,38.78619645321837,35.17980254678168,59573392,46.324526063684985,49.67804624344086,NaN,NaN,NaN,NaN,NaN,NaN,-0.1372452879971754,-0.2143513617981938,-0.07710607380101842,17.414465924892035,11.961533962531291,178630152,-790196807.371983,15.460797784927232,23.12300359480425,14.208118035547527,7.142857142857143,85.71428571428571
2002-04-01,35.8,36.89999,35.3,36.75,40.61782752448117,37.624672164985576,36.98839654678949,36.548085400416475,38.19219955000014,38.37149899999988,36.76899800000013,37.03349900000003,37.03349900000003,38.74906643617798,35.31793156382207,70732688,50.746811679514366,49.01783077599415,NaN,NaN,NaN,NaN,50.746811679514366,NaN,-0.0744517881595761,-0.17017080900048853,-0.09571902084091244,53.70370370370375,25.553105319341643,249362840,-732725697.0982441,14.00117309176382,24.48027177003025,14.497720918003527,0,100
2002-04-02,35.98599,36.14999,35,35.09,40.56282426553111,37.57448063696606,36.91394962338598,36.409220124186334,38.13089950000013,38.35479909999987,36.67779820000013,36.93049950000003,36.93049950000003,38.841902043174976,35.01909695682509,77764000,41.819962112683704,47.96758014365149,NaN,NaN,NaN,NaN,NaN,NaN,-0.13625582310801115,-0.26603879972592637,-0.1297829766179152,3.061224489796037,24.72646470613061,171598840,-798317834.7342231,12.600018807492319,23.745986873117726,15.842203302379318,0,100
2002-04-03,35.3,35.45,34.3,35.03,40.50777128776463,37.52409488177861,36.84006924599829,36.27786582664478,38.07579950000013,38.323199099999876,36.606598200000136,36.81099950000002,36.81099950000002,38.877589978072194,34.74440902192785,85768496,41.53555703914898,47.29060724574593,NaN,NaN,NaN,NaN,NaN,NaN,-0.17049649267579725,-0.3429035924626618,-0.17240709978686453,20.05494505494516,25.606624416148318,85830344,-775197631.4646579,11.766682964916328,26.201253719272383,18.203756657717655,21.428571428571427,100
2002-04-04,34.508,35.16,34.28,34.75999,40.45057943415504,37.46936013164438,36.758497510861105,36.13330622410718,38.020599450000134,38.289398999999875,36.55379820000013,36.66899850000003,36.66899850000003,38.88416430599506,34.453832694005,90533808,40.21028765166546,46.608210550260516,NaN,NaN,NaN,NaN,NaN,NaN,-0.1986797779189901,-0.4207568221856022,-0.22207704426661207,13.114480874316975,12.076883473019391,-4703464,-766969342.8693845,11.158513346723858,24.964490322460023,20.57970705110116,14.285714285714286,100
2002-04-05,35.00999,35.175,34.17999,34.37,40.39007615620325,37.40798666369103,36.66483094180773,35.96537229800173,37.969699450000135,38.255598999999876,36.47259840000013,36.503499000000026,36.503499000000026,38.88048391119219,34.126514088807866,68433312,38.3090190998555,45.637603630269766,NaN,NaN,NaN,NaN,NaN,NaN,-0.228793009537617,-0.5080683061886333,-0.2792752966510163,5.053444006797877,12.740956645353338,-73136776,-809266206.767114,10.497820982324805,24.08147604500412,22.922289873481777,7.142857142857143,100
2002-04-08,33.479,34.8,33.425,34.8,40.33445350788282,37.35634336341992,36.5917003166388,35.8543844600968,37.932449450000135,38.22629899999988,36.38979840000014,36.309999000000026,36.309999000000026,38.577580248827864,34.04241775117219,74959872,41.58849432139446,44.814304302977796,NaN,NaN,NaN,NaN,NaN,NaN,-0.20568599709124452,-0.536382793015072,-0.33069679592382745,30.86419753086416,16.344040803993003,1823096,-734306334.767114,9.647707300948168,26.57783780805934,26.126040149080435,0,100
2002-04-09,34.78,34.98,33.498,33.59,40.26734451775463,37.281762306718534,36.4739865787314,35.63872879723044,37.88739940000014,38.182198999999876,36.28499840000014,36.062999000000026,36.062999000000026,38.38504265678928,33.74095534321077,80925008,35.81831365249229,43.60815938479652,NaN,NaN,NaN,NaN,NaN,NaN,-0.2546250431549541,-0.6489780998675201,-0.394353056712566,4.441453566621968,13.453031701428001,-79101912,-805183973.3528084,9.862338125762006,24.29427973918766,29.00957036732554,0,92.85714285714286
2002-04-10,33.75999,34.25,33.13,33.84,40.20339084096105,37.2136085976746,36.370692987408596,35.467421292732304,37.84644940000015,38.12699899999988,36.18079840000014,35.85499900000003,35.85499900000003,38.19097440227517,33.51902359772489,85758192,37.74035263780983,43.121753626143466,NaN,NaN,NaN,NaN,NaN,NaN,-0.25240156611360043,-0.7098550143545665,-0.4574534482409661,17.70573566084791,17.670462252778012,6656280,-782213029.0670937,9.217764510539865,24.853923463242808,31.331205429769494,7.142857142857143,100
2002-04-11,33.66,33.85001,32.88901,33,40.131715310205216,37.130170803661244,36.23850894868669,35.23242878866256,37.80234935000014,38.06059899999988,36.08119840000014,35.65099900000003,35.65099900000003,38.22401191252791,33.07798608747215,90671184,34.05058048131818,41.943716042967274,NaN,NaN,34.05058048131818,NaN,NaN,NaN,-0.2872129484499021,-0.8164696338033437,-0.5292566853534416,2.6109212207039065,8.252703482724595,-84014904,-851940207.4226398,8.692785833026834,24.866628502948316,33.70106139025605,0,100
2002-04-12,33.325,33.8,32.95,33.52,40.06592709816337,37.05868227289567,36.131900754620546,35.06934033259946,37.75609935000014,38.00099899999988,35.98619840000014,35.483999000000026,35.483999000000026,38.153218757164126,32.814779242835925,78359808,38.086021886825954,41.19686074097718,NaN,NaN,NaN,NaN,NaN,NaN,-0.2559655537757608,-0.8492136275731426,-0.5932480737973818,15.727606499517782,12.014754460356533,-5655096,-825205684.6932273,8.245472518270889,23.587041701189353,36.070917350742604,0,92.85714285714286
2002-04-15,33.80299,33.96001,33.2,33.78999,40.003479962858265,36.993955693234376,36.04006111718444,34.94749744378046,37.708299250000145,37.94519889999988,35.891798400000134,35.31199850000002,35.31199850000002,37.952192967089644,32.6718040329104,69329120,40.134291917839505,41.023312827055804,NaN,NaN,NaN,NaN,NaN,NaN,-0.20032349436283547,-0.8436524417509261,-0.6433289473880907,22.462839505557326,13.60045574192634,63674024,-786895464.3982303,8.850148996893966,22.473494775357214,37.32280838855361,0,85.71428571428571
2002-04-16,34.431,35.22,34.41701,35.2,39.95568414233231,36.95843181812082,36.00711754396153,34.97154530627756,37.668049250000145,37.89229879999988,35.832998400000136,35.19999850000003,35.19999850000003,37.65301327371195,32.74698372628811,72092320,49.5256506107715,41.366287684556035,NaN,NaN,NaN,NaN,49.5256506107715,NaN,-0.05909818952305934,-0.7172016842919149,-0.6581034947688555,57.6165924537146,31.93567948626324,135766344,-718394338.3109807,15.770359186568692,20.511338880050147,36.31038776937317,21.428571428571427,78.57142857142857
2002-04-17,35.39999,35.5,34.45,35.02,39.90657285733398,36.92004702964318,35.96840705204147,34.97616003901303,37.626349250000146,37.85629879999988,35.79499840000014,35.081998500000026,35.081998500000026,37.321994942865395,32.84200205713466,69130128,48.48009116893277,41.74071145170984,NaN,NaN,NaN,NaN,NaN,NaN,0.02702974476536313,-0.6243163138121517,-0.6513460585775148,53.12891113892371,44.40278103273189,66636216,-712468898.7681233,16.47405244624565,19.186698313215548,34.90794375689803,14.285714285714286,71.42857142857143
2002-04-18,34.785,35.14999,34,34.35001,39.85128367467394,36.869155207274005,35.90494050098102,34.91652670196417,37.58054935000014,37.81339889999988,35.75579860000013,34.99649900000003,34.99649900000003,37.2110435247441,32.78195447525596,91120000,44.6975572836144,41.62449939599052,NaN,NaN,NaN,NaN,NaN,NaN,0.04277712262067879,-0.5978746553016663,-0.6406517779223451,36.42501333838606,49.05683897700812,-24483784,-748122483.9297339,15.308015322279514,20.598344534110883,34.54187769091526,7.142857142857143,64.28571428571429
2002-04-19,35.058,35.06,34.38,34.46001,39.79763916049808,36.82144936158541,35.84827655976608,34.87304892082473,37.53389945000014,37.76519899999988,35.72379880000014,34.86849950000003,34.86849950000003,36.887738166947784,32.84926083305227,62431696,45.450085043446116,41.24616177912849,NaN,NaN,NaN,NaN,NaN,NaN,0.06326546951897405,-0.5615699410236275,-0.6248354105426015,48.1757017828995,45.90987542006976,37947912,-795862532.8798525,14.619993876629426,19.672548309976502,33.64917201272344,0,57.142857142857146
2002-04-22,34.00999,34.02,33.256,33.59,39.73587160666228,36.75746026531639,35.75971669467721,34.75085378550809,37.48009940000014,37.69859899999988,35.691798800000136,34.71400000000003,34.71400000000003,36.62514024605181,32.80285975394825,64641600,40.72942493938651,41.168266266750116,NaN,NaN,NaN,NaN,NaN,NaN,0.022965187445509905,-0.5961289262357141,-0.619094113681224,26.84767080685886,37.14946197604814,-26693688,-803985037.5918941,13.510990611290596,25.26172670225767,33.62348860485444,0,50
2002-04-23,33.59801,33.94,32.7,33.00999,39.66894741157111,36.683252933329925,35.6518842752781,34.585057234507325,37.416649350000135,37.62669889999988,35.62859860000013,34.58649950000002,34.58649950000002,36.59274433702704,32.580254662973005,73101376,37.90299951188523,40.90879787194557,NaN,NaN,NaN,NaN,NaN,NaN,-0.034868842017116486,-0.6626801662026196,-0.6278113241855031,11.071071428571408,28.69814800610992,-99795064,-840536904.6463457,12.462494356874924,26.78096344164696,33.514093370108725,71.42857142857143,100
2002-04-24,33.213,33.31,32.2,32.5,39.597614601505725,36.60041624158082,35.52828097036523,34.386480355030436,37.35189935000014,37.56419889999988,35.54599860000013,34.416999500000024,34.416999500000024,36.52436056732999,32.309638432670056,68965120,35.5659165926717,40.57705708201745,NaN,NaN,NaN,NaN,NaN,NaN,-0.0961129433027833,-0.7479525033139822,-0.6518395600111989,9.090909090909012,15.669883775446431,-168760184,-872223581.4031029,11.595056192313583,28.05221468315388,33.749063518829274,64.28571428571429,100
2002-04-25,32.308,32.73,32,32.42,39.526195550744475,36.51763572194555,35.406387598978355,34.199196511694204,37.28579935000014,37.488898899999874,35.46779860000013,34.25749950000003,34.25749950000003,36.460261636522446,32.054737363477614,103085632,35.19927037203075,40.3549321728871,NaN,NaN,NaN,NaN,NaN,NaN,-0.1286238764481923,-0.8126194055714393,-0.683995529123247,12.000000000000048,10.72066017316016,-271845816,-856690130.0058416,11.050311943395101,28.021444444373884,34.04571944693013,57.142857142857146,100
2002-04-26,32.662,34,31.00999,31.03999,39.441755694518164,36.409167489827816,35.235156320587045,33.898319701056664,37.223749300000144,37.40279889999988,35.34959840000013,34.00649900000003,34.00649900000003,36.46023653529481,31.552761464705238,100194624,29.54174749701322,39.49445025685987,NaN,NaN,NaN,NaN,NaN,NaN,-0.22409158092724857,-0.9641100052823077,-0.7400184243550592,0.6681499595769526,7.253019683495341,-372040440,-954874166.2686768,16.444571221043873,23.211340303254964,31.926317415521037,50,100
2002-04-29,31.244,31.55,30.56799,31.12,39.35895215526923,36.30443149993024,35.073777641348336,33.633717824765554,37.17109935000015,37.32429889999988,35.23439840000013,33.724999000000025,33.724999000000025,36.14674932571797,31.30324867428208,85336368,30.241806432674863,39.0961283125872,NaN,NaN,NaN,NaN,NaN,NaN,-0.2603289796121355,-1.0654296488702286,-0.8051006692580931,11.192394176005308,7.95351471186077,-286704072,-944271534.6664732,15.503297376243081,24.45906206217834,30.509049153602486,42.857142857142854,100
2002-04-30,31.032,32.19501,30.942,31.73,39.283042183575006,36.21384869795142,34.942649106393496,33.452411365264076,37.119699400000144,37.23329889999988,35.15339840000013,33.556999000000026,33.556999000000026,36.042021594689196,31.071976405310856,95421120,35.50331606568324,38.93633998600672,NaN,NaN,NaN,NaN,NaN,NaN,-0.2231262797380188,-1.0840085189306166,-0.8608822391925978,23.5605767222694,11.807040285950555,-191282952,-919674709.7817558,18.12641725911325,22.67555561199908,28.02743263597551,35.714285714285715,92.85714285714286
2002-05-01,31.67,31.84,30.58,31.56,39.206195992693665,36.12169327819001,34.809996200260414,33.272181711429404,37.07499940000014,37.12039879999988,35.09099860000013,33.38349900000003,33.38349900000003,35.916991235653086,30.850006764346972,109968368,34.717417801083556,38.98397122313282,NaN,NaN,NaN,NaN,NaN,NaN,-0.19111220371266358,-1.0997724938334272,-0.9086602901207637,20.113706176589208,18.28889235828797,-301251320,-858581172.0039781,16.799816858477847,23.118667938468384,25.71562798829125,28.571428571428573,85.71428571428571
2002-05-02,31.39799,31.99001,30.46001,30.50999,39.11966657983104,36.01057044099813,34.64136850613256,33.009115834150414,37.02254935000013,36.99639869999988,34.99819860000013,33.17099900000003,33.17099900000003,35.91151413553806,30.430483864462,85858368,30.261679856889984,38.42508964956597,NaN,NaN,NaN,NaN,NaN,NaN,-0.21975308632725077,-1.1833516480298272,-0.9635985617025764,0.9916686342631219,14.888650511040575,-387109688,-938830126.6279783,16.188814508521627,21.099358091290597,23.213808047937782,21.428571428571427,100
2002-05-03,30.47,30.51401,23.88,29.74001,39.02633666361382,35.886400927315,34.449158368637164,32.69777242137418,36.953249350000135,36.87649879999989,34.92339880000013,32.93949950000003,32.93949950000003,35.99938047123685,29.879618528763217,92128128,27.476784825385934,37.52098200010499,NaN,NaN,NaN,NaN,NaN,NaN,-0.26653819740799545,-1.2967713084625707,-1.0302331110545753,50.430378657487104,23.845251156113147,-479237816,-868199455.2407962,11.498893085528962,43.72116736752348,24.275255653201555,14.285714285714286,100
2002-05-06,29.63699,29.98399,28.85001,28.97,38.926273612234574,35.74944249311074,34.23428941300433,32.3427464764814,36.88234940000014,36.756198799999886,34.829799000000136,32.64799950000003,32.64799950000003,36.036520621689526,29.25947837831054,96519184,24.999122243312158,35.76908711671504,NaN,NaN,NaN,NaN,NaN,NaN,-0.32163762661050654,-1.4322801443177084,-1.110642517707202,43.803786574870905,31.741944622207047,-575757000,-944292640.7431864,10.916714243015226,41.507603120769446,27.50992285348338,7.142857142857143,92.85714285714286
2002-05-07,29.27,29.35001,28.42,28.7,38.82451964594368,35.60984957245508,34.01725845563161,31.99581824062603,36.814099350000134,36.63089879999988,34.703599200000134,32.403499500000024,32.403499500000024,36.169508184819904,28.637490815180147,102059808,24.17591120810647,34.033074262370306,NaN,NaN,24.17591120810647,NaN,NaN,NaN,-0.34641735891322867,-1.5436642163487377,-1.197246857435509,42.768449661446006,45.66753829793468,-677816808,-984897741.2884283,10.449451881555257,41.710038874757764,31.24748579773706,0,85.71428571428571
2002-05-08,30.13,31.88,30,31.77,38.75432542061091,35.53381294725795,33.92913067305783,31.97431174151879,36.75644935000013,36.53299879999989,34.64139920000014,32.29999950000003,32.29999950000003,36.01584798993315,28.5841510100669,129922816,45.964349470592936,34.12355941858306,NaN,NaN,NaN,NaN,NaN,NaN,-0.13695374569044527,-1.3684390395485657,-1.2314852938581204,70.57245080500893,52.38156234710862,-547893992,-870178659.0756623,19.859032991477733,36.03106194445399,32.26189498095802,0,78.57142857142857
2002-05-09,31.578,31.89,30.8,30.95,38.67667044130135,35.44304437404492,33.812302019212424,31.876758242326524,36.702949400000136,36.44489889999989,34.57239940000014,32.19749950000003,32.19749950000003,35.94343123858498,28.451567761415077,106527120,42.455139647501994,33.9096347474442,NaN,NaN,NaN,NaN,NaN,NaN,-0.0395899372287265,-1.2809727153940287,-1.2413827781653022,69.723865877712,61.02158878138898,-654421112,-947386388.2499745,18.952603818293724,34.30683576579507,33.268712477827215,0,71.42857142857143
2002-05-10,31.01401,31.099,29.5,29.56,38.58595730258193,35.326548445846015,33.64554507728253,31.656114600200187,36.63754940000013,36.339398899999885,34.487999400000135,31.99949950000003,31.99949950000003,35.86170972189856,28.137289278101502,112373808,37.26189494545681,33.661954033592075,NaN,NaN,NaN,NaN,NaN,NaN,-0.053877921283669084,-1.3087301797698885,-1.2548522584862194,56.12648221343873,65.47426629871988,-766794920,-1051326889.8334644,17.620488661087556,37.60988530886057,33.6891444123415,0,64.28571428571429
2002-05-13,29.87,30.98,29.675,30.75999,38.5080869811632,35.23612154592827,33.532386054644,31.57076940018112,36.58309940000014,36.238998799999884,34.388399000000135,31.847999500000025,31.847999500000025,35.65469942409946,28.041299575900588,93973808,43.66822697601893,34.07375599531592,NaN,NaN,NaN,NaN,NaN,NaN,0.028011823692653204,-1.219837478870403,-1.2478493025630562,67.9840909090909,64.6114796667472,-672821112,-989039177.6159627,16.51064575835436,35.24099162574565,33.66818029496575,21.428571428571427,57.142857142857146
2002-05-14,32.05499,32.64999,31.87,32.57001,38.44900163806705,35.183327257890085,33.49464581720698,31.665935171592444,36.54289945000014,36.152098999999886,34.29679940000001,31.716500000000003,31.716500000000003,35.22062245792936,28.212377542070648,107841680,51.68263926594964,35.22495047197862,NaN,NaN,NaN,NaN,NaN,NaN,0.20475795505176264,-0.9919018587483528,-1.1966598138001154,85.86966403162059,69.99341238471673,-564979432,-903313621.0698533,22.460155903873527,32.32281927697946,31.989196189263104,14.285714285714286,50
2002-05-15,32.082,33.63,31.85001,32.81,38.39289216903156,35.13633067852592,33.467796961630235,31.77489372667888,36.506199500000136,36.07509909999988,34.204599400000006,31.606,31.606,34.813266624427385,28.39873337557262,204584496,52.644654011886004,36.47104930339685,NaN,NaN,NaN,NaN,NaN,NaN,0.3310305759355556,-0.782871593880671,-1.1139021698162266,88.24110671936761,80.69828722002636,-360394936,-887223764.6127716,24.98570666185507,29.81850342790604,29.51651677654109,7.142857142857143,42.857142857142854
2002-05-16,32.54201,33.05,32.22,32.86,38.33783851560836,35.09125482350561,33.443961786664346,31.87823718128089,36.46799950000014,36.01579919999988,34.109799200000005,31.531499500000002,31.531499500000002,34.543632120942284,28.519366879057724,89899184,52.855261253887335,38.136300286030725,NaN,NaN,NaN,NaN,NaN,NaN,0.40616875525359886,-0.6061912257492281,-1.012359981002827,92.10256410256407,88.73777828451743,-270495752,-838483243.1669881,24.049999086347825,28.701808994349086,28.92755866098053,0,35.714285714285715
2002-05-17,33.28999,33.411,32.47,32.92999,38.28402907764211,35.04845750026787,33.42380603032457,31.978404116396998,36.42714940000013,35.95029909999988,34.014799200000006,31.454998500000006,31.454998500000006,34.23446853943835,28.675528460561658,82720128,53.169229884705594,39.7739733897472,NaN,NaN,NaN,NaN,53.169229884705594,NaN,0.4456679640641763,-0.4552750259226066,-0.9009429899867829,92.8204102564102,91.05469369278063,-187775624,-840331040.287669,24.675851267906765,27.446828732474067,27.706541533891464,85.71428571428571,28.571428571428573
2002-05-20,32.60001,32.7,31.94,32.21001,38.22359107686955,34.99225061907445,33.376206185998115,32.000461819597284,36.37844945000014,35.87919909999989,33.885599400000004,31.385999000000005,31.385999000000005,34.014453330621016,28.757544669378994,78157376,49.516072849581256,40.77488458859706,NaN,NaN,NaN,NaN,NaN,NaN,0.4093289354815667,-0.3892818206348245,-0.7986107561163912,85.43599999999995,90.11965811965808,-265933000,-862953487.0935643,23.51111724869301,28.67826840474193,27.61736013699802,78.57142857142857,21.428571428571427
2002-05-21,32.369,32.59,31.092,31.33,38.15499813083105,34.919730804835346,33.29596280615505,31.93660831296897,36.32659945000014,35.79559909999989,33.741599400000005,31.3019995,31.3019995,33.822655432122474,28.78134356787753,104169872,45.40926570747477,41.53858801048215,NaN,NaN,NaN,NaN,NaN,NaN,0.3162152366739792,-0.4033417102739172,-0.7195569469478964,76.41025641025637,84.88888888888884,-370102872,-934022652.1029103,21.831882219373576,30.673152198459054,27.689468237815415,71.42857142857143,14.285714285714286
2002-05-22,30.99001,31.59,30.41,31.39999,38.087784119579005,34.85003296711584,33.22161093140387,31.885501806971927,36.27479945000014,35.70949909999989,33.609599200000005,31.246999,31.246999,33.70799178669446,28.786006213305537,89542496,45.79433233654744,42.64806318760054,NaN,NaN,NaN,NaN,NaN,NaN,0.2523035105707375,-0.4041775587344745,-0.656481069305212,77.12810256410253,79.65811965811962,-280560376,-873317392.8231819,20.58467907873469,32.22265038769163,28.322995454838225,64.28571428571429,7.142857142857143
2002-05-23,31.63,32.10001,30.8,32.03,38.02750766067772,34.79419073014325,33.17488109095666,31.899263539641268,36.21944940000014,35.626499100000004,33.508599200000006,31.227499,31.227499,33.65698378903685,28.798014210963153,94453808,49.263562020172216,44.204261558656704,NaN,NaN,NaN,NaN,NaN,NaN,0.24520949086863797,-0.3499692057194146,-0.5951786965880526,69.28982725527828,74.27606207654573,-186106568,-789036908.2562008,21.76830008049236,30.177264502478035,25.31124920046145,57.142857142857146,0
2002-05-24,31.592,31.69,31.00999,31.24001,37.959970370521724,34.72381091370477,33.09900379327208,31.83647748824686,36.156099450000134,35.54979920000001,33.39619940000001,31.2375,31.2375,33.66546121059742,28.80953878940258,55876896,45.34458579345442,45.65750895509543,NaN,NaN,NaN,NaN,NaN,NaN,0.18291962438042242,-0.3665291661125245,-0.5494487904929469,54.12687140115162,66.84826707351081,-241983464,-807111996.5830191,20.66017106090567,28.64107185522091,22.29950294608468,50,7.142857142857143
2002-05-28,31.47099,31.52699,30.49001,31.10001,37.89171205837723,34.65205247977002,33.02061187981043,31.766337727461444,36.095699550000134,35.459699300000004,33.273599600000004,31.2365005,31.2365005,33.66467081819945,28.80833018180055,68838624,44.666445827522004,47.121118570767976,NaN,NaN,NaN,NaN,NaN,NaN,0.13036334065840083,-0.38649461466994595,-0.5168579553283468,38.741162227602906,54.0526202946776,-310822088,-794962442.1417763,19.56949432330644,29.77622226096187,19.49603361271912,42.857142857142854,0
2002-05-29,30.66499,30.89999,30.24001,30.28,37.81597362993566,34.565477183140914,32.91313690413159,31.624781753417498,36.03459955000014,35.34749930000001,33.130399600000004,31.164000500000004,31.164000500000004,33.61537896612555,28.71262203387446,73479312,40.81608813774111,46.75338561842141,NaN,NaN,NaN,NaN,NaN,NaN,0.04296919128544141,-0.463146466221545,-0.5061156575069864,18.88619854721551,37.25141072532335,-384301400,-859537127.6777017,18.688352319095607,29.744413211381783,19.05976474176718,35.714285714285715,14.285714285714286
2002-05-30,30.013,30.72,29.89999,30.53999,37.74357578287162,34.48576456565297,32.82007231965584,31.52146825309202,35.97589950000014,35.23619920000001,32.99359940000001,31.113000000000007,31.113000000000007,33.571732779340486,28.65426722065953,92089680,42.50827075821091,46.75718069775776,NaN,NaN,NaN,NaN,NaN,NaN,0.007145829810566329,-0.49718337024377846,-0.5043292000543448,25.181355932203363,27.602905569007266,-292211720,-807878816.3117427,17.8624790416127,30.262383263004395,18.84097764067743,28.571428571428573,7.142857142857143
2002-05-31,30.75999,31.03999,30,30.03999,37.66692318801718,34.39772942573905,32.711049483590905,31.380375086130876,35.923599450000125,35.12449900000001,32.8731992,31.089499999999997,31.089499999999997,33.579621234037745,28.59937876596225,79907680,40.13181151395025,46.962174738364446,NaN,NaN,NaN,NaN,NaN,NaN,-0.04299311421454077,-0.5580705928225207,-0.5150774786079799,9.228571428571394,17.765375302663433,-372119400,-881641229.293406,18.597126548938057,28.53977081801488,17.762432227353152,21.428571428571427,0
2002-06-03,30.008,30.25,28.78999,28.98,37.580486141370244,34.290447654932336,32.564733817567735,31.151767935070794,35.865149450000125,34.99939890000002,32.71239920000001,31.051499500000006,31.051499500000006,33.64393098534007,28.459068014659945,77072624,35.58932978516367,46.38511065330335,NaN,NaN,NaN,NaN,NaN,NaN,-0.13511568530408746,-0.6839720852380893,-0.5488563999340018,3.9258183350861007,12.778581898620295,-449192024,-938652936.8801758,17.123497173819008,32.84541910103562,17.424621080310686,14.285714285714286,100
2002-06-04,28.75101,29.67999,28.61,29.36,37.49869025936656,34.19281502810199,32.43905798158469,30.981123369825955,35.810549450000124,34.88189890000002,32.5659994,31.070999500000006,31.070999500000006,33.60573540028284,28.536263599717174,98375680,38.28615941727557,45.428219235540915,NaN,NaN,NaN,NaN,NaN,NaN,-0.15651880937906337,-0.7445049116578311,-0.5879861022787677,14.940239043824691,9.364876269160739,-350816344,-899117496.2154968,16.115640957788834,31.90229092049964,18.487008084554702,7.142857142857143,100
2002-06-05,29.42101,29.8,28.97,29.66,37.42069334136291,34.10305631467423,32.330075315640194,30.8553020965092,35.75334940000013,34.76469890000001,32.4479994,31.118999500000008,31.118999500000008,33.50427228863075,28.733726711369265,95370192,40.40749641310239,44.554136549913515,NaN,NaN,NaN,NaN,NaN,NaN,-0.13722304207600888,-0.7595149048737788,-0.6222918627977699,21.870443657571347,13.578833678827388,-255446152,-835920381.034774,16.038005031054077,30.40720657640979,20.066984261362514,0,92.85714285714286
2002-06-06,29.511,29.51801,27.89999,28.88,37.33571131806577,33.999629456957905,32.194778244438616,30.667178087317847,35.69474935000012,34.64499880000001,32.3077994,30.974499500000007,30.974499500000007,33.52868600418934,28.420312995810676,93207504,36.859862231108366,43.411608048286446,NaN,NaN,NaN,NaN,NaN,NaN,-0.1620398319853421,-0.8248416527794475,-0.6628018207941054,17.78276577251719,18.197816157971086,-348653656,-816219162.0337728,14.48754573577527,33.3449838627533,22.253097354664643,7.142857142857143,100
2002-06-07,27.63,28.78999,27.52,28.3,37.24580374276163,33.886765507315175,32.04204184269592,30.44173255519234,35.640749300000124,34.52839870000002,32.1615994,30.841999500000007,30.841999500000007,33.64986580169297,28.034133198307043,106055312,34.43860717521588,42.07370642618004,NaN,NaN,NaN,NaN,NaN,NaN,-0.20007172670039153,-0.9128914791695948,-0.7128197524692033,15.05791505791507,18.237041496001215,-454708968,-792000781.548005,13.408824595974941,32.94256964070533,24.883559786340033,0,100
2002-06-10,28.36,28.75,28.14,28.25,37.156293257759025,33.775146388358436,31.893334319452947,30.232996121364497,35.58419930000012,34.40749870000001,32.0053994,30.776499500000007,30.776499500000007,33.75675786232082,27.7962411376792,73149808,34.22986093509802,40.981834146574094,NaN,NaN,NaN,NaN,NaN,NaN,-0.21011353256398713,-0.9754616681741872,-0.7653481356102001,14.398422090729781,15.746367640387357,-527858776,-838768691.580792,12.943307899571604,31.798896227691838,27.18655723978284,0,92.85714285714286
2002-06-11,28.60001,28.69,27.36301,27.46001,37.05981282733356,33.65009418264837,31.719478463788125,29.96890220504407,35.532699400000126,34.29429880000002,31.8195996,30.611500500000005,30.611500500000005,33.92402328998699,27.29897771001302,84609504,31.029599044664494,39.9547150992305,NaN,NaN,31.029599044664494,NaN,NaN,NaN,-0.24883082674307944,-1.0763866690390493,-0.8275558422959699,2.0477095207937794,10.501348889812887,-612468280,-911008664.7056533,11.96977001397471,33.81120666116842,29.391531729223736,0,100
2002-06-12,27.24899,27.96001,26.834,27.86,36.96827240119094,33.535438852298896,31.568126367168983,29.768054375992254,35.48059940000012,34.17639890000002,31.6749996,30.376000000000012,30.376000000000012,33.766864845457995,26.98513515454203,152986368,34.37510076856748,39.13905570151765,NaN,NaN,NaN,NaN,NaN,NaN,-0.22698285754644176,-1.1112844142290221,-0.8843015566825804,19.483441922822028,11.976524511448531,-459481912,-785198195.0789895,11.199960380502857,34.658188845692834,31.47119885086855,7.142857142857143,100
2002-06-13,27.765,28.21001,27.353,27.67999,36.875851680781075,33.419489370075155,31.41565043120157,29.56919110208823,35.43554935000013,34.06729880000002,31.527999400000002,30.11949950000001,30.11949950000001,33.51119777051028,26.727801229489742,97610368,33.58554450635954,38.01919730767389,NaN,NaN,NaN,NaN,NaN,NaN,-0.2048159664253627,-1.1403215147142838,-0.9355055482889211,17.421540362438225,12.98423060201801,-557092280,-808322584.54357,12.09985823771377,32.922701978081086,33.61846797071219,0,92.85714285714286
2002-06-14,26.862,27.72,26.2,27.62,36.78375365410664,33.3046479964103,31.26680139468386,29.383553854270303,35.38519935000013,33.96949890000002,31.3851996,29.85749950000001,29.85749950000001,33.17057542882844,26.544423571171578,122091632,33.31094925367111,37.159651840546516,NaN,NaN,NaN,NaN,NaN,NaN,-0.17548499325331324,-1.1548617898555626,-0.9793767966022494,26.656704818293278,21.187229034517845,-679183912,-702295640.9646224,11.043603532126882,36.67049132223488,36.29855579091308,0,100
2002-06-17,28.002,28.75,27.91,28.56,36.70192525953841,33.21069457073881,31.160652320382532,29.30512015386361,35.34139930000013,33.87079900000002,31.2689996,29.63900000000001,29.63900000000001,32.677776957949355,26.600223042050665,87635872,41.39630781961772,36.92607055426764,NaN,NaN,NaN,NaN,NaN,NaN,-0.07898429888625169,-1.078107170210064,-0.9991228713238123,48.7604313232052,30.94622550131223,-591548040,-654304568.2027179,16.2764602740757,34.27504755898657,37.36429368091092,0,92.85714285714286
2002-06-18,28.317,29.14999,28.28,29.02,36.62548819227933,33.12771051983309,31.07670517056361,29.277965853495648,35.289999300000126,33.771599000000016,31.153399600000004,29.479499500000014,29.479499500000014,32.287882927906864,26.671116072093163,100205680,44.91584914795957,37.2189106264261,NaN,NaN,NaN,NaN,44.91584914795957,NaN,0.02410589213510783,-0.9689905061549275,-0.9930963982900354,58.264583191287585,44.560573110928686,-491342360,-584043453.8717486,17.802402453871487,32.51404205060989,37.82219270432352,14.285714285714286,85.71428571428571
2002-06-19,28.104,28.3239,27.25,27.34,36.533095274943214,33.01310239072748,30.93016771289445,29.093397676972252,35.22994925000013,33.65669900000002,31.028399599999997,29.279999500000013,29.279999500000013,32.10106980755044,26.458929192449588,93516128,36.33352747920313,36.7778575350684,NaN,NaN,NaN,NaN,NaN,NaN,-0.01070264893628503,-1.0064747094603916,-0.9957720605241066,23.553767673073715,43.526260729188834,-584858488,-661885028.3378999,16.001139008772753,35.112170586628615,38.65243784749459,7.142857142857143,78.57142857142857
2002-06-20,27.27,27.45,25.67,26.46001,36.432865570714924,32.883338184970505,30.754867410427998,28.84259885059394,35.17164930000013,33.53079910000002,30.880799799999995,29.033000500000014,29.033000500000014,31.93231074006442,26.13369025993561,99923184,32.798356714628554,36.25403933511684,NaN,NaN,NaN,NaN,NaN,NaN,-0.07903955976706012,-1.0945715102329316,-1.0155319504658715,17.249126637554564,33.02249250063862,-684781672,-673111229.6504393,14.420901223037031,40.41071333963493,40.53145179561323,0,100
2002-06-21,26.367,26.78,25.64999,25.82001,36.32726501777249,32.743470300119604,30.561343590411212,28.55473324577547,35.11294935000012,33.40919920000002,30.737199999999998,28.722501000000012,28.722501000000012,31.60149743976155,25.843504560238475,101815808,30.47590663385668,35.8887948243092,NaN,NaN,30.47590663385668,NaN,NaN,NaN,-0.14931332113904072,-1.2021736018896725,-1.0528602807506318,4.0968575979335204,14.966583969520599,-786597480,-744288859.8004024,13.508815255254142,37.96683415830407,41.67790613686577,0,100
2002-06-24,25.457,26.8,25.21001,26.33,36.22778974396381,32.616470888236044,30.39540854764999,28.34285388903495,35.06374935000012,33.28979920000002,30.593399999999995,28.477000500000013,28.477000500000013,31.292099150516965,25.661901849483062,139673120,34.458595816312965,35.61539742424044,NaN,NaN,NaN,NaN,NaN,NaN,-0.14338720573868557,-1.2320942879239887,-1.088707082185303,24.40070675535236,15.248896996946817,-646924360,-687190304.9234539,12.32737747106015,37.066469701949764,42.90710615319055,7.142857142857143,100
2002-06-25,26.584,26.72,25.3,25.46001,36.12064765695919,32.47475879143929,30.201863506565676,28.068297328174477,35.00789940000013,33.159299400000016,30.426800399999998,28.195000500000013,28.195000500000013,31.032445650155918,25.35755534984411,136737872,31.177494949821508,34.956111605434664,NaN,NaN,NaN,NaN,NaN,NaN,-0.17775143184506015,-1.3108963719916282,-1.133144940146568,5.8031569173630455,11.433573756882973,-783662232,-793112082.6999047,11.370915594101557,34.190540473159245,44.274778372027505,0,92.85714285714286
2002-06-26,24.438,25.78,24.39,25.45,36.01447205838249,32.33565465695535,30.015515918072904,27.818935677872147,34.95779940000013,33.03239940000002,30.231800399999994,27.95350050000001,27.95350050000001,30.86131186701531,25.045689132984712,149032320,31.140753556375188,34.54760384295373,NaN,NaN,NaN,NaN,NaN,NaN,-0.18028038793902978,-1.3584954250703554,-1.1782150371313256,22.268954346542724,17.49093933975271,-932694552,-714843310.3258044,10.511189744382692,36.55532091868907,45.4112684933806,0,100
2002-06-27,26,26.25,20.59,26.21001,35.91691522198067,32.21435476275821,29.866280391873968,27.665704660931944,34.912199450000124,32.925299500000015,30.055600599999995,27.73700150000001,27.73700150000001,30.48251527999386,24.99148772000616,121381008,37.192691944235015,34.74432418359795,NaN,NaN,NaN,NaN,NaN,NaN,-0.11317126851958625,-1.3196791227808085,-1.2065078542612222,65.65439912897097,31.24217013095891,-811313544,-595177506.039557,7.893942178788553,44.170247955236405,47.37793863145119,50,100
2002-06-28,26.05,26.75,25.85001,26.10001,35.819234573005744,32.09327862884221,29.718583513761264,27.51659088370033,34.87319955000012,32.82319960000002,29.890600599999992,27.540002500000007,27.540002500000007,30.15874428187164,24.921260718128373,87860000,36.69007298123066,34.92005361546457,NaN,NaN,NaN,NaN,NaN,NaN,-0.06119638889943513,-1.2830033403855161,-1.221806951486081,64.36935089877443,50.764234791429374,-899173544,-634225852.5767406,9.843066749732028,42.36392637967522,48.817182749028426,42.857142857142854,92.85714285714286
2002-07-01,25.978,26.14,24.78,24.85001,35.71008805984151,31.949847566884934,29.527659062241213,27.262630799538396,34.82894960000013,32.71109970000002,29.698400599999996,27.333503000000007,27.333503000000007,30.111943878645576,24.55506212135444,64782400,31.483352742636825,34.952464593891165,NaN,NaN,NaN,NaN,NaN,NaN,-0.09404462446371076,-1.3393627320657195,-1.2453181076020088,49.76653010108658,59.93009337627732,-963955944,-692338523.4237995,9.22888040292355,44.629797479146525,50.104377749663044,35.714285714285715,85.71428571428571
2002-07-02,24.608,24.75,23.09,23.95,35.59307225825105,31.7914347437783,29.308927334310184,26.94714215196331,34.778199550000124,32.59869970000002,29.505600599999994,27.06300300000001,27.06300300000001,30.04550751938119,24.08049848061883,111611008,28.36244235211464,34.522988992715966,NaN,NaN,28.36244235211464,NaN,NaN,NaN,-0.15578649565938862,-1.4400512271762445,-1.2842647315168558,39.252382304184934,51.12942110134865,-1075566952,-688304390.6045225,8.490525428536609,48.741436255747765,51.47405878283028,28.571428571428573,78.57142857142857
2002-07-03,23.85201,24.75,23.62,24.75,35.4851809919998,31.652000392416355,29.13014587021959,26.737890518442995,34.745949550000134,32.484499700000015,29.340400799999998,26.81750300000001,26.81750300000001,29.711526168554254,23.923479831445764,101076320,34.571094322790074,34.59338540817529,NaN,NaN,NaN,NaN,NaN,NaN,-0.1235559913917601,-1.438709720756556,-1.315153729364796,48.59818761470516,45.87236667332556,-974490632,-587228070.6045225,8.045468547604079,46.18650467056627,53.19403220404193,21.428571428571427,71.42857142857143
2002-07-05,25.26401,26.39,25.05,26.34,35.39418416620875,31.546812265833854,29.02072838511294,26.699996183353186,34.725149550000125,32.38159970000002,29.217200799999997,26.690503000000007,26.690503000000007,29.43015209215213,23.950853907847883,56771104,44.80910946147877,35.414682565875836,NaN,NaN,NaN,NaN,44.80910946147877,NaN,0.016582564489875384,-1.2944255237524516,-1.311008088242327,67.1729756693641,51.674515196084734,-917719528,-534693616.15676135,15.008621191247023,42.68908396690065,52.784440729285905,14.285714285714286,64.28571428571429
2002-07-08,26.2,26.55,25.08,25.38,35.294540542664386,31.424697171460906,28.877954722951646,26.574282261129074,34.70219955000013,32.27209970000001,29.0764008,26.54450300000001,26.54450300000001,29.23630549129264,23.85270050870738,97348192,40.67110568949826,35.36288241372444,NaN,NaN,NaN,NaN,NaN,NaN,0.05423666417569173,-1.2432122580227123,-1.297448922198404,55.958009296739824,57.24305752693636,-1015067720,-592307852.238394,14.72769037835748,39.78125143507562,53.52428672079372,7.142857142857143,57.142857142857146
2002-07-09,25.25101,25.48,24.59,24.66,35.18872421885678,31.290742772026036,28.712544733816287,26.391969664831066,34.68064955000013,32.14919970000001,28.948800999999992,26.365003000000012,26.365003000000012,29.056739606752057,23.673266393247967,91053008,37.84808278897806,34.858041959511475,NaN,NaN,NaN,NaN,NaN,NaN,0.040874225033475486,-1.2463561409065598,-1.2872303659400353,52.62545416930657,58.585479711803494,-1106120728,-669037915.1597424,14.101404966903965,40.4308077833355,54.884576686130835,0,50
2002-07-10,24.998,25.03,23.83,23.89999,35.07639850523631,31.144391231985917,28.52381709719604,26.154638268180488,34.659199500000135,32.019399600000014,28.804400799999993,26.187002000000014,26.187002000000014,29.032025424885617,23.34197857511441,115303376,35.08011563844035,34.768512542314134,NaN,NaN,NaN,NaN,NaN,NaN,-0.006410416507536043,-1.2952433865744553,-1.2888329700669192,48.250583090379,52.278015518808466,-1221424104,-770891152.3493422,13.28132718026749,41.762721341275906,55.90981758393571,0,42.857142857142854
2002-07-11,23.767,24.89,23.53,24.8,34.97414578379117,31.01875972244164,28.377785054168744,26.025625099782346,34.63514950000013,31.909599600000014,28.665800799999992,26.034002000000015,26.034002000000015,28.83141021764508,23.23659378235495,170214320,40.61847468635513,35.32709239743746,NaN,NaN,NaN,NaN,NaN,NaN,0.033475110640411865,-1.2469890817664044,-1.2804641924068163,67.79388083735911,56.223306032348226,-1051209784,-623205198.2316952,12.401099160061266,40.456833554168945,56.31541071775056,0,35.714285714285715
2002-07-12,25.25,25.526,24.55,24.8,34.87291050236041,30.895615965561607,28.23747975792683,25.908898899803074,34.610649500000136,31.810799700000015,28.53060079999999,25.890002500000016,25.890002500000016,28.629572940802554,23.150432059197477,130025632,40.61847468635513,36.051561544044496,NaN,NaN,NaN,NaN,NaN,NaN,0.06839351335399213,-1.1949723007143263,-1.2633658140683184,67.79388083735911,61.279448255032406,-1051209784,-686619338.4284164,14.971988254702065,38.485559045067596,56.06339199250892,7.142857142857143,28.571428571428573
2002-07-15,24.688,25.64,23.75,25.57001,34.78034432820757,30.7901584216891,28.13287310075323,25.876623766488496,34.595149550000144,31.714999900000016,28.431801199999995,25.787503000000015,25.787503000000015,28.411454672597664,23.163551327402367,140525312,45.252772088020414,36.822574134880746,NaN,NaN,NaN,NaN,NaN,NaN,0.14735249499585423,-1.0791751953235007,-1.226527690319355,80.84431818181818,72.14402661884547,-910684472,-556501821.7584482,13.590961566063084,38.83999239581316,55.9256315440507,0,21.428571428571427
2002-07-16,25.252,26.02699,24.89999,25.19,34.68491801648411,30.67926419551704,28.0174663124884,25.811231026822924,34.578699550000145,31.632099900000018,28.340800999999992,25.619003000000014,25.619003000000014,27.922393419387937,23.31561258061209,148231376,43.45053858367697,37.69922010872756,NaN,NaN,NaN,NaN,NaN,NaN,0.17604866212493597,-1.006466862663185,-1.182515524788121,74.67532467532469,74.43784123150066,-1058915848,-628444677.1661496,14.751167429176068,36.66800797357367,55.39266682809132,21.428571428571427,14.285714285714286
2002-07-17,26.077,26.44,24.89,25.64999,34.59501823522557,30.579674607487,27.92462410415552,25.795874738554073,34.56204950000015,31.552099900000016,28.274400799999995,25.45050250000001,25.45050250000001,27.147226894284454,23.753778105715565,157983376,46.2414830714005,38.777843645515084,NaN,NaN,NaN,NaN,46.2414830714005,NaN,0.224942357465737,-0.9013375779559496,-1.1262799354216866,82.1426948051948,79.22077922077922,-900932472,-631504458.4226146,15.661001866342191,33.86323043188375,54.065484435065166,14.285714285714286,7.142857142857143
2002-07-18,25.38901,25.57001,24.52,24.73,34.49685884980044,30.463839466744684,27.79934472752197,25.69436285869178,34.542049500000154,31.449300000000022,28.195000799999992,25.320002500000008,25.320002500000008,26.803423303467607,23.83658169653241,113974192,41.79823955557289,39.10681133203922,NaN,NaN,NaN,NaN,NaN,NaN,0.1953525950468058,-0.8820891916131792,-1.077441786659985,44.80874316939892,67.20892088330613,-1014906664,-699889407.8058774,14.773783699679974,33.79980474551489,51.88643882826949,7.142857142857143,0
2002-07-19,24.332,24.71001,23.8,23.99001,34.392313090100934,30.335644823838848,27.64995905193287,25.53204353881637,34.51789950000015,31.34040010000002,28.039400999999994,25.196502500000012,25.196502500000012,26.69095252263698,23.702052477363043,124783008,38.586562426977984,39.242274863878315,NaN,NaN,NaN,NaN,NaN,NaN,0.12916399742938678,-0.9159867898732514,-1.0451507873026382,26.011849710982702,50.98776256185882,-1139689672,-772563055.7986685,14.067435490280511,35.88529562107208,50.556785922335784,0,14.285714285714286
2002-07-22,23.855,24.5,23.09,23.39999,34.2829367409457,30.198305124356892,27.483293598915896,25.32899082083386,34.47989945000015,31.23040010000002,27.88840079999999,25.075501500000012,25.075501500000012,26.73156762614812,23.419435373851904,150017312,36.1982711989776,39.579054753616944,NaN,NaN,NaN,NaN,NaN,NaN,0.05278201877080124,-0.9791732638391366,-1.0319552826099379,8.959248554913266,26.593280478431637,-1289706984,-856617436.5264984,13.048800585071863,36.933030911470475,49.27511108149092,28.571428571428573,7.142857142857143
2002-07-23,23.453,23.75,22.28,22.39999,34.16469846491639,30.04388304268646,27.283948359742723,25.050038361706825,34.43539940000014,31.11660000000002,27.745200599999993,24.87900100000001,24.87900100000001,26.803844964637403,22.954157035362616,150829008,32.523985653383605,39.87630784656472,NaN,NaN,32.523985653383605,NaN,NaN,NaN,-0.052269170818713295,-1.0972917461333296,-1.0450225753146163,2.8100702576111907,12.593722841169063,-1440535992,-982823352.4585805,12.067705228047377,38.29909755822259,47.97163182541143,21.428571428571427,100
2002-07-24,21.81599,23.66,21.64,23.62,34.05977609213115,29.916677437880786,27.140264110341047,24.913844232020462,34.39469945000015,30.99539990000002,27.60240079999999,24.787000500000012,24.787000500000012,26.767068764525987,22.806932235474036,186473872,40.463863114557675,40.29721990311955,NaN,NaN,NaN,NaN,NaN,NaN,-0.027987725592565793,-1.0800072323053236,-1.0520195067127578,40.325865580448074,17.365061464324185,-1254062120,-803734584.3001645,10.859428741158988,37.636679013004006,46.892048201543034,14.285714285714286,100
2002-07-25,23.258,23.39999,21.8,22.25,33.9422658822592,29.764862043071265,26.948489047190417,24.660144781351846,34.34664945000015,30.84640000000002,27.396000599999994,24.627000500000012,24.627000500000012,26.86700741342311,22.386993586576914,153921680,35.423135415618674,39.62679318555812,NaN,NaN,NaN,NaN,NaN,NaN,-0.08914056171183438,-1.1634452088525506,-1.0743046471407163,12.423625254582472,18.51985369754726,-1407983800,-871074778.1658762,9.897845262861612,34.30401671745273,47.40921077328506,7.142857142857143,92.85714285714286
2002-07-26,22.569,22.84399,22.00999,22.67,33.83010403268448,29.624369725386686,26.780705162986873,24.47060718312786,34.30454945000015,30.698900000000023,27.19320059999999,24.45000000000001,24.45000000000001,26.720925062648394,22.179074937351626,96037376,37.974144833235485,39.434153124396495,NaN,NaN,NaN,NaN,NaN,NaN,-0.08619942991665352,-1.1820539345365333,-1.0958545046198798,21.458333333333353,24.73594138945464,-1311946424,-815108248.8091373,9.483440002220048,32.86776826020633,48.070136537277925,0,85.71428571428571
2002-07-29,23.27699,24.12,23.08,23.83,33.730600509971204,29.509629730824575,26.664991235026605,24.40959697521092,34.26119945000015,30.561199900000023,27.01260059999999,24.33649950000001,24.33649950000001,26.49008826904203,22.18291073095799,96715872,44.495753035412044,39.90898671342749,NaN,NaN,NaN,NaN,NaN,NaN,0.004181917434312066,-1.0906271078269896,-1.0948090252613016,45.62499999999994,26.502319529305257,-1215230552,-772330074.6552916,15.19112100742548,30.478500457125307,47.01239042112028,42.857142857142854,78.57142857142857
2002-07-30,23.731,24.69,23.59,24.31,33.63686319146403,29.40666676585775,26.57263863757458,24.400111549000357,34.20924945000015,30.427500000000023,26.840200799999987,24.30949900000001,24.30949900000001,26.45016018667125,22.168837813328768,117358368,46.979971753443934,40.75897643592775,NaN,NaN,NaN,NaN,46.979971753443934,NaN,0.10122561548917841,-0.9682770058998287,-1.069502621389007,55.62499999999996,40.90277777777775,-1097872184,-736055670.0007465,17.244412959830132,28.769893260022588,45.10558249194329,35.714285714285715,71.42857142857143
2002-07-31,24.00301,24.19,23.36,23.85001,33.53948156766837,29.296633958613043,26.46586888708146,24.347720925286037,34.155749500000155,30.279300100000018,26.673000799999986,24.30449950000001,24.30449950000001,26.44895944556762,22.160039554432398,93840128,44.90573986123525,41.065209662704895,NaN,NaN,NaN,NaN,NaN,NaN,0.1371392754194185,-0.898078527114734,-1.0352178025341525,46.041875,49.09729166666663,-1191712312,-719094349.5157343,16.389859064608522,28.54395197741616,43.24638658936639,28.571428571428573,64.28571428571429
2002-08-01,23.74001,23.89999,22.66,22.73,33.431924537144305,29.166601602996945,26.31936422484297,24.193652265734986,34.097399550000155,30.12130010000002,26.50100079999999,24.20349950000001,24.20349950000001,26.44270026235779,21.96429873764223,85188496,40.24634808901225,41.038629191466114,NaN,NaN,NaN,NaN,NaN,NaN,0.09042165571869143,-0.9221907328857881,-1.0126123886044796,22.70833333333333,41.45840277777776,-1276900808,-794664711.950141,15.322524373650822,30.361374594992835,42.45594831928721,21.428571428571427,57.142857142857146
2002-08-02,22.78,22.84,21.82001,22.25,33.32066160642645,29.029639195016806,26.159781314064816,24.008542526141177,34.03384950000015,29.96380010000002,26.318000999999985,23.998999500000007,23.998999500000007,26.166266035556813,21.8317329644432,86720688,38.40708951048661,40.549651864499424,NaN,NaN,NaN,NaN,NaN,NaN,0.03499921937723971,-0.9688633643829299,-1.0038625837601696,12.70833333333332,27.152847222222217,-1363621496,-808268940.7042267,14.48680506378989,33.19708302612097,41.81890754130842,14.285714285714286,50
2002-08-05,22.11,22.32401,21.3,21.44,33.202446068054044,28.87934930996697,25.974691850768156,23.763919428413445,33.97879950000016,29.807400100000017,26.106200999999984,23.801999500000008,23.801999500000008,26.140817887165664,21.463181112834352,84911120,35.461940499973764,39.97903771566347,NaN,NaN,35.461940499973764,NaN,NaN,NaN,-0.04411349106044704,-1.0590044475857283,-1.0148909565252813,2.723735408560322,12.713467358408991,-1448532616,-869962403.0641645,13.680104258428571,34.1762878497812,41.833525536710674,7.142857142857143,100
2002-08-06,21.804,23.00999,21.78999,22.5,33.09595406737689,28.753025561254752,25.838429425247835,23.643546149516926,33.92464950000015,29.663800100000017,25.931400799999984,23.69399950000001,23.69399950000001,26.063645679526253,21.32435332047377,114818496,41.756284533091794,39.65866639149857,NaN,NaN,NaN,NaN,NaN,NaN,-0.014488012427676944,-1.0330009720598774,-1.0185129596322005,28.102978681548745,14.511682474480795,-1333714120,-851137816.531443,16.207243851231002,31.298609255488657,41.47732517107467,0,92.85714285714286
2002-08-07,23.201,23.37,21.96001,22.8,32.993506763223884,28.63514386697248,25.719275330140075,23.563208420991504,33.87089950000015,29.51950010000002,25.765400599999985,23.63900000000001,23.63900000000001,26.037850524756507,21.240149475243513,126214368,43.43764987934329,39.775767128910736,NaN,NaN,NaN,NaN,NaN,NaN,0.03327103657147168,-0.976924163917861,-1.0101952004893326,43.988140797241066,24.93828496245004,-1207499752,-826969831.4986981,16.90949915319392,28.941687942303247,40.553921464099275,0,85.71428571428571
2002-08-08,22.757,23.60001,22.3,23.57001,32.89974062627638,28.534844186438374,25.634990415232622,23.563856190420886,33.816499550000145,29.380800200000017,25.631200799999984,23.57750050000001,23.57750050000001,25.91645813325106,21.23854286674896,111674000,47.61748508738929,40.42083303322583,NaN,NaN,NaN,NaN,NaN,NaN,0.11981135665256593,-0.8604310046736252,-0.9802423613261911,66.96194690265483,46.35102212714821,-1095825752,-720449976.4668139,16.96400285027345,26.928227269606847,39.05567548931735,0,78.57142857142857
2002-08-09,23.207,23.717,22.88,23.33,32.80451932651244,28.43177796492474,25.54459863424311,23.541584172285564,33.75999955000015,29.240300200000014,25.487000999999985,23.50400050000001,23.50400050000001,25.776106154265126,21.231894845734896,93577808,46.46489642702521,41.1541634066578,NaN,NaN,NaN,NaN,NaN,NaN,0.16139224842372668,-0.7785020507965328,-0.9398942992202595,59.882005899704936,56.94403119986694,-1189403560,-713406485.5420829,16.826562207070413,25.68905721696362,37.13135005196729,42.857142857142854,71.42857142857143
2002-08-12,23.05,23.48,22.89999,23.39999,32.710941920278486,28.33213859928267,25.460496334861027,23.52809901302027,33.70009950000016,29.11370010000002,25.354200999999986,23.39549950000001,23.39549950000001,25.46041083517714,21.33058816482288,62889504,46.8687733793664,42.178791101370855,NaN,NaN,NaN,NaN,NaN,NaN,0.19202933268629996,-0.6998576333623845,-0.8918869660486844,61.946607669616455,62.930186823992074,-1126514056,-667867679.6853566,16.26789993385433,24.83614936062345,34.90024654157909,35.714285714285715,64.28571428571429
2002-08-13,23.23,23.87,22.55,22.60001,32.61033563251452,28.21863110226717,25.348320400160596,23.439709583208817,33.62909955000015,28.969500200000017,25.226601199999983,23.266000000000012,23.266000000000012,25.18414823206227,21.347851767937755,88333680,42.88626693739092,42.35181994585895,NaN,NaN,NaN,NaN,NaN,NaN,0.15824387715266564,-0.6940821196078524,-0.852325996760518,38.34837758112095,53.39233038348078,-1214847736,-749508075.8417202,17.267025106050855,22.967249346086753,31.968269867764665,28.571428571428573,57.142857142857146
2002-08-14,22.67,24.2,22.47,24.03999,32.52505856154423,28.135885733905443,25.297013325644492,23.49687914671274,33.56924955000015,28.843100200000016,25.120200999999984,23.185500000000008,23.185500000000008,24.809230913718324,21.561769086281693,102656880,50.96336848352597,43.46183659356661,NaN,NaN,NaN,NaN,NaN,NaN,0.228439055593192,-0.566777177269028,-0.79521623286222,80.82566371681412,60.3735496558505,-1112190856,-665840938.4646103,17.44062475162247,20.762137039643296,28.645353674143575,21.428571428571427,50
2002-08-15,24.243,24.55,23.72,24.53,32.445505740036324,28.064482056006327,25.26693437169765,23.595271608930574,33.52169960000014,28.732800200000014,25.01760099999998,23.175500000000007,23.175500000000007,24.76312151666098,21.587878483339033,120286688,53.37952389872124,44.56222081252987,NaN,NaN,NaN,NaN,NaN,NaN,0.29898200881017367,-0.4214887218495029,-0.7204707306596766,95.28023598820059,71.48475909537855,-991904168,-551351199.2838873,18.609321314433448,19.78087736705776,24.919385794238327,14.285714285714286,42.857142857142854
2002-08-16,24.13,25,23.731,24.7,32.368436031180245,27.997858648956697,25.24470165123892,23.700483836651472,33.47829960000015,28.62090020000002,24.934000999999984,23.210999500000007,23.210999500000007,24.898493489365315,21.5235055106347,95853008,54.22225170741466,45.25697071767292,NaN,NaN,NaN,NaN,NaN,NaN,0.34494123127096765,-0.28929419157096703,-0.6342354228419347,91.89189189189187,89.33259719896886,-896051160,-500818762.4422799,19.826004936606097,18.352706316408018,22.804036204163662,100,35.714285714285715
2002-08-19,24.77,25.59,24.67999,25.3,32.29810333435258,27.944435705413,25.246870213935434,23.852818709351332,33.43529965000015,28.517800200000014,24.874000999999986,23.306000000000004,23.306000000000004,25.223596599946227,21.388403400053782,76021504,57.16527447338872,45.98449234052612,NaN,NaN,NaN,NaN,NaN,NaN,0.39973799377547903,-0.13456293062258595,-0.534300924398065,93.24009324009326,93.47074037339523,-820029656,-473249992.28036946,22.203029808034437,17.383447391447685,21.884551786444995,100,28.571428571428573
2002-08-20,25.188,25.42999,24.85001,25.19,32.227375937990864,27.889892424117694,25.24464000946738,23.98016930846073,33.384549650000146,28.409100200000015,24.812800999999983,23.445500500000005,23.445500500000005,25.481441446615072,21.409559553384938,89981808,56.44876855015804,46.80899438973489,NaN,NaN,NaN,NaN,NaN,NaN,0.41097979327290746,-0.020576182806930632,-0.4315559760798381,90.6759906759907,91.93599193599194,-910011464,-457735352.46520317,21.42635446952746,16.775363945003573,20.822118897266787,92.85714285714286,21.428571428571427
2002-08-21,25.396,25.85001,25,25.75,32.162924436120306,27.847518316709422,25.264458048311795,24.148724612416853,33.33529960000015,28.29910020000002,24.77860079999998,23.552000500000005,23.552000500000005,25.822625989177723,21.281375010822288,101371120,59.249071546731365,48.16633177957197,NaN,NaN,NaN,NaN,NaN,NaN,0.43615400072780186,0.11363652482991426,-0.3225174758978876,97.80198285278492,93.90602225628963,-808640344,-380218365.26646453,22.890697997112653,15.897644432028013,19.758503470614666,100,14.285714285714286
2002-08-22,25.748,26.21001,25.42,26.16,32.103193844716124,27.814102112418148,25.29957734053486,24.340274649329533,33.28229965000015,28.209800200000018,24.74460079999998,23.747500500000005,23.747500500000005,26.20191495768731,21.293086042312698,80359312,61.215349806501436,49.79549322928731,NaN,NaN,NaN,NaN,61.215349806501436,NaN,0.4581743652564582,0.2502004806726852,-0.20797388458377303,98.98146846951431,95.81981399942997,-728281032,-310033023.7051173,24.01924648137608,15.106525759797155,18.582897195506913,100,7.142857142857143
2002-08-23,25.802,25.81,24.95,25.14999,32.0340077368085,27.76134741712274,25.293711170317806,24.417390397012436,33.21709960000015,28.11100010000002,24.69400079999998,23.871500000000005,23.871500000000005,26.346139513166595,21.396860486833415,75212880,54.26858681028832,51.13882510859549,NaN,NaN,NaN,NaN,NaN,NaN,0.385397625388237,0.27377314715152323,-0.11162447823671377,76.0177555757666,90.9337356326886,-803493912,-350264917.95814055,22.197257908509343,16.907062661987577,16.490032770193853,92.85714285714286,0
2002-08-26,25.3,25.39,24.61,25.25,31.96650517226314,27.711617765298527,25.291997006775933,24.496686549677918,33.15264960000015,28.01590020000002,24.646600799999977,23.942500000000003,23.942500000000003,26.488749147299956,21.39625085270005,83341808,54.81537019880974,52.07161694186106,NaN,NaN,NaN,NaN,NaN,NaN,0.32697945801560063,0.297099844282787,-0.0298796137328136,77.4115294117647,84.13691781901521,-720152104,-296840682.0607047,21.086827293800265,18.24187914728578,14.737631972991384,85.71428571428571,0
2002-08-27,25.431,25.51801,24.14999,24.37,31.89091805612122,27.645447116480735,25.25584026141217,24.484621163994305,33.08574960000015,27.915900200000024,24.56280079999998,23.945500000000003,23.945500000000003,26.49361473841463,21.397385261585374,92351808,49.23689766493161,52.48584892654594,NaN,NaN,NaN,NaN,NaN,NaN,0.21733614153263292,0.24179056318297754,0.02445442165034463,52.94104107150622,68.79010868634583,-812503912,-359487776.2727774,19.266392874829915,19.569994031303832,12.919054684975748,78.57142857142857,0
2002-08-28,24.026,24.093,23.39,23.48,31.80722732919464,27.562963015164286,25.186199466846986,24.38894295789961,33.01449960000015,27.802700200000025,24.452000799999983,23.926999500000004,23.926999500000004,26.482979552368153,21.371019447631856,115697120,44.32393692454076,52.25059548634248,NaN,NaN,NaN,NaN,NaN,NaN,0.08020004814307721,0.12470448182919114,0.04450443368611393,27.005275386964236,52.45261529007838,-928201032,-445561167.1120377,18.063351814982745,23.190408515929615,12.185235223259392,71.42857142857143,0
2002-08-29,23.2,24.22,23.02,23.78999,31.727453823431507,27.48825067823034,25.131446154421614,24.331899819052026,32.94344955000015,27.70470010000002,24.381000599999982,23.979999000000003,23.979999000000003,26.47779622958482,21.482201770415188,97065120,46.332593014578556,52.24114524259629,NaN,NaN,NaN,NaN,NaN,NaN,0.009418681706236914,0.056277785818910075,0.04685910411267316,35.293755899048406,38.41335745250628,-831135912,-418061000.86403763,16.68913949871504,23.771862142253415,11.946648909336997,64.28571428571429,21.428571428571427
2002-08-30,23.62,24.007,23.38,23.49001,31.645489208272984,27.409077595493105,25.06707610915018,24.251719836285165,32.86409960000015,27.601200200000022,24.32160059999999,24.041999500000003,24.041999500000003,26.423816723916477,21.66018227608353,59501808,44.653697034776606,52.08292550369701,NaN,NaN,NaN,NaN,NaN,NaN,-0.055010678671711964,-0.021904244226966796,0.03310643444474517,27.272921730155865,29.857317672056165,-890637720,-456683083.51131,16.004036290012703,22.796007213858733,11.708062595414603,57.142857142857146,14.285714285714286
2002-09-03,23.06,23.42999,22.34,22.64,31.555882350479223,27.314640415384332,24.971896653889388,24.09822270901991,32.77909960000015,27.497600200000026,24.258000399999986,24.1019995,24.1019995,26.26941582552332,21.934583174476682,81871504,40.20775841714965,51.89160346653692,NaN,NaN,NaN,NaN,NaN,NaN,-0.14705748034069333,-0.15071541598112148,-0.003657935640428163,7.751917953700395,23.439531860968216,-972509224,-493487291.1140952,14.803679150540303,27.869086375837988,12.883068924061208,50,100
2002-09-04,22.5,23.02,22.24001,22.73,31.468062625598833,27.223855456663852,24.883979138050588,23.967915784351348,32.69534960000015,27.389700200000025,24.186000399999983,24.113499500000003,24.113499500000003,26.24899957589437,21.977999424105636,82711872,40.87895738966975,51.171288388404335,NaN,NaN,NaN,NaN,NaN,NaN,-0.19126469781891842,-0.2427388079140762,-0.051474110095157774,12.342317380352618,15.789052354736294,-889797352,-472279907.3254825,14.0347979900388,27.08742771112627,14.52925669246431,42.857142857142854,100
2002-09-05,22.39999,22.5,21.92999,22.17,31.375544589523223,27.12377911098734,24.777548583617232,23.79668570965122,32.60934960000015,27.273500300000027,24.120200199999985,24.081999500000002,24.081999500000002,26.310625410318853,21.85337358968115,92293120,38.019136111728855,50.074117832190595,NaN,NaN,38.019136111728855,NaN,NaN,NaN,-0.24421512589024907,-0.3567430174579691,-0.11252789156772004,5.607684076242672,8.567306470098563,-982090472,-486850630.41595405,13.273315307161035,27.720310470567405,16.828567154191344,35.714285714285715,100
2002-09-06,22.66,23.22,22.60001,22.85001,31.29071339957772,27.03915001968066,24.701958835240085,23.706526118255866,32.52114960000015,27.150000400000025,24.068200399999988,24.045999500000004,24.045999500000004,26.32913822205306,21.762860777946948,86010880,43.2141988366485,49.28782834142158,NaN,NaN,NaN,NaN,NaN,NaN,-0.22017872305918268,-0.3877512953916984,-0.1675725723325157,21.495693945355416,13.148565133983572,-896079592,-503496778.726733,17.212011792781475,25.745887059248556,17.97190420456238,28.571428571428573,92.85714285714286
2002-09-09,22.677,23.37,22.39,23.08,31.2090147587859,26.960751009389952,24.63835260640714,23.64685696413626,32.44344960000015,27.030600400000022,24.005600199999986,24.0334995,24.0334995,26.33484636089223,21.732152639107774,72684320,44.896450936717976,48.41148380308796,NaN,NaN,NaN,NaN,NaN,NaN,-0.17736588727972963,-0.38927993143217776,-0.21191404415244813,26.86926696604217,17.990881662546755,-823395272,-473829709.3389783,16.062096394010734,25.45752016746599,18.718622687997225,21.428571428571427,85.71428571428571
2002-09-10,23.23,23.67,23.03,23.64999,31.133800582081562,26.895191385441635,24.59959328850882,23.647155348504235,32.36849955000016,26.923600200000024,23.956599799999985,24.0459995,24.0459995,26.33613517810694,21.755863821893062,74622128,48.93407165095565,47.87471973885921,NaN,NaN,NaN,NaN,48.93407165095565,NaN,-0.10292640825205335,-0.3405720544675148,-0.23764564621546147,40.18672809940137,29.517229670266317,-748773144,-403873796.28047895,17.44491237997787,24.315042123176458,19.024098248833607,14.285714285714286,78.57142857142857
2002-09-11,24.12,24.35001,23.42,23.45,31.05734485489667,26.82696977384873,24.554511198763375,23.628378648646688,32.28934955000015,26.813500100000024,23.928599599999988,24.088499000000002,24.088499000000002,26.299915412192608,21.877082587807397,73908496,47.61574728118338,47.043768005605784,NaN,NaN,NaN,NaN,NaN,NaN,-0.06146993712437221,-0.3144830676209267,-0.2530131304965545,35.51408638277389,34.190027149405815,-822681640,-473014053.4873481,21.098307322856638,22.71944991795749,18.000597402139395,7.142857142857143,71.42857142857143
2002-09-12,23.237,23.26401,22.71001,22.81,30.975281722012127,26.747425817930935,24.486098994890302,23.55043782496605,32.20214955000015,26.705700100000026,23.905799599999987,24.0269995,24.0269995,26.30771761237144,21.746281387628557,70772496,43.5703740868081,45.78341259705626,NaN,NaN,NaN,NaN,NaN,NaN,-0.07080010091705774,-0.3415132566428767,-0.27071315572581894,22.680611647908098,32.79380871002779,-893454136,-518239466.9059766,19.97510286102228,26.617784711810256,17.391825318393654,0,64.28571428571429
2002-09-13,22.60001,23.08,22.52,22.99001,30.895826281992107,26.67302154430854,24.427428838227936,23.497063746397856,32.116099600000155,26.60550030000002,23.870599799999987,23.95,23.95,26.26136906618558,21.63863093381442,79653632,44.986108204014236,45.12037841089383,NaN,NaN,NaN,NaN,NaN,NaN,-0.05898075071533504,-0.34443909411998774,-0.2854583434046527,29.543313582421543,29.246003871034514,-813800504,-464185943.27626145,19.14448410580065,26.921861234089224,17.631437832268702,0,57.142857142857146
2002-09-16,22.86,23.005,22.37,22.66,30.81387776177328,26.593555771153916,24.358117903395467,23.41734338959806,32.03564960000016,26.507100300000026,23.79699979999999,23.848000000000003,23.848000000000003,26.19770869686407,21.498291303135936,58853600,42.862999468278694,44.26663764442732,NaN,NaN,NaN,NaN,NaN,NaN,-0.06693874058303761,-0.3691317691334497,-0.3021930285504121,20.345761729310315,24.189895653213316,-872654104,-469283499.18177325,18.219327137367472,26.762397761973407,18.471333866186136,7.142857142857143,50
2002-09-17,23.05,23.21001,22.17999,22.17999,30.727968430810364,26.50615842915087,24.272701122870153,23.29950020963634,31.94679955000016,26.404700200000025,23.732999599999985,23.6919995,23.6919995,26.049662963715285,21.334336036284718,89176320,39.912404645327754,43.60060242874133,NaN,NaN,NaN,NaN,NaN,NaN,-0.09629569571923513,-0.422562648199456,-0.32626695248022086,10.330493136420356,20.073189482717407,-961830424,-558459819.1817732,18.350431780183037,24.679071942680295,19.466043317176595,0,42.857142857142854
2002-09-18,22.00999,22.55,21.78,21.92999,30.640426356871952,26.41554123253402,24.180830098443874,23.16907066586145,31.858199550000162,26.313600200000028,23.67839939999999,23.528999,23.528999,25.900588077423837,21.15740992257616,92396192,38.42866822189695,43.179511807123916,NaN,NaN,NaN,NaN,NaN,NaN,-0.12262798939670783,-0.4795519392261056,-0.3569239498293978,5.836164061618397,12.170806309116358,-1054226616,-614859894.7192279,17.26822646727473,26.287166505873383,20.05738131401369,64.28571428571429,100
2002-09-19,21.7,22.13,21.55,21.58,30.550272860783675,26.319787940800676,24.078836761249995,23.017730602446075,31.771249550000157,26.218200200000027,23.631999599999986,23.320499,23.320499,25.606039654671257,21.034958345328747,86253120,36.38917892301276,42.46926794344064,NaN,NaN,NaN,NaN,NaN,NaN,-0.15178573573485582,-0.5466561194979676,-0.39487038376311173,1.0714247449115388,5.746027314316766,-1140479736,-692190278.1675044,16.479841462435687,26.89748600929064,20.52247242420059,57.142857142857146,100
2002-09-20,21.83099,21.89999,21.48,21.67,30.46191193679578,26.22771293207195,23.98437257453431,22.889375306975023,31.675449550000156,26.11760020000003,23.569399599999986,23.095999,23.095999,25.08455910423509,21.107438895764908,78120192,37.31054485379799,41.94475707337074,NaN,NaN,NaN,NaN,NaN,NaN,-0.15276083952069636,-0.5858214331639822,-0.4330605936432858,6.620185992383345,4.509258266304427,-1062359544,-699628613.55187,15.913281343570926,26.545774531649574,21.060807850206597,50,100
2002-09-23,21.45,21.52,20.81,21.02,30.367962564290348,26.12458990371409,23.86812266965061,22.711339563453592,31.566299500000156,26.01220020000003,23.49379959999999,22.8894995,22.8894995,24.83936659242923,20.93963240757077,72763312,33.5328478872711,41.467977749807986,NaN,NaN,33.5328478872711,NaN,NaN,NaN,-0.1828973907629895,-0.6616823320970227,-0.47878494133403315,5.932186632241172,4.541265789845352,-1135122856,-729348839.5800389,14.791881299416865,30.16516975161867,21.31636702886642,42.857142857142854,100
2002-09-24,20.687,21.45,20.64999,21.03,30.2750475138994,26.023706935323712,23.756823741429017,22.551211985981823,31.456899500000155,25.917400300000033,23.402999399999988,22.6784995,22.6784995,24.46764813388651,20.889350866113492,91502128,33.644160915635865,40.95120657309128,NaN,NaN,NaN,NaN,NaN,NaN,-0.18719544623591622,-0.7127792491289284,-0.5255838028930122,10.270485024405327,7.607619216343281,-1043620728,-733922745.0296203,13.816487219856862,29.494932422716168,21.63481523619699,35.714285714285715,100
2002-09-25,21.35001,22.03999,21.10001,21.87,30.19141520032826,25.941455312842056,23.68283065352984,22.486334653983555,31.35759950000016,25.838700200000034,23.33659939999999,22.553499499999997,22.553499499999997,24.195769981418568,20.911229018581427,98052368,42.3742641738136,41.26228714895448,NaN,NaN,NaN,NaN,NaN,NaN,-0.1216778047089786,-0.6776810587792355,-0.5560032540702569,32.973065010459436,16.391912222368642,-945568360,-671334795.4987789,17.48592504934246,27.068197293732325,20.653742799551754,28.571428571428573,92.85714285714286
2002-09-26,22.16,22.33,21.37,21.60001,30.105928581419523,25.85548609872637,23.601151412214946,22.401922782175596,31.260599550000162,25.76500030000003,23.255599799999985,22.4595,22.4595,24.094081451063154,20.824918548936843,104434320,40.52859093112958,41.070458012845975,NaN,NaN,NaN,NaN,NaN,NaN,-0.08639522022009916,-0.6639972793453808,-0.5776020591252816,25.676077426608547,22.97320915382444,-1050002680,-725725494.7837788,18.474253724773938,24.9656012461682,20.302144748789864,21.428571428571427,85.71428571428571
2002-09-27,21.55,22.21001,21.31,21.31,30.018406903992464,25.765476473009016,23.511302337226123,22.29793013625411,31.16099955000016,25.69110030000003,23.187199799999988,22.335500500000002,22.335500500000002,23.923134695316403,20.7478663046836,92254624,38.58450457447651,40.6196047012573,NaN,NaN,NaN,NaN,NaN,NaN,-0.07299367255968836,-0.668844149824892,-0.5958504772652037,17.8380116864233,25.49571804116376,-1142257304,-817980118.7837788,17.13076492214008,23.634856654774765,19.82542803729054,14.285714285714286,78.57142857142857
2002-09-30,21.07001,21.24001,20.49001,20.72,29.925885442261194,25.665566047800915,23.401839500472157,22.14765107565848,31.05679955000016,25.580600300000032,23.12179959999999,22.197000000000003,22.197000000000003,23.839937223426066,20.55406277657394,91527008,34.91513469874893,39.61825206181396,NaN,NaN,NaN,NaN,NaN,NaN,-0.09298755977439876,-0.7120849269832021,-0.6190973672088034,5.958290155440344,16.49079308949073,-1233784312,-853373002.5973262,15.989839747551004,28.720847554752993,20.684193457814548,7.142857142857143,100
2002-10-01,20.91,21.99001,20.47,21.98,29.846821905522276,25.592584541903868,23.346081088688933,22.13168430654815,30.96789960000016,25.490900300000032,23.093399799999993,22.164,22.164,23.796499531429905,20.531500468570098,102096192,46.59557078817151,39.545382312313116,NaN,NaN,NaN,NaN,46.59557078817151,NaN,-0.014590330464766432,-0.6373352802897614,-0.622744949824995,54.044187386587794,25.946829742817147,-1131688120,-752621516.0688956,19.903756921239278,25.350398475669504,21.279617228513217,0,100
2002-10-02,21.50999,21.97,20.97,21.25,29.76128138904942,25.50659276879686,23.263881830308975,22.047714372591184,30.87359960000016,25.40780030000003,23.070399999999992,22.09,22.09,23.747153800985046,20.432846199014953,94883504,41.903482618927924,39.42631863603596,NaN,NaN,NaN,NaN,NaN,NaN,-0.005597064458751522,-0.6297412803984344,-0.6241442159396828,28.46704939033072,29.489842310786287,-1226571624,-794370257.8288953,18.36182246158196,23.386515318818464,21.120961056291993,0,92.85714285714286
2002-10-03,21.06,21.39999,20.67999,20.74001,29.671517494631015,25.412204991196923,23.164906464414507,21.92317109901107,30.77329965000016,25.30760050000003,23.012800199999994,22.018500500000002,22.018500500000002,23.776034171409357,20.260966828590647,74364624,38.95241348595633,38.99534044188897,NaN,NaN,NaN,NaN,NaN,NaN,-0.026523018879345606,-0.6572979895388649,-0.6307749706595193,9.854343597286237,30.788526791401583,-1300936248,-856336646.4608951,17.33107524883536,24.33479010630894,21.115693021351273,14.285714285714286,85.71428571428571
2002-10-04,20.94,21.02,20.11011,20.35001,29.578766176276478,25.311963506222725,23.0545183677708,21.773346232438588,30.668749750000156,25.185400500000032,22.974800399999996,21.893500500000002,21.893500500000002,23.74954874994882,20.037452250051185,81850368,36.81707755926694,38.56348887695956,NaN,NaN,NaN,NaN,NaN,NaN,-0.057386855115928226,-0.7025085395544295,-0.6451216844385013,7.738959321268496,15.353450769628486,-1382786616,-895025965.7996279,16.101003593686773,27.05291348304212,21.571864534873193,7.142857142857143,100
2002-10-07,20.25999,20.59,19.85001,20.16,29.485047109845866,25.20994442689158,22.941007843544494,21.619694210301578,30.566999800000158,25.058900500000036,22.924600399999996,21.747500500000005,21.747500500000005,23.665598435491756,19.829402564508253,79871312,35.787728887762384,38.2688691799906,NaN,NaN,NaN,NaN,NaN,NaN,-0.07996793901254384,-0.7450816082041811,-0.6651136691916373,11.481153633902316,9.691485517485685,-1462657928,-907979324.835723,15.158704788106647,27.526737932134747,22.590946714434295,0,100
2002-10-08,20.28,20.61,19.75999,20.2,29.39265858138969,25.110737606557095,22.83351733987608,21.484485237891903,30.47404985000016,24.932300500000032,22.852000399999994,21.575001,21.575001,23.39575185613475,19.75425014386525,94102624,36.192170085007064,38.109119313069904,NaN,NaN,NaN,NaN,NaN,NaN,-0.08131285251115217,-0.7667547348305774,-0.6854418823194253,17.120945054688537,12.113686003286452,-1368555304,-904656987.7499945,14.135352413270343,26.38338322219334,23.271035303246403,0,100
2002-10-09,19.94,20.53,19.84,20.06,29.299796306948,25.010723000486657,22.724751953998588,21.348819977140295,30.37694985000016,24.803600600000035,22.767000399999997,21.405501,21.405501,23.124842163386408,19.686159836613594,103305632,35.35287473154008,38.035097585107565,NaN,NaN,35.35287473154008,NaN,NaN,NaN,-0.08057869427772335,-0.7861652501665795,-0.7055865558888561,11.67349543386992,13.425198040820261,-1471860936,-942086564.5615892,13.347623487865674,24.913101229460935,23.71473044678974,35.714285714285715,92.85714285714286
2002-10-10,20.10001,21.21001,19.91,21.08,29.21800728896842,24.932886901467118,22.66025187737119,21.323218074555506,30.285749800000158,24.692300500000034,22.7116002,21.319001000000004,21.319001000000004,22.916771862206073,19.721230137793935,109583008,45.304782989344446,38.60611459478945,NaN,NaN,NaN,NaN,NaN,NaN,-0.004367754776559041,-0.7110462493595548,-0.7066784945829958,51.362056956976815,26.718832481845094,-1362277928,-854421675.4531058,17.305418098722896,22.3823046389594,22.83975382048288,28.571428571428573,85.71428571428571
2002-10-11,21.55,22.38,21.42,22.22,29.14837537564535,24.8791663687648,22.64298709786644,21.40862587697879,30.198399800000157,24.601200500000033,22.7014002,21.280500500000006,21.280500500000006,22.747077534491297,19.813923465508715,124799504,53.854900707489534,40.057689796233625,NaN,NaN,NaN,NaN,NaN,NaN,0.12282354026848508,-0.5531490692473895,-0.6759726095158746,93.89315307956839,52.30956849013838,-1237478424,-771222006.1197727,24.473793166874657,20.175173816575292,21.084903075843556,100,78.57142857142857
2002-10-14,21.87,22.5,21.78,22.48,29.082023381857834,24.831658123838764,22.636595446969714,21.510661507742714,30.110749850000158,24.512000600000032,22.7060002,21.271500500000005,21.271500500000005,22.70596215305925,19.83703884694076,78913376,55.561135818223086,41.62318800356129,NaN,NaN,NaN,NaN,NaN,NaN,0.21886127280244572,-0.4023960185128175,-0.6212572913152632,99.27007565665821,81.50842856440114,-1158565048,-696692706.5642171,24.040114826863817,19.054462388373167,19.32560030886525,100,71.42857142857143
2002-10-15,23.44,23.634,23.17999,23.56,29.02707787557069,24.80647677485186,22.672807390225802,21.70583660224341,30.02689985000016,24.427300600000034,22.748400199999995,21.340501000000003,21.340501000000003,23.04959763743001,19.631404362569995,118106128,61.868305133649024,43.01561950069239,NaN,NaN,NaN,NaN,NaN,NaN,0.3421697544836858,-0.1935450982106559,-0.5357148526943417,98.0898345641854,97.08435443347066,-1040458920,-617087287.676352,30.53440337524173,17.387339390229663,19.74898646125498,100,64.28571428571429
2002-10-16,22.718,23.16,22.07001,22.78,28.96491789670929,24.766348521884495,22.677011021981652,21.808137878220226,29.946249850000157,24.34270050000003,22.754000199999997,21.383001500000002,21.383001500000002,23.18819350199035,19.577809498009653,97493632,55.71766933385685,44.10055367231577,NaN,NaN,NaN,NaN,NaN,NaN,0.35662625025575306,-0.08993203987465037,-0.44655829013040343,77.9556583488427,91.77185618989544,-1137952552,-587571490.6289661,27.2226120442283,23.581379241784163,19.19355208556176,92.85714285714286,57.142857142857146
2002-10-17,23.60001,23.81,22.58,23.55,28.911038116642533,24.74226241254025,22.711245883864724,21.974029508865918,29.863449850000162,24.267200400000032,22.7690002,21.4815015,21.4815015,23.518981311445973,19.444021688554027,95857184,59.95048944281807,45.62669544862588,NaN,NaN,NaN,NaN,NaN,NaN,0.40020315223172437,0.05369565015925204,-0.34650750207247233,93.58026276478334,89.8752518926038,-1042095368,-532239294.9866893,29.47597136148986,21.507559081116415,19.170304946202837,100,50
2002-10-18,23.28,23.85001,22.92999,23.81,28.860281518466987,24.72380177070777,22.75433428057591,22.148883841354877,29.774999850000164,24.20250040000003,22.7738,21.5885015,21.5885015,23.865078469498275,19.311924530501724,85208000,61.29580656278396,47.51102915319981,NaN,NaN,NaN,NaN,NaN,NaN,0.4262886349675703,0.18635329163699055,-0.23993534333057975,99.02176517474237,90.18589542945614,-956887368,-454442377.5283736,27.81371725559586,20.084754492270612,18.289015127322568,100,42.857142857142854
2002-10-21,23.52,24.45,23.3,24.28999,28.814805980969805,24.715211438614546,22.814556073494504,22.352798713606795,29.688099800000163,24.14000040000003,22.792999799999997,21.752001,21.752001,24.29578628655138,19.20821571344862,85705312,63.71880201808976,48.73411709819397,NaN,NaN,NaN,NaN,NaN,NaN,0.45311104071441033,0.32645345756243316,-0.12665758315197717,96.58828019556462,96.39676937836344,-871182056,-392586990.69901705,29.805566170388264,18.442434993216565,19.111574765970115,100,35.714285714285715
2002-10-22,23.73801,24.34,23.64999,24.14,28.768290498572096,24.703821113097426,22.8665342666908,22.523008359929957,29.60274975000016,24.081000500000027,22.807799999999997,21.907501,21.907501,24.629701091851302,19.185300908148697,90275184,62.404114315083845,50.19844793363368,NaN,NaN,NaN,NaN,NaN,NaN,0.4377526771282156,0.4205332632582923,-0.01721941386992326,93.39020599103203,96.33341712044636,-961457240,-354644488.25435656,28.309778918934082,17.516904540584783,19.93413440461766,92.85714285714286,28.571428571428573
2002-10-23,23.85001,24.63,23.67,24.60001,28.726815070725607,24.701765447491535,22.93451370721273,22.720818039936628,29.51829975000016,24.037200600000034,22.847799999999996,22.0440015,22.0440015,25.00803312467777,19.07996987532223,88296880,64.80269359975077,52.044896513190416,NaN,NaN,NaN,NaN,64.80269359975077,NaN,0.4346923833283904,0.5261460652905647,0.09145368196217435,99.38419017620092,96.45422545426588,-873160360,-271864323.7360229,28.442551963375895,16.291881582374756,20.6736019367902,100,21.428571428571427
2002-10-24,24.67999,24.86,23.92,23.98,28.67958307997212,24.687473062392694,22.975513169674976,22.840740131371234,29.43264975000016,23.98340060000003,22.846600199999997,22.163000999999998,22.163000999999998,25.235301814711267,19.09070018528873,88944000,59.31031931441725,53.6515566385583,NaN,NaN,NaN,NaN,NaN,NaN,0.3695856019281542,0.5534356843723671,0.18385008244421291,82.74513187229047,91.83984267984114,-962104360,-349453770.5445337,28.1695874460132,15.172962805825222,21.002681734516763,100,14.285714285714286
2002-10-25,23.99001,24.75101,23.99001,24.62,28.63918921847986,24.686136962147295,23.040002849295565,23.010193452193022,29.348849750000163,23.933000600000028,22.8484002,22.328500999999996,22.328500999999996,25.552057726982746,19.104944273017246,71738688,62.81391134996055,55.581998243001024,NaN,NaN,NaN,NaN,NaN,NaN,0.34857082344567225,0.6195636117513033,0.270992788305631,95.29412687426107,92.47448297425085,-890365672,-302415438.6940212,26.558400014040977,14.30513018224211,21.074896439353974,92.85714285714286,7.142857142857143
2002-10-28,25,25.03999,24.17,24.49001,28.597903853121853,24.682253259926558,23.096865874813385,23.151128361507972,29.26704975000016,23.889100700000025,22.8442004,22.5170015,22.5170015,25.782909850840618,19.25109314915938,90285680,61.652740072028095,57.4006103849311,NaN,NaN,NaN,NaN,NaN,NaN,0.30636026122309595,0.653943114834501,0.347582853611405,89.42344119892543,89.154233315159,-980651352,-326281227.7601023,26.991084220487295,13.375491349137134,21.325025075675537,100,0
2002-10-29,24.31,24.47,23.37,23.92,28.551357546125615,24.667159135967616,23.129145644428547,23.224354231840547,29.186849700000156,23.845300700000024,22.8166004,22.6140015,22.6140015,25.925274396046177,19.302728603953824,90364128,56.70277666624658,58.925603380267276,NaN,NaN,56.70277666624658,NaN,NaN,NaN,0.2242980343654677,0.6279553965682396,0.40365736220277193,78.16779369940296,87.62845392419649,-1071015480,-326281227.760102,24.76023825286852,18.173596376131965,20.261690105148496,92.85714285714286,0
2002-10-30,24.06799,24.78999,23.85001,24.56,28.511642545666653,24.66503717287915,23.185257579941155,23.351558590712877,29.10794970000016,23.808400700000025,22.804000399999996,22.7795015,22.7795015,26.13214958861451,19.426853411385487,103512000,60.53414016146603,60.01341460684739,NaN,NaN,NaN,NaN,NaN,NaN,0.19826818450776768,0.6514925928374815,0.45322440832971383,86.74057110655,84.77726866829279,-967503480,-273422911.6257164,25.405421551989853,16.910363028989252,20.781926255782388,85.71428571428571,0
2002-10-31,24.66,25.03999,24.36,24.55,28.47222321685405,24.66275920905976,23.238776890531696,23.46569586778784,29.03679970000016,23.779300600000024,22.7800004,22.970001,22.970001,26.270018702994157,19.669983297005842,81518624,60.44413815114047,60.484074424251034,NaN,NaN,NaN,NaN,NaN,NaN,0.16678949598841925,0.6617112783152379,0.49492178232681866,84.96958579627547,83.29265020074281,-1049022104,-309386340.5199057,25.98897396306358,16.041680358139345,21.78472405221591,78.57142857142857,0
2002-11-01,24.37801,25.39999,24.14,25.25,28.44016129429829,24.67438773957343,23.31764838502065,23.63562959466519,28.96479975000016,23.753200600000024,22.76180039999999,23.2150005,23.2150005,26.42698218426572,20.003018815734276,86668816,64.43079383279976,61.11762142529222,NaN,NaN,NaN,NaN,NaN,NaN,0.17847614013688073,0.7180169574979196,0.5395408173610389,95.49576874335585,89.06864188206043,-962353288,-243351744.96902025,26.229104055659068,14.550172254116061,23.00403012887056,100,0
2002-11-04,26.05,26.82001,25.8,25.89999,28.414885958036614,24.698657091265044,23.418916683647293,23.85128296660184,28.90134970000016,23.735400600000027,22.776800399999992,23.502,23.502,26.594342089756488,20.40965791024351,110564816,67.68738541421882,61.5332700167615,NaN,NaN,NaN,NaN,NaN,NaN,0.2130070407596386,0.8057996183105871,0.5927925775509485,80.63115789473683,87.03217081145606,-851788472,-332239565.7398758,33.35249398114939,12.93617878936026,24.1948914946097,100,7.142857142857143
2002-11-05,25.71001,26.17,25.56,26.10001,28.39185236641436,24.72640665381425,23.524057598014064,24.065447445973092,28.844849800000155,23.720200700000028,22.79380059999999,23.7970005,23.7970005,26.692474349320342,20.901526650679656,79619184,68.63893485618,62.45621755407029,NaN,NaN,NaN,NaN,NaN,NaN,0.2308445915826185,0.8813483170292216,0.6505037254466031,83.01890797427367,86.3819448707888,-772169288,-270891026.619089,31.87314494019558,14.107508676405523,26.442747222788142,92.85714285714286,0
2002-11-06,26.28999,26.61,25.64,26.47,28.372729457295808,24.76093325472882,23.63958475103312,24.294452451118513,28.785049850000156,23.699300700000027,22.835800599999992,24.1175005,24.1175005,26.68826663679622,21.546734363203775,116768000,70.37671080947621,63.20094765168873,NaN,NaN,NaN,NaN,70.37671080947621,NaN,0.2476049470655438,0.9600099092785328,0.712404962212989,91.00235988503913,84.88414191801655,-655401288,-187829253.4232129,32.825307664575895,13.111589134077612,28.391704056968326,85.71428571428571,0
2002-11-07,25.99001,26.10001,25.31,25.53999,28.344542995034157,24.776360120971813,23.714110447071036,24.41307507482151,28.71804980000016,23.66450060000003,22.877000399999993,24.3405,24.3405,26.569700942068483,22.111299057931515,82741376,61.197249465726216,63.193907859041744,NaN,NaN,NaN,NaN,NaN,NaN,0.17928422712581704,0.9365102461202603,0.7572260189944433,63.63589876165123,79.21905554032135,-738142664,-222394811.22789887,30.08964853831274,14.389747664769667,29.76033851524818,78.57142857142857,0
2002-11-08,25.49001,25.87,24.96001,25.07001,28.31196057717312,24.78217497006148,23.767282978558445,24.47564030579089,28.649249850000157,23.64180070000003,22.90260079999999,24.483000499999996,24.483000499999996,26.506671468349005,22.459329531650987,77013632,57.14110592667765,62.724072423940875,NaN,NaN,NaN,NaN,NaN,NaN,0.09016723730633858,0.8699350656273666,0.779767828321028,49.27550934634971,67.97125599768002,-815156296,-280789558.3610323,28.110471599481123,15.973049468173711,30.044715714997242,71.42857142857143,0
2002-11-11,24.95,25.02,24.14999,24.31,28.272140073917665,24.772824970654323,23.788565999007133,24.45986503857271,28.575549850000158,23.620300600000032,22.919000599999993,24.574500499999996,24.574500499999996,26.38152535376885,22.76747564623114,74621504,51.228027252605735,61.925780490906725,NaN,NaN,51.228027252605735,NaN,NaN,NaN,-0.02602733812770497,0.7472336556613968,0.7732609937891017,27.246297836817806,46.719235314939574,-889777800,-327962672.44588196,26.231840118933402,20.78955580670662,29.189183774919258,64.28571428571429,35.714285714285715
2002-11-12,24.39999,25.39999,24.39999,24.92999,28.23888484930157,24.77593714945325,23.833327724536264,24.504638844422928,28.51029980000016,23.61140040000003,22.964800399999994,24.642999999999997,24.642999999999997,26.394000399817056,22.89199960018294,88867632,55.29242490541377,61.24647558416836,NaN,NaN,NaN,NaN,NaN,NaN,-0.06497481036150854,0.6920424808372161,0.7570172911987246,45.21697038559307,40.579592522920194,-800910168,-322630614.52588177,26.909879259289447,19.156158572497457,28.451324233163625,57.142857142857146,28.571428571428573
2002-11-13,24.7,25.45,24.493,25.23,28.2089456965722,24.78492849302843,23.888099186319156,24.573720859239792,28.445099800000158,23.60040040000003,23.014800399999995,24.765499999999996,24.765499999999996,26.308463836309805,23.222536163690187,119372624,57.15314295150111,61.09239155824577,NaN,NaN,NaN,NaN,NaN,NaN,-0.07373588931484654,0.6648474295551665,0.738583318870013,53.912887209022585,42.12538514381115,-681537544,-258141955.58335268,25.41039217550079,17.83148683508129,27.561391287043843,50,21.428571428571427
2002-11-14,25.58,26.42,25.52,26.10001,28.187961261780437,24.810969710988264,23.97484078685566,24.719081729788382,28.38304990000016,23.60680040000003,23.093400599999995,24.893000499999996,24.893000499999996,26.434560498241787,23.351440501758205,86195872,62.081717296009536,61.04009198296355,NaN,NaN,NaN,NaN,NaN,NaN,-0.026573324148821853,0.7053666636839857,0.7319399878328076,79.13049527392675,59.42011762284747,-595341672,-233239010.43064156,30.16525096210972,16.32020595106662,27.546946467520687,42.857142857142854,14.285714285714286
2002-11-15,25.90199,26.45,25.75,26.44,28.170568612409486,24.84322773651325,24.071513697175046,24.882978707903774,28.324549900000157,23.616700400000028,23.165200399999993,25.024500499999995,25.024500499999995,26.62177996902819,23.4272210309718,69316128,63.83255831858472,61.19579328628903,NaN,NaN,NaN,NaN,NaN,NaN,0.01940468593607725,0.7561958452529041,0.7367911593168268,88.98524931811795,74.0095439336891,-526025544,-165903343.2306412,28.84657820901073,15.488621862767838,27.289774425294418,35.714285714285715,7.142857142857143
2002-11-18,26.715,26.77,25.99001,26.05,28.14946842721138,24.867124216978333,24.149101395325044,24.99412359286532,28.270199900000158,23.615100300000027,23.224600399999996,25.112500999999998,25.112500999999998,26.73199291419881,23.493009085801187,76934816,60.3880127201298,61.45902443299498,NaN,NaN,NaN,NaN,NaN,NaN,0.015599512966389062,0.7562905505248132,0.7406910375584241,74.07373737373739,80.72982732192736,-602960360,-231003854.65791604,29.54837985216804,14.596150002004896,28.613324699338015,28.571428571428573,0
2002-11-19,25.8,26.05,25.3,25.64999,28.124597995099826,24.882626509711436,24.207959771978963,25.05658706021148,28.21689985000016,23.610600100000028,23.264600399999996,25.188000499999998,25.188000499999998,26.759172230963358,23.616828769036637,88217872,56.991075908591014,61.20594841493248,NaN,NaN,NaN,NaN,NaN,NaN,-0.019883690486887096,0.7158364244498152,0.7357201149367023,56.34270021380513,73.13389563522016,-691178232,-236887398.6011698,27.884573879566144,18.954670062371573,28.54115432832206,21.428571428571427,0
2002-11-20,25.56,26.75,25.53999,26.74001,28.110821000123707,24.919406380806258,24.30725585935234,25.216913054477054,28.17029990000016,23.629500100000026,23.330400599999997,25.295000499999997,25.295000499999997,26.978860571436634,23.61114042856336,75625504,63.084889976434,61.394573545310585,NaN,NaN,NaN,NaN,NaN,NaN,0.021773570987302704,0.7629370786708307,0.741163507683528,97.01493651143099,75.81045803299116,-615552728,-162510642.60318613,30.554977784382437,17.265545456927274,28.835687821672558,14.285714285714286,7.142857142857143
2002-11-21,26.92999,29.7,26.75,27.73,28.107031736440884,24.975061699998214,24.441481119769893,25.45625466833638,28.132999900000158,23.66730010000003,23.428800599999995,25.4825005,25.4825005,27.362595973686798,23.602405026313203,105595376,67.57803991999026,61.619376837252766,NaN,NaN,NaN,NaN,NaN,NaN,0.10316393165273852,0.8701184222494511,0.7669544905967126,64.50456846023702,72.62073506182439,-509957352,-197947734.88793185,43.694294970688496,13.98287123243001,30.469540764200797,100,0
2002-11-22,27.37,27.94,27.32001,27.72,28.103180674386746,25.029416913859635,24.570050487622055,25.671849461828156,28.09074990000016,23.69700010000003,23.523400399999996,25.637500499999998,25.637500499999998,27.709011632043087,23.56598936795691,73821632,67.48868230490214,61.605183758015855,NaN,NaN,NaN,NaN,NaN,NaN,0.14113945482674606,0.9433788091301452,0.8022393543033991,64.3243886047052,75.28129785879108,-583778984,-176516493.18455,41.89743576132516,13.407847628909497,30.998599135212523,92.85714285714286,35.714285714285715
2002-11-25,27.75999,28.205,27.53999,27.99001,28.10205459802469,25.088042519525782,24.704166546930995,25.89262665593976,28.047549950000157,23.713500200000027,23.630000599999995,25.8125005,25.8125005,28.051288491342255,23.573712508657742,72711008,68.69244174958534,61.60900567897338,NaN,NaN,NaN,NaN,68.69244174958534,NaN,0.16746055794839387,1.0115650517388914,0.8441044937904976,69.18942488391917,66.00612731628713,-511067976,-150818731.93247795,41.80454351623849,12.799822624271625,32.03293867988965,85.71428571428571,28.571428571428573
2002-11-26,27.78,27.92999,26.89999,27.05,28.09158639306922,25.12689316270349,24.7961600156788,26.002852688707403,28.00114995000016,23.730200200000027,23.727400799999995,25.9690005,25.9690005,28.091303975984932,23.846697024015068,80053632,60.31912573371089,60.89060674499014,NaN,NaN,NaN,NaN,NaN,NaN,0.10749477458766032,0.978472962025073,0.8709781874374126,52.2523382840752,61.922050590899865,-591121608,-207554217.6483612,38.70617148132454,16.20282141998343,31.894954017644817,78.57142857142857,21.428571428571427
2002-11-27,27.53,28.2,27.487,27.91,28.089779563287436,25.182004189184607,24.918271387612965,26.184485765973363,27.955949950000157,23.762700200000026,23.847000999999995,26.1365005,26.1365005,28.31557974917341,23.95742125082659,73686816,64.57377763133366,61.13178732824781,NaN,NaN,NaN,NaN,NaN,NaN,0.11121697860026791,1.0099994106877475,0.8987824320874795,67.74780585980928,63.06318967593455,-517434792,-193808991.10137638,37.52350939280045,14.944371891807219,32.44761042938789,71.42857142857143,14.285714285714286
2002-11-29,28.21001,28.28999,27.22,27.72,28.08610016464776,25.23226153197303,25.028143097902653,26.33072521683304,27.91014995000016,23.800900300000027,23.969800999999997,26.295000500000004,26.295000500000004,28.4504574678324,24.139543532167608,34652096,62.96743337231827,61.547953574364996,NaN,NaN,NaN,NaN,NaN,NaN,0.08740042217249011,1.0080329598030922,0.920632537630602,64.3243886047052,61.44151091619656,-552086888,-196075647.98512298,34.81414480546754,15.667075849099504,33.19020366245332,64.28571428571429,7.142857142857143
2002-12-02,28.42,28.78999,27.57001,28,28.085243446591562,25.287068234310198,25.14468650582804,26.489703767610848,27.87124995000016,23.832900300000023,24.096400999999993,26.432500500000003,26.432500500000003,28.65361940500655,24.21138159499346,85998624,64.37393239000218,62.486946798464736,NaN,NaN,NaN,NaN,NaN,NaN,0.07736670621094155,1.017340920394279,0.9399742141833374,67.92458882153053,66.66559442868167,-466088264,-221452707.15002728,35.316631391502625,14.391172289369027,35.37040867139793,57.142857142857146,0
2002-12-03,27.55,27.58,26.92999,27.17,28.076136546625477,25.32435401184861,25.224110564423018,26.554493884981245,27.833700000000157,23.85660030000002,24.219400999999994,26.496001,26.496001,28.725195372896952,24.266806627103048,76699120,57.412954402084935,62.63841319108411,NaN,NaN,NaN,NaN,NaN,NaN,0.00548385039553223,0.9468290271777526,0.9413451767822204,51.41156135970814,61.220179595314626,-542787384,-241510988.42077643,32.79405227220927,17.635640030328577,36.31517692266773,50,0
2002-12-04,26.56,26.95,26.21001,26.57001,28.06115021282821,25.34902046705953,25.276890934445646,26.555971610221125,27.790800100000155,23.866600300000027,24.33020119999999,26.519501,26.519501,28.74139934244383,24.297602657556173,130339872,52.95516876676226,62.338557892174194,NaN,NaN,NaN,NaN,NaN,NaN,-0.08673042793031083,0.8329321418693318,0.9196625697996427,28.86386363636363,49.40000460586743,-673127256,-245031973.89528283,30.67695264396633,21.338851438582747,36.34558115229128,42.857142857142854,0
2002-12-05,26.95,27,26.13,26.2,28.04263130523788,25.365871546919735,25.31309128995758,26.522069552104828,27.754400100000158,23.876700300000024,24.41680119999999,26.506001000000005,26.506001000000005,28.73221512989722,24.27978687010279,85192496,50.35838827646461,61.50117724792098,NaN,NaN,NaN,NaN,NaN,NaN,-0.17197956064007225,0.7046881189995524,0.8766676796396247,20.45454545454543,33.5766568168724,-758319752,-316515332.6079265,28.858676471339145,20.619156281508044,35.4076774099107,35.714285714285715,21.428571428571427
2002-12-06,25.81,26.72,25.74001,26.47,28.026983232548947,25.3877354766837,25.35846025897885,26.51711054714246,27.71850015000016,23.884900400000024,24.514200999999993,26.552501499999998,26.552501499999998,28.734473986107638,24.37052901389236,81765008,52.200374440337804,60.67030697090335,NaN,NaN,NaN,NaN,NaN,NaN,-0.2071582553842808,0.6177198604092737,0.8248781157935545,26.590909090909058,25.30310606060604,-676554744,-276467591.110646,26.922894437106248,21.90545374360348,33.98954966919172,28.571428571428573,14.285714285714286
2002-12-09,26.22,26.55,25.2,25.22,27.99905305113055,25.384413982095907,25.35303044490125,26.39357620931937,27.66955020000016,23.889800400000027,24.59240099999999,26.560001,26.560001,28.72248447973238,24.39751752026762,75950496,44.05095373879283,59.50337418652214,NaN,NaN,NaN,NaN,NaN,NaN,-0.30564033776375243,0.442827693588864,0.7484680313526164,0.444444444444435,15.829966329966306,-752505240,-350167702.0439794,24.486214421403567,23.54318345752158,31.710432772270444,21.428571428571427,100
2002-12-10,25.42,25.95,25.35001,25.60001,27.97518197599492,25.388683210173216,25.36271591765022,26.317998475098477,27.623150250000158,23.90590040000003,24.690001199999994,26.624501499999997,26.624501499999997,28.581925620146283,24.667077379853712,69645504,46.7715651287077,58.773409130816184,NaN,NaN,NaN,NaN,NaN,NaN,-0.33391711727645446,0.33107163475704837,0.6649887520335028,8.88911111111115,11.974821548821547,-682859736,-361774318.72919065,23.260284753658166,22.36446768802641,30.488892853278884,14.285714285714286,92.85714285714286
2002-12-11,25.44,26.07001,25.32001,25.72,27.95274235434323,25.395243938684636,25.376727058134524,26.261046239374814,27.57975030000016,23.929100500000033,24.764801199999994,26.664002,26.664002,28.511870711814506,24.816133288185494,64276704,47.63738953784841,57.67001624234579,NaN,NaN,NaN,NaN,NaN,NaN,-0.3325410618388912,0.2493124247348888,0.58185348657378,11.555555555555546,6.963037037037044,-618583032,-357490919.1746308,22.879283821031784,21.190622795915335,28.77757501916009,7.142857142857143,85.71428571428571
2002-12-12,26,26.17,25.56,25.86,27.931919047334837,25.404447029007713,25.39567893820768,26.222851359434355,27.540150300000153,23.963700600000028,24.857001199999992,26.695501999999998,26.695501999999998,28.464304213958282,24.926699786041713,62382400,48.68617860799136,56.320597577203,NaN,NaN,NaN,NaN,NaN,NaN,-0.31061639922617623,0.19358298754105974,0.504199386767236,18.384452324379737,12.943039663682145,-556200632,-358513581.4697129,22.5941420218919,20.259239299736155,25.48723670660908,0,78.57142857142857
2002-12-13,25.52,25.57001,25.00999,25.03999,27.90314363392852,25.397230058136273,25.381730352395614,26.11019789663108,27.48665020000016,23.977900500000032,24.94300079999999,26.642501,26.642501,28.53845635288028,24.746545647119717,72695632,43.2250973397489,54.58748436540634,NaN,NaN,43.2250973397489,NaN,NaN,NaN,-0.3375192326082151,0.08230034600696712,0.4198195786151822,0.7936507936508235,10.24455289119537,-628896264,-423420673.9175538,21.19610170654116,23.009455674605217,22.100720569128306,35.714285714285715,100
2002-12-16,25.22,25.96001,25.07001,25.85001,27.882714443541172,25.40619599757912,25.400094260144805,26.08541809695193,27.43015030000016,24.013900600000035,25.053000799999992,26.613001499999996,26.613001499999996,28.538767031971936,24.687235968028055,60359200,49.277587971348545,53.20070909553228,NaN,NaN,NaN,NaN,NaN,NaN,-0.2888219223963228,0.058792175619778675,0.3476140980161015,22.222751322751385,13.800284813593981,-568537064,-377981725.60294694,22.621890834396247,21.461555485561178,18.494590720768088,28.571428571428573,92.85714285714286
2002-12-17,25.81,26.2,25.66,25.92999,27.863284349575586,25.4165681560429,25.420874485237164,26.070615421051745,27.372700250000157,24.04650050000003,25.16840059999999,26.607000999999997,26.607000999999997,28.540478608909854,24.67352339109014,62797104,49.846116982971346,52.452637041908034,NaN,NaN,NaN,NaN,49.846116982971346,NaN,-0.24122386397735868,0.04608426804440313,0.2873081320217618,24.338624338624378,15.785008818342193,-505739960,-377984051.4216135,23.51191357018216,20.586181607161247,16.041133860995032,21.428571428571427,85.71428571428571
2002-12-18,25.55,25.60001,25.05,25.38,27.838575052564885,25.41584403414106,25.41927156424747,26.004842523808723,27.311600200000157,24.062000500000025,25.27200059999999,26.593501500000002,26.593501500000002,28.557054147149998,24.629948852850006,67548496,46.02569637850208,51.12777409527721,NaN,NaN,NaN,NaN,NaN,NaN,-0.23646337985517357,-0.00827109279720517,0.2281922870579684,9.788624338624352,18.78333333333337,-573288456,-364475825.9801856,21.941320053470694,23.841527053217757,13.263724530006597,14.285714285714286,78.57142857142857
2002-12-19,25.17101,25.78,24.81,25.06,27.81092753960404,25.408797617623414,25.40518248329659,25.914857521541226,27.248500250000156,24.069500500000025,25.37200059999999,26.509501,26.509501,28.5815403539011,24.4374616460989,96176496,43.91663707625092,49.767002931272394,NaN,NaN,NaN,NaN,NaN,NaN,-0.24358583746876544,-0.07629000977798839,0.16729582769077705,6.281422817645269,13.469557164964668,-669464952,-411076808.5781239,20.329277682926033,23.90770505135256,11.13230513746324,7.142857142857143,100
2002-12-20,25.33,25.45,25.07001,25.32001,27.786142290453753,25.407039446977404,25.40184238591241,25.858205376632537,27.181750300000157,24.08420050000003,25.456800799999993,26.3890015,26.3890015,28.443343431648668,24.33465956835133,65596624,46.078724910161995,48.4602023969981,NaN,NaN,NaN,NaN,NaN,NaN,-0.22021285716726707,-0.10797024376830677,0.11224261339896029,18.411913357400767,11.493986837890128,-603868328,-390359813.7986822,19.702501303852163,23.170601400265234,8.703183108867742,0,92.85714285714286
2002-12-23,25.17999,25.75999,25.13,25.67,27.765086148260185,25.412246586641217,25.41235837077859,25.840281055048486,27.117450300000158,24.11360050000003,25.52580079999999,26.286501499999996,26.286501499999996,28.268262586037093,24.3047404139629,46003808,48.932589668694135,47.85446205889876,NaN,NaN,NaN,NaN,NaN,NaN,-0.17270695438854916,-0.10364107958672619,0.06906587480182298,39.26940639269418,21.32091418924674,-557864520,-357498699.11736935,21.204332793872815,21.991118306666056,6.686250840987276,0,85.71428571428571
2002-12-24,25.5,25.73,25.32001,25.35001,27.741055539819786,25.411014178984956,25.40991333663041,25.793588573615295,27.05420035000016,24.144600600000032,25.58320099999999,26.1545015,26.1545015,28.012644666209354,24.296358333790643,16773102,46.50891195919816,47.394015144072746,NaN,NaN,NaN,NaN,NaN,NaN,-0.154928265577434,-0.12459445716996953,0.030333808407464483,24.65799086758,27.44643687255832,-574637622,-371817140.95492625,20.47390159134325,21.233584497615972,5.534038256042129,7.142857142857143,78.57142857142857
2002-12-26,25.53,25.91,25.17,25.28,27.71656742499571,25.408419838807035,25.404818695978236,25.744675376128125,26.995200350000154,24.18300060000003,25.617600999999986,26.0660015,26.0660015,27.913684938289737,24.21831806171026,33816800,45.97239659021471,47.08073002362632,NaN,NaN,NaN,NaN,NaN,NaN,-0.1404077543575868,-0.14517588453951902,-0.004768130181932215,24.60732984293206,29.511575701068747,-608454422,-395580297.71168303,20.715536248075168,19.90106330265168,4.487775271781662,0,71.42857142857143
2002-12-27,25.17999,25.85001,24.75,24.82001,27.687745958080328,25.396768158830657,25.381885021626147,25.656612006973067,26.93500040000016,24.206200700000025,25.658401199999986,25.911502000000002,25.911502000000002,27.628734242925443,24.19426975707456,42540608,42.503113579713826,46.38806853358176,NaN,NaN,NaN,NaN,NaN,NaN,-0.15325818978457237,-0.19634086741264767,-0.04308267762807531,3.889444444444438,17.718255051652164,-650995030,-432705922.2732052,18.824405019930065,21.569890485897876,4.239278431044189,0,100
2002-12-30,24.84,24.97,24.36,24.63,27.657320625164104,25.38158463093302,25.352399334503552,25.558839434880394,26.87200040000016,24.224500700000025,25.68000119999999,25.757002,25.757002,27.34688314277246,24.16712085722754,57458704,41.12261470688491,46.17890145987405,NaN,NaN,NaN,NaN,NaN,NaN,-0.16501176395406333,-0.24934738257065447,-0.08433561861659114,14.673913043478239,14.390229110284908,-708453734,-439299544.04369706,17.85118630075858,23.760130186490777,5.1133415586270194,0,100
2002-12-31,24.53999,24.71001,24.28,24.37,27.624610967202273,25.361553252102663,25.313873870405374,25.44561663155845,26.80665040000016,24.232500600000026,25.691201199999988,25.575502,25.575502,26.907605581611914,24.243398418388086,46028000,39.244278899735995,45.64123815780464,NaN,NaN,39.244278899735995,NaN,NaN,NaN,-0.17955220805936348,-0.3087758786907955,-0.129223670631432,4.687499999999997,7.750285829307554,-754481734,-466060457.23176247,17.177014950613923,23.56541103001952,6.093092604298259,35.714285714285715,100
2003-01-02,24.72,25.55,24.45,25.39999,27.60247543519031,25.362314375823402,25.317250973526733,25.441271238076695,26.746750350000156,24.253200500000027,25.713401199999986,25.487001499999998,25.487001499999998,26.600934494470664,24.373068505529332,66305120,49.15270576371083,45.74947503108053,NaN,NaN,NaN,NaN,NaN,NaN,-0.11234379019284743,-0.2696534083724913,-0.15730961817964387,58.332812499999946,25.898075181159395,-688176614,-417839757.32485354,22.59955572686721,21.19940906675214,6.047733985681416,28.571428571428573,92.85714285714286
2003-01-03,25.46001,25.71001,25.28,25.67999,27.58334622687996,25.36860498224274,25.33147603338843,25.464006358259866,26.69485030000016,24.276000500000027,25.744200999999986,25.4425005,25.4425005,26.44539271264203,24.439608287357974,39091296,51.46977769117059,45.94830353702191,NaN,NaN,NaN,NaN,NaN,NaN,-0.04502650116618995,-0.21359274463738132,-0.16856624347119137,72.91614583333336,45.31215277777776,-649085318,-384206570.23357666,23.153445998336796,20.395769326871243,6.11085810895996,21.428571428571427,85.71428571428571
2003-01-06,25.71001,26.59,25.2,26.32001,27.570775717159762,25.387444685564667,25.370242071294765,25.54553051461607,26.641350350000153,24.31320050000003,25.778600999999984,25.448501,25.448501,26.470700712480415,24.426301287519586,67359312,56.364538144916,46.88683502310528,NaN,NaN,NaN,NaN,NaN,NaN,0.04190840249885458,-0.11618074034762316,-0.15808914284647774,88.3121212121212,73.1870265151515,-581726006,-343014654.84779245,27.834754409707212,18.018022056514386,7.347082967340782,100,78.57142857142857
2003-01-07,26.41,26.92999,26.25,26.64999,27.561613670222847,25.412445582880217,25.420428264577325,25.65071713227168,26.591200350000154,24.339300500000032,25.83200079999999,25.457500500000002,25.457500500000002,26.517968043217316,24.397032956782688,88784000,58.67858981642167,47.55833515489621,NaN,NaN,NaN,NaN,NaN,NaN,0.11670042944312767,-0.01221360604256816,-0.12891403548569583,89.43392239215993,83.5540631458715,-492942006,-327347965.3964773,29.117290414281932,16.975420089623068,9.04066474632255,100,71.42857142857143
2003-01-08,26.39,26.97,25.84,25.89999,27.54508010136491,25.42209992777368,25.439234607142918,25.67445740538866,26.542900300000156,24.35300040000003,25.857600599999987,25.491500000000002,25.491500000000002,26.562875583181878,24.420124416818126,75091008,51.93691290315854,47.70767772062387,NaN,NaN,NaN,NaN,NaN,NaN,0.11077303041047888,0.009552252527402771,-0.10122077788307611,60.222676579925626,79.32290672806892,-568033014,-394466036.1045836,26.384987078237277,18.78721892195474,9.768162226095981,100,64.28571428571429
2003-01-09,26.24001,26.98,26.224,26.7,27.5366713441374,25.447404879698954,25.488676387254962,25.77212812868498,26.496950300000154,24.373000400000034,25.90180039999999,25.546499500000003,25.546499500000003,26.740436443986873,24.352562556013133,75427872,57.54068069195948,48.530176600156544,NaN,NaN,NaN,NaN,NaN,NaN,0.15322852597313197,0.09031487958333884,-0.06291364638979312,89.62962962962959,79.76207620057171,-492605142,-374910661.8823616,24.142592684309594,17.13247054182486,10.684836381530342,100,57.142857142857146
2003-01-10,26.35001,27.25999,26.22,27.10001,27.532326455141007,25.4801297335663,25.551865940695944,25.898593068810218,26.45440035000015,24.391000500000033,25.965400599999985,25.615500000000004,25.615500000000004,26.987760777052806,24.243239222947203,82638000,60.048855545813794,49.68247791941103,NaN,NaN,NaN,NaN,60.048855545813794,NaN,0.19790759097120786,0.18447084232421673,-0.01343674864699114,94.63152560914642,81.49461060623389,-409967142,-317696804.8837362,24.37524457915217,15.698580275436068,11.653584864252974,100,50
2003-01-13,27.33,27.47,26.73,26.94,27.526432659567465,25.509038055673898,25.60630257047257,25.997774681304485,26.408800350000153,24.40850050000003,26.013000599999987,25.6695,25.6695,27.156221103717506,24.182778896282493,72945184,58.5586813775403,50.57390338136662,NaN,NaN,NaN,NaN,NaN,NaN,0.20544795627427495,0.24337319669585256,0.0379252404215776,83.38557993730413,89.21557839202671,-482912326,-349240668.2350873,24.616587098498364,14.75245742284274,12.865465321615929,100,42.857142857142854
2003-01-14,26.91,27.32001,26.85001,27.08,27.52199054355187,25.540146212987285,25.66409462653247,26.100843759275485,26.36045035000015,24.42180050000003,26.063600599999987,25.771500500000002,25.771500500000002,27.348639908618388,24.194361091381616,47262496,59.50555781772857,51.32911539201194,NaN,NaN,NaN,NaN,NaN,NaN,0.20799290556737848,0.2979163723808007,0.08992346681342223,87.77429467084637,88.59713340576565,-435649830,-350248264.42640686,23.64199670021333,14.16839581845046,14.52504339351547,92.85714285714286,35.714285714285715
2003-01-15,27.24001,27.353,26.58,26.74001,27.514209642621005,25.56390589193803,25.706287386276294,26.16171673458258,26.318700400000154,24.427600600000034,26.09340079999998,25.8160005,25.8160005,27.448733514371096,24.183267485628907,55450400,56.15023642827936,52.01778142551774,NaN,NaN,NaN,NaN,NaN,NaN,0.17616751607518646,0.3101328619074053,0.13396534583221884,77.11630094043893,82.75872518286315,-491100230,-382742342.294453,22.092783985128918,15.528871502828443,15.641165600921799,85.71428571428571,28.571428571428573
2003-01-16,26.78999,26.98,26.25,26.44,27.503520989460597,25.581254290117474,25.735060429951734,26.188219902717574,26.275750400000156,24.440500700000033,26.104200999999986,25.841501,25.841501,27.496340070180104,24.1866619298199,69707504,53.29453035620745,52.54079098023151,NaN,NaN,NaN,NaN,NaN,NaN,0.1266177123978941,0.29223748632958646,0.16561977393169236,67.71159874608155,77.53406478578896,-560807734,-416163748.32185006,20.712443318915007,17.383043834173257,16.122190270798143,78.57142857142857,21.428571428571427
2003-01-17,25.90401,25.94,25.27,25.31,27.481694909963476,25.57588291803594,25.71839139348304,26.104579911982565,26.228500450000155,24.441100700000035,26.088400799999985,25.838001,25.838001,27.497020401994767,24.17898159800523,77452128,44.180335294176906,52.660592531264584,NaN,NaN,NaN,NaN,NaN,NaN,0.015299461703573852,0.18474410106115968,0.16944463935758583,32.288401253918444,59.03876698014631,-638259862,-484367861.0382682,18.696225455438398,23.844463247354252,16.501133037823045,71.42857142857143,14.285714285714286
2003-01-21,25.41,25.55,25.02,25.03,27.457299935734984,25.565073355302555,25.691395652562136,26.002238967984226,26.181800450000154,24.44770070000003,26.059600799999984,25.836501,25.836501,27.498383182404986,24.17461881759501,68031184,42.25215001048013,52.74127362437853,NaN,NaN,NaN,NaN,NaN,NaN,-0.0746884246042327,0.07608410860229498,0.15077253320652767,23.510971786833874,41.170323928944626,-706291046,-549831830.5477018,17.848635433429198,24.901913711568398,16.665301289191664,64.28571428571429,7.142857142857143
2003-01-22,24.968,25.53,24.87,24.92999,27.432152573190358,25.552497447276764,25.661536607363622,25.900120018652395,26.132450400000156,24.46220060000003,26.04740079999998,25.817,25.817,27.511500244968726,24.122499755031274,80967008,41.554546933824945,52.90629276967059,NaN,NaN,NaN,NaN,NaN,NaN,-0.13493276671608778,-0.017893425188582057,0.11703934152750572,15.893708609271552,23.8976938833413,-787258054,-616080017.9115808,16.825678756922137,24.77727877674728,16.91052302721825,57.142857142857146,0
2003-01-23,25.39999,25.84,25.11,25.50999,27.41302657743722,25.55165571564752,25.655593603153285,25.86296477878074,26.092050350000157,24.47940060000003,26.056200399999984,25.808999500000006,25.808999500000006,27.507706148075766,24.110292851924246,78658816,47.0178854542252,52.75380560470733,NaN,NaN,NaN,NaN,NaN,NaN,-0.12967213494947655,-0.045050827159339946,0.08462130779013659,24.61499999999992,21.33989346536845,-708599238,-608539546.7558551,18.17776029630077,22.83405763133866,17.49315108218397,50,0
2003-01-24,25.53,25.53101,24.64,24.82001,27.38722541746272,25.5371676816743,25.6228256187159,25.763635752230194,26.04695040000016,24.49270060000003,26.066400599999984,25.7824995,25.7824995,27.524992269057563,24.040006730942437,74576320,41.98936852010653,52.0766335210599,NaN,NaN,NaN,NaN,NaN,NaN,-0.16438163327769062,-0.12085573380697667,0.04352589947071393,6.360777385158991,15.62316199814349,-783175558,-652982684.4948255,16.789332949763075,25.118987141689924,18.460549216765916,42.857142857142854,100
2003-01-27,24.45,25.03,24.37,24.53,27.358795313806375,25.5172237671857,25.57996971209959,25.646146632970176,26.004600400000157,24.511600600000033,26.05840079999998,25.7449995,25.7449995,27.55991159159503,23.93008740840497,76589632,40.0505103873128,50.911345824088244,NaN,NaN,40.0505103873128,NaN,NaN,NaN,-0.1964242955517777,-0.20200446996900823,-0.005580174417230507,5.161290322580653,12.045689235913189,-859765190,-692437949.4645225,15.82511397438608,26.025819933752377,18.672310629672754,35.714285714285715,100
2003-01-28,24.77,25.05,24.42,24.78,27.33313565894263,25.50262527674638,25.548598350840784,25.563656477449207,25.96090040000016,24.53210060000003,26.049400799999987,25.742999000000005,25.742999000000005,27.56206842808501,23.923929571915,65295104,42.51470591808434,49.75678268849271,NaN,NaN,NaN,NaN,NaN,NaN,-0.19020584000765167,-0.2433374744267951,-0.053131634419143425,13.225806451612916,8.249291386450857,-794470086,-683110077.4645225,15.119900665757319,24.57498882695053,18.49210565583067,28.571428571428573,92.85714285714286
2003-01-29,24.75999,25.45,24.34,25.14999,27.311412816565092,25.495642399979126,25.53296665080781,25.524259670073093,25.91770040000016,24.561900500000032,26.030400399999984,25.7689985,25.7689985,27.537864879410883,24.000132120589114,95805120,46.049161554409,49.336229020724886,NaN,NaN,NaN,NaN,NaN,NaN,-0.1522410397056874,-0.24343293405125266,-0.09119189434556527,25.878274760383366,14.75512384485898,-698664966,-639093235.0342523,17.120658659894655,22.2242388207508,18.217236086787267,21.428571428571427,100
2003-01-30,25.32001,25.42,24.49001,24.53999,27.283836470131607,25.476718590078548,25.49402638999182,25.430519701494703,25.86440035000016,24.578800300000033,25.992400199999985,25.777498,25.777498,27.52084315235012,24.03415284764988,70503120,41.51689752796319,48.191673080439436,NaN,NaN,NaN,NaN,NaN,NaN,-0.1585621073440831,-0.28939452852566916,-0.13083242118158606,6.389456869009576,15.164512693668621,-769168086,-702018325.2971587,15.760403354930702,20.45849841582539,17.930627085307208,14.285714285714286,92.85714285714286
2003-01-31,24.06,24.75999,24.00999,24.44,27.25553958983179,25.456189509086894,25.452692021756846,25.33618449182854,25.811500350000166,24.59240030000003,25.96020019999998,25.7294985,25.7294985,27.562341710481927,23.89665528951807,90548000,40.80789291281667,46.81731860665393,NaN,NaN,NaN,NaN,NaN,NaN,-0.15940029639688852,-0.3300827916776967,-0.1706824952808082,12.427998763009438,14.898576797467463,-859716086,-688735537.3504914,14.743086935270464,23.269225802962374,17.986215648948043,7.142857142857143,100
2003-02-03,24.528,24.79601,24.38,24.49001,27.22802188247028,25.437057241580224,25.41493978560952,25.255596444987727,25.76220035000016,24.600800500000034,25.937000599999983,25.6699995,25.6699995,27.581001812980727,23.758997187019272,53194496,41.347399081827774,45.58794129981732,NaN,NaN,NaN,NaN,NaN,NaN,-0.14682202902656302,-0.354210031564012,-0.20738800253744896,14.358916066658573,11.058790566225865,-806521590,-713796447.5955329,14.517184931213109,22.405318705153405,17.722535633401343,0,92.85714285714286
2003-02-04,24.17999,24.3,23.82001,24.19,27.197792809012864,25.412363038776654,25.36690293127189,25.15411106927461,25.71085030000016,24.60820050000003,25.886000399999986,25.563499,25.563499,27.553508393996584,23.573489606003417,69504128,39.04809692135253,44.12669409293331,NaN,NaN,NaN,NaN,NaN,NaN,-0.14849678183659332,-0.3930089798331906,-0.2445121979965973,10.472432698649055,12.419782509439022,-876025718,-676149041.9439149,13.638928997884884,26.106280799604924,18.1734384626196,7.142857142857143,100
2003-02-05,24.33,24.86,24.00999,24.08,27.166769994992833,25.385979612266226,25.316436149653384,25.051814776962743,25.66330030000016,24.620900500000033,25.813000399999982,25.4349995,25.4349995,27.45938835103074,23.41061064896926,80168128,38.20910769361193,42.845184897599935,NaN,NaN,NaN,NaN,NaN,NaN,-0.14655280975346863,-0.42770321018843305,-0.2811504004349644,8.22755768214451,11.019635482484047,-956193846,-743111276.7396468,17.627409167432553,24.113189225379205,18.03709104224176,0,92.85714285714286
2003-02-06,24.03999,24.35001,23.86,24.21001,27.137349497530217,25.36269308529066,25.273046888882664,24.971642893442482,25.61930040000016,24.633100500000033,25.74280059999999,25.350500500000003,25.350500500000003,27.4305164898849,23.270484510115104,103594688,39.85397990498286,41.88514557965532,NaN,NaN,NaN,NaN,NaN,NaN,-0.12679169625163744,-0.43964002074951125,-0.3128483244978738,18.396313190156572,12.365434523650046,-852599158,-698712345.2344122,16.82973571973254,24.407163109802763,18.725358222605895,0,85.71428571428571
2003-02-07,24.36,24.45,23.64999,23.81,27.10424154233091,25.33194668756213,25.215672501083343,24.86101023692415,25.57585040000016,24.644600500000028,25.659200399999985,25.206000500000002,25.206000500000002,27.292467393141827,23.119533606858177,72338880,36.6236416780934,41.34538174993507,NaN,NaN,36.6236416780934,NaN,NaN,NaN,-0.13043470816096264,-0.4758917096990771,-0.3454570015381145,7.306359331692535,11.310076734664541,-924938038,-742114226.4748968,15.589394825567027,24.543046965570987,19.45452576110458,0,100
2003-02-10,23.899,24.25,23.62,24.02,27.073552571760455,25.305967545234168,25.1687833833938,24.780914023883756,25.533850400000162,24.66300060000003,25.598600399999988,25.052000000000003,25.052000000000003,27.00708171700274,23.096918282997265,67603312,39.40065130520045,41.14170327098652,NaN,NaN,NaN,NaN,NaN,NaN,-0.10932929957112997,-0.48211862600202693,-0.37278932643089696,18.018018018017962,14.573563513289022,-857334726,-723872062.9193414,14.672344639660606,23.379322781693336,19.91047603400225,14.285714285714286,100
2003-02-11,24.25,24.61,23.92,24.14999,27.04446239691707,25.283076900774084,25.128830701692085,24.720826021609113,25.49940040000016,24.685200600000027,25.523400199999983,24.912499500000003,24.912499500000003,26.69976516860584,23.125233831394166,78007312,41.12049734281,41.110699728771166,NaN,NaN,NaN,NaN,NaN,NaN,-0.07867530855560045,-0.47113346212539753,-0.3924581535697971,23.873423423423343,16.399266924377944,-779327414,-749876761.3341825,17.105517522256104,21.86242797896631,19.41720283861443,7.142857142857143,92.85714285714286
2003-02-12,24.07001,24.33,23.78,23.82001,27.012378293465158,25.254105278976578,25.077504399664946,24.635034019551103,25.462900450000163,24.707600700000025,25.445400399999986,24.7495,24.7495,26.294536633934122,23.20446336606588,51815008,38.15982500570708,40.47798112530558,NaN,NaN,NaN,NaN,NaN,NaN,-0.07281827780841271,-0.483481000830313,-0.41066272302190027,10.466193269527588,17.452544903656293,-831142422,-794153156.7157099,16.20307557074309,22.05193861496479,19.698316464762286,0,85.71428571428571
2003-02-13,23.85001,23.98,23.32001,23.94,26.98180736517197,25.22808339226417,25.03289638399181,24.56884030340338,25.423950450000163,24.73030070000003,25.364200399999987,24.609499500000002,24.609499500000002,25.892998498120864,23.32600050187914,77763008,39.85560408431938,40.325569379892215,NaN,NaN,NaN,NaN,NaN,NaN,-0.053928534817737406,-0.478073391544072,-0.4241448567263346,29.107648392715532,21.14908836188882,-753379414,-725816110.6848304,15.168895049612678,25.092909942968657,20.039231620562788,0,100
2003-02-14,23.83,24.5,23.62,24.49001,26.95701336153842,25.21346807756587,25.011606721874486,24.561332655460202,25.388600500000162,24.765000800000024,25.310600599999983,24.512,24.512,25.482594766212205,23.541405233787795,67562000,47.02641314989959,40.823848148648416,NaN,NaN,NaN,NaN,NaN,NaN,-0.00029458598549025883,-0.4245130892081974,-0.42421850322270716,54.929835351339776,31.5012256711943,-685817414,-659788075.1848302,18.856361040585874,22.986238515236494,19.003240763977708,14.285714285714286,92.85714285714286
2003-02-18,24.7,25.34,24.67999,25.25,26.94002815396092,25.214191481970506,25.020955477879408,24.62692002160685,25.362300550000164,24.80720080000003,25.284200399999982,24.509,24.509,25.470033922501344,23.547966077498657,74026496,55.008640349248225,41.716272036588684,NaN,NaN,NaN,NaN,55.008640349248225,NaN,0.08570588220693154,-0.31708615046404276,-0.4027920326709743,90.61028455532659,58.21592276646063,-611790918,-605950317.6584897,25.279072551351646,21.14008295805679,17.9387511875087,7.142857142857143,85.71428571428571
2003-02-19,25.2,25.24001,24.71001,25.08,26.92152041113544,25.211534224901783,25.023270949335117,24.67007049573953,25.339000500000164,24.839300800000025,25.261800399999984,24.511499999999998,24.511499999999998,25.478185678076724,23.544814321923273,45608800,53.08184135252266,42.218606307882524,NaN,NaN,NaN,NaN,NaN,NaN,0.12793964082309311,-0.24286748164210792,-0.37080712246520103,83.80944671165086,76.44985553943907,-657399718,-587880627.424528,23.962372701282327,20.03896882482337,17.649120114048433,0,78.57142857142857
2003-02-20,25.14999,25.27,24.84,24.98,26.902201800079364,25.206949388765114,25.021574049361192,24.699587591383384,25.319050500000163,24.873100700000027,25.232000399999983,24.5140005,24.5140005,25.485251170103897,23.542749829896106,59952896,51.92956682128354,42.96236840026255,NaN,NaN,NaN,NaN,NaN,NaN,0.14470294651055393,-0.18992843932700865,-0.3346313858375626,82.17812959470099,85.53262028722615,-717352614,-608794428.3547604,23.236005868192912,19.182147441808773,17.405227611539996,0,71.42857142857143
2003-02-21,24.92999,25.37,24.50999,25.17,26.884965961272606,25.206217717700458,25.02739467487644,24.744388773156395,25.301400500000163,24.911700700000026,25.231000399999985,24.497001,24.497001,25.407956533577057,23.586045466422945,70344688,53.973903456992005,43.9027977248465,NaN,NaN,NaN,NaN,NaN,NaN,0.16280042078441986,-0.13113085985703776,-0.2939312806414576,90.24385484807247,85.41047705147479,-647007926,-571167819.4468638,21.276548440788357,20.800467119993623,15.88390706837735,100,64.28571428571429
2003-02-24,25.13,25.21201,24.71001,24.74001,26.86362311588681,25.19698588170639,25.016124687626384,24.7439717471415,25.266250550000162,24.951900800000026,25.213800399999982,24.493001,24.493001,25.398936812380963,23.587065187619036,56709200,48.90496766673227,44.44262405233968,NaN,NaN,NaN,NaN,NaN,NaN,0.14084805809459222,-0.11787120802321738,-0.2587192661178096,69.2686305786858,80.56353834048643,-703717126,-621099027.414991,20.205453761344646,19.753339117809848,14.438723129761923,92.85714285714286,57.142857142857146
2003-02-25,24.45,24.95,24.08,24.77,26.842791045081967,25.188530715732007,25.006472739092015,24.74645062836612,25.235350550000163,24.979800800000024,25.19480039999998,24.505001,24.505001,25.41890230766659,23.59109969233341,74635184,49.26286764577906,45.172250532655866,NaN,NaN,NaN,NaN,NaN,NaN,0.12397784040477539,-0.10374696561184038,-0.22772480601661577,70.73156454421724,76.74801665699185,-629081942,-577347367.828784,18.470070305175447,24.27628012245584,13.168348112181844,85.71428571428571,50
2003-02-26,24.67999,24.94,24.2,24.22,26.816693621747817,25.16935188967791,24.97563067089233,24.696312473283633,25.20865055000016,25.009500800000023,25.162000399999982,24.477001,24.477001,25.38979880025712,23.56420319974288,60143696,43.2759835696699,45.53417023808858,NaN,NaN,43.2759835696699,NaN,NaN,NaN,0.07388120001744078,-0.13537330599481479,-0.20925450601225556,43.9021653764164,61.300786833106486,-689225638,-634240053.2341895,17.122960922773167,22.505696460214843,13.02867920869107,78.57142857142857,42.857142857142854
2003-02-27,24.42,24.92,24.27,24.77,26.796328511083658,25.161443931466465,24.967566723014198,24.703330332970907,25.178700600000163,25.049800700000024,25.156600599999983,24.4580015,24.4580015,25.328830268547268,23.587172731452736,66519184,49.840717902827826,46.24750866650607,NaN,NaN,NaN,NaN,NaN,NaN,0.07561607025591416,-0.11473441819236285,-0.190350488448277,70.73156454421724,61.78843148828363,-622706454,-598422031.0803437,15.938723317916898,20.94918458169853,12.686363486711146,71.42857142857143,35.714285714285715
2003-02-28,24.81,25.22,24.72,25.16,26.780046635351482,25.161415338764158,24.97511312603325,24.74682268221177,25.141650550000158,25.097900600000024,25.142800399999985,24.489002000000003,24.489002000000003,25.41188583673272,23.566118163267287,50595200,53.91366659756407,47.48251044646827,NaN,NaN,NaN,NaN,NaN,NaN,0.0993638119162846,-0.06614572355292125,-0.16550953546920585,89.75604759047602,68.12992583703655,-572111254,-559969679.0803435,18.164402705649287,19.89097265902294,11.416844454053374,64.28571428571429,28.571428571428573
2003-03-03,25.27,25.48,24.56,24.64999,26.7588520419649,25.151288104333183,24.96236319952214,24.737600522001127,25.100850500000156,25.14280050000002,25.117200399999984,24.4995015,24.4995015,25.424691645931933,23.57431135406807,60441200,48.38103731488979,48.12396659001751,NaN,NaN,NaN,NaN,NaN,NaN,0.078000893225468,-0.06800841893737086,-0.14600931216283886,61.57343321033888,74.02034844834404,-632552454,-608586740.8455609,19.083047593436397,18.08115734437078,9.974977235969064,100,21.428571428571427
2003-03-04,24.66,24.77,24.42,24.5,26.736375902243857,25.13839131018797,24.9442313093448,24.714971900858163,25.059050500000158,25.185800500000024,25.099600399999986,24.500001000000005,24.500001000000005,25.42518089608166,23.57482110391835,56092608,46.85808761599615,48.53379446667366,NaN,NaN,NaN,NaN,NaN,NaN,0.052281221577587106,-0.08065778519085498,-0.1329390067684421,54.6294195806462,68.65296679382037,-688645062,-639037013.759847,18.39724985983824,18.868866568629848,9.193427095100073,92.85714285714286,14.285714285714286
2003-03-05,24.39999,24.78,24.32001,24.55,26.71462091814193,25.126739997114942,24.928771257997944,24.699260291252624,25.01715055000016,25.230700500000022,25.089400399999985,24.518001,24.518001,25.432299472116373,23.60370252788363,69205504,47.45191424164464,49.197515126383486,NaN,NaN,NaN,NaN,NaN,NaN,0.03782282437558415,-0.0856604762989619,-0.12348330067454605,56.944245112245916,57.715699301076995,-619439558,-639038518.2600318,17.50677923625093,19.007711812506113,8.394953605567961,85.71428571428571,7.142857142857143
2003-03-06,24.42999,24.67999,24.23,24.49001,26.692485486120617,25.114131482320587,24.91156493415489,24.679331692085707,24.978550550000165,25.264800600000022,25.072800399999984,24.538501500000002,24.538501500000002,25.43071691016134,23.646286089838664,59550304,46.77654056743685,49.69186773232045,NaN,NaN,NaN,NaN,NaN,NaN,0.024075198190990313,-0.09338930293580816,-0.11746450112679847,46.77473118279575,52.78279862522928,-678989862,-629770961.6718405,16.65737874788048,19.055985408577765,7.114065290812512,78.57142857142857,0
2003-03-07,24.08,24.95,23.96001,24.53999,26.671067620587078,25.102762344056814,24.896993368109598,24.666061054744212,24.944600500000163,25.28800050000002,25.050200199999985,24.555000500000002,24.555000500000002,25.434419956310748,23.675581043689256,73329808,47.44763666877914,49.72195512652613,NaN,NaN,NaN,NaN,NaN,NaN,0.018456899035093746,-0.0943933773329313,-0.11285027636802504,38.15682997914454,47.291935424728734,-605660054,-617181069.3842821,17.751963306472156,17.09129611634302,6.5444996536078905,71.42857142857143,0
2003-03-10,24.33,24.457,23.91,24.00999,26.64458923630263,25.08112328773886,24.862208922301377,24.603578097149526,24.907650500000162,25.303300400000023,25.023399799999982,24.565,24.565,25.41434136844926,23.715658631550742,55990496,41.475406118732614,48.75529553863216,NaN,NaN,NaN,NaN,NaN,NaN,-0.018826610572213714,-0.1363835395832922,-0.11755692901107848,6.368789808917085,30.433450323619123,-661650550,-652701767.596202,16.580452304025147,16.487254313368755,5.927734279687281,64.28571428571429,100
2003-03-11,24.06,24.24001,23.78,23.8,26.616284865792156,25.055754509763833,24.820553670446422,24.527046849801952,24.86650050000016,25.30570040000002,24.993799799999984,24.554000000000002,24.554000000000002,25.436347301327043,23.67165269867296,54945104,39.36142908645192,47.775266091055684,NaN,NaN,39.36142908645192,NaN,NaN,NaN,-0.05353759719968834,-0.1844789255106889,-0.13094132831100055,1.1764705882352695,15.234030125432296,-716595654,-702869140.3294905,15.7624724260234,17.068063428950637,5.574891636436143,57.142857142857146,100
2003-03-12,23.75999,24.24001,23.53999,24.23,26.592540737774325,25.039402935313063,24.797394702977936,24.498756673630336,24.831450450000165,25.320200400000022,24.981999599999984,24.558000500000002,24.558000500000002,25.433684877009313,23.68231612299069,77964128,45.48849199228578,47.31518931755584,NaN,NaN,NaN,NaN,NaN,NaN,-0.04385187930502854,-0.18575617744228623,-0.1419042981372577,35.56734243637922,14.370867611177191,-638631526,-627134722.6842806,14.583419063392533,18.355999607130915,5.710333970828559,50,100
2003-03-13,24.64,25.64999,24.39999,25.62,26.582863715507912,25.050899906891022,24.829653734233702,24.605541752332208,24.804050400000165,25.34090040000002,25.00179959999998,24.648000000000003,24.648000000000003,25.57053242767904,23.725467572320966,128537632,59.67338776144065,47.722295339302164,NaN,NaN,NaN,NaN,NaN,NaN,0.054517996108295386,-0.07375680300188847,-0.12827479911018386,98.57867298578209,45.107495336798856,-510093894,-504764840.4181682,26.48159469355806,15.777807392863416,7.438713905009559,100,92.85714285714286
2003-03-14,25.73,25.98,25.36,25.72,26.57427800689589,25.06414941368526,24.864569274067673,24.711680633062475,24.781250400000168,25.360000400000022,25.028799599999985,24.737000000000002,24.737000000000002,25.71114890038389,23.762851099616114,89832320,60.470337516972556,48.548393185747905,NaN,NaN,NaN,NaN,NaN,NaN,0.12086762807322508,0.0228097359813475,-0.09805789209187758,89.3443059659591,74.49677379604013,-420261574,-490275756.5472008,28.138545116720433,14.80034474337458,9.576697077748829,100,85.71428571428571
2003-03-17,25.42999,26.8,25.35001,26.60001,26.57453404662827,25.094562494602386,24.932625773123842,24.891521525151763,24.761550500000165,25.38310060000002,25.052799999999984,24.842500000000005,24.842500000000005,26.102025910856412,23.582974089143597,141198368,66.70593793990032,49.794326778185145,NaN,NaN,NaN,NaN,NaN,NaN,0.21317236861576494,0.16840756867782858,-0.04476479993793635,93.86535624123854,93.92944506432657,-279063206,-388026983.5324351,31.973566111187196,12.80272055386532,11.664682188381894,100,78.57142857142857
2003-03-18,26.8,26.97,26.42,26.92999,26.578070921786196,25.13090759371917,25.010953782020945,25.085661379899214,24.746000500000168,25.411000500000018,25.077799999999982,24.926499500000002,24.926499500000002,26.47456070878281,23.378438291217194,97193008,68.6997649059001,51.61031115934444,NaN,NaN,NaN,NaN,NaN,NaN,0.28131900877710564,0.30688396103344573,0.025564952256340076,98.83353109757701,94.01439776825822,-181870198,-304974674.62363476,31.917943419471296,12.133731950758389,13.902427497368722,100,71.42857142857143
2003-03-19,26.85001,27.75999,26.33,26.7,26.57928414644504,25.161978730477205,25.07719088860836,25.23940791514691,24.73460050000017,25.43200040000002,25.085399799999983,25.0074995,25.0074995,26.737990132779746,23.277008867220257,91369808,65.74456701189251,52.74630038142048,NaN,NaN,NaN,NaN,NaN,NaN,0.29437430002148135,0.3935328272831917,0.0991585272617104,74.88175355450238,89.1935469644393,-273240006,-349061873.7102856,34.89522048758258,10.585043391840772,16.750228152604937,100,64.28571428571429
2003-03-20,26.53999,27.14,26.17,26.8,26.581480324092354,25.19441479522023,25.14475203023156,25.388035732751966,24.721800500000167,25.460200400000023,25.088399999999982,25.098499500000003,25.098499500000003,26.996902564193228,23.200096435806778,93099808,66.4209237065347,53.6396758892041,NaN,NaN,NaN,NaN,NaN,NaN,0.2926032734292594,0.4649126190482846,0.17230934561902525,77.25142180094791,83.65556881767577,-180140198,-321227910.4937908,31.91914238366221,11.089067495790951,19.885641999226348,92.85714285714286,57.142857142857146
2003-03-21,27.21001,27.38,26.2,27.17,26.587336241265564,25.233535294324778,25.22417351924209,25.557746615347018,24.70935050000017,25.48570040000002,25.113800199999986,25.198499500000004,25.198499500000004,27.30114892254709,23.09585007745292,93395184,68.8700499028773,55.103176788346055,NaN,NaN,NaN,NaN,68.8700499028773,NaN,0.2981961053740789,0.5450544773366239,0.246858371962545,86.01919431279627,79.38412322274887,-86745014,-261075080.12090904,30.755316026010497,9.974596730539117,23.337422919845658,85.71428571428571,50
2003-03-24,26.47,26.60001,25.97,26.03999,26.58189001000919,25.249504694437157,25.256166322409065,25.60367455674254,24.69515045000017,25.501200200000017,25.100599999999986,25.263498500000004,25.263498500000004,27.38571758438551,23.1412794156145,85300688,55.545401086815836,55.7236991791189,NaN,NaN,NaN,NaN,NaN,NaN,0.2117044925498538,0.5114889876498623,0.2997844951000085,59.24170616113746,74.17077409162722,-172045702,-327423068.47131604,27.705816758799855,10.886023246549009,26.360156532350175,78.57142857142857,42.857142857142854
2003-03-25,26.158,26.75999,26.00999,26.41,26.580179661650888,25.272484799497807,25.301414701922436,25.680467456100395,24.68570045000017,25.52610020000002,25.08679979999999,25.345498500000005,25.345498500000005,27.511393886700326,23.179603113299684,78789184,58.384596850494994,56.504605079751066,NaN,NaN,NaN,NaN,NaN,NaN,0.16727542169923693,0.5088787722240546,0.3416033505248177,68.00971563981047,71.09020537124808,-93256518,-322168355.15974236,27.3069703397524,10.204964553529226,29.32303701372634,71.42857142857143,35.714285714285715
2003-03-26,26.5,26.77,26.36,26.56,26.579978868997646,25.2979801500028,25.350770988121557,25.76423246028131,24.67725045000017,25.54610020000002,25.079199799999987,25.462498500000002,25.462498500000002,27.62536701891886,23.299629981081146,68026624,59.51348652752496,57.41438693404307,NaN,NaN,NaN,NaN,NaN,NaN,0.1371176038414571,0.5130003553266391,0.375882751485182,71.56421800947868,66.27187993680887,-25229894,-323827541.11096215,26.423663522359508,9.842449733761784,32.10908589460468,64.28571428571429,28.571428571428573
2003-03-27,26.27,26.64999,26.10001,26.37,26.577889527017568,25.319208265844328,25.39074075329326,25.821924606921186,24.671800400000166,25.56430020000002,25.06499979999999,25.5424985,25.5424985,27.715331026940497,23.369665973059504,64201392,57.38985318949122,58.12454525695108,NaN,NaN,NaN,NaN,NaN,NaN,0.09547512907180672,0.49522666282494043,0.3997515337531337,67.06184834123228,68.87859399684048,-89431286,-324994881.59607047,25.13386671981563,11.669498595811183,34.58683584708825,57.142857142857146,21.428571428571427
2003-03-28,26.14,26.42999,25.95,26.08,26.57293540237063,25.334273448698895,25.41777052767392,25.846503215785834,24.66290040000017,25.57260020000002,25.051799599999985,25.5884985,25.5884985,27.76594143659581,23.41105556340419,45395696,54.210238192423645,59.03417611935758,NaN,NaN,NaN,NaN,NaN,NaN,0.04221788766937118,0.45252389333984766,0.4103060056704765,60.18981042654027,66.27195892575041,-134826982,-345800729.97424525,24.031371296588887,12.528515957604963,36.814065087765584,50,14.285714285714286
2003-03-31,25.60001,25.73,25.21001,25.25,26.559771866028633,25.33260466753654,25.41119129129455,25.789693385710994,24.650750450000164,25.566100300000016,25.027999599999983,25.618499000000003,25.618499000000003,27.759623524196304,23.477374475803703,89399184,46.303178690491414,59.530015376788974,NaN,NaN,46.303178690491414,NaN,NaN,NaN,-0.050085193412671924,0.3476995139046366,0.39778470731730853,40.521563981042675,55.92440758293841,-224226166,-421449367.35542583,22.13604386295886,18.24878016960376,37.21755062189107,42.857142857142854,7.142857142857143
2003-04-01,25.44,25.67,25.25,25.45,26.548729359898996,25.33492932758532,25.41271320143986,25.7573416346909,24.639900450000162,25.55960020000002,25.030799599999987,25.665999,25.665999,27.74707074506685,23.58492725493315,73423504,48.26150070335795,59.728087427579844,NaN,NaN,NaN,NaN,NaN,NaN,-0.09617642230917489,0.2775641794308399,0.3737406017400148,31.250297619047632,43.98722400887686,-150802662,-424945724.6887597,21.264131071843185,17.529982133665605,37.087012607421165,35.714285714285715,0
2003-04-02,26.06,26.56,26.03,26.36,26.5468514558204,25.355227756742046,25.44986170334418,25.81473766948224,24.62890045000016,25.558500200000015,25.057399599999982,25.756499,25.756499,27.792508659140974,23.72048934085903,75971008,56.10556387517387,59.47324286427507,NaN,NaN,NaN,NaN,NaN,NaN,-0.06535703231575446,0.2920443113453217,0.3574013436610762,45.098000768633476,38.95662078957459,-74831654,-406311326.50008047,27.203203038175396,15.762860491328153,37.179704796105526,28.571428571428573,0
2003-04-03,26.64,26.85001,26.31,26.48,26.54618626720527,25.377500474430324,25.49025928360519,25.87809598667441,24.61620045000016,25.56790030000002,25.088399799999983,25.8559985,25.8559985,27.828212127397304,23.883784872602693,71118320,57.03070924040615,59.22755513023462,NaN,NaN,NaN,NaN,NaN,NaN,-0.03821415227744346,0.30963365331427184,0.3478478055917153,49.80392003074538,42.05073947280883,-3713334,-432652274.2291963,28.53263154066587,14.972123804284877,37.187344575334066,21.428571428571427,78.57142857142857
2003-04-04,26.57001,26.60001,25.97,26.05,26.54124909041716,25.390817296718833,25.512209899934398,25.894467797467325,24.60975045000016,25.577700200000024,25.099199999999986,25.931499000000002,25.931499000000002,27.8097899604413,24.053208039558704,65743872,52.741064857920954,58.230064195807515,NaN,NaN,NaN,NaN,NaN,NaN,-0.049811129393000475,0.2855838938504647,0.33539502324346515,32.941042674844546,42.61432115807447,-69457206,-481699554.8735032,26.840926351601365,17.284161041377523,35.676174594317324,14.285714285714286,71.42857142857143
2003-04-07,27.11,27.2,26.07001,26.09,26.536759049716494,25.404662498764004,25.53486833523109,25.913089911994245,24.60790040000016,25.595500200000025,25.124599799999988,26.035499500000004,26.035499500000004,27.694203108863814,24.376795891136194,83879376,53.09450224319937,57.115402577043184,NaN,NaN,NaN,NaN,NaN,NaN,-0.054973734119412476,0.26667785559419954,0.321651589713612,34.5096824288818,39.084881711490574,14422170,-562611207.7498649,29.485225926302967,15.479949436707125,34.69300098078435,7.142857142857143,64.28571428571429
2003-04-08,26.14999,26.28999,25.88,26.06,26.532015178575037,25.417639478986498,25.555461733849477,25.927081348947173,24.609100350000162,25.60680030000002,25.155199799999988,26.148499500000003,26.148499500000003,27.452665944154134,24.844333055845873,54282608,52.775709387336455,56.1890556038606,NaN,NaN,NaN,NaN,NaN,NaN,-0.060174706823393154,0.2464332061843706,0.30660791300776374,39.1702265909059,35.54031723154409,-39860438,-569229875.4586384,28.34906961519494,16.669275892952765,32.72817055585413,0,57.142857142857146
2003-04-09,26.10001,26.28,25.41,25.46001,26.52134846038026,25.418478499204586,25.551718528600478,25.882598363333155,24.60475040000016,25.60910040000002,25.168799999999987,26.21,26.21,27.231957122427183,25.18804287757282,76543632,46.732280179751235,54.78272392337607,NaN,NaN,46.732280179751235,NaN,NaN,NaN,-0.10136536411954505,0.1799012078583324,0.28126657197787747,11.520790418389034,28.400233146058913,-116404070,-636973629.2142246,26.054763159798405,19.6923332681629,30.26210239748053,7.142857142857143,50
2003-04-10,25.46001,25.77,25.3,25.77,26.513872356296876,25.425439321002514,25.56027858630242,25.871874709682377,24.606300350000165,25.605800300000023,25.18120019999999,26.2175,26.2175,27.224113808806372,25.21088619119363,57234704,49.92291261753643,53.42935697442315,NaN,NaN,NaN,NaN,NaN,NaN,-0.10465054627248693,0.1504533891372688,0.25510393540975573,28.140342413780946,26.277119807691957,-59169366,-579738925.2142246,24.883157673061504,19.859247402618937,27.419798150571147,0,42.857142857142854
2003-04-11,26.02,26.168,25.36,25.50999,26.503883477129744,25.427113591873752,25.558306484878795,25.837409499236436,24.606600300000167,25.59650020000002,25.20060019999999,26.206999500000002,26.206999500000002,27.238233298950576,25.17576570104943,67992368,47.360461184937506,52.84471841000327,NaN,NaN,NaN,NaN,NaN,NaN,-0.12014264489227369,0.10492562929441362,0.22506827418668732,15.074447610289402,18.24519348081979,-127161734,-622488285.1045218,26.756403215307312,18.332996580923755,25.641066671274228,71.42857142857143,35.714285714285715
2003-04-14,25.60001,26.14,25.491,26.03,26.49916821865084,25.439051936589124,25.57680426978551,25.85575145169011,24.60570025000017,25.596300200000023,25.232400199999987,26.178499,26.178499,27.196127786972998,25.160870213027,53422608,52.60051424940085,52.43156965278225,NaN,NaN,NaN,NaN,NaN,NaN,-0.09242079733595673,0.1095422775167414,0.20196307485269813,41.20573470218449,28.140174908751614,-73739126,-587175035.7485894,25.088554035607103,17.19021692317635,23.718975856867992,64.28571428571429,28.571428571428573
2003-04-15,25.97,26.46001,25.849,26.28,26.496987440355806,25.45570437348835,25.604380572931174,25.896156075338673,24.606600200000166,25.60260030000002,25.26819999999999,26.145999500000006,26.145999500000006,27.10540359841628,25.18659540158373,64621296,54.92370473781355,52.1037280963743,NaN,NaN,NaN,NaN,NaN,NaN,-0.05608727228227134,0.13185398449985897,0.1879412567821303,53.76861190257244,36.682931405015445,-9117830,-560629972.520426,26.71048527117715,16.168374988615554,22.209321745926882,57.142857142857146,21.428571428571427
2003-04-16,26.64999,26.83,26.12,26.22,26.494231346421916,25.470838940349964,25.6285225112476,25.92699835387785,24.613450150000165,25.59740020000002,25.308799999999987,26.121999500000005,26.121999500000005,27.048209048675343,25.195789951324667,70747184,54.236636511390586,51.87849833365283,NaN,NaN,NaN,NaN,NaN,NaN,-0.03591641957543046,0.14304573231284223,0.1789621518882727,50.75352137447922,48.575955993078715,-79865014,-611448372.2950742,28.469151500198947,15.048930134664474,21.7988684476664,50,14.285714285714286
2003-04-17,26.162,26.98,26.14999,26.82001,26.497472925064486,25.497555198956896,25.675247510806518,26.01204708207996,24.627800200000166,25.588300300000018,25.363600199999986,26.123,26.123,27.052175397909053,25.19382460209095,70275008,59.66990545496689,52.26847456669163,NaN,NaN,NaN,NaN,NaN,NaN,0.015268750879413234,0.19804809048753924,0.182779339608126,80.90492917049836,61.809020815850005,-9590006,-568265323.5001923,27.635544010338275,13.842350904834838,21.926816563968266,42.857142857142854,7.142857142857143
2003-04-21,26.948,27.106,26.62,26.92,26.501677174566332,25.52572242273993,25.724061333912143,26.098518788548535,24.63865020000017,25.58030030000002,25.41779999999999,26.110500000000002,26.110500000000002,26.988305172051138,25.232694827948865,52750096,60.51129843346433,53.28334026261827,NaN,NaN,NaN,NaN,NaN,NaN,0.051264974802886776,0.24686055811173446,0.1955955833088477,85.64102564102576,72.43315872866778,43160090,-555891844.1915503,27.553269176488644,13.176192111144278,23.7606313069063,35.714285714285715,0
2003-04-22,26.737,27.46001,26.64999,27.42999,26.510914118102985,25.563430691596565,25.790960497288136,26.225325570591533,24.644100150000167,25.57470010000002,25.490199799999992,26.18,26.18,27.22806362406126,25.13193637593874,70905808,64.57120299731935,54.44831899790122,NaN,NaN,NaN,NaN,NaN,NaN,0.10190247867810717,0.32297368165648166,0.2210712029783745,98.61019161948323,88.38538214366912,114065898,-490241690.01777685,28.837428138947978,12.128532229757516,25.986467882960177,100,0
2003-04-23,27.5,27.75,27.25999,27.63,26.52204930100743,25.604352856119405,25.863079693472915,26.359104087678052,24.655350150000167,25.580500100000016,25.562399799999994,26.241000000000003,26.241000000000003,27.46307747711813,25.018922522881876,70578320,66.04559780338433,55.15832142134483,NaN,NaN,NaN,NaN,66.04559780338433,NaN,0.13904789575885085,0.39488107267693806,0.2558331769180872,95.1020408163265,93.11775269227849,184644218,-454231637.6041528,30.331769625332676,11.531222444273737,27.292413976925307,100,42.857142857142854
2003-04-24,27.36,27.75,27.27,27.48,26.5315811487586,25.641494383721,25.926488332944565,26.46585607932776,24.669450150000166,25.57620010000002,25.62899999999999,26.287,26.287,27.618045213386846,24.95595478661315,72510816,63.897923772323686,55.648836745053224,NaN,NaN,NaN,NaN,NaN,NaN,0.14313577128495258,0.43475289102427794,0.29161711973932536,88.97959183673471,94.23060809084815,112133402,-463295489.6041526,28.833763160650417,10.961725643375438,28.273809241787983,92.85714285714286,35.714285714285715
2003-04-25,27.32001,27.42,26.86,26.95,26.535744520412745,25.667405386023553,25.96662604537811,26.51196502415369,24.684700200000165,25.56850010000002,25.691599799999995,26.316000000000003,26.316000000000003,27.677930012915215,24.95406998708479,63355808,56.86207511716722,55.94319462071367,NaN,NaN,56.86207511716722,NaN,NaN,NaN,0.1017125793787807,0.41875784396280125,0.31704526458402055,67.34693877551017,83.8095238095238,48777594,-506286930.7470099,26.980244529709474,14.508041469701705,28.87406910296605,85.71428571428571,28.571428571428573
2003-04-28,27.05,27.63,26.95,27.48,26.54514009732406,25.70329834867655,26.025974043598577,26.60415883137715,24.698100200000166,25.56330010000002,25.762399799999994,26.386000000000003,26.386000000000003,27.833443732958134,24.93855626704187,59685008,61.435128904546666,56.53895366795276,NaN,NaN,NaN,NaN,NaN,NaN,0.10135030437423337,0.44373314505181227,0.3423828406775789,88.97959183673471,81.76870748299321,108462602,-472933543.9234802,27.25561284599537,13.484221900676413,29.063805967398924,78.57142857142857,21.428571428571427
2003-04-29,27.64,28.06,27.41,27.73,26.556929748096955,25.743431054643352,26.092798590908437,26.71138179981742,24.71275020000017,25.56890010000002,25.827199599999993,26.51,26.51,27.971765152163673,25.04823484783633,80373376,63.405774134220714,57.29824400701592,NaN,NaN,NaN,NaN,NaN,NaN,0.10864326394217083,0.47818692060529244,0.3695436566631216,88.04347826086962,81.45666962437151,188835978,-474170057.400403,29.88998885344451,12.571005344718007,30.12405338328682,100,14.285714285714286
2003-04-30,27.64999,27.78999,27.42999,27.45,26.56581601926017,25.77722449910586,26.146022175578693,26.781726390311,24.722150150000164,25.577700000000014,25.871199599999997,26.610000000000003,26.610000000000003,28.041348091862858,25.178651908137148,60413104,59.724710527700886,58.226274746155184,NaN,NaN,NaN,NaN,NaN,NaN,0.086281085443847,0.47739501346793034,0.39111392802408335,77.89855072463769,84.973873607414,128422874,-527867238.0057366,28.729477379145518,12.082922327439194,32.04406414870276,92.85714285714286,7.142857142857143
2003-05-01,27.44,27.87,27.19,27.69,26.577001929516285,25.81510124169782,26.206570325556,26.86822863885281,24.734650150000167,25.592600000000015,25.923399599999993,26.676500000000004,26.676500000000004,28.177115993543755,25.175884006456254,66057504,61.773274382044015,59.07272915790573,NaN,NaN,NaN,NaN,NaN,NaN,0.07949243640830433,0.49047947353446375,0.4109870371261594,86.29629629629638,84.07944176060123,194480378,-496781353.7704424,26.626525747010742,13.781836925192826,33.51254154435254,85.71428571428571,0
2003-05-02,27.60699,28.28999,27.57001,28.28,26.59394718394896,25.863911118099846,26.287881293181258,27.002683054200162,24.747800200000164,25.61070000000002,25.98939959999999,26.7665,26.7665,28.41755068367982,25.11544931632018,85039632,66.30995199319102,60.426264215638135,NaN,NaN,NaN,NaN,NaN,NaN,0.1049758491247268,0.5422068485320679,0.4372309994073411,99.64308554157041,87.94597752083483,279520010,-414101637.11164594,29.069051064308105,12.720164609154901,34.97259115726949,100,0
2003-05-05,28.325,28.71001,28.17,28.25,26.610425321422102,25.911160402889948,26.364827124821208,27.12147514427634,24.765400200000162,25.641000000000023,26.05099959999999,26.876500000000004,26.876500000000004,28.612889460944512,25.140110539055495,80670688,65.88180760910853,61.374928027045826,NaN,NaN,NaN,NaN,NaN,NaN,0.10954466956807157,0.5741618363674306,0.464617166799359,83.92141236835941,89.95359806874207,198849322,-470870341.6668954,31.922438754519955,11.975044030022266,36.88396936418012,100,0
2003-05-06,28.22,28.89999,28.21001,28.61,26.63032158688059,25.964602771149554,26.45287311992626,27.26323941625002,24.788500150000164,25.671099900000016,26.12839939999999,27.002500000000005,27.002500000000005,28.854210657764607,25.150789342235402,77620880,68.50940227642346,62.34533499408939,NaN,NaN,NaN,NaN,68.50940227642346,NaN,0.1254043380687121,0.6213725893852491,0.495968251316537,89.5686675131925,91.0443884743741,276470202,-458495639.79147875,31.595110174072428,11.081812570144574,38.56116139680763,100,0
2003-05-07,28.41,28.69,28.12,28.28999,26.64683570044397,26.010650043007978,26.524916919144836,27.36102518613097,24.812950150000162,25.69679980000002,26.19879919999999,27.1139995,27.1139995,28.99361878488189,25.234380215118108,70379680,63.80531927010488,63.02881233399756,NaN,NaN,NaN,NaN,NaN,NaN,0.10382702993613002,0.6257520387366995,0.5219250088005695,77.81818181818184,83.76942056657792,206090522,-486896927.4995493,29.628919030217855,11.374883586446664,39.538278804807284,92.85714285714286,0
2003-05-08,27.855,28.19,27.75999,27.77,26.658011464618657,26.04548865601772,26.57374370662935,27.39997516840421,24.839800200000163,25.71589980000002,26.269799199999987,27.229498999999997,27.229498999999997,28.96689336976086,25.492104630239133,80333808,56.96116505136388,62.83533087659733,NaN,NaN,56.96116505136388,NaN,NaN,NaN,0.046917169058198094,0.5805714701233171,0.533654301065119,50.438817714112766,72.60855568182903,125756714,-563490629.8365178,27.89090165766358,14.692167760905669,39.376917306009986,85.71428571428571,0
2003-05-09,28.03999,28.48,27.995,28.41,26.675444186363745,26.092310662829252,26.64575375734977,27.496168009508573,24.863750200000162,25.74959990000002,26.342599199999984,27.361499,27.361499,29.035276838327675,25.68772116167232,58580496,62.31862905282672,62.964425920837506,NaN,NaN,NaN,NaN,NaN,NaN,0.04476577570428397,0.589611520695474,0.54484574499119,78.22266666666673,68.82655539965377,184337210,-521819967.73342514,28.9016310125375,13.545833672457741,39.43956330029863,78.57142857142857,0
2003-05-12,28.36,28.96001,28.17,28.84,26.696982055156145,26.14672035267422,26.731802629610563,27.624152008602994,24.896700200000158,25.77949980000002,26.416199199999987,27.5279995,27.5279995,29.090759402243386,25.965239597756614,67597120,65.43210065360242,63.02591861057203,NaN,NaN,NaN,NaN,NaN,NaN,0.06354496888151506,0.6242769560930839,0.5607319872115688,94.28526530826042,74.31558322967997,251934330,-474760133.01133317,31.62553133194136,12.387660389220962,39.64828199429927,100,0
2003-05-13,28.63,28.99001,28.53999,28.66,26.716514572020262,26.19648826648265,26.80741821276309,27.72280419825985,24.926650200000164,25.806799900000023,26.496399399999987,27.6594995,27.6594995,29.136162643055737,26.18283635694426,65188000,63.08238635132782,62.814260649710846,NaN,NaN,NaN,NaN,NaN,NaN,0.05538500509944644,0.6299632435858769,0.5745782384864304,84.50664550870647,85.67152582787787,186746330,-505179847.69068074,30.38164724223389,11.770299344965283,39.594231294132065,100,14.285714285714286
2003-05-14,28.87399,28.97,28.36,28.60001,26.735255820059862,26.24408275625527,26.877715929909634,27.80634760794939,24.95050025000016,25.839000000000024,26.57839959999999,27.7755,27.7755,29.1622291732998,26.388770826700203,62228304,62.279671039435314,62.69867116879025,NaN,NaN,NaN,NaN,NaN,NaN,0.038300382623544516,0.622453716765861,0.5841533341423165,81.6902268064469,86.8273792078046,124518026,-518439577.1233361,28.321276127571572,12.973106863601211,39.041230236665875,92.85714285714286,7.142857142857143
2003-05-15,28.75,28.98,28.56,28.92,26.75699456811897,26.297071216527442,26.957805501285726,27.91240974052564,24.97355025000016,25.877600000000026,26.665799599999986,27.910500000000003,27.910500000000003,29.186500705360235,26.63449929463977,62485104,64.84907516514215,63.26917117221702,NaN,NaN,NaN,NaN,NaN,NaN,0.04067970269697241,0.635002962513532,0.5943232598165596,96.5681540776761,87.58834213094315,187003130,-473807359.98047847,27.079319263423507,12.35198743286643,39.56175528893879,85.71428571428571,0
2003-05-16,28.73,28.94,28.48,28.7,26.77632795550087,26.344653964715018,27.026126854176482,27.987418336666053,24.99780020000016,25.911399900000028,26.74999939999999,28.004499499999998,28.004499499999998,29.22091330214976,26.788085697850235,70645872,61.735475984687355,63.29062453508421,NaN,NaN,NaN,NaN,NaN,NaN,0.020580299435194793,0.6200486341105531,0.5994683346753583,83.8884228420952,87.3822679087394,116357258,-476878919.6326529,25.631865940015352,12.621350777834891,39.576633980525635,78.57142857142857,0
2003-05-19,28.52,28.67999,27.61,27.69,26.78541921962524,26.371294480265217,27.05216109518917,27.959092780793096,25.02260020000016,25.931599900000027,26.81299959999999,28.042999499999997,28.042999499999997,29.164733734148218,26.921265265851776,91762880,49.89213171127632,62.325364362016764,NaN,NaN,NaN,NaN,NaN,NaN,-0.06301754927751013,0.5206963980784707,0.5837139473559808,27.77762345764745,69.41140012580625,24594378,-554920119.2431163,22.555284073214104,20.686757348546543,36.97185570688645,71.42857142857143,14.285714285714286
2003-05-20,27.75999,27.96001,27.41,27.77,26.79521604331056,26.398991619269864,27.08031164047587,27.941083944527087,25.050200200000162,25.955799800000026,26.888199799999988,28.059999999999995,28.059999999999995,29.154020676240567,26.965979323759424,72017376,50.6989011690966,61.680663693545014,NaN,NaN,NaN,NaN,NaN,NaN,-0.11232777275793004,0.44330423140856823,0.5556320041664983,32.22204321087095,47.96269650353787,96611754,-532661917.12635493,21.174188303180163,21.64663699893042,34.13723651232127,64.28571428571429,7.142857142857143
2003-05-21,27.64999,27.75,27.44,27.69,26.804119366262693,26.42455614166056,27.10422098790819,27.91717118790546,25.08145020000016,25.97989980000003,26.96599979999999,28.063,28.063,29.15260783772933,26.973392162270667,64102800,49.834807174209836,60.82791603584258,NaN,NaN,49.834807174209836,NaN,NaN,NaN,-0.1475170621034556,0.3712356765371787,0.5187527386406343,17.721406826539127,25.90702449835251,32508954,-493373104.2231287,20.368329519680728,20.822797505815494,31.945530147204725,57.142857142857146,0
2003-05-22,27.75999,28.32001,27.62,28.09,26.816914198439182,26.45753522796431,27.14287898838238,27.933631074771608,25.10940020000016,26.012599700000028,27.043199799999993,28.0935,28.0935,29.149763338396713,27.037236661603284,62474096,54.05164675082316,59.95232280424487,NaN,NaN,NaN,NaN,NaN,NaN,-0.14104224294950019,0.3424499349537591,0.48349217790325927,43.0377022930234,30.993717443477824,94983050,-471954612.6315229,25.252394067165294,19.15723834618063,30.131429334186144,50,85.71428571428571
2003-05-23,28.041,28.25,27.95,28.10001,26.829681320842774,26.490059480875907,27.18041353785758,27.949476686698123,25.135900250000162,26.04729980000003,27.092799999999993,28.151000500000002,28.151000500000002,29.068037596337483,27.23396340366252,37940608,54.15550250876036,59.11472958279143,NaN,NaN,NaN,NaN,NaN,NaN,-0.13335937538582598,0.3167929586709768,0.45015233405680277,43.67124258707225,34.81011723554493,132923658,-471952083.25765586,24.353349177022416,18.47519540013071,27.865999927173892,42.857142857142854,78.57142857142857
2003-05-27,27.92999,29.22,27.89999,29.10001,26.852271655958766,26.541741669373412,27.255691830490616,28.05905128796497,25.163550250000156,26.09459990000003,27.160400199999994,28.232001000000004,28.232001000000004,29.183204545028953,27.280797454971054,101570320,63.122926148791585,58.729981287960584,NaN,NaN,NaN,NaN,NaN,NaN,-0.061839273100565584,0.37285324268109576,0.43469251578166135,93.37071823204431,60.02655437071331,234493978,-388847415.3312004,31.445384471106024,15.80830706284567,26.79637643775579,100,71.42857142857143
2003-05-28,29.16,29.39999,28.96001,29.19,26.875532634506442,26.59418242839572,27.331547052824316,28.166760689111165,25.19285025000016,26.132500000000032,27.212199999999992,28.305001000000004,28.305001000000004,29.31327854119387,27.296723458806138,76399008,63.80898313538965,58.73024299262378,NaN,NaN,NaN,NaN,NaN,NaN,-0.011990198806246855,0.41970476727385275,0.4316949660800996,89.44768566676225,75.49654882862626,310892986,-385374575.2930163,31.91157032521883,15.029549713000707,26.18540063570217,100,64.28571428571429
2003-05-29,29.23,29.8,29.16,29.31,26.899756190382,26.64796099417006,27.40913344290964,28.27564062348153,25.22240030000016,26.16880010000003,27.25980019999999,28.398001000000004,28.398001000000004,29.416738874075225,27.379263125924783,97637312,64.75071175301434,59.28663918559884,NaN,NaN,NaN,NaN,NaN,NaN,0.023605220314347364,0.4612014914730338,0.43759627115868643,79.49790794979072,87.43877061619908,408530298,-437244397.2930168,34.1030812125711,13.952811228078929,26.966517906672692,100,57.142857142857146
2003-05-30,29.53,29.87,29.45,29.78999,26.92851473575133,26.71017939032511,27.502500366717104,28.419864373626144,25.25835020000016,26.203499900000033,27.321599999999993,28.503000500000002,28.503000500000002,29.634813588852815,27.37118741114719,78160880,68.3035190877285,59.714131330948966,NaN,NaN,NaN,NaN,NaN,NaN,0.0713206735480777,0.5267471130937835,0.45542643954570583,96.7475609756097,88.5643848640542,486691178,-388862812.57301724,32.736921570546976,13.070447855696193,27.4491596854367,100,50
2003-06-02,30.08,30.2,29.31,29.58,26.954897673704053,26.76700752120976,27.583970940571334,28.530353480899844,25.28605025000016,26.232800000000033,27.377199999999995,28.568000500000004,28.568000500000004,29.78707416803594,27.348926831964068,103101312,65.20704852819756,59.698056179134326,NaN,NaN,NaN,NaN,NaN,NaN,0.0799359405326654,0.5553463652115376,0.4754104246788722,77.77777777777774,84.67441556772604,383589866,-429408272.34829825,33.16095775683785,11.793919210377652,27.72206242919638,100,42.857142857142854
2003-06-03,29.44,29.88,28.66,29.86,26.983804164512968,26.82825489702739,27.673226982117555,28.656986482718906,25.31270025000016,26.272400100000038,27.43099999999999,28.6485005,28.6485005,29.980359083371084,27.316641916628917,82208000,67.33356944379604,60.001712114310635,NaN,NaN,NaN,NaN,NaN,NaN,0.0946801686575508,0.5937606355008107,0.4990804668432599,87.8136200716846,87.44631960835733,465797866,-349895616.6105933,28.982378640762143,17.021373494500132,26.425424349474984,92.85714285714286,35.714285714285715
2003-06-04,29.81,30.58,29.72,30.42,27.017995167851147,26.899378562432787,27.78094357105412,28.82489253198377,25.34130025000016,26.309600100000033,27.518600199999987,28.739000500000003,28.739000500000003,30.277971560188853,27.200029439811154,87114880,71.13358919703307,60.63413483985333,NaN,NaN,NaN,NaN,NaN,NaN,0.1301461446982276,0.6617631477160444,0.5316170030178168,94.95268138801272,86.84802641249166,552912746,-295195575.6803601,33.55840285122827,15.535286808050547,26.392851711761146,100,28.571428571428573
2003-06-05,30.13,30.67999,29.97,30.64,27.054035016927255,26.97345027406778,27.89306343101278,28.99775990989008,25.368000250000158,26.34500000000003,27.60320019999999,28.856501,28.856501,30.5872939362221,27.125708063777903,89486624,72.48762929041794,61.179745848801595,NaN,NaN,NaN,NaN,72.48762929041794,NaN,0.1547462907291256,0.7250498664292238,0.5703035757000982,98.7770604803073,93.84778731333485,642399370,-215789572.79829118,32.155585412444594,14.416259709612383,26.445773028930812,100,21.428571428571427
2003-06-06,31.17,31.47,30.02,30.13,27.08464163367425,27.035956209234755,27.980786433718162,29.105592299424355,25.392700250000157,26.376900000000038,27.674600199999986,28.974501000000004,28.974501000000004,30.714676635984908,27.2343253640151,157178128,64.88889445311993,61.40499002511821,NaN,NaN,NaN,NaN,NaN,NaN,0.12430677202582396,0.7256870407323781,0.6013802687065541,66.99507389162561,86.90827191998187,485221242,-349119984.8258775,35.20910901248664,12.444714581584883,27.428543271253563,100,14.285714285714286
2003-06-09,30,30.22,29.53,29.73,27.110963607468534,27.089303611032086,28.04938304416059,29.16505969947918,25.41260025000016,26.403400000000033,27.74180019999999,29.040501,29.040501,30.790132594387032,27.290869405612966,94981120,59.61080352244902,62.099180868773395,NaN,NaN,NaN,NaN,NaN,NaN,0.06770177037379488,0.6860074816737978,0.6183057113000029,57.14285714285717,74.30499717159667,390240122,-389039585.9852978,32.90312126810153,16.280687556878767,29.533933864237092,92.85714285714286,7.142857142857143
2003-06-10,29.86,30.2,29.67999,30.17999,27.141501183513622,27.150505321704717,28.132936258115077,29.26171972810021,25.43270020000016,26.437799800000036,27.82379999999999,29.107500499999997,29.107500499999997,30.9226869615241,27.292314038475894,69923632,63.23391300929467,62.994538857358975,NaN,NaN,NaN,NaN,NaN,NaN,0.05175414868010675,0.6829983971501363,0.6312442484700296,67.98982630272954,64.04258577907076,460163754,-324497280.7917821,31.242411297270138,15.458957000151582,31.869165378146608,85.71428571428571,0
2003-06-11,30.07001,30.64,29.8,30.52,27.175118087160254,27.217227988601653,28.226546600934093,29.381555944471618,25.459550250000156,26.478599800000033,27.92919999999999,29.200500499999997,29.200500499999997,31.102942488103892,27.2980585118961,87395872,65.73506276911276,64.13027139985205,NaN,NaN,NaN,NaN,NaN,NaN,0.05498916092104733,0.6999806996213387,0.6449915387002914,75.32467532467534,66.81911959008734,547559626,-262071657.93463945,32.948626307922204,14.211174365661062,34.62834501984914,78.57142857142857,0
2003-06-12,30.638,30.75,30.25999,30.64999,27.209693927089006,27.285203473975876,28.32158359697589,29.502359187855273,25.486550200000156,26.531999700000032,28.03319979999999,29.3029995,29.3029995,31.284248482864143,27.321750517135854,79562128,66.66863583070776,65.03148490555809,NaN,NaN,NaN,NaN,NaN,NaN,0.056549574619678245,0.7156785069748892,0.659128932355211,77.03059655295084,73.44836606011857,627121754,-214986452.53328052,32.44189114437799,13.525342950663024,36.58744452323473,71.42857142857143,0
2003-06-13,30.655,30.73,29.86,29.96001,27.237060256172697,27.33816993983774,28.38583561278076,29.545944979488105,25.514500250000154,26.581299800000032,28.10519999999999,29.354999999999997,29.354999999999997,31.347868826621898,27.362131173378096,83365872,57.68463538505197,65.28356582529321,NaN,NaN,57.68463538505197,NaN,NaN,NaN,0.004521125209875132,0.6647803388675548,0.6602592136576797,57.703479822185415,70.01958389993719,543755882,-279185839.8005907,29.701198273151284,16.266764713634117,37.69464410183998,64.28571428571429,7.142857142857143
2003-06-16,30.17,30.89999,30,30.88,27.273308412827696,27.408305188553825,28.483645980907003,29.672997838584475,25.55150025000016,26.640799900000033,28.193199999999987,29.464,29.464,31.538445024608208,27.38955497539179,71592816,64.54512938340272,65.38515177062257,NaN,NaN,NaN,NaN,NaN,NaN,0.024365851541149786,0.690716528084117,0.6663506765429672,79.0035587188612,71.24587836466581,615348698,-210773371.11964977,28.66150780996276,14.810904025677035,37.60670956695382,57.142857142857146,0
2003-06-17,31.02,31.11,30.56,30.75999,27.30800176195379,27.474675184820086,28.572914373812612,29.77652090157643,25.58635025000016,26.693299900000035,28.28739979999999,29.617499499999997,29.617499499999997,31.59628109232899,27.638717907671005,67724624,63.10779012960554,65.3350665559237,NaN,NaN,NaN,NaN,NaN,NaN,0.02179309359125181,0.693592043532032,0.6717989499407802,74.7327402135231,70.47992625152324,547624074,-229246185.83324993,29.16984833665026,14.020221279619587,37.54330932915384,50,28.571428571428573
2003-06-18,30.66,31.22501,30.45,30.92,27.343942042929374,27.542899438586026,28.66495694738859,29.885423672854866,25.62350020000016,26.754299800000034,28.38399979999999,29.774999499999996,29.774999499999996,31.63859876490129,27.911400235098704,80241008,64.25086766308718,65.2993634066432,NaN,NaN,NaN,NaN,NaN,NaN,0.023124910369409002,0.7007050879025414,0.6775801775331324,80.42704626334529,78.05444839857653,627865082,-212163872.172884,28.09594095261599,12.969532003863868,37.179306116287265,42.857142857142854,21.428571428571427
2003-06-19,30.98,31.24001,30.38,30.42,27.374549584790774,27.599871726930857,28.733782165138056,29.936335704011547,25.662400200000157,26.813199800000035,28.47119979999999,29.9114995,29.9114995,31.52774012754886,28.295258872451143,79539632,58.184156436170824,64.57655178867478,NaN,NaN,NaN,NaN,NaN,NaN,-0.015338779738023556,0.6584067028606029,0.6737454825986264,62.63345195729546,72.59774614472127,548325450,-284304554.6722963,25.786569077528686,12.572518140027636,36.57325630498982,35.714285714285715,14.285714285714286
2003-06-20,30.69,30.78,30.25,30.38,27.40445456404659,27.654923771942126,28.798339727289505,29.978589446486637,25.700650200000155,26.869199800000032,28.569599599999993,30.0259995,30.0259995,31.41888112603266,28.633117873967343,71569184,57.71465695647305,64.04138096212303,NaN,NaN,NaN,NaN,NaN,NaN,-0.04733810686272777,0.6145728490202167,0.6619109558829445,61.209964412811374,68.0901542111507,476756266,-320764327.6534287,24.452638959540018,13.19098661390718,35.315150912133284,28.571428571428573,7.142857142857143
2003-06-23,30.33,30.371,29.56,29.91,27.429385364404332,27.699578746755154,28.841934247787957,29.972057118249815,25.739350200000157,26.916799900000036,28.65239959999999,30.116499000000005,30.116499000000005,31.19731473458006,29.035683265419948,86598496,52.36759124644092,62.972382519454804,NaN,NaN,NaN,NaN,NaN,NaN,-0.10094194122166256,0.5357335293558663,0.6366754705775288,19.587628865979354,47.81034841202872,390157770,-332616896.156511,22.5122817146858,18.821411087570358,34.09582117853787,21.428571428571427,0
2003-06-24,29.73,30.13,29.53,29.67999,27.45177944038041,27.738794811175843,28.874799179247255,29.944241202226024,25.773500100000156,26.968199900000037,28.735799599999993,30.145498000000003,30.145498000000003,31.143624709443593,29.147371290556414,83041120,49.929659459525595,61.457816109632844,NaN,NaN,NaN,NaN,NaN,NaN,-0.14973139235082122,0.4495112301390023,0.5992426224898235,7.731443298969028,29.50967885925324,307116650,-374140224.1938445,21.187461435298825,18.008037928393307,32.052966183218935,14.285714285714286,21.428571428571427
2003-06-25,29.67,30.17999,29.47,29.52,27.47235874943135,27.77406620105355,28.90010117221795,29.9038372782045,25.80570010000016,27.018999900000036,28.80559959999999,30.161998000000004,30.161998000000004,31.105831773555614,29.218164226444394,94353120,48.24713538016639,59.72635225890059,NaN,NaN,48.24713538016639,NaN,NaN,NaN,-0.18813587674149945,0.36407277656294923,0.5522086533044487,2.5000000000000355,9.939690721649457,212763530,-455203985.18878794,19.709387224922096,17.341309987399537,29.78876727218116,7.142857142857143,100
2003-06-26,29.71001,30.28,29.61,30.22,27.499698463367356,27.822500533705956,28.951861910562346,29.933948013613595,25.838550150000156,27.076299800000033,28.884399599999988,30.207498000000005,30.207498000000005,31.066587005926657,29.348408994073353,79266688,55.33844445636503,59.04417725913238,NaN,NaN,NaN,NaN,NaN,NaN,-0.16270668621295215,0.3488252955382585,0.5115319817512106,42.372641962474724,17.534695087147913,292030218,-390134315.9350571,19.221832003465696,16.05052859015116,27.018807291531804,0,92.85714285714286
2003-06-27,30.25,30.57001,29.772,29.83,27.52288554333385,27.862252998385046,28.986298698383433,29.92404820279325,25.870450150000156,27.132699800000033,28.956599599999986,30.209498500000002,30.209498500000002,31.06486758647208,29.354129413527925,82545504,51.134497177982496,58.43872680595621,NaN,NaN,NaN,NaN,NaN,NaN,-0.16779123720727035,0.3017929352421227,0.46958417244939304,20.338868141987835,21.73717003482085,209484714,-460680874.47823334,20.55091629880326,14.804457769347648,25.765726337035094,57.142857142857146,85.71428571428571
2003-06-30,30.16,30.34,29.8,29.95,27.547035935937494,27.9035945231695,29.024090906289963,29.926519802527228,25.90615015000016,27.19139980000003,29.019199399999984,30.2279985,30.2279985,31.043168111854992,29.41282888814501,72086000,52.3343747359437,57.66018835785972,NaN,NaN,NaN,NaN,NaN,NaN,-0.15880523095648463,0.27107763375378724,0.4298828647102719,27.118490855983847,29.943333653482117,281570714,-492719096.7004559,19.45050659024282,14.011745229308161,24.51264538253838,50,78.57142857142857
2003-07-01,29.7,30.38,29.25999,30.35001,27.574926225132145,27.952038393997825,29.07608773349428,29.96685220228654,25.942950150000158,27.25279980000003,29.087799599999986,30.252499,30.252499,31.05124375279527,29.45375424720473,105918192,56.1956117769014,56.97879900127318,NaN,NaN,NaN,NaN,NaN,NaN,-0.12323960002286716,0.27583336468168795,0.3990729647045551,55.05095908122145,34.169439359731044,387488906,-392473151.5162518,17.372707488873687,17.665478784420785,21.73434163512625,42.857142857142854,100
2003-07-02,30.412,30.99001,30.38,30.97,27.608708053737796,28.011800009958264,29.150358802769013,30.062390087783058,25.98450015000016,27.324399800000034,29.158599799999987,30.279999000000004,30.279999000000004,31.135755040070176,29.42424295992983,81992000,61.41307990344875,56.60340214932611,NaN,NaN,NaN,NaN,NaN,NaN,-0.058559286750039796,0.3258738562670054,0.3844331430170452,86.36326905788817,56.1775729983645,469480906,-315860276.1863399,22.180358803703413,16.57582025471094,19.82782560989666,35.714285714285715,92.85714285714286
2003-07-03,30.7,31.10001,30.47,30.58,27.638273147730455,28.062655455305624,29.206423163444736,30.111686269898957,26.02650020000016,27.389999800000034,29.217599799999984,30.276999000000007,30.276999000000007,31.128093810297365,29.42590418970265,50050800,56.82778258521939,56.54219837790951,NaN,NaN,NaN,NaN,NaN,NaN,-0.04334283735241251,0.33025459632652954,0.37359743367894205,66.66649831819869,69.3602421524361,419430106,-348433296.46855783,21.890638126865678,15.558440203623213,18.948052542816583,28.571428571428573,85.71428571428571
2003-07-07,30.97,31.89999,30.96201,31.89,27.680578887554034,28.138444456190662,29.31166147076063,30.281049482289532,26.07630025000016,27.467399900000032,29.305799799999985,30.364999000000005,30.364999000000005,31.464734913806712,29.265263086193297,88708192,66.00836194177967,56.64671498922214,NaN,NaN,NaN,NaN,NaN,NaN,0.048661764604827185,0.434424639434976,0.3857628748301488,99.62159090909097,84.2171194283926,508138298,-261614685.99072218,26.599969947651836,13.665864804900252,18.96670331663376,100,78.57142857142857
2003-07-08,31.78,32.31,31.62,32.28,27.726344271757476,28.220455457058172,29.42806690327982,30.47142572207148,26.12980025000016,27.55199980000003,29.412399799999985,30.492499,30.492499,31.833094054488186,29.151903945511812,82302496,68.17792474656035,57.00886746186177,NaN,NaN,NaN,NaN,68.17792474656035,NaN,0.12514949897066047,0.5421997485434744,0.41705024957281395,99.01639666755187,88.43482863161385,590440794,-186468928.77333155,28.703490318734048,12.790030694755997,19.200633966036825,100,71.42857142857143
2003-07-09,32.17999,32.49001,31.92999,32.2,27.77085825910317,28.299258319294644,29.53677016197473,30.636051843778958,26.182450250000162,27.63459980000003,29.506799799999982,30.5934995,30.5934995,32.11664435657146,29.070354643428537,89848496,67.23000119158702,57.22166271389748,NaN,NaN,NaN,NaN,NaN,NaN,0.15762240489883628,0.6140782556963593,0.45645585079752304,91.02141782403838,96.55313513356042,500592298,-189677689.03189313,28.885968843010513,12.111570568226561,19.492117060506068,100,64.28571428571429
2003-07-10,31.85001,31.99001,31.33,31.60001,27.808959271450405,28.364619738714552,29.617681528171797,30.727857382466677,26.23535030000016,27.70569980000003,29.58419999999998,30.6475,30.6475,32.23174691261215,29.06325308738785,103214816,60.442489514013666,57.38297221945767,NaN,NaN,NaN,NaN,NaN,NaN,0.12726158533048287,0.6155328324606266,0.48827124713014375,72.44599104649515,87.49460184602846,397377482,-208442171.0425289,26.531390461793507,16.745805550582986,18.646625496957004,92.85714285714286,57.142857142857146
2003-07-11,31.65199,31.99001,31.61,31.84,27.849069129445922,28.433439149829116,29.70483127216506,30.83377572699366,26.28940030000016,27.771599800000033,29.671999999999983,30.7070005,30.7070005,32.374359805039106,29.03964119496089,67778368,62.0911160529214,57.69557644063256,NaN,NaN,NaN,NaN,NaN,NaN,0.11242487460132455,0.6288023403817995,0.5163774657804749,79.87597600014865,81.11446162356073,465155850,-194175200.02513492,25.526881059111016,16.111789811555788,18.12483401714353,85.71428571428571,50
2003-07-14,32.34399,32.75,32.07001,32.22,27.89256097890417,28.508420552802797,29.803465339923292,30.965797086327598,26.341150300000024,27.84299980000003,29.762599999999978,30.82,30.82,32.573637944411544,29.066362055588456,84558128,64.60643346297249,58.56977945609909,NaN,NaN,NaN,NaN,NaN,NaN,0.11677501151421055,0.6623462301732381,0.5455712186590276,84.81379709513723,79.04525471392701,549713978,-241430209.983047,30.564535700923713,14.712104912749435,19.987900793871493,100,42.857142857142854
2003-07-15,32.53,32.64999,31.94,32.25999,27.936017984089204,28.582709056707692,29.899799640318456,31.0890535542964,26.394450200000023,27.91579970000003,29.84219979999998,30.8889995,30.8889995,32.75184585869385,29.026153141306153,76114688,64.87059832050636,59.63698937474059,NaN,NaN,NaN,NaN,NaN,NaN,0.11095825370584578,0.6842690357913348,0.573310782085489,85.95963908412875,83.54980405980488,625828666,-248935652.74545172,28.48530407579614,14.956964812484575,21.63284748686316,92.85714285714286,35.714285714285715
2003-07-16,32.46001,32.5,31.73,32.16,27.978047655889313,28.653546501129323,29.98843494854126,31.191048453887216,26.448700200000022,27.985699700000033,29.92039979999998,30.959000000000003,30.959000000000003,32.90074046671526,29.01725953328474,81709632,63.59255136195125,60.73309051629665,NaN,NaN,NaN,NaN,NaN,NaN,0.08988791442179722,0.6856706751127355,0.5957827606909383,83.0946043134546,84.6226801642402,544119034,-239385176.2779204,26.38865609920738,15.86346096129545,22.955633561201456,85.71428571428571,28.571428571428573
2003-07-17,31.67,31.84,31.043,31.17999,28.009907778716286,28.703575085265378,30.035162597618076,31.18999526780272,26.501000150000024,28.050099500000034,29.971799599999986,30.9719995,30.9719995,32.91600135393426,29.02799764606573,110496688,52.64504865571305,60.54070510196436,NaN,NaN,NaN,NaN,NaN,NaN,0.003995774529880203,0.6007774788532885,0.5967817043234083,55.01416901384239,74.68947080380859,433622346,-311897068.069338,23.667214957037505,20.570336453100673,22.813466618716213,78.57142857142857,21.428571428571427
2003-07-18,31.39999,31.96001,30.92,31.28,28.042446009773837,28.754593400408638,30.08397975065266,31.198567147059602,26.547500150000023,28.115199500000035,30.031599799999984,31.0149995,31.0149995,32.94626317441111,29.08373582558889,80587632,53.52433837677337,60.71140804473514,NaN,NaN,NaN,NaN,NaN,NaN,-0.04910756017497975,0.5353972541046836,0.5845048142796634,57.879776848776984,65.32951672535799,514209978,-336693798.9818485,21.44921237466096,19.750925900904353,21.946939306696947,71.42857142857143,14.285714285714286
2003-07-21,31.24001,31.3,30.61,30.88,28.07068037783579,28.796680659806487,30.115196231019222,31.16822741876821,26.595650150000026,28.18179950000004,30.09379979999999,31.0399995,31.0399995,32.95056995933916,29.129429040660835,111931680,49.56060487686964,60.51328162622985,NaN,NaN,49.56060487686964,NaN,NaN,NaN,-0.11067328648137664,0.4461632061779426,0.5568364926593192,46.418491637559775,53.104145833393055,402278298,-361026772.8948923,20.103120720144226,21.330938465635526,20.997645192118124,64.28571428571429,7.142857142857143
2003-07-22,31.11,31.5,30.86,31.34,28.10321092133991,28.847043419018238,30.16322775137141,31.18458671221886,26.648650100000022,28.24749950000004,30.15239979999999,31.1114995,31.1114995,32.953360180426046,29.269638819573952,91610688,53.79797744808512,60.3420220313144,NaN,NaN,NaN,NaN,NaN,NaN,-0.11918026110433644,0.4078611662788987,0.5270414273832351,40.50632911392407,48.26819920008695,493888986,-315221428.8948923,20.760667565582054,20.072640878825325,21.058315661505997,57.142857142857146,0
2003-07-23,31.39,31.64,30.99001,31.60001,28.138004942023098,28.90155760874065,30.219572153278413,31.224150834864684,26.70490010000002,28.31189960000004,30.20759999999999,31.207500500000002,31.207500500000002,32.93766540835381,29.477335591646195,69189632,56.04571156729654,59.9586385787321,NaN,NaN,NaN,NaN,NaN,NaN,-0.10647634708826392,0.39394599352290527,0.5004223406111692,49.56184210526323,45.495554285582365,563078618,-254545445.97774,20.807828358491076,18.85607381402304,20.376866605033655,50,0
2003-07-24,31.85001,32.02,31.08,31.17999,28.16827345006267,28.946675081834893,30.257235598247888,31.219945041068048,26.76000005000002,28.377199600000036,30.257999799999983,31.2905,31.2905,32.838574520208795,29.74242547979121,83615504,51.672430011002795,59.590399109145196,NaN,NaN,NaN,NaN,NaN,NaN,-0.12429906395434731,0.34504851066823505,0.46934757462258236,26.635046728971986,38.90107264938644,479463114,-320372196.26505893,22.499875540855573,17.2297179831408,20.1165984688891,42.857142857142854,0
2003-07-25,31.13,31.84,30.769,31.8,28.20441003264911,29.003176565362914,30.31773616302248,31.275188370490138,26.818000050000023,28.450199600000037,30.321999599999984,31.369500000000006,31.369500000000006,32.850815199448874,29.888184800551134,83055632,57.005653796207554,58.94734852731862,NaN,NaN,NaN,NaN,NaN,NaN,-0.09366539777933625,0.35226582739841206,0.4459312251777483,55.60747663551406,43.934788489916436,562518746,-243520533.04190287,20.346587257335305,18.35982390094016,18.188821285120195,35.714285714285715,71.42857142857143
2003-07-28,31.86,31.98801,31.60001,31.89,28.241082569637676,29.060341385850776,30.37939356839415,31.333741859014886,26.877150050000022,28.52359960000004,30.381399599999988,31.472500000000007,31.472500000000007,32.7885663813492,30.156433618650812,56219008,57.73478623019593,58.20141006186402,NaN,NaN,NaN,NaN,57.73478623019593,NaN,-0.06787659448282851,0.36108548207421265,0.42896207655704116,59.81308411214957,47.35186915887855,618737754,-215703715.6299433,20.987290017471942,17.69898241741942,16.056554187110688,28.571428571428573,64.28571428571429
2003-07-29,31.92999,32.02,31.23,31.64999,28.275002046556704,29.111621556427988,30.429220879437516,31.363860729584896,26.93000000000002,28.59519940000004,30.440399399999983,31.557499500000013,31.557499500000013,32.673667206993585,30.441331793006437,80601632,55.0534509275181,57.331656471573375,NaN,NaN,NaN,NaN,NaN,NaN,-0.06738211180837594,0.34473443679657123,0.4121165486049472,48.59766355140184,54.672741433021834,538136122,-210604387.06366506,19.45205678133532,19.83042511554919,13.202809658428805,21.428571428571427,57.142857142857146
2003-07-30,31.71001,31.74001,31.33,31.42,28.306295558531264,29.157332020657137,30.46807496259683,31.369207326767288,26.976000000000028,28.663999500000042,30.514999399999983,31.61099900000001,31.61099900000001,32.58391040815262,30.6380875918474,56642304,52.53559144268235,56.76687803790685,NaN,NaN,NaN,NaN,NaN,NaN,-0.08197451041202852,0.30964841058991155,0.39162292100194007,37.850467289719724,48.75373831775706,481493818,-242379944.59406602,18.687987776528068,19.051493954013566,11.656508734562872,14.285714285714286,50
2003-07-31,31.78999,32.33,31.52,31.8,28.341058786804584,29.209662079654024,30.520307317004796,31.4102352004085,27.022600000000025,28.74189960000004,30.595599399999987,31.652499000000013,31.652499000000013,32.58235702148136,30.72264097851867,85711120,56.10747151551638,56.33947485666363,NaN,NaN,NaN,NaN,NaN,NaN,-0.06614314302863467,0.30894399221614677,0.37508713524478143,55.60747663551406,47.35186915887855,567204938,-268833993.9767821,22.64859338986517,17.41635058085134,10.974222463334096,7.142857142857143,42.857142857142854
2003-08-01,31.69,31.78999,31.3,31.46001,28.37209312723439,29.254223424611368,30.55715840261245,31.414975657512453,27.062100050000026,28.81849970000004,30.670999599999988,31.69649950000001,31.69649950000001,32.492898486775644,30.90010051322437,73569632,52.314186285300785,55.46145720111565,NaN,NaN,NaN,NaN,NaN,NaN,-0.07786998113891608,0.27774965882113634,0.3556196399600524,41.66736111451525,45.041768346583034,493635306,-294354168.57430446,21.553963651010452,18.701165611991833,8.979537531759048,0,35.714285714285715
2003-08-04,31.42,31.92,30.84,31.45,28.402719066266883,29.29770414887649,30.592171798588435,31.418311309177934,27.105450050000027,28.89069970000004,30.738199599999984,31.674499500000007,31.674499500000007,32.47260930330856,30.876389696691454,96430320,52.20228452222535,54.556577644095576,NaN,NaN,NaN,NaN,NaN,NaN,-0.08501899418500791,0.24934589722879252,0.33436489141380044,44.44444444444442,47.23976073149126,397204986,-281853941.9076378,19.37564860169382,21.115712457488264,7.062138342357668,0,28.571428571428573
2003-08-05,31.41,31.48,30.17999,30.21001,28.420702060632387,29.315769611274977,30.57718506138889,31.30323499401813,27.138750100000024,28.93659980000004,30.78039959999999,31.57100000000001,31.57100000000001,32.54555138405235,30.596448615947665,111179680,40.61311025537424,52.91518899362579,NaN,NaN,NaN,NaN,NaN,NaN,-0.1672246267481441,0.12533410797862032,0.2925587347267644,1.396272575476412,29.169359378145373,286025306,-387898870.6463397,17.131294641060638,24.550634434251023,6.554241141230718,0,100
2003-08-06,30.36,30.77,30.10001,30.19,28.43830701525296,29.333081104121018,30.562001333491285,31.19721261363545,27.170650100000024,28.98129980000004,30.802199399999985,31.47050000000001,31.47050000000001,32.57125128896494,30.36974871103508,96848128,40.45702190747296,52.04461565446578,NaN,NaN,NaN,NaN,NaN,NaN,-0.21392752698418177,0.025149325996537186,0.23907685298071896,4.035444105130532,16.625387041683798,189177178,-458730601.27109516,16.096458143543902,23.788722341659593,7.431773703195611,71.42857142857143,100
2003-08-07,30.22,30.50999,30.02,30.31,28.456930826046463,29.352426032752284,30.552118928256334,31.112716174241598,27.200750150000026,29.018399700000042,30.824599399999983,31.405999500000014,31.405999500000014,32.614721810597196,30.197277189402833,67364320,41.899155584958834,51.21424545505045,NaN,NaN,NaN,NaN,NaN,NaN,-0.2265070639783653,-0.04405697699223765,0.18245008698612764,12.554112554112525,5.9952764115731645,256541498,-446355935.57750964,15.365436822841428,23.449934409756125,8.625062410307956,64.28571428571429,100
2003-08-08,30.42999,30.55,29.92999,30.07001,28.472981365090778,29.36663561626214,30.533212695775692,31.013410824313826,27.230400200000027,29.04979990000004,30.83979959999999,31.317500000000013,31.317500000000013,32.63999131572086,29.995008684279163,66706624,39.821883672888724,50.51862251190896,NaN,NaN,39.821883672888724,NaN,NaN,NaN,-0.2394967632372625,-0.11692086706045046,0.12257589617681201,5.8341423577401725,7.474566338994415,189834874,-482933169.75321656,14.469942794703316,22.929354696075087,10.02905296693228,57.142857142857146,100
2003-08-11,30.08,30.60001,30.03,30.39999,28.492155580363505,29.387098079306455,30.52798827633351,30.954989793426794,27.259400100000022,29.086799800000037,30.851999599999985,31.22649950000001,31.22649950000001,32.538491339219064,29.914507660780956,63737296,43.93754249240806,49.81430572936059,NaN,NaN,NaN,NaN,NaN,NaN,-0.21514258734312633,-0.1463523380020959,0.06879024934103042,19.583251736451064,12.657168882767927,253572170,-463927488.79828644,14.159183158512379,21.678476548427067,11.40737989603488,50,92.85714285714286
2003-08-12,30.50999,30.89999,30.326,30.86,28.515716221354914,29.416264453973653,30.541008343928272,30.945943146433766,27.29380010000002,29.127399800000035,30.877599599999986,31.156500000000015,31.156500000000015,32.387339843422865,29.925660156577162,59770000,49.157772986535264,49.32231011644908,NaN,NaN,NaN,NaN,NaN,NaN,-0.15987011581625482,-0.13104739542928812,0.028822720386966712,38.75025520726997,21.38921643382041,313342170,-412485864.90239966,16.287458470008616,20.467608527003748,11.868255421034323,42.857142857142854,85.71428571428571
2003-08-13,30.98,31.06599,30.64999,30.87,28.539141930595164,29.445051296469224,30.553909977499714,30.93871046582103,27.32505010000002,29.164399800000034,30.89779959999999,31.092000000000013,31.092000000000013,32.238010349062634,29.94598965093739,58071600,49.26836247251487,49.15059100655708,NaN,NaN,NaN,NaN,NaN,NaN,-0.11647034042681584,-0.11676520514655309,-0.0002948647197372478,39.166920137832825,32.50014236051796,371413770,-409132788.3831684,17.27401734367582,19.612587806418222,11.373599909256138,35.714285714285715,78.57142857142857
2003-08-14,30.88,31.19,30.67,30.89999,28.56263295616138,29.473861963865872,30.56748174308796,30.935022802409502,27.357100000000017,29.212999800000034,30.90739939999999,31.078000000000014,31.078000000000014,32.22620766421332,29.92979233578671,51191200,49.62226936685821,48.623206404460696,NaN,NaN,NaN,NaN,NaN,NaN,-0.08124605433954504,-0.10185243264416854,-0.02060637830462351,40.416498264590544,39.444557869897785,422604970,-415041434.1985535,17.62402492107857,18.56839977285797,11.193343568591967,28.571428571428573,71.42857142857143
2003-08-15,31,31.28999,30.92999,31.17,28.588576906846342,29.507448855670507,30.591109910025686,30.957401583132405,27.39335000000002,29.260599800000037,30.917999399999985,31.072500000000012,31.072500000000012,32.217834815745015,29.92716518425501,28131296,52.8138977127254,48.271714367498525,NaN,NaN,NaN,NaN,NaN,NaN,-0.037489829981644025,-0.06746866578167854,-0.029978835800034513,51.666868054716545,43.75009548571331,450736266,-405662772.68210876,17.95445347489987,17.80284009890484,10.616491634105646,21.428571428571427,64.28571428571429
2003-08-18,31.31,32.00999,31.05,31.97,28.622222907773242,29.55621224466713,30.64518403120115,31.053839527595986,27.430400000000017,29.314699800000035,30.954799399999988,31.127000000000017,31.127000000000017,32.33265369827182,29.921346301728217,67352688,60.74849437669668,48.678503185297,NaN,NaN,NaN,NaN,NaN,NaN,0.04322844496126463,0.024056720401546272,-0.019171724559718356,85.00006249973958,59.02780960634889,518088954,-343921463.95297635,23.574926588367095,16.048820374805242,11.90440091766274,14.285714285714286,57.142857142857146
2003-08-19,32.11,32.38,31.84599,32.37,28.659514222123757,29.611930814079663,30.712823873114832,31.179188144015416,27.46950000000002,29.374699800000034,31.007599400000014,31.178500000000014,31.178500000000014,32.49869992431367,29.858300075686355,68390816,64.00744730331763,49.49792146105667,NaN,NaN,NaN,NaN,NaN,NaN,0.11725683988645937,0.12739932529835585,0.010142485411896485,99.59183840065938,78.7529229850385,586479770,-278092053.76934814,26.122679024387434,15.154381314939519,13.733628223469683,100,50
2003-08-20,32.10001,32.52,32.02,32.28999,28.695638359217053,29.664961689048383,30.774673525149545,31.284978796966328,27.50469995000002,29.436799700000034,31.049799400000012,31.212999000000014,31.212999000000014,32.60932094860397,29.816677051396052,58280304,62.88278408701359,49.981872359020755,NaN,NaN,NaN,NaN,NaN,NaN,0.1523110879671244,0.20053134537080197,0.04822025740367758,91.11933930757024,91.90374673598973,528199466,-273431960.66150814,26.22256546817903,14.348063547719606,14.89143619212573,100,42.857142857142854
2003-08-21,32.59,32.82001,32.27,32.64,28.734885738727332,29.723873338770197,30.847823582986816,31.414028435350488,27.53840000000002,29.510699700000032,31.092199400000013,31.285999500000013,31.285999500000013,32.814216482020775,29.75778251797925,77253808,65.7203697321599,50.93945689093926,NaN,NaN,NaN,NaN,NaN,NaN,0.18819521826757754,0.2834642802381495,0.09526906197057197,93.77132338184501,94.8275003633582,605453274,-246746171.3450965,27.90197893633194,13.49731601225955,16.870555511403474,100,35.714285714285715
2003-08-22,33.25999,33.37,32.33,32.44,28.771752547297208,29.777658025131185,30.91026187385008,31.511740012936155,27.57009995000002,29.580599700000036,31.127999600000013,31.31799950000002,31.31799950000002,32.91325975216423,29.722739247835815,93034368,62.76751068391476,51.69411590248851,NaN,NaN,NaN,NaN,NaN,NaN,0.1871891090130794,0.3292554482369212,0.14206633922384182,72.96519486861955,85.95195251934491,512418906,-320100192.2681735,30.59333482103804,12.043206909949072,19.67128482087251,100,28.571428571428573
2003-08-25,32.36,32.50999,32.21001,32.50999,28.808948939861416,29.831763608791952,30.972996310169684,31.606811440275568,27.600299900000017,29.642099600000037,31.17899920000001,31.34899900000002,31.34899900000002,33.01024634827536,29.68775165172468,43082304,63.3874699299228,53.32085587924198,NaN,NaN,NaN,NaN,NaN,NaN,0.17991714340810452,0.36696276848397247,0.18704562507586794,74.99978197737808,80.5787667426142,555501210,-277017888.2681735,29.602675817558673,12.948469067922636,21.195525737390494,92.85714285714286,21.428571428571427
2003-08-26,32.28,32.59,31.81,32.53999,28.84607372652946,29.88539185416241,31.034447043104205,31.69568558882075,27.635299900000017,29.702699500000037,31.212199000000012,31.39349900000002,31.39349900000002,33.130563923413064,29.656434076586976,79913312,63.6667342473016,54.97869247494402,NaN,NaN,NaN,NaN,NaN,NaN,0.16613693294643206,0.394716791258908,0.22857985831247596,75.87187246548716,74.61228310382825,635414522,-207351921.73771232,27.141626970085547,16.135477367438135,21.634510459237877,85.71428571428571,14.285714285714286
2003-08-27,32.49001,32.83,32.37,32.8,28.885416276514242,29.943106866951272,31.103684413962863,31.80085838988544,27.673949850000017,29.770199500000036,31.252999200000012,31.462499000000026,31.462499000000026,33.30474195361667,29.620256046383385,47272000,66.08150423801466,56.70600309301943,NaN,NaN,NaN,NaN,NaN,NaN,0.16329990327582716,0.4327047374072599,0.26940483413143274,83.4302807259281,78.10064505626444,682686522,-166245834.7811908,28.397054508347836,15.326245538962747,22.282103048814914,78.57142857142857,7.142857142857143
2003-08-28,32.94,33.12,32.52,33.09,28.927252930479273,30.00542158245719,31.181579142827065,31.923633781324924,27.717849850000015,29.840199500000036,31.296399200000014,31.526999000000025,31.526999000000025,33.497833497402404,29.55616450259765,55356800,68.58902951372137,58.76079922450748,NaN,NaN,NaN,NaN,NaN,NaN,0.16901226732987545,0.48067016829377707,0.3116579009639016,91.61676646706604,83.63963988616042,738043322,-116424714.78118977,29.70909647300794,14.317598063456833,23.16355270830903,71.42857142857143,0
2003-08-29,33.03999,33.46001,32.98,33.39,28.97165837395709,30.072442937260018,31.268183882324042,32.06328770691302,27.760149900000016,29.91349950000004,31.355799200000014,31.62349850000002,31.62349850000002,33.75427231299077,29.49272468700927,53194608,70.97918564408572,60.692345163913025,NaN,NaN,NaN,NaN,NaN,NaN,0.18003673767157652,0.5367038230533723,0.35666708538179576,97.76612072073807,90.93772263791072,791237930,-78747093.95262289,31.915778085516237,13.549342747810753,24.550353976262123,100,0
2003-09-02,33.49001,33.89,33.13,33.87,29.020398091629158,30.147642087017246,31.370215886938784,32.23535554434988,27.803349900000015,29.997599400000034,31.425599200000015,31.744498500000027,31.744498500000027,34.08649903247751,29.402497967522542,80504320,74.34316049079824,62.491301414217524,NaN,NaN,NaN,NaN,NaN,NaN,0.20488965171372653,0.6127791500239539,0.40788949831022736,99.38271795457412,96.25520171412607,871742250,-2479843.4263077825,33.983006812191654,12.413597189866154,27.058654635339508,100,0
2003-09-03,34.10001,34.2,33.64999,33.85001,29.068453931513446,30.220956303115916,31.46746271490197,32.3891321591737,27.842099900000015,30.078399500000035,31.50439940000001,31.926498500000026,31.926498500000026,34.328201070703955,29.524795929296094,85258000,73.95866746857332,64.25489462822169,NaN,NaN,NaN,NaN,NaN,NaN,0.2047319568508999,0.6638044443738522,0.4590724875229523,90.08526912181289,95.74470259904167,786484250,-25726952.133423794,35.35538324315857,11.652362647215307,30.20749448176394,100,0
2003-09-04,33.83,34.22,33.7,34.16,29.119116081448635,30.298957168400747,31.573052412356795,32.557786239252394,27.880699900000018,30.164899600000034,31.59399960000001,32.12499850000002,32.12499850000002,34.57554672848449,29.67445027151555,63903104,76.02905731677491,66.14109376750146,NaN,NaN,NaN,NaN,76.02905731677491,NaN,0.20949829065160674,0.7209453508374608,0.5114470601858541,98.17629733648218,95.88142813762306,850387354,23429281.712729383,33.503672718286985,10.96758542586188,33.64080212787322,100,0
2003-09-05,33.966,34.34,33.67,33.94,29.167085075663074,30.371057026452217,31.66587388638202,32.68942564503788,27.920149900000016,30.243999600000038,31.682399600000007,32.30649850000002,32.30649850000002,34.73001243602918,29.882984563970858,91046688,71.67384521017352,67.48823287446204,NaN,NaN,NaN,NaN,NaN,NaN,0.18280083850223505,0.7399481083136479,0.5571472698114128,87.84194528875364,92.03450391568289,759340666,5763506.429146025,32.32800863851701,10.140675260551287,37.34222922769872,100,0
2003-09-08,34,34.53,33.95,34.5,29.22014890575598,30.452818273453165,31.77701608691606,32.861861297891416,27.964399950000015,30.326199600000038,31.767999600000007,32.52799800000001,32.52799800000001,34.90267382800331,30.15332217199671,69355008,75.5181970858637,68.54321163940254,NaN,NaN,NaN,NaN,NaN,NaN,0.18714315712132645,0.7910762162130709,0.6039330590917444,98.89705882352936,94.97176714958839,828695674,67943858.42914574,32.319692908051834,9.463994721322072,39.89266649697068,100,0
2003-09-09,34.33,34.386,33.92,34.09,29.268605135549453,30.524841673978845,31.86772133840955,32.97882688856843,28.00114990000002,30.404899600000036,31.853199600000007,32.712498500000024,32.712498500000024,34.967539517384765,30.457457482615283,88014688,68.21829732474686,68.84398664093321,NaN,NaN,NaN,NaN,NaN,NaN,0.1483833001870607,0.7894121843255704,0.6410288841385097,83.8235294117648,90.18751117468258,740680986,44145895.57936083,30.187141692935533,9.180823215043246,41.805990276742214,92.85714285714286,35.714285714285715
2003-09-10,33.75,33.89,33.11,33.27,29.308420009822594,30.579201244791143,31.92271265847192,33.00655766108572,28.02884990000002,30.46939950000003,31.919599600000012,32.832998500000016,32.832998500000016,34.93131697823181,30.734680021768217,111708880,56.46276938209362,68.38541416201035,NaN,NaN,56.46276938209362,NaN,NaN,NaN,0.058136252670758504,0.7136991999769577,0.6555629473061992,53.67647058823541,78.79901960784316,628972106,-21733700.318074077,26.951250363730693,17.056632734553993,41.32134911797491,85.71428571428571,28.571428571428573
2003-09-11,33.278,33.78,33.00999,33.64,29.35152030823232,30.639811121131913,31.99005726010047,33.06688550288708,28.058449900000017,30.536599500000033,31.98539940000001,32.97149850000002,32.97149850000002,34.89133940436921,31.051657595630825,96963120,59.82673070332253,67.96443994566484,NaN,NaN,NaN,NaN,NaN,NaN,0.016159446590678916,0.6757622555445479,0.659602808953869,67.27941176470588,68.25980392156869,725935226,39970561.22554205,24.709956089339695,16.718292857944725,40.21391393190089,78.57142857142857,21.428571428571427
2003-09-12,33.34,33.84,33.05,33.82001,29.39598289223001,30.702785356357023,32.06182011264555,33.13861164546927,28.087599900000015,30.600499700000036,32.04239960000001,33.11749950000002,33.11749950000002,34.81640761702549,31.418591382974554,105031504,61.38977787409791,67.86603045924934,NaN,NaN,NaN,NaN,NaN,NaN,-0.00552356236527074,0.6526983559972805,0.6582219183625513,73.89742647058834,64.95110294117654,830966730,139686673.4155168,23.269710194014895,15.311431893886654,38.57961377340397,71.42857142857143,14.285714285714286
2003-09-15,33.84,33.91,33.444,33.49001,29.436719480367024,30.757977923557874,32.11782755920847,33.17207815542458,28.119799950000015,30.659099800000035,32.10059980000001,33.23350000000002,33.23350000000002,34.68321248187933,31.783787518120715,54625008,57.0106006937328,67.41053979952149,NaN,NaN,NaN,NaN,NaN,NaN,-0.045885210688767386,0.600865405001592,0.6467506156903594,61.76507352941168,67.64730392156862,776341722,95848346.17980772,22.851159655047855,14.53446619563934,37.37293018964787,64.28571428571429,7.142857142857143
2003-09-16,33.52,34.42999,33.52,34.39999,29.486105256681782,30.83009697457653,32.20732412551402,33.28902214062224,28.152249900000015,30.72829970000004,32.150799600000006,33.35499950000002,33.35499950000002,34.76761094697915,31.942388053020895,87608880,64.52538809686655,67.47187221734757,NaN,NaN,NaN,NaN,NaN,NaN,-0.016601235545483428,0.6259990712585051,0.6426003068039885,93.9810185185186,76.54783950617288,863950602,177680753.03175226,26.07480317024055,13.091390248699131,37.92419683447201,57.142857142857146,0
2003-09-17,34.33,34.50101,34.03,34.25999,29.533606597411318,30.898015648347293,32.28782082647425,33.38149527008679,28.184949850000013,30.801399600000035,32.19039940000001,33.44949900000002,33.44949900000002,34.83856603803446,32.06043196196558,79821680,62.709173057693754,67.2309914187532,NaN,NaN,NaN,NaN,NaN,NaN,-0.012169280321021048,0.6273887064027122,0.6395579867237332,86.56666666666669,80.77091957153233,784128922,175811507.94056556,25.51559083509558,12.425649123759165,38.25321004637145,50,0
2003-09-18,34.17,34.86,34,34.78,29.58580951684006,30.97488662560774,32.3855533430831,33.51468619674519,28.218849850000016,30.87439960000004,32.24199940000001,33.57399950000002,33.57399950000002,34.971375646975574,32.17662335302447,91633312,66.48290740307169,67.08055412513538,NaN,NaN,NaN,NaN,66.48290740307169,NaN,0.018601612413377655,0.6628100022404553,0.6442083898270776,95.74468085106393,92.0974553454164,875762234,250396761.8940543,26.99072742643569,11.296109390152985,38.6841196842703,100,0
2003-09-19,34.78999,34.86,34.36,34.58,29.635502954483446,31.046275009259073,32.471610074726904,33.616144654198024,28.255899850000013,30.942899600000036,32.30159920000001,33.67099950000002,33.67099950000002,35.064900674451124,32.27709832554892,69834496,63.80836250102327,66.56835247205949,NaN,NaN,NaN,NaN,NaN,NaN,0.018276426902594123,0.6670539234553203,0.6487774965527262,84.86494667596384,89.0587647312315,805927738,242016622.37405398,25.537235750228916,10.687796738452187,38.72665142238761,92.85714285714286,0
2003-09-22,34.13,34.2,33.77,33.92,29.67813476588162,31.10318045462028,32.52840967963957,33.64508325856012,28.292649800000014,31.007599600000038,32.34319920000001,33.74499950000002,33.74499950000002,35.02186471611972,32.46813428388032,97494688,55.826907262861596,65.2457629557783,NaN,NaN,NaN,NaN,NaN,NaN,-0.030919912289284368,0.6101276061911207,0.6410475184804051,49.18946384073605,76.59969712258794,708433050,212541484.14149526,23.344057169893222,16.02548477939546,36.733810579741785,85.71428571428571,50
2003-09-23,33.97,34.56,33.91,34.52,29.726312529405185,31.170840247598097,32.606511260830175,33.72840866250677,28.334249800000013,31.075899600000035,32.38919920000001,33.845500000000015,33.845500000000015,35.0308517790588,32.66014822094123,77858320,60.64619849556012,64.29487231484879,NaN,NaN,NaN,NaN,NaN,NaN,-0.027688061278535736,0.6064374418822354,0.6341255031607711,81.62172096367064,71.89204382679019,786291370,280817241.6799571,25.557766070577426,14.918270664829034,35.009686539368396,78.57142857142857,42.857142857142854
2003-09-24,34.50999,34.8,33.17,33.22,29.761075588814087,31.21141766843774,32.6305696427584,33.679988789887084,28.36799980000001,31.125299600000034,32.408399400000015,33.87950050000002,33.87950050000002,34.946183902934195,32.812817097065846,115575808,48.34034149391475,62.317106898930206,NaN,NaN,NaN,NaN,NaN,NaN,-0.11295510988316282,0.49293161580681755,0.6058867256899804,11.351830530645628,47.38767177835078,670715562,172331974.04805487,21.538905030066196,19.711213170696386,31.706481686588834,71.42857142857143,35.714285714285715
2003-09-25,33.38,33.98,32.75999,32.78999,29.791214040666684,31.242676526488477,32.63682142147376,33.59522700037403,28.405849750000012,31.170699500000037,32.42099920000001,33.87900000000002,33.87900000000002,34.94771644514235,32.81028355485769,117989120,45.08175689749597,60.41767201945323,NaN,NaN,NaN,NaN,NaN,NaN,-0.19344353778451717,0.3640823034593339,0.5575258412438511,1.4285646258827898,31.467372040066362,552726442,60145550.091530174,19.115994063784335,21.274361360861217,28.35646616940054,64.28571428571429,100
2003-09-26,32.89,33.17,32.52,32.58,29.8189631546899,31.2691581794293,32.634593130435576,33.498538714624125,28.440749700000012,31.210399500000037,32.44899940000001,33.85350000000002,33.85350000000002,35.016483164159034,32.690516835841,106691680,43.53829660422632,58.13339341362199,NaN,NaN,NaN,NaN,NaN,NaN,-0.2522354230695438,0.24223156240692134,0.4944669854764651,2.564102564102362,5.114832573543601,446034762,-26849204.370009825,17.956997355563566,22.22304478753111,25.20770038544281,57.142857142857146,100
2003-09-29,32.75999,33.17,32.45,33.14,29.852008297429304,31.30620455211387,32.6544130076734,33.46439217037421,28.47784970000001,31.258899600000035,32.48619940000001,33.84100000000002,33.84100000000002,35.02875201120277,32.653247988797276,97110320,48.59295028826477,56.73158291101612,NaN,NaN,NaN,NaN,NaN,NaN,-0.24463250948478588,0.18867634862048277,0.43330885810526865,28.630705394190816,10.874457528058656,543145082,62168588.96332319,16.745851690149376,21.37990176287644,22.26453834135253,50,100
2003-09-30,32.92,32.96001,32.35699,32.42,29.877560453673787,31.328259907517555,32.64522034070581,33.364926249386194,28.51064970000001,31.30539960000004,32.51699940000001,33.76850000000002,33.76850000000002,35.10768252681159,32.42931747318845,119186320,43.23386526944475,55.78666118868406,NaN,NaN,43.23386526944475,NaN,NaN,NaN,-0.27694222225621684,0.08713108028499761,0.36407330254121445,2.5173690876184494,11.23739234863721,423958762,-32109999.87286833,15.5199059703103,20.684315868860196,21.677461408656175,42.857142857142854,100
2003-10-01,32.61,33.23,32.42,33.14999,29.910121941696932,31.36433377073503,32.66501522930558,33.344456130397035,28.551199700000005,31.352799500000042,32.553199200000016,33.73349900000002,33.73349900000002,35.09866994464839,32.368328055351654,106833680,49.33479823832754,55.03723744118441,NaN,NaN,NaN,NaN,NaN,NaN,-0.23940848575573442,0.06481269534654643,0.30422118110228086,31.681855046524003,20.943309842777754,530792442,53618093.12268859,16.86308524195143,19.124555953689097,20.748436311745234,35.714285714285715,92.85714285714286
2003-10-02,33.10001,33.42999,32.92999,33.25999,29.94345396217756,31.401871517849187,32.68834757325438,33.33641173702589,28.588249600000008,31.39699940000004,32.58639880000001,33.68849850000002,33.68849850000002,35.05380178576763,32.32319521423241,83940688,50.20329458897068,54.23820292081818,NaN,NaN,NaN,NaN,NaN,NaN,-0.19908646185691842,0.05536310378113285,0.25444956563805127,36.076563817164136,23.425262650435528,614733130,80479113.2826904,17.967447731177273,18.211630946649368,19.32326135441672,28.571428571428573,85.71428571428571
2003-10-03,33.85001,34.47,33.82001,34.19,29.98570815160863,31.457081982842272,32.747235903714994,33.41770585730914,28.62954965000001,31.452299400000044,32.646599000000016,33.70099850000002,33.70099850000002,35.0797944283838,32.32220257161624,112935872,56.92611998507606,54.23216858448556,NaN,NaN,NaN,NaN,NaN,NaN,-0.10634565973194587,0.12151749097311892,0.2278631507050648,73.23222839700989,46.99688242023268,727669002,96114890.9427764,25.48929315510608,16.196643251656404,19.326572224435786,21.428571428571427,78.57142857142857
2003-10-06,34.28,34.45,34.06,34.44,30.030029463532923,31.516149666350344,32.81361880945166,33.515067204232075,28.67484965000001,31.51069930000004,32.699399000000014,33.69799850000002,33.69799850000002,35.07007217736899,32.325924822631045,49243904,58.54625808226174,53.80508786915664,NaN,NaN,NaN,NaN,NaN,NaN,-0.028765675332217633,0.19190605653979276,0.2206717318720104,83.22020287573751,64.17633169663718,776912906,142833466.53251868,24.546589798409478,15.597621934445213,18.551037250329134,14.285714285714286,71.42857142857143
2003-10-07,34.16,34.64999,34.00999,34.64999,30.075999220114685,31.57820591058103,32.885633365943754,33.6231550895433,28.72279960000001,31.567999200000042,32.75459880000002,33.72599800000002,33.72599800000002,35.15076984704834,32.3012261529517,80178624,59.91025874708949,53.60516541839918,NaN,NaN,NaN,NaN,NaN,NaN,0.032757149317534845,0.26161816851892894,0.2288610192013941,91.60970191888977,82.68737773054573,857091530,223012090.53251868,24.957753868077507,14.640694532142732,17.9477256187777,7.142857142857143,64.28571428571429
2003-10-08,34.81,34.84,34.22,34.42999,30.119322511456826,31.634676882648733,32.94619637120086,33.699996509586796,28.768349500000014,31.62529910000004,32.810198800000016,33.78399750000002,33.78399750000002,35.224154838679475,32.343840161320564,71430496,57.76573958368052,52.982510574156954,NaN,NaN,NaN,NaN,NaN,NaN,0.0534749117507505,0.2957046588898322,0.2422297471390817,82.82028437760921,85.88339639074552,785661034,199967690.83909845,25.299978000164007,13.759980684633055,17.13001931721264,0,57.142857142857146
2003-10-09,34.91,35.27,34.42999,34.69,30.16480188945228,31.695178330517074,33.0145808272322,33.79428255629281,28.81344950000001,31.69529910000004,32.87559880000001,33.83649750000002,33.83649750000002,35.32748683938232,32.345508160617726,118275120,59.6060744358646,52.682347140931334,NaN,NaN,NaN,NaN,NaN,NaN,0.07804202903920693,0.33978228343809036,0.26174025439888343,80.0893234146122,84.83976990370373,903936154,154912446.6767668,27.389001571655186,12.649704613932256,16.831477678450792,100,50
2003-10-10,34.77,35.03,34.64,35.00999,30.213012716422906,31.76081816555634,33.092832167340745,33.91006421759826,28.86174940000001,31.76769900000004,32.939798600000024,33.89599650000002,33.89599650000002,35.47214726947869,32.319845730521344,68398192,61.811515322827006,53.10981914521459,NaN,NaN,NaN,NaN,NaN,NaN,0.10738390839835887,0.39597013989683205,0.2885862314984732,91.07418100178161,84.66126293133435,972334346,216291931.89769018,26.3268725852659,12.159156687073022,18.13313433288654,92.85714285714286,42.857142857142854
2003-10-13,35.14,35.37,34.92,35.24001,30.263032589891335,31.829713053367104,33.17703521960189,34.03672572068414,28.911549450000017,31.84319910000004,33.01539860000002,33.983496500000015,33.983496500000015,35.65141007633721,32.315582923662824,60980608,63.360142966698,53.303672321724434,NaN,NaN,NaN,NaN,NaN,NaN,0.132193941457306,0.45382865832010566,0.32163471686279965,95.68570963919801,88.9497380185306,1033314954,242042009.96915668,28.590020427261237,11.600174249264555,19.275112763922838,100,35.714285714285715
2003-10-14,35.10001,35.42999,34.96001,35.33,30.313450176061572,31.899025666171717,33.26146521099005,34.1598946996666,28.964099400000013,31.915599100000037,33.092998600000016,34.029997000000016,34.029997000000016,35.79102155409401,32.26897244590602,64216896,63.97563753031793,54.42047918146751,NaN,NaN,NaN,NaN,NaN,NaN,0.14362523392508997,0.5011662592691621,0.35754102534407217,96.746176374878,94.50202233861921,1097531850,278934137.12350416,27.811960354444317,11.029857462213426,22.044792781846358,100,28.571428571428573
2003-10-15,35.8,35.85001,35.03,35.17999,30.361873457891804,31.963995256940592,33.33670147722574,34.257046633031685,29.016849350000015,31.986398900000037,33.19239820000002,34.075997000000015,34.075997000000015,35.90538512287675,32.24660887712328,97791120,62.10283277168181,55.63627031533793,NaN,NaN,NaN,NaN,NaN,NaN,0.13042815346237607,0.5205762171720423,0.3901480637096662,80.81831767353172,91.08340122920258,999740730,216917434.72523978,29.791627474994552,10.097092091207921,25.18978761090146,100,21.428571428571427
2003-10-16,35.10001,35.53,35,35.46001,30.412601184678948,32.03322327165464,33.41996847811885,34.37161457274295,29.072299400000016,32.049998900000034,33.29779840000002,34.10999750000001,34.10999750000001,36.0142062911132,32.20578870888683,74087632,64.20905673535529,57.11275318184715,NaN,NaN,NaN,NaN,64.20905673535529,NaN,0.12963253656957413,0.5521887344216339,0.4225561978520597,88.83487641067038,88.79979015302668,1073828362,271437544.5981443,28.135482734698385,9.850450924156828,27.869715741287653,92.85714285714286,14.285714285714286
2003-10-17,35.41299,35.49001,34.60001,34.61,30.45436634702045,32.08424855340405,33.466636380937715,34.39431794676743,29.118349450000014,32.104198900000036,33.38379840000002,34.11149750000002,34.11149750000002,36.017231518731776,32.205763481268264,98011008,54.33689452751977,57.523034913222496,NaN,NaN,NaN,NaN,NaN,NaN,0.06424029092164046,0.5028565615041103,0.4386162705824698,64.50034640511649,78.0511801631062,975817354,175626828.66538066,25.56535499547863,13.05606694178614,29.315062990707464,85.71428571428571,7.142857142857143
2003-10-20,34.64999,35.67999,34.08,35.03999,30.499994443069998,32.14277808700001,33.52833652286173,34.45581052326577,29.165149450000012,32.16149880000003,33.483198000000016,34.16749700000001,34.16749700000001,36.11284112898144,32.22215287101859,76162192,57.866022864495626,58.5681890271547,NaN,NaN,NaN,NaN,NaN,NaN,0.043328292456210726,0.49277663615273326,0.44944834369652253,76.38432541013013,76.57318274197233,1051979546,190858886.25204113,21.723491639767488,15.978150968526245,29.384656161659137,78.57142857142857,0
2003-10-21,35.14,35.45,34.939,35.25,30.547258179954873,32.204307233792086,33.59585273765146,34.53144761628808,29.209799400000016,32.216098900000034,33.58019820000002,34.203997000000015,34.203997000000015,36.20113136106899,32.20686263893104,75015184,59.51189379297097,59.295124423914956,NaN,NaN,NaN,NaN,NaN,NaN,0.037254529084647214,0.4960165050523315,0.4587619759676843,79.45185306949962,73.4455082949154,1126994730,207153769.66495648,20.655859421930636,15.192881775233602,30.024295166302426,71.42857142857143,0
2003-10-22,34.89,34.92999,34.44,34.57001,30.587285561248855,32.25115283312294,33.63405498323376,34.53512022426064,29.249399500000013,32.265999000000036,33.65439840000002,34.27149750000002,34.27149750000002,36.221744527992264,32.32125047200777,88815184,52.37752542094288,59.450426626198684,NaN,NaN,NaN,NaN,NaN,NaN,-0.016083150687428716,0.4386580376083984,0.4547411882958271,36.94581280788188,64.26066376250387,1038179546,165469596.795145,19.057050623401885,18.78527668693739,30.027384104990354,64.28571428571429,0
2003-10-23,34.14999,34.507,34.05,34.17,30.622934461136925,32.28914980672446,33.65507243487165,34.50034686956915,29.290749550000008,32.30909900000003,33.72039840000002,34.34049800000001,34.34049800000001,36.170117263175634,32.51087873682439,99351376,48.68044178071816,58.86144961160169,NaN,NaN,48.68044178071816,NaN,NaN,NaN,-0.07834456202575657,0.3568104857636314,0.43515504778938796,8.69610112933556,41.69792233557234,938828170,118293998.12556265,18.08903996648652,21.64065321794178,29.073626437672967,57.142857142857146,0
2003-10-24,33.78999,34.23,33.49001,34.2,30.65852715306591,32.32698842441309,33.67644214330805,34.47174240580066,29.32824955000001,32.34689900000003,33.78639860000002,34.421498000000014,34.421498000000014,36.06628976316701,32.776706236833014,101828496,48.971354979437756,58.177527961399974,NaN,NaN,NaN,NaN,NaN,NaN,-0.11531455264138335,0.29101185698765875,0.4063264096290421,30.084322033898516,25.242078657038636,1040656666,211866018.0110222,16.782619325571183,25.543128936187117,28.9597532549418,50,100
2003-10-27,34.28,34.45,34.03999,34.21001,30.69386529084635,32.364275980365306,33.697366372982245,34.44681551001012,29.363799550000014,32.382599100000036,33.84719880000002,34.47499850000001,34.47499850000001,36.01590366911644,32.934093330883584,63646096,49.07508592280162,57.40358704537941,NaN,NaN,NaN,NaN,NaN,NaN,-0.13550723263468595,0.23694236883568465,0.3724496014703706,30.508474576271144,23.096299246501726,1104302762,201004533.3225493,18.306056690921892,24.487840254279,28.13055885478726,42.857142857142854,92.85714285714286
2003-10-28,34.42999,35.41,34.37,35.36,30.740294491932456,32.423597248080846,33.76256769168882,34.53378546143772,29.405899550000008,32.43489910000003,33.91499880000002,34.62199850000001,34.62199850000001,35.88690739166354,33.35708960833648,107497376,59.30891635024472,57.51381395727686,NaN,NaN,NaN,NaN,NaN,NaN,-0.07106597691603633,0.2836171303253252,0.35468310724136154,79.23686440677974,46.609887005649796,1211800138,298165623.16870373,25.41411100471629,21.666509531745945,26.5888196383543,35.714285714285715,85.71428571428571
2003-10-29,35.2,35.41,35.07001,35.32001,30.78586380047044,32.48095195603964,33.8236438606422,34.608663988919844,29.447099600000012,32.49079920000003,33.97399900000002,34.730499500000015,34.730499500000015,35.83367076604034,33.62732823395969,74110880,58.86590610641654,57.46094479088771,NaN,NaN,NaN,NaN,NaN,NaN,-0.032735696887020105,0.3137634861325864,0.3464991830196065,77.54237288135619,62.42923728813569,1137689258,333044536.9861711,24.551039842773946,20.93070808847183,24.52791575911812,28.571428571428573,78.57142857142857
2003-10-30,35.81,36,35.14,35.39,30.83167610096327,32.53855686780123,33.88506959159741,34.68307694235605,29.49034955000001,32.54289930000003,34.03599920000002,34.83700000000002,34.83700000000002,35.74591471557943,33.928085284420604,95149632,59.436981331724624,57.29133522009469,NaN,NaN,NaN,NaN,NaN,NaN,-0.005687329241883032,0.3393900214672527,0.34507735070913576,75.69711433113284,77.49211720642292,1232838890,293214458.4745433,28.281348513273173,19.158367535164285,23.272063016234366,100,71.42857142857143
2003-10-31,35.44,35.49001,35.06,35.17999,30.874942905928812,32.59086247437943,33.93585078408378,34.730401995465,29.53404950000001,32.589499200000034,34.08679900000001,34.88649950000001,34.88649950000001,35.756057885743274,34.01694111425675,55497200,56.88499820698812,56.828824880115405,NaN,NaN,NaN,NaN,NaN,NaN,-0.004984149134443394,0.3388471642910815,0.3438313134255249,67.33014872569203,73.52321197939368,1177341690,268689138.32849896,27.048061423088587,19.134202321022805,21.476529708697168,92.85714285714286,64.28571428571429
2003-11-03,35.42999,35.98,35.36,35.75999,30.923550339700665,32.653617474886765,34.00738565529618,34.828457995896905,29.58629945000001,32.64059920000003,34.15319880000001,34.95249900000002,34.95249900000002,35.87523017441255,34.029767825587484,71175248,61.76734090808762,56.67108940709896,NaN,NaN,NaN,NaN,NaN,NaN,0.02959746842894362,0.38082814896170447,0.35123068053276085,90.4378105092053,77.82169118867672,1248516938,289350624.03017735,29.796038673295488,17.59676164566735,20.22899438630594,85.71428571428571,57.142857142857146
2003-11-04,35.69,35.87,35.446,35.52,30.969286157216082,32.710377524889005,34.06670386489241,34.89431913914482,29.638749450000013,32.69619910000004,34.21339900000001,34.995999500000025,34.995999500000025,35.93938318875745,34.052615811242596,60072512,58.80026296237849,56.43519156357729,NaN,NaN,NaN,NaN,NaN,NaN,0.03120330394788562,0.3902348104676179,0.35903150651973226,80.87641783433413,79.54812568974381,1188444426,250246819.04904675,28.489483640220513,16.825144393251414,18.54092899818119,78.57142857142857,50
2003-11-05,35.52,35.89,35.14999,35.84,31.01775097157214,32.77235024716843,34.13624488979859,34.98438398303579,29.693299500000013,32.74579910000003,34.279399200000015,35.06650000000002,35.06650000000002,36.040402212851134,34.092597787148904,68430496,61.458766119539284,56.23874223387615,NaN,NaN,NaN,NaN,NaN,NaN,0.047722512496780556,0.41868464714070797,0.3709621346439274,93.6254726114448,88.3132336516614,1256874922,309430075.68741703,26.32020721120321,18.589810524006918,16.332125815430835,71.42857142857143,42.857142857142854
2003-11-06,35.78999,35.966,35.34,35.939,31.066718623596298,32.835056182868065,34.20694116863002,35.07529979417524,29.745444550000006,32.79758920000003,34.34217920000002,35.12895000000002,35.12895000000002,36.156951123636034,34.100948876364,90631632,62.269914719224246,56.80538653328362,NaN,NaN,NaN,NaN,62.269914719224246,NaN,0.05851069716901891,0.444100506105201,0.3855898089361821,97.56971143311328,90.69053395963073,1347506554,392243643.5851803,25.40041440413266,17.383941863493142,15.356941372648492,64.28571428571429,35.714285714285715
2003-11-07,36.08,36.17999,35.60001,35.63,31.112124408436134,32.89040160498949,34.262747397311195,35.12812838520617,29.799494500000005,32.84468920000003,34.39297920000001,35.159950500000015,35.159950500000015,36.208912897026956,34.110988102973074,63605808,58.15580518895766,56.82608527074519,NaN,NaN,NaN,NaN,NaN,NaN,0.03897028808465236,0.43430266904199755,0.3953323809573452,79.55412307898222,90.24976904118007,1283900746,335215780.2795502,26.09920535306005,16.327220081073072,15.913642346639037,100,28.571428571428573
2003-11-10,35.7,35.743,35.09,35.19,31.152700284969107,32.93593820687089,34.299110244475465,35.13402091994844,29.85279450000001,32.89238920000003,34.428979200000015,35.15745000000001,35.15745000000001,36.205875386070886,34.10902461392914,68950496,52.80575657157284,56.34707546921675,NaN,NaN,NaN,NaN,NaN,NaN,-0.00700409060019902,0.38657726770709644,0.39358135830729546,63.19712414218695,80.10698621809415,1214950250,287383353.4985383,24.307611620451308,20.567823886096313,15.420409595731948,92.85714285714286,21.428571428571427
2003-11-11,35.149,35.3,34.85001,35.06,31.191578889098768,32.9779988364378,34.32894905841761,35.12697130852478,29.904194500000006,32.93918920000004,34.452779200000016,35.14395000000001,35.14395000000001,36.19009119035565,34.09780880964437,75928496,51.30402788240231,56.27039707360671,NaN,NaN,NaN,NaN,NaN,NaN,-0.047337276897088554,0.33440976218593477,0.3817470390830233,58.36437445631585,67.03854055916166,1139021754,282319653.9386386,23.129328544114262,22.156043408511948,15.522627584868564,85.71428571428571,14.285714285714286
2003-11-12,35.17,35.963,35.14,35.81,31.237533328013207,33.03407806739943,34.38702948749927,35.19202166009385,29.95749455000001,32.998189200000034,34.491979000000015,35.17545050000001,35.17545050000001,36.26122534237612,34.0896756576239,81156192,58.61615369477338,56.98009078175351,NaN,NaN,NaN,NaN,NaN,NaN,-0.025752905431198403,0.3495559072940253,0.3753088127252237,86.24562264403474,69.26904041417919,1220177946,333301125.70534605,27.898191207657003,20.055155174156454,16.05234988870554,78.57142857142857,7.142857142857143
2003-11-13,35.71001,35.89999,35.55,35.77,31.282632498878748,33.088254739332115,34.441263625244396,35.24706721627539,30.01364460000001,33.05908930000003,34.52417900000001,35.19095000000001,35.19095000000001,36.301107227657155,34.08079277234286,64326000,58.11494126843607,57.63320408811053,NaN,NaN,NaN,NaN,NaN,NaN,-0.01684855505595889,0.3542481189052751,0.37109667396123397,80.84158878504698,75.15052862846586,1155851946,349844407.68483216,26.836050836745574,19.29161499347555,15.742187707956301,71.42857142857143,0
2003-11-14,35.811,36.02,34.95,35.03999,31.320019140680948,33.12690296231564,34.46474309092109,35.227345576630114,30.06664455000001,33.11428920000004,34.546178800000014,35.212449500000005,35.212449500000005,36.29303145429078,34.131867545709234,91047872,49.753491633046785,57.68166163884233,NaN,NaN,NaN,NaN,NaN,NaN,-0.060355001953661946,0.29565292151915656,0.3560079234728185,37.01622660898712,68.03447934602296,1064804074,274111298.30404717,23.846882906069986,23.38875346993576,14.779644961842186,64.28571428571429,0
2003-11-17,34.84,34.91,34.256,34.67999,31.35345168654482,33.157657161081666,34.473184146179086,35.175216474093915,30.11759445000001,33.15888910000003,34.54977860000001,35.194449500000005,35.194449500000005,36.29767908985807,34.09121991014194,108519312,46.221677404121124,56.74685885697636,NaN,NaN,NaN,NaN,NaN,NaN,-0.11068010633161574,0.2176577905582988,0.32833789688991455,22.03701682441162,46.631610739481914,956284762,306298723.59725773,21.92029213731623,28.650834073766475,15.161723149093723,57.142857142857146,100
2003-11-18,34.87,34.97,33.82001,33.88,31.378591470758302,33.17196097967411,34.44992202279951,35.05186252418021,30.16604445000001,33.19938910000003,34.54557860000001,35.125949500000004,35.125949500000004,36.3682396649532,33.88365933504681,108732000,39.50977563420995,55.36427810896159,NaN,NaN,39.50977563420995,NaN,NaN,NaN,-0.1904677595415719,0.09025319746294969,0.2807209570045216,2.5419706946668734,20.53173804268854,847552762,208910879.07687047,19.4393946634867,29.69905242573263,16.0845172961327,50,100
2003-11-19,34.00999,34.39999,33.88,34.21001,31.406764789457224,33.19251640581918,34.44051370817992,34.971686093305905,30.216694500000006,33.241989200000035,34.564378800000014,35.107949500000004,35.107949500000004,36.39168005659634,33.824218943403665,86402496,43.17552324607631,54.20274538855814,NaN,NaN,NaN,NaN,NaN,NaN,-0.21199129228527563,0.01573184164792707,0.2277231339332027,16.525563775963974,13.70151709834749,933955258,232178521.7524585,18.42400634038743,28.14776589843944,16.20226030681926,42.857142857142854,92.85714285714286
2003-11-20,33.89,34.67999,33.81,33.882,31.431393995532275,33.20616954629801,34.41861120981992,34.86790646537201,30.265054450000008,33.27730910000004,34.569218800000016,35.09354950000001,35.09354950000001,36.424629995063064,33.76246900493695,117403184,40.545470963868134,53.03563629976386,NaN,NaN,NaN,NaN,NaN,NaN,-0.23737783204069793,-0.06899915611766971,0.16837867592302821,3.0379875020567932,7.368507324229214,816552074,134207812.25906098,19.607641576850266,25.726542799275485,15.9423445276006,35.714285714285715,100
2003-11-21,34.08,34.265,33.73,34.23199,31.4592606224424,33.226482822608936,34.411292731003456,34.807342992479434,30.317164400000006,33.30992900000003,34.57745840000001,35.095149000000006,35.095149000000006,36.42200086187252,33.768297138127494,81824368,44.43486865888897,51.797602567678254,NaN,NaN,NaN,NaN,NaN,NaN,-0.22004541722473464,-0.1066780956078901,0.11336732161684454,20.489471385597756,13.351007554539507,898376442,205934900.30511796,18.550874049573785,25.145909798322975,15.181769139540322,28.571428571428573,100
2003-11-24,34.52,35.25,34.47,35.17999,31.49628280530367,33.265166133052325,34.441437721944496,34.84283318367187,30.37296435000001,33.35592890000004,34.611258000000014,35.143648000000006,35.143648000000006,36.406926528489805,33.88036947151021,92188496,53.33895314784154,51.40750900949704,NaN,NaN,NaN,NaN,NaN,NaN,-0.13818105395614783,-0.059358995828340255,0.07882205812780757,59.183506871456615,27.57032191970372,990564938,281574379.3693223,26.329159540925502,22.644941178688597,13.880483998107863,21.428571428571427,92.85714285714286
2003-11-25,35.28999,35.45,35.09,35.17999,31.532936608235975,33.30308343734832,34.470400556378046,34.8749433566555,30.42811435000001,33.388828800000034,34.62685800000001,35.13464750000001,35.13464750000001,36.394191510805065,33.87510348919495,72575008,53.338953147841536,50.827522368661484,NaN,NaN,NaN,NaN,NaN,NaN,-0.08034498351206767,-0.021609171262277016,0.05873581224979065,59.183506871456615,46.285495042837,990564938,245282843.4244307,27.395768898236977,21.81852022193204,13.460448376826502,14.285714285714286,85.71428571428571
2003-11-26,35.39999,35.52,34.81,35.34,31.570817836014722,33.34341841878697,34.504502495343615,34.91923446554545,30.48571430000001,33.419428800000034,34.648458200000015,35.135647000000006,35.135647000000006,36.39580936958708,33.875484630412934,72865632,54.75812718097227,50.29096611592921,NaN,NaN,NaN,NaN,NaN,NaN,-0.030206657030240898,0.02097749096198953,0.05118414799223043,65.71455393695513,61.36052255995612,1063430570,281202521.17090964,25.42501719153647,23.08590204940616,12.46651321364383,7.142857142857143,78.57142857142857
2003-11-28,35.25999,35.5,35.20799,35.38,31.60872014610413,33.3837467669298,34.53883573082034,34.963116897398265,30.54291430000001,33.45122880000004,34.660458200000015,35.135147,35.135147,36.39491316311302,33.87538083688699,24809104,55.12555985294233,50.07452002049954,NaN,NaN,NaN,NaN,NaN,NaN,0.004888627989084196,0.05729493297858568,0.05240630498950148,72.05240174672494,65.65015418504557,1088239674,285621279.0868717,24.639940416850088,22.373052756713978,11.165731223815053,0,71.42857142857143
2003-12-01,35.71001,36.00999,35.47,35.89999,31.65141934863046,33.43357336560445,34.5922143296117,35.05234290716986,30.599964200000013,33.494228600000035,34.686858000000015,35.171147000000005,35.171147000000005,36.474382040092124,33.867911959907886,82815872,59.706852869559945,50.56745547035575,NaN,NaN,NaN,NaN,59.706852869559945,NaN,0.059336171502720095,0.1265765193679016,0.0672403478651815,94.7593886462882,77.50878144332275,1171055546,334696726.5604919,28.409437312830743,20.87541555744569,11.662372665827604,28.571428571428573,64.28571428571429
2003-12-02,35.82001,36.05,35.58,35.7,31.6917037332212,33.47845310093902,34.63565690492104,35.11402453505844,30.652214200000014,33.53282860000004,34.72245800000002,35.16814750000001,35.16814750000001,36.46621354805496,33.87008145194506,65084608,57.28457108019049,50.994637127340624,NaN,NaN,NaN,NaN,NaN,NaN,0.07697642479098371,0.16346087885391114,0.08648445406292743,84.91379310344853,83.9085278321539,1105970938,302846812.00730175,27.39398332474196,19.81001001286038,12.656455126696995,100,57.142857142857146
2003-12-03,35.84,36.12,35.25,35.25,31.727109666223974,33.51353323755409,34.65974879100257,35.12697457933859,30.703064200000007,33.563128600000034,34.73705800000002,35.1546475,35.1546475,36.44337803627036,33.865916963729646,107817184,52.157104114944254,50.533276443067116,NaN,NaN,NaN,NaN,NaN,NaN,0.05449135144130453,0.15459864336455809,0.10010729192325356,63.598326359832754,81.09050270318983,998153754,195029628.00730175,24.864321251843265,21.483372655312177,12.009254785986794,100,50
2003-12-04,35.38,35.71001,35.08,35.63,31.765944395913287,33.55544347047381,34.69779785802208,35.17488176225872,30.75631420000001,33.59682870000004,34.78525800000002,35.1441475,35.1441475,36.41364968003596,33.874645319964046,102447184,55.75834625973522,50.36494822815992,NaN,NaN,NaN,NaN,NaN,NaN,0.06087966956779202,0.17620687888299358,0.11532720931520156,79.49790794979101,76.0033424710241,1100600938,271455640.305775,23.19401491698151,21.85286713278073,11.05365989126903,92.85714285714286,42.857142857142854
2003-12-05,35.27,35.5,34.95799,35.03999,31.798521964113156,33.58484043145453,34.71121715770749,35.162034927757894,30.805664150000005,33.625628600000034,34.830258000000015,35.099197000000004,35.099197000000004,36.315488598640826,33.88290540135918,87631184,49.52501841093071,50.348628712294484,NaN,NaN,NaN,NaN,NaN,NaN,0.022987854747198902,0.14406202774920018,0.12107417300200128,54.81129707112996,65.96917712691791,1012969754,210339675.9068897,21.532419348526844,21.58802589700901,10.993593848187189,85.71428571428571,35.714285714285715
2003-12-08,35.02,35.33,34.78,35.235,31.83271577541551,33.61751685855444,34.7317576613268,35.16898398225714,30.858139100000002,33.66617870000004,34.883358000000015,35.079447,35.079447,36.27324058723563,33.88565341276438,87125680,51.45664026094146,50.72255463063879,NaN,NaN,NaN,NaN,NaN,NaN,0.009374210469456315,0.13279193608882167,0.12341772561936536,62.97071129707122,65.7599721059974,1100095434,267367393.72507173,20.253561056413954,22.227905391176172,10.374913990717102,78.57142857142857,28.571428571428573
2003-12-09,35.45,35.46001,34.35001,34.42999,31.858559300038245,33.633605435612765,34.71992363539242,35.09860360299455,30.906439050000003,33.69767860000003,34.90915780000002,35.041446500000006,35.041446500000006,36.266714414674105,33.81617858532591,109997120,43.97523492942499,51.04151600886843,NaN,NaN,43.97523492942499,NaN,NaN,NaN,-0.05214900302262605,0.058231471841082794,0.11038047486370885,29.28828451882843,49.02343096234321,990098314,173221750.5856121,17.938036124483954,24.115433223849294,9.932792799991775,71.42857142857143,21.428571428571427
2003-12-10,34.53,34.7,34.13,34.56,31.88543930700304,33.65194988243231,34.713652120278994,35.047308021756976,30.958139050000003,33.73447860000003,34.95195780000002,35.01644650000001,35.01644650000001,36.25945525408446,33.77343774591556,103567376,45.35700698047684,51.19733627561133,NaN,NaN,NaN,NaN,NaN,NaN,-0.08068620767278843,0.009522715272723303,0.09020892294551174,34.72803347280357,42.32900976290108,1093665690,225913924.3399979,16.871355041723817,24.9766502430685,9.824887831805478,64.28571428571429,14.285714285714286
2003-12-11,34.5,35.39,34.493,35.3,31.919415035291568,33.684584538225735,34.73664615477786,35.07137392444679,31.010789050000003,33.77407860000003,34.99495800000002,34.9909465,34.9909465,36.18786122074325,33.79403177925675,108425376,52.53308298552624,52.05359427715833,NaN,NaN,NaN,NaN,NaN,NaN,-0.04794041666219549,0.030283402117767366,0.07822381877996286,65.69037656903765,43.235564853556546,1202091066,312581699.80487996,22.369143657419183,22.690015671026597,8.911658538820847,57.142857142857146,7.142857142857143
2003-12-12,35.28999,35.34,34.89999,35.24001,31.952455781209064,33.715385042419285,34.75638591341402,35.0874345030709,31.061189100000007,33.81047860000003,35.034558400000016,34.96444700000001,34.96444700000001,36.11371529285547,33.81517870714455,72224624,51.937604207431775,52.5895039591971,NaN,NaN,NaN,NaN,NaN,NaN,-0.02944444666556087,0.04141826044801178,0.07086270711357265,55.77939698492454,52.065935675588584,1129866442,351980978.22745955,21.337202715276707,21.643272152035394,7.88447189500294,50,0
2003-12-15,35.92999,35.99001,34.64999,34.78,31.98059054955524,33.73646652672782,34.757311956025234,35.05815502658796,31.111839150000005,33.84647870000003,35.04635840000001,34.95144750000001,34.95144750000001,36.10288332155199,33.80001167844802,106241808,47.49203595927212,52.17186701715644,NaN,NaN,NaN,NaN,NaN,NaN,-0.046310809756320445,0.012974194918172088,0.059285004674492534,32.66331658291458,51.377696712292256,1023624634,266354530.38339737,24.90783025640642,18.798985776138334,8.345477604333462,42.857142857142854,78.57142857142857
2003-12-16,34.78999,35.02299,34.42,34.85001,32.0091419868731,33.758516892535184,34.76094717343601,35.038331690722444,31.1635892,33.87697880000003,35.054558600000014,34.95994850000001,34.95994850000001,36.10573882181687,33.81415817818315,89884880,48.218472555299414,51.806118403403424,NaN,NaN,NaN,NaN,NaN,NaN,-0.050527245640682616,-0.003874052376360737,0.04665319326432188,36.18140703517572,41.54137353433828,1113509514,304668782.2058147,23.416557891555506,19.957059257048144,8.105725009003782,35.714285714285715,71.42857142857143
2003-12-17,34.81,35,34.57401,34.91,32.03800624571018,33.78131853822756,34.76679238232087,35.02610962493935,31.2153892,33.90717880000003,35.05975880000001,35.01144850000001,35.01144850000001,36.04559920447651,33.977297795523505,68579808,48.87121443904272,51.385624636122735,NaN,NaN,NaN,NaN,NaN,NaN,-0.047118210863518285,-0.012244570315075975,0.03487364054844231,39.19597989949729,36.01356783919585,1182089322,344270526.30759996,22.396386806932238,19.08760547641817,8.331025823956908,28.571428571428573,64.28571428571429
2003-12-18,34.95,35.64,34.94901,35.56,32.073050959683215,33.81653995331216,34.79789856340633,35.07695632732608,31.27073915,33.94627890000003,35.08235900000001,35.078948000000004,35.078948000000004,36.07039339201285,34.087502607987155,90025632,55.42743332892391,51.40718702726428,NaN,NaN,NaN,NaN,NaN,NaN,-0.0013479342791600513,0.033188722699492246,0.0345366569786523,71.85929648241223,49.07889447236173,1272114954,413450558.34233314,27.253958525413914,17.667159192459618,9.510995572657281,21.428571428571427,57.142857142857146
2003-12-19,35.61,35.64999,35.2,35.46001,32.10675204466149,33.84908391463271,34.82386371778255,35.1134376294855,31.32533925,33.98667900000003,35.09775920000001,35.15784850000001,35.15784850000001,35.99484763761581,34.3208493623842,89768368,54.27448050370959,51.01916042970354,NaN,NaN,NaN,NaN,NaN,NaN,0.020714656994243595,0.06042997822145679,0.0397153212272132,66.83467336683405,59.296649916247844,1182346586,427420821.70605004,26.075470589703876,16.835465915642867,9.957159493553828,14.285714285714286,50
2003-12-22,35.35001,35.67999,35.28999,35.57001,32.14121232282406,33.88316165889741,34.85312435630088,35.156920712391646,31.38313935,34.02437910000003,35.10895960000001,35.22474950000001,35.22474950000001,35.96312420783938,34.48637479216064,63610608,55.37422881570766,50.8827074108119,NaN,NaN,NaN,NaN,NaN,NaN,0.04011503124930284,0.08985911028884175,0.04974407903953891,72.36231155778917,70.35209380234514,1245957194,455155046.7940517,25.301742586493248,16.126878851559624,10.391432014808254,7.142857142857143,42.857142857142854
2003-12-23,35.60001,36.02,35.53,35.84,32.1780161803084,33.92191093297865,34.89182536193614,35.22197588264006,31.443339349999995,34.068179000000036,35.12095940000001,35.25775,35.25775,36.04270033611076,34.47279966388924,67049184,58.04165657328819,51.303032586407895,NaN,NaN,NaN,NaN,NaN,NaN,0.06694853754047117,0.13342975096512788,0.06648121342465671,90.4761904761905,76.55772513360456,1313006378,472943605.81446016,27.677221763800812,15.257957182043663,11.936493773814073,0,35.714285714285715
2003-12-24,35.84,36.02,35.8,35.89999,32.21505074567846,33.96108081549392,34.93136123009551,35.28654865572196,31.5016893,34.112678900000034,35.13235920000002,35.29375,35.29375,36.12576451319054,34.46173548680947,44840304,58.63331830845176,51.508387732744794,NaN,NaN,NaN,NaN,NaN,NaN,0.08348003158705694,0.1708312529084779,0.08735122132142095,93.65026455026452,85.49625552808139,1357846682,468863138.15046126,26.974481725788497,14.870549171889861,13.789950086827455,92.85714285714286,28.571428571428573
2003-12-26,35.96001,36.09,35.82001,35.85001,32.25121949447768,33.99848535380097,34.96738667205255,35.3402116408913,31.552839349999996,34.16907890000004,35.14575960000001,35.3192505,35.3192505,36.18591322169604,34.452587778303965,25499008,57.90076118486043,52.10665507373977,NaN,NaN,NaN,NaN,NaN,NaN,0.08547951933868399,0.19420062049477593,0.10872110115609195,87.75561224489766,90.62735575711757,1332347674,449030786.24883413,26.94046902362535,14.38774112398682,15.95025804031896,100,21.428571428571427
2003-12-29,36.03,36.53,36.02,36.44,32.29289890249283,34.04683217847818,35.025136214324995,35.444953389377844,31.606439349999995,34.23157890000004,35.165359400000014,35.3722505,35.3722505,36.367411824197525,34.377089175802475,63368096,63.670882600011545,52.97910095510191,NaN,NaN,NaN,NaN,NaN,NaN,0.11891237582251546,0.2573615709342363,0.13844919511172082,96.24999999999986,92.55195893172068,1395715770,490033671.895892,29.997069587018117,13.223276983964203,18.390429604633173,100,14.285714285714286
2003-12-30,36.53,36.58,36.3,36.56,32.33535761988096,34.096597877914256,35.08532695101813,35.551148304675195,31.656239299999996,34.29407890000004,35.204359400000016,35.405251,35.405251,36.50635858246234,34.30414341753766,48266896,64.72974750821035,54.46156613930087,NaN,NaN,NaN,NaN,NaN,NaN,0.1400297641044327,0.3134864002422617,0.173456636137829,99.18367346938791,94.39642857142847,1443982666,531405297.0387506,29.576462961616794,12.765136005626616,20.177190756539606,100,7.142857142857143
2003-12-31,36.62,36.64,36.25,36.46001,32.37639893709608,34.143398117955556,35.13923609019389,35.637706561372795,31.703889399999998,34.35797890000004,35.23275980000001,35.4432515,35.4432515,36.63143905723563,34.25506394276437,60522608,63.07992626496473,55.72748894533572,NaN,NaN,NaN,NaN,NaN,NaN,0.13796264309833034,0.34590994001074193,0.2079472969124116,91.89234234234218,95.77533860390997,1383460058,536063985.99300593,28.87535167900137,12.134507693907072,21.709554731963866,100,0
2004-01-02,36.66,36.78999,36.22,36.36,32.41603675861751,34.187291224530696,35.18710918469609,35.706496412670624,31.7521894,34.41757900000004,35.25495980000001,35.498751500000004,35.498751500000004,36.74778512851832,34.249717871481685,55259008,61.3944084776411,56.360440766201066,NaN,NaN,NaN,NaN,NaN,NaN,0.12115656160411015,0.3593929989175493,0.23823643731343913,81.85688547209045,90.97763376127351,1328201050,507950230.0851478,28.690595166283543,11.259046418926282,24.775389900601105,100,21.428571428571427
2004-01-05,36.58,37.158,36.56,37.09,32.462543855546684,34.244770606223156,35.2617323539237,35.838258659082946,31.803639399999998,34.47987900000005,35.30535960000001,35.5717515,35.5717515,37.000645523071995,34.142857476928,69748000,68.09566159642219,57.51458772255752,NaN,NaN,NaN,NaN,NaN,NaN,0.14868654661366365,0.4240946205805187,0.27540807396685507,97.51643535427327,90.42188772290196,1397949050,561835808.6804659,30.400167455146043,10.154477774552626,28.290381793052298,100,14.285714285714286
2004-01-06,37.08,37.42,36.95,37.34,32.51107575748154,34.306062277387056,35.34323304592669,35.98128164393219,31.8544894,34.54457900000004,35.36875960000001,35.686752,35.686752,37.28600937833028,34.08749462166972,60068800,70.01524982414709,59.12338871290574,NaN,NaN,NaN,NaN,NaN,NaN,0.17159098652168964,0.4898968071189671,0.31830582059727747,97.33333333333339,92.2355513865657,1458017850,601455655.488977,31.884864511043315,9.559622271882734,31.139735546686335,100,7.142857142857143
2004-01-07,37.28,37.67999,37.07001,37.67999,32.56250773999416,34.37287272733979,35.4348705735374,36.14306339212913,31.912689399999998,34.61237900000005,35.43835940000001,35.8090015,35.8090015,37.612228599444315,34.00577440055569,71864816,72.44349887097826,60.85374773545423,NaN,NaN,NaN,NaN,NaN,NaN,0.19574739678338082,0.5629900665765035,0.3672426697931227,99.99999999999999,98.28325622920221,1529882666,673320471.488977,32.69750031905217,8.83615384955225,34.673634655849774,100,0
2004-01-08,37.85001,38,37.60001,37.979,32.61640318536735,34.44428118818455,35.53464035496731,36.31791449764064,31.970534400000002,34.680469000000045,35.51373920000001,35.986452,35.986452,37.90663881563615,34.06626518436385,78254816,74.4065259306025,62.67769855627993,NaN,NaN,NaN,NaN,74.4065259306025,NaN,0.21636080308942285,0.6376936736549013,0.4213328705654784,99.31169882562706,98.88167738632013,1608137482,743358326.3849491,35.09749962944719,8.387874245306335,38.49120937999201,100,0
2004-01-09,37.71001,38.35001,37.59,37.73,32.66728474571196,34.50934492703238,35.62073289006663,36.45239883119868,32.026384400000005,34.738069000000046,35.561139200000014,36.144952,36.144952,38.091145019960415,34.19875898003959,94320000,69.93848879835173,63.71420251838191,NaN,NaN,NaN,NaN,NaN,NaN,0.19820708635060136,0.6690917285037301,0.47088464215312875,80.31720534220521,93.20963472261076,1513817482,683787342.8452575,36.12786644917496,7.599017716640668,41.62705655456158,100,0
2004-01-12,37.85001,38.35001,37.67999,38.33,32.72363017112776,34.58500146313075,35.72697865908362,36.631217990132136,32.0861844,34.79766900000004,35.62133900000001,36.296452,36.296452,38.41964686786855,34.173257132131454,77691632,73.99133718196126,65.12254942397132,NaN,NaN,NaN,NaN,NaN,NaN,0.21043597829851846,0.7339296150262768,0.5234936367277584,99.34608270534181,92.99166229105803,1591509114,756838487.8260045,33.16645775440758,6.976124660683166,44.74921984999127,92.85714285714286,0
2004-01-13,38.27,38.36,37.60001,37.94901,32.77562400027077,34.6516154935638,35.81411714304112,36.756721991071934,32.14552945,34.854259200000044,35.67251920000001,36.431902,36.431902,38.613081792163776,34.250722207836226,93054688,67.74567971318899,66.00622448807714,NaN,NaN,67.74567971318899,NaN,NaN,NaN,0.17798292584928843,0.7459722940393689,0.5679893681900805,85.47738515901065,88.38022440218589,1498454426,749248308.864282,30.147783727062365,7.299021484719775,47.525676299139306,100,0
2004-01-14,38.11,38.25,37.75,38.08,32.82840386096459,34.71950429567145,35.902975294294414,36.8827484681127,32.209679449999996,34.908659200000045,35.730519400000006,36.596902,36.596902,38.7523914213945,34.4414125786055,69028624,68.72320669855023,66.76919235416729,NaN,NaN,NaN,NaN,NaN,NaN,0.1514930473516667,0.7573556773796639,0.6058626300279972,89.06249999999997,91.29532262145081,1567483050,771337468.5442815,28.321452833560812,6.856852051949526,49.81788853599409,92.85714285714286,0
2004-01-15,37.92999,38.46001,37.63,38.17999,32.88165347428833,34.78802876506409,35.99226998863581,37.0062952806734,32.2733294,34.966059100000045,35.77891940000001,36.763401,36.763401,38.867243714880274,34.65955828511973,104554128,69.48349577852159,67.54420503060085,NaN,NaN,NaN,NaN,NaN,NaN,0.1278057830871736,0.7656198588869643,0.6378140757997907,89.39318181818177,87.97768899239747,1672037178,805344863.5589916,28.026414432827718,6.186828378988028,52.311324694738914,100,0
2004-01-16,38.38,38.63,38.17,38.57001,32.93825403673322,34.86291948258757,36.09335783221872,37.155220492037834,32.33437945,35.02665930000004,35.83991960000001,36.9464015,36.9464015,39.009880503859975,34.882922496140026,77353680,72.31085548052732,68.57349748029132,NaN,NaN,NaN,NaN,NaN,NaN,0.1253346104673635,0.794482338883995,0.6691477284166315,97.70153256704984,92.05240479507718,1749390858,862522685.892905,28.51840650933694,5.845890514971002,54.854445052790474,100,0
2004-01-20,38.73,39,38.30701,38.53999,32.99399270303438,34.93573276016009,36.18930419173956,37.28710330231995,32.3946794,35.08665930000004,35.89391940000001,37.095401,37.095401,39.16726615801449,35.02353584198551,82061872,71.75974878846628,69.15127363660953,NaN,NaN,NaN,NaN,NaN,NaN,0.10919918157878294,0.8056467053901102,0.6964475238113272,83.45287769784184,90.18253069435781,1667328986,835638449.7565116,30.55970796881847,5.366132358561034,57.09135005008293,100,0
2004-01-21,38.39,38.66,38,38.38,33.047584815442,35.003936071840094,36.27521383127918,37.391188702099,32.4563294,35.14245930000004,35.94273940000001,37.241400500000005,37.241400500000005,39.242025400019074,35.240775599980935,112286624,68.75237955158134,69.43860449685032,NaN,NaN,NaN,NaN,NaN,NaN,0.07680183863652879,0.7924498221069882,0.7156479834704594,77.6978417266188,86.28408399717016,1555042362,852651574.604998,28.187111326115904,8.560980281991714,58.07014775743941,92.85714285714286,14.285714285714286
2004-01-22,38.55,38.69,38.06,38.14999,33.09835501628337,35.06623416942742,36.348734465346666,37.46345549237529,32.51662935,35.193059200000036,35.99313920000001,37.370399500000005,37.370399500000005,39.25250862483233,35.48829037516768,90937504,64.56319566344999,69.54455231102783,NaN,NaN,NaN,NaN,NaN,NaN,0.03126660551597671,0.7547312403654303,0.7234646348494536,69.42410071942456,76.85827338129506,1464104858,787693327.7001094,26.455732151822964,7.928230131800147,59.00319265939181,85.71428571428571,7.142857142857143
2004-01-23,38.21001,38.46001,37.78,38.00999,33.1472270061711,35.12452636409222,36.41388174121543,37.515506397863355,32.576379300000006,35.23925910000004,36.04953900000001,37.478899,37.478899,39.24203168570347,35.71576631429652,88798000,62.083579599986976,69.59377881976681,NaN,NaN,NaN,NaN,NaN,NaN,-0.0144432054798449,0.7054106279996475,0.7198538334794924,59.42581967213119,68.84925403939151,1375306858,758961067.9686354,24.36262139522852,10.558699094135676,58.70996642571196,78.57142857142857,0
2004-01-26,37.98,38.64999,37.84,38.59,33.20138395138333,35.193149604407225,36.499219712148154,37.61783912187637,32.64202925000001,35.28645910000004,36.12013900000001,37.6133995,37.6133995,39.28210968747366,35.94468931252634,84668128,67.63023405368432,69.56053399528552,NaN,NaN,NaN,NaN,NaN,NaN,-0.011883979569263792,0.7049988590179126,0.7168828385871764,80.00000000000014,69.61664013051863,1459974986,831087705.3361093,24.278958650749193,9.58583654550349,58.24322367073056,71.42857142857143,0
2004-01-27,38.50999,38.63,37.69,37.74001,33.24654440957852,35.243582483527874,36.54787815480901,37.62947444360243,32.7018793,35.325359100000036,36.15873920000001,37.7078995,37.7078995,39.16740976984292,36.24838923015709,97342192,54.9450832347344,68.4840935246132,NaN,NaN,NaN,NaN,NaN,NaN,-0.07043698856948155,0.6288366028753245,0.699273591444806,34.715205778268064,58.04700848346647,1362632794,744103136.7870029,21.77187003576623,10.24378039636145,56.96749852425508,64.28571428571429,0
2004-01-28,37.94,38.06,37.004,37.10001,33.28488735077674,35.28034342444811,36.56953038403219,37.57904925849744,32.75982940000001,35.35475920000004,36.185339400000004,37.740899999999996,37.740899999999996,39.111376631030296,36.370423368969696,128136128,47.69158743300582,66.7160998504723,NaN,NaN,NaN,NaN,NaN,NaN,-0.15066290561504603,0.5109449594259985,0.6616078650410445,4.810120240480942,39.84177533958305,1234496666,639266913.4257907,19.35400910250886,16.320490314882274,53.47126240101183,57.142857142857146,100
2004-01-29,37.23,37.31,36.66,37.24001,33.32424180499787,35.31914870317191,36.59582370230544,37.54675980530721,32.815879450000004,35.38775930000004,36.229339800000005,37.7749005,37.7749005,39.05741960575166,36.49238139424834,144018816,49.26927971865517,64.92058226390465,NaN,NaN,NaN,NaN,NaN,NaN,-0.19014623739521663,0.4239250682970237,0.6140713056922403,24.786752136752163,21.437359385167056,1378515482,752270723.481666,18.026945173693463,18.83025313104111,49.23964987609482,50,100
2004-01-30,37.2,37.44,36.97,37.07001,33.36151313032127,35.35381922390118,36.6144192433915,37.50135506194462,32.8698295,35.41345940000004,36.277140200000005,37.805400500000005,37.805400500000005,38.986383554330835,36.624417445669174,84304880,47.39974996491624,63.31067234723067,NaN,NaN,NaN,NaN,NaN,NaN,-0.22137321859686798,0.33735478244615535,0.5587280010430233,17.52179487179514,15.706222416342754,1294210602,703843847.9446465,18.515197380813238,17.87579797961028,44.70491825130445,42.857142857142854,92.85714285714286
2004-02-02,37.2,37.48,36.82001,36.97,33.397418472308125,35.38582280362591,36.62836358678791,37.4507498179499,32.9235795,35.44225940000004,36.3389402,37.8359005,37.8359005,38.89076648799031,36.78103451200969,94528320,46.28700800177901,61.331791691503376,NaN,NaN,NaN,NaN,NaN,NaN,-0.24081715661828973,0.2577065552701612,0.4985237118884509,13.247863247863325,18.518803418803547,1199682282,652280732.6198679,17.19701185257698,18.221114333409947,40.25121790530444,35.714285714285715,85.71428571428571
2004-02-03,36.91,37.24001,36.72,36.92999,33.432568437757794,35.41640037187094,36.64019207358054,37.401153644811814,32.97412940000001,35.47885930000004,36.39333980000001,37.8279,37.8279,38.90741261050519,36.74838738949481,73805504,45.82354305943764,59.765924787664,NaN,NaN,NaN,NaN,NaN,NaN,-0.24747849724786164,0.18917559032862385,0.4366540875764855,11.53803418803417,14.102564102564216,1125876778,638083381.4821584,16.217326793264146,18.27872117216784,36.31972892950829,28.571428571428573,78.57142857142857
2004-02-04,36.62,37.75999,36.32899,36.33,33.46139860255622,35.43449145361607,36.62802767853817,37.29913901197259,33.02117940000001,35.505759300000044,36.44229980000001,37.7774,37.7774,39.02490874796067,36.52989125203933,110027680,39.44514674802553,57.674634791197946,NaN,NaN,39.44514674802553,NaN,NaN,NaN,-0.28095131681877206,0.08546494155302042,0.3664162583717925,0.03781341140620374,8.274570282434572,1015849098,528211016.586002,19.123439603710324,15.638495313054351,32.677485154235214,21.428571428571427,100
2004-02-05,36.50999,36.71001,36.33,36.47,33.491334934869094,35.45499657334644,36.621830514673924,37.220173391784726,33.06637945000001,35.53225920000004,36.487060000000014,37.7169005,37.7169005,39.08861421962828,36.34518678037172,96939872,41.49163612648084,55.675216244623606,NaN,NaN,NaN,NaN,NaN,NaN,-0.2816095735222575,0.014404291468970598,0.2960138649912281,5.279276378598405,5.61837465934626,1112788970,502698644.2833789,18.36482341881146,15.01812492478768,28.834017457072104,14.285714285714286,92.85714285714286
2004-02-06,36.60001,37.28,36.53,37.131,33.527550507656464,35.48818476001285,36.641797945471026,37.21168068780523,33.11388445000001,35.56866910000004,36.52608020000001,37.67450050000001,37.67450050000001,39.0635016296668,36.28549937033321,107239008,50.07127691677758,54.08667491864149,NaN,NaN,NaN,NaN,NaN,NaN,-0.22777494300923765,0.011295186229681065,0.2390701292389187,30.026469387984395,11.781186392663002,1220027978,567328019.7713786,22.705138278955726,13.764702125892208,25.872420964158263,7.142857142857143,85.71428571428571
2004-02-09,37.34,37.38,37.05,37.12,33.56329627374944,35.5204979330819,36.66055096721726,37.202949193728536,33.16208445000001,35.59586920000004,36.56488040000001,37.644000500000004,37.644000500000004,39.05342636190844,36.234574638091566,58882496,49.940033993766576,52.528123861877226,NaN,NaN,NaN,NaN,NaN,NaN,-0.18497365169678848,0.007853064617933114,0.1928267163147216,33.50303471819263,22.936260161591814,1161145482,533425976.61986315,22.97353043737621,13.27847014182644,22.7736283445577,0,78.57142857142857
2004-02-10,37.05,37.41,37.03,37.17999,33.59928327600068,35.55335916212978,36.68092112536561,37.200762603849626,33.21323440000001,35.625069200000034,36.60168020000001,37.5865,37.5865,38.97293359604385,36.20006640395615,65095808,50.69898535626985,51.23859570506926,NaN,NaN,NaN,NaN,NaN,NaN,-0.14637954973737957,0.009852279142997133,0.1562318288803767,36.04389646803694,33.191133524737985,1226241290,519718169.89312536,22.340713695549923,12.72120817265785,20.918524819319433,7.142857142857143,71.42857142857143
2004-02-11,37.237,37.67,37,37.58,33.63889239763252,35.59349066386979,36.71617912044931,37.23688045110204,33.26373440000001,35.65306920000003,36.64568020000001,37.5680495,37.5680495,38.94448045810061,36.191618541899395,92485680,55.539327809802764,50.59403371552303,NaN,NaN,NaN,NaN,55.539327809802764,NaN,-0.09041268850142281,0.04321596825359819,0.133628656755021,53.89961223610504,41.148847807444874,1318726970,587356950.7886468,23.55594205794508,11.782311592527826,19.44944033072088,0,64.28571428571429
2004-02-12,37.52,37.7,37.24001,37.24001,33.67472441357647,35.62609500715949,36.73672150788267,37.23717850337803,33.31128445000001,35.67966930000003,36.672480600000014,37.52605,37.52605,38.88862464758441,36.16347535241559,70728496,50.959730104320826,49.799473037261166,NaN,NaN,NaN,NaN,NaN,NaN,-0.07350979608341897,0.041741411650747295,0.11525120773416626,39.251184834123166,43.06489784608838,1247998474,516628454.7886468,22.67450605978526,11.172629996972445,19.053239735289402,7.142857142857143,57.142857142857146
2004-02-13,37.39,37.58,36.75999,36.94,33.707214717918994,35.652112927809796,36.744693213455896,37.2088757887706,33.358734450000014,35.70986930000004,36.69728060000001,37.4640505,37.4640505,38.81475303350566,36.11334796649434,90596880,47.25680176907653,48.34422787407489,NaN,NaN,NaN,NaN,NaN,NaN,-0.07925854618271565,0.0161780250057717,0.09543657118848735,26.55399150807684,39.90159619276835,1157401594,465807539.3959069,20.625546067869475,15.45278428575416,16.97823871567698,0,50
2004-02-17,37.28,37.62,37.22,37.44,33.74435686002925,35.6875166322096,36.77196014626155,37.230887618411494,33.407484450000005,35.73906930000003,36.74108060000001,37.40755,37.40755,38.65939444329107,36.15570555670893,69765184,53.34185786662395,48.229711776352715,NaN,NaN,NaN,NaN,NaN,NaN,-0.04766813250717615,0.03585140555451716,0.08351953806169331,64.18276035378173,43.32931223199392,1227166778,472784057.7959068,19.524623559502842,14.298874281935554,15.509837724765516,0,42.857142857142854
2004-02-18,37.50999,37.67,37.32001,37.55,33.782223955949355,35.72439749097773,36.80247151307482,37.261279273800874,33.45383445000001,35.782369300000035,36.779480600000014,37.358050500000004,37.358050500000004,38.50036746038207,36.215733539617936,71116128,54.58328492944892,48.721975883241505,NaN,NaN,NaN,NaN,NaN,NaN,-0.019110519615571406,0.05963138854222905,0.07874190815780045,85.32564640111781,58.6874660876588,1298282906,495133447.5462404,19.31641902088518,13.730564670762552,16.109797769913353,0,35.714285714285715
2004-02-19,37.83,37.89999,36.82001,36.98,33.814042623054334,35.749260906997975,36.809433414522864,37.23449077153413,33.49748445000001,35.824269400000034,36.81828080000001,37.288050500000004,37.288050500000004,38.339238550720076,36.23686244927993,100889376,47.52664753696051,48.5975021559776,NaN,NaN,NaN,NaN,NaN,NaN,-0.0373032994133652,0.032112783891093954,0.06941608330445916,41.439210693825416,63.649205816241654,1197393530,424135905.2213813,17.062810476839907,17.530044434424052,16.050594316032726,100,28.571428571428573
2004-02-20,36.97,37.14,36.55,36.86,33.844350656655784,35.77125574052277,36.81141641787491,37.19882498376897,33.53873445000001,35.867069400000034,36.85078080000001,37.223551,37.223551,38.21168716559353,36.23541483440647,132369376,46.17326735045652,48.50989625494476,NaN,NaN,NaN,NaN,NaN,NaN,-0.055041653581121175,0.0006140163280576871,0.05565566990917886,33.80076384468493,53.52187364654272,1065024154,430866551.45866966,15.966856617849487,19.343553317406613,16.608156210824415,92.85714285714286,21.428571428571427
2004-02-23,37,37.03,35.89999,36.45,33.87027751579354,35.78469622090846,36.79724322501707,37.12750831864812,33.57953450000001,35.90016940000004,36.89118100000002,37.145551499999996,37.145551499999996,38.11923335950579,36.1718696404942,125298128,41.794160578840035,48.18897858187769,NaN,NaN,NaN,NaN,NaN,NaN,-0.08994698017577343,-0.05677805531053792,0.033168924865235504,27.500500000000017,34.24682484617012,939726026,427541190.7461806,14.098994543131935,23.809868002630346,18.23136356488375,85.71428571428571,100
2004-02-24,36.27,36.67,36,36.36,33.89505087384534,35.796088374949875,36.780096431879144,37.054412288300675,33.62248450000001,35.93956940000004,36.92718100000001,37.0340515,37.0340515,37.81152130747188,36.256581692528115,124564624,40.87767744850031,47.835702466810744,NaN,NaN,40.87767744850031,NaN,NaN,NaN,-0.11315577782580039,-0.10827579741701499,0.004879980408785404,23.000499999999846,28.100587948228263,815161402,436837058.2088666,13.11904272162921,22.15496109082627,19.634265462944622,78.57142857142857,92.85714285714286
2004-02-25,36.42999,36.67,36.33,36.58,33.92176678554837,35.81161137742612,36.77224951298192,37.00923016560537,33.663334500000005,35.973869500000035,36.952781000000016,36.976051,36.976051,37.70581818322778,36.24628381677222,74520624,44.104327798495206,48.16850111327286,NaN,NaN,NaN,NaN,NaN,NaN,-0.10777539351901547,-0.12983926148998393,-0.022063867970968463,34.00049999999979,28.16716666666655,889682026,471905587.15004194,12.63895931486268,21.3442137350205,20.747922160482407,71.42857142857143,85.71428571428571
2004-02-26,36.47,36.84,36.30499,36.67,33.949112389672266,35.828609171932534,36.7682397281591,36.976922530785814,33.70248450000001,36.00796960000004,36.98138080000002,36.954550499999996,36.954550499999996,37.6937198526517,36.215381147348296,71463376,45.41672271630472,48.44886444111743,NaN,NaN,NaN,NaN,NaN,NaN,-0.09280856683596614,-0.13807457651592614,-0.04526600967996,38.50049999999996,31.8338333333332,961145402,497953834.7599185,13.756354838499444,20.097885097390524,21.369828640098394,64.28571428571429,78.57142857142857
2004-02-27,36.75999,36.94,36.27,36.57001,33.97519097285961,35.84329037644872,36.760466013329335,36.93816895642526,33.74203455000001,36.031769700000034,37.017181000000015,36.92105049999999,36.92105049999999,37.666140552208624,36.17596044779136,99452128,44.175731108182134,48.02775402621775,NaN,NaN,NaN,NaN,NaN,NaN,-0.08453091802961958,-0.15092965721698448,-0.0663987391873649,33.50100000000005,35.33399999999993,861693274,487566282.64433724,13.841694426143597,18.630717959928564,20.672212500050268,57.142857142857146,71.42857142857143
2004-03-01,36.67999,37.07001,36.47,37.05,34.005786087557524,35.867185616519045,36.77182028731642,36.9488195320038,33.784284500000005,36.05786970000004,37.06118080000001,36.920049999999996,36.920049999999996,37.6643906411591,36.17570935884089,79781008,51.08532509245901,48.10956053326721,NaN,NaN,NaN,NaN,51.08532509245901,NaN,-0.04367421263206536,-0.1209915049774466,-0.07731729234538123,57.50049999999973,43.16733333333324,941474282,562025986.0991447,14.356454812591801,17.405313514365933,19.447614543231964,50,64.28571428571429
2004-03-02,36.983,37.17999,36.61,36.62,34.0317981662883,35.88209283203352,36.76586655055892,36.91750338609868,33.822784500000004,36.07756980000004,37.095380800000015,36.90255,36.90255,37.65774864279467,36.14735135720532,91604880,45.63582863481907,47.74790648173501,NaN,NaN,NaN,NaN,NaN,NaN,-0.042513255266262706,-0.13045886142820962,-0.08794560616194691,36.00049999999975,42.33399999999984,849869402,473635368.80550736,14.667817785779299,16.30796859352583,17.866127586809633,42.857142857142854,57.142857142857146
2004-03-03,36.50999,36.63,36.21001,36.42,34.05556136861379,35.892744459121964,36.75230315641935,36.87012211123214,33.86138450000001,36.09746990000004,37.11258080000002,36.877050499999996,36.877050499999996,37.660724157754636,36.093376842245355,84023184,43.32107051286454,46.87517381766799,NaN,NaN,NaN,NaN,NaN,NaN,-0.051518724049473885,-0.15234401122378927,-0.10082528717431538,26.00049999999996,39.833833333333146,765846218,473633368.2058748,13.968970773257967,20.068582801640968,16.766362303831006,35.714285714285715,50
2004-03-04,36.44,36.83,36.39,36.75999,34.082471106239524,35.90991763814925,36.75260460126565,36.85963333873384,33.90673445,36.11816980000004,37.138580400000016,36.89854999999999,36.89854999999999,37.643656213959595,36.15344378604039,66033632,48.1369799336728,46.673548805478845,NaN,NaN,NaN,NaN,NaN,NaN,-0.031845908353853855,-0.1406326726166327,-0.10878676426277885,42.99999999999997,35.000333333333224,831879850,518653297.5862394,15.575124794114375,19.044836680249603,15.054966409028792,28.571428571428573,42.857142857142854
2004-03-05,36.41,37.14999,36.36,36.63,34.107819652446096,35.924176694819565,36.74779657768661,36.83776349694967,33.95103445,36.134369900000046,37.159780200000014,36.906549999999996,36.906549999999996,37.6363582419931,36.17674175800689,118130816,46.50982155127254,46.6201930756357,NaN,NaN,NaN,NaN,NaN,NaN,-0.02514982341827675,-0.1402240435356248,-0.11507422011734804,36.5005,35.16699999999998,713749034,481271150.10103136,17.813361651512366,17.33500579854116,14.128064652406545,21.428571428571427,35.714285714285715
2004-03-08,36.69,36.82001,35.73,35.77,34.12435876038196,35.92112369096175,36.70945161385576,36.736071735335415,33.99143445000001,36.13966980000004,37.15838020000002,36.838499999999996,36.838499999999996,37.71163829378849,35.9653617062115,112721872,37.482603582638724,45.487389198208184,NaN,NaN,NaN,NaN,NaN,NaN,-0.07346853298779069,-0.2069098863520864,-0.13344135336429572,1.8433264669425273,27.114608822314167,601027162,376822367.11856455,15.716689405100912,22.09754714700668,14.229790721225388,14.285714285714286,100
2004-03-09,35.83,35.98,35.52,35.66,34.13963877271647,35.91595292480409,36.668296648606514,36.63358871292252,34.029284450000006,36.14296980000004,37.15358040000002,36.765499999999996,36.765499999999996,37.766988132770855,35.76401186722914,126229184,36.50658216433411,44.196196143557124,NaN,NaN,NaN,NaN,NaN,NaN,-0.10570580582982086,-0.2655736106515718,-0.15986780482175095,5.882377657048706,14.742068041330413,474797978,327428338.59682286,14.918646715255345,23.293574962926673,14.587941991575908,7.142857142857143,100
2004-03-10,35.75,35.99899,35.13,35.19,34.15009012821182,35.90157761936242,36.610324231014104,36.49610407359656,34.064734400000006,36.143069900000036,37.14038020000002,36.666000499999996,36.666000499999996,37.859925764017845,35.472075235982146,134315632,32.60048119749206,43.13004140502367,NaN,NaN,NaN,NaN,NaN,NaN,-0.14890704862910967,-0.346001615608138,-0.19709456697902836,2.926843545578044,3.55084922318976,340482346,211660533.2001195,13.521822036720591,25.314670834326584,16.660421586427315,0,100
2004-03-11,35.07001,35.53,34.8,34.87,34.15725341051817,35.88115033977108,36.54207622195473,36.34123701896832,34.09358435000001,36.137169800000045,37.10898020000001,36.530500499999995,36.530500499999995,37.88329800075865,35.17770299924134,152504688,30.228933221498423,41.99116039581237,NaN,NaN,30.228933221498423,NaN,NaN,NaN,-0.18680357599872413,-0.4305990369774335,-0.24379546097870938,2.9411888285245023,3.916803343717085,187977658,88403319.61107837,12.465906680537783,26.8679385973038,18.59270486337868,50,100
2004-03-12,35.2,35.59,35.14999,35.50999,34.170713476085155,35.873800630072644,36.501602252466306,36.26207063620944,34.12518430000001,36.146169700000044,37.087980000000016,36.4439995,36.4439995,37.82520874412584,35.062790255874155,118398816,39.67993035998614,41.840143951608525,NaN,NaN,NaN,NaN,NaN,NaN,-0.15769852969617698,-0.4409186230989306,-0.2832200934027536,29.831637948058813,11.89989010738712,306376474,163743617.54030657,12.149385677732058,24.81007630336664,19.20979391379449,42.857142857142854,92.85714285714286
2004-03-15,35.36,35.39999,34.81,34.89,34.177870555925104,35.854319429477144,36.438402164134295,36.13139724228473,34.1530843,36.144669800000045,37.056579800000016,36.34149949999999,36.34149949999999,37.857907613292994,34.82509138670699,115887632,34.766751626091946,41.40364925000792,NaN,NaN,NaN,NaN,NaN,NaN,-0.1681734828817642,-0.4934369470049589,-0.3252634641231947,3.781528493817345,12.184785090133554,190488842,79283672.65364678,11.247441367625495,26.574013541400515,20.274588144078212,35.714285714285715,85.71428571428571
2004-03-16,35.11,35.25,34.63,34.95,34.18555343596565,35.836412114041956,36.3800334518153,36.01888321920999,34.178884350000004,36.14166980000004,37.02837980000002,36.2169995,36.2169995,37.76082788037728,34.67317111962272,123745376,35.59783270306038,40.79604245747687,NaN,NaN,NaN,NaN,NaN,NaN,-0.15912862399461714,-0.5241742441164661,-0.36504562012184893,12.549068819877766,15.387411753917974,314234218,83275458.97622807,10.503651519921872,26.73657649769468,21.55840171094877,28.571428571428573,100
2004-03-17,35.21001,35.62,35.17999,35.5,34.19863250625455,35.829750488021325,36.34552233605784,35.96946576976142,34.208484350000006,36.15096970000004,36.99657980000002,36.114499499999994,36.114499499999994,37.55977478798505,34.66922421201494,91960128,42.79268784238302,40.6086113950539,NaN,NaN,NaN,NaN,42.79268784238302,NaN,-0.10668992991751225,-0.4984080325187392,-0.39171810260122697,34.11778085404254,16.81612605591255,406194346,125076657.13372567,13.699372141349311,24.825972938111818,22.283357758259598,21.428571428571427,92.85714285714286
2004-03-18,35.37,35.46001,34.97,35.34,34.20998939673958,35.82005245855556,36.306090087584984,35.90951664883176,34.235884350000006,36.16266970000003,36.956579800000014,36.03249949999999,36.03249949999999,37.458008647659064,34.60699035234092,111342368,41.345606593260555,40.40645964398807,NaN,NaN,NaN,NaN,NaN,NaN,-0.0748691169950953,-0.4853044988450961,-0.4104353818500008,27.8432464441038,24.836698706008036,294851978,181880556.18950278,12.913256711658564,25.674946607508815,23.59217947514275,14.285714285714286,85.71428571428571
2004-03-19,35.28,35.45599,34.72501,34.75,34.21536263657302,35.7988633009604,36.24506694689538,35.79908649180017,34.25753435000001,36.168169700000036,36.89798000000002,35.926999499999994,35.926999499999994,37.403334457948375,34.45066454205161,100132624,36.450684828395055,39.36112819655493,NaN,NaN,NaN,NaN,NaN,NaN,-0.08491024571998718,-0.5165731889999847,-0.43166294327999755,4.705900807454058,22.22230936853347,194719354,88594396.5900616,11.899080610562287,26.290707588399304,25.59827544466813,7.142857142857143,78.57142857142857
2004-03-22,34.53,34.55,34.03,34.31,34.21630430188075,35.76938085935722,36.169181968585754,35.65726873067634,34.27588435000001,36.16916960000003,36.82460000000001,35.81999949999999,35.81999949999999,37.43307125291803,34.20692774708194,134556320,33.28578120684969,38.47898195169997,NaN,NaN,NaN,NaN,NaN,NaN,-0.1108970787106826,-0.5702842916683508,-0.4593872129576682,8.974387738422271,13.841178329993378,60163034,98944882.74390946,10.984018587032644,31.692179231234576,28.68605880700448,0,100
2004-03-23,34.59,34.64999,34.006,34.03,34.21445052773268,35.73493767402341,36.08529247962161,35.50229075632622,34.295384350000006,36.15586960000003,36.75060000000002,35.703499499999985,35.703499499999985,37.47273973639051,33.93425926360946,126105008,31.416386264745213,37.62864736254859,NaN,NaN,31.416386264745213,NaN,NaN,NaN,-0.13505251440359178,-0.628202855962158,-0.4931503415585662,0.7633612066196424,4.814549917498657,-65941974,-17760848.273528367,11.297304207094799,29.506501369971694,30.593628847865165,14.285714285714286,100
2004-03-24,34.14999,34.63,34.00999,34.42,34.21649579611345,35.708899304240774,36.019986892185464,35.39921544619991,34.31883435,36.14686950000004,36.67240000000002,35.59549949999999,35.59549949999999,37.40087441454317,33.79012458545681,118985312,36.74516056212286,36.814945978866454,NaN,NaN,NaN,NaN,NaN,NaN,-0.11372815113985135,-0.6353105304833804,-0.521582379343529,13.167980814188377,7.635243253076763,53043338,20622810.462814346,10.543395430801814,27.537428931738823,33.06533854601928,7.142857142857143,92.85714285714286
2004-03-25,34.64999,35.46001,34.62,35.343,34.22770479316705,35.701653773463725,35.99343838660956,35.39386159418087,34.34464940000001,36.14639950000004,36.62027980000002,35.52914949999999,35.52914949999999,37.26800263544925,33.79029636455073,142146624,47.20091017532663,36.86430945201318,NaN,NaN,NaN,NaN,NaN,NaN,-0.030741765063224902,-0.5600095856725602,-0.5292678206093353,47.512268968482765,20.481203663096927,195189962,123168533.3444013,17.994949530067696,24.574920460475386,34.0721893781239,0,85.71428571428571
2004-03-26,35.3,35.584,35.2,35.22,34.23757837731464,35.692116074979296,35.96310746948762,35.377303347116026,34.36814940000001,36.14679960000004,36.56307980000001,35.46164899999999,35.46164899999999,37.13730455029635,33.785993449703625,78444128,46.10716062148681,37.480349240502335,NaN,NaN,NaN,NaN,NaN,NaN,0.01985968918170422,-0.5044432091322051,-0.5243028983139093,60.91350182389271,40.53125053552128,116745834,52895668.677733004,18.581330942199813,23.566793786721064,33.711775994531614,0,78.57142857142857
2004-03-29,35.50999,35.96001,35.49001,35.78999,34.25302525913241,35.69405417250446,35.95631854911555,35.41660683786688,34.39384940000001,36.14709960000003,36.51527980000001,35.398648499999986,35.398648499999986,36.91816653340888,33.87913046659109,103919632,51.693414450654984,38.56512297523954,NaN,NaN,NaN,NaN,NaN,NaN,0.09169002230861756,-0.4096903704281374,-0.5013803927367549,89.51324391993958,65.97967157077169,220665466,81630552.45373555,21.11000033816213,21.717821931677847,32.24765724277084,7.142857142857143,71.42857142857143
2004-03-30,35.67,35.94299,35.517,35.91,34.26951256998681,35.69833032750437,35.95450213542475,35.46359666283194,34.42359935000001,36.150999600000034,36.46207960000002,35.36314849999999,35.36314849999999,36.7976694053391,33.928627594660874,95854496,52.80269571293578,40.00813829777123,NaN,NaN,NaN,NaN,NaN,NaN,0.14413508821801785,-0.3212115324642326,-0.46534662068225047,97.440647693717,82.62246447918311,316519962,162638503.59098992,20.130873580076198,20.710503114055197,30.180074452232592,0,64.28571428571429
2004-03-31,35.92,36,35.61,35.84,34.28513931058396,35.70113566755379,35.95001185560417,35.499444599705086,34.44839935000001,36.150999600000034,36.40807980000002,35.33414849999998,35.33414849999998,36.70403049486492,33.96426650513505,86058000,52.05187371077509,41.566919761291,NaN,NaN,NaN,NaN,NaN,NaN,0.169226079850611,-0.25381402086898674,-0.42304010071959774,91.97592778335022,92.97660646566892,230461962,178084811.2832992,19.889792516320412,19.804829583847358,27.58001606649328,100,57.142857142857146
2004-04-01,35.81,36.25,35.78,36.16,34.3037946408269,35.71022208997847,35.95824668479616,35.56235463782841,34.47539940000001,36.15320960000004,36.36367980000002,35.30414899999998,35.30414899999998,36.57015774532572,34.03814025467424,93091872,55.188798499084875,42.6746960569409,NaN,NaN,NaN,NaN,NaN,NaN,0.20035994484269493,-0.1725901696662291,-0.372950114508924,95.98930481283408,95.13529342996709,323553834,235524476.9854254,21.678302172384015,18.7411862172086,25.6522281893329,100,50
2004-04-02,36.89,37.16,36.52,37.10001,34.33161767922663,35.737742642652165,36.003021716764934,35.70879800565428,34.50629945000001,36.16790970000004,36.34268020000001,35.327649499999985,35.327649499999985,36.7038821186596,33.95141688134037,146006624,62.872864512611905,44.682275548835186,NaN,NaN,NaN,NaN,NaN,NaN,0.2727602060380828,-0.03199985696132046,-0.3047600629994033,98.09797083069121,95.35440114229182,469560458,354159421.69242555,29.274190104319675,16.687630769512346,24.71375160984753,100,42.857142857142854
2004-04-05,37.03999,37.5,36.97,37.45,34.362646359035324,35.77164872893628,36.059765963166306,35.87462676702054,34.54144945000001,36.190509700000035,36.33148040000002,35.41164949999998,35.41164949999998,37.063173570870454,33.76012542912951,67379376,65.26136376141892,46.8010991958608,NaN,NaN,NaN,NaN,65.26136376141892,NaN,0.32895472989415875,0.10643334936829518,-0.22252138052586357,98.56897538637672,97.55208367663401,536939834,408825707.88110554,31.327053085894292,15.705388553036695,23.972673078578687,100,35.714285714285715
2004-04-06,37.16,37.39999,36.92,36.98,34.38868967884592,35.79557647687813,36.095853572453905,35.979900408256675,34.57444945,36.20970970000004,36.299280400000015,35.477649499999984,35.477649499999984,37.26362733319482,33.69167166680515,98707680,59.706397334929434,48.00922130247126,NaN,NaN,NaN,NaN,NaN,NaN,0.31896640122170217,0.17618662100126414,-0.14277978022043802,85.11734401831701,93.92809674512831,438232154,334795461.9943142,29.45965764990852,15.331550873607453,24.16273690115582,92.85714285714286,28.571428571428573
2004-04-07,36.994,37.11,36.66,36.94,34.41407585119571,35.81823832882114,36.1289573539263,36.071338464613184,34.60959945000001,36.22100970000004,36.283280200000014,35.56514949999998,35.56514949999998,37.45465662373989,33.67564237626007,91091680,59.244210018597904,49.287692975709646,NaN,NaN,NaN,NaN,NaN,NaN,0.2947341539461615,0.2256379122122638,-0.06909624173389765,83.97252432741837,89.2196145773707,347140474,357062317.10542506,27.936948209548586,17.52550951300264,23.43628681893694,85.71428571428571,21.428571428571427
2004-04-08,37.35001,37.39,36.74001,36.94,34.43920942481566,35.84045143122072,36.16076294788998,36.154068134650025,34.64589950000001,36.232709700000036,36.28008000000002,35.66864949999999,35.66864949999999,37.62026021545103,33.71703878454894,77246688,59.244210018597904,50.91580191786699,NaN,NaN,NaN,NaN,NaN,NaN,0.26472533668211523,0.2618104291187464,-0.002914907563368832,83.97252432741837,84.35413089105126,347140474,327350406.97314584,29.063696414468648,16.221281982665054,22.77018785633569,78.57142857142857,14.285714285714286
2004-04-12,37.07001,37.24001,36.98,37.17,34.46638147033988,35.866779125651995,36.200340871502135,36.25082355039764,34.68414950000001,36.25400980000004,36.27867980000002,35.75164999999999,35.75164999999999,37.80761793507154,33.69568206492844,55325504,61.244827424103896,52.91287664767087,NaN,NaN,NaN,NaN,NaN,NaN,0.24674368913556735,0.30551470385609036,0.058771014720523006,90.5552375500859,86.16676206830755,402465978,352882145.07922035,28.02695058412014,15.642644419892301,21.32984448197676,71.42857142857143,7.142857142857143
2004-04-13,37.34,37.36,36.46001,36.63,34.487910012923564,35.88189241029255,36.21719024909029,36.28693559321691,34.71619950000001,36.27350990000004,36.26987960000002,35.83864999999999,35.83864999999999,37.888659695109475,33.7886403048905,100740688,54.482691606744055,54.56046988638507,NaN,NaN,NaN,NaN,NaN,NaN,0.1875410863223441,0.29319737262345313,0.10565628630110904,75.07170466560275,83.19982218103569,301725290,290197234.48368156,25.130840301309192,19.99654777926824,18.954923676460425,64.28571428571429,0
2004-04-14,36.41,36.95,36.36,36.81,34.5110153859293,35.90027077840557,36.240437690302436,36.33675125100578,34.75109950000002,36.30280990000004,36.26667960000002,35.93164999999998,35.93164999999998,37.98072494983559,33.88257505016438,113763808,56.217987824327686,55.95138611939971,NaN,NaN,NaN,NaN,NaN,NaN,0.15112675947504195,0.2945647356449115,0.14343797616986953,76.04166666666677,80.55620296078514,415489098,349971438.6870715,23.422143903666935,19.78946448617136,16.367816419386088,57.142857142857146,0
2004-04-15,36.75,36.86,36.02,36.14999,34.52732359104443,35.90521571348665,36.23689072205528,36.318964465195705,34.78209945000001,36.322209700000045,36.25107960000002,35.964149499999984,35.964149499999984,38.0054121990818,33.922886800918164,123788496,48.8621475219684,56.070045929874105,NaN,NaN,NaN,NaN,NaN,NaN,0.0769526574679456,0.23962879800480152,0.16267614053685592,41.303913043478296,64.13909479191594,291700602,264495482.19907147,21.210935507571325,21.742430977411196,15.352138167066105,50,0
2004-04-16,36.2,36.32001,35.78999,36.09,34.54287261003901,35.90887480826909,36.231130301582525,36.29715832565326,34.810799400000015,36.34428970000005,36.246279600000015,36.001649499999985,36.001649499999985,38.023130035810915,33.980168964189055,110813680,48.244251221782875,56.222695258466686,NaN,NaN,NaN,NaN,NaN,NaN,0.021116272884782683,0.18907148164283427,0.1679552087580516,29.850397265658277,49.065325658601104,180886922,279130698.9833438,19.93226862704029,23.047809973286427,15.025021732859846,42.857142857142854,0
2004-04-19,36.00999,36.59,35.98,36.53,34.56264502187942,35.92117431701624,36.24285068191262,36.31933372321009,34.838599400000014,36.367269800000045,36.24747960000002,36.09064949999999,36.09064949999999,38.039291363622134,34.14200763637785,85887376,52.94441232181751,56.31205224926401,NaN,NaN,NaN,NaN,NaN,NaN,0.011560715342335659,0.18240610293597115,0.1708453875936355,51.08421583459403,40.74617538124354,266774298,348122197.73744166,21.62364018335677,21.445467407505873,14.953198096274376,35.714285714285715,0
2004-04-20,36.61,36.78999,35.64,35.67999,34.57376288235823,35.91639838994661,36.22077771399448,36.25844384480913,34.86409935000002,36.37226980000005,36.21845940000002,36.15914899999999,36.15914899999999,37.9418497890495,34.376448210950485,119746688,44.530992435151504,55.72121630085085,NaN,NaN,44.530992435151504,NaN,NaN,NaN,-0.05083777201361256,0.10729817257661978,0.15813594459023234,3.7031746031744492,28.212595901142254,147027610,236703703.9880343,18.94902402605832,22.44982661509984,15.455845119547009,28.571428571428573,0
2004-04-21,35.89999,36.11,35.45,35.99001,34.58785489347905,35.91785604559123,36.21172799972019,36.23287871673207,34.88459940000001,36.38037000000004,36.19585960000002,36.25714949999999,36.25714949999999,37.75336880835727,34.76093019164271,119168320,47.789795995275924,55.416782178315195,NaN,NaN,NaN,NaN,NaN,NaN,-0.06893987809893712,0.07196109696656094,0.14090097506549806,26.341951219511998,27.04311388576016,266195930,312541700.6037912,17.603284752141725,22.899948252885054,16.37463770181665,21.428571428571427,100
2004-04-22,36,37.00999,35.98,36.92,34.61106031742453,35.937700480332,36.23950337228018,36.29831883894806,34.907799400000016,36.39617000000004,36.19065980000002,36.38214949999999,36.38214949999999,37.64271394448548,35.1215850555145,137853008,56.118259409630426,55.483172243354154,NaN,NaN,NaN,NaN,NaN,NaN,-0.018606763289704398,0.11764252095336758,0.13624928424307198,71.70731707317077,33.91748096528574,404048938,426306334.56148016,25.04341471347748,20.458127816071183,16.57539686503022,14.285714285714286,92.85714285714286
2004-04-23,37.08,37.25999,36.89999,37.21001,34.63692051327105,35.96289472824621,36.27756245572017,36.385146568572054,34.93284945000001,36.414470100000045,36.18326000000002,36.47549999999999,36.47549999999999,37.69010681709057,35.260893182909406,92016624,58.349513105343995,55.1600757142636,NaN,NaN,NaN,NaN,58.349513105343995,NaN,0.031182057203124502,0.1752268557469776,0.1440447985438531,85.85414634146325,61.301138211382,496065562,492773009.29747754,26.75672625330098,19.668705888633028,15.70987710327181,7.142857142857143,85.71428571428571
2004-04-26,37.17999,37.28999,36.64999,36.94,34.65983672706935,35.98224334748886,36.3035403986331,36.43798975251757,34.95954940000001,36.42487020000004,36.17725980000002,36.56149999999999,36.56149999999999,37.6448197681767,35.47818023182327,74493184,55.5190425966544,54.464195631066126,NaN,NaN,NaN,NaN,NaN,NaN,0.0422094740137931,0.19680664106109447,0.15459716704730136,76.41064825973442,77.99070389145614,421572378,485791601.20947635,24.91602143070996,21.00288444288446,13.9461046073162,0,78.57142857142857
2004-04-27,36.95,37.19,36.69,36.87,34.68182840142686,35.99982268714255,36.32575450064749,36.47913358561114,34.98469940000001,36.43657020000005,36.17585980000002,36.61550049999999,36.61550049999999,37.64598893666577,35.585012063334204,87639504,54.777179212127365,54.112108622294556,NaN,NaN,NaN,NaN,NaN,NaN,0.04103188552930265,0.20588702395892966,0.164855138429627,73.1958762886596,78.48689029661908,333932874,461252540.0894762,23.55279398295534,19.85375601424742,12.30179749499615,0,71.42857142857143
2004-04-28,36.71001,36.72,36.019,36.2,34.696934586487295,36.00378659432784,36.320822951602494,36.452549434600556,35.00459940000001,36.44607020000004,36.15105980000002,36.63000049999999,36.63000049999999,37.628022223262136,35.63197877673784,111768688,48.14582740253548,53.319367006861526,NaN,NaN,NaN,NaN,NaN,NaN,-0.006117950947342576,0.1572076997454488,0.16332565069279137,38.65979381443304,62.75543945427568,222164186,407201776.56308675,21.40609426731512,25.230774758684817,11.251783329327234,7.142857142857143,64.28571428571429
2004-04-29,36.09,36.34,35.3,35.64,34.70631832194513,35.99658289939066,36.29412401232396,36.37516377416241,35.02149945000001,36.44617020000004,36.11285980000002,36.62000049999999,36.62000049999999,37.65288355248043,35.587117447519546,156988816,43.41497039386939,52.18870703366663,NaN,NaN,NaN,NaN,NaN,NaN,-0.07257674242782225,0.07260472265801354,0.1451814650858358,16.504854368932186,42.78684149067493,65175370,352859494.1015487,19.113356955642,29.933172696010434,10.801869314504824,0,100
2004-04-30,35.66,35.8,34.72,34.77,34.70695197048299,35.9722941291057,36.23435444321322,36.22229103376599,35.03454945000001,36.443470300000044,36.06865980000002,36.550500499999984,36.550500499999984,37.850387678990145,35.25061332100982,150908880,37.28532914437073,50.47731429939997,NaN,NaN,37.28532914437073,NaN,NaN,NaN,-0.1672721918674442,-0.06390877474846945,0.10336341711897473,1.893939393939555,19.01952919243492,-85733510,215923658.54599434,17.06881790552287,32.4758855747625,10.997455067855686,7.142857142857143,100
2004-05-03,35,35.52,34.89,35.10001,34.71086299565231,35.9550211760541,36.189870347400934,36.11540712578828,35.05414955000001,36.44212040000004,36.03346000000002,36.45050049999999,36.45050049999999,37.86828012959731,35.03272087040267,117051376,40.70516263538827,49.49320508716028,NaN,NaN,NaN,NaN,NaN,NaN,-0.1977386576256698,-0.14380990491311252,0.05392875271255728,14.786438857738668,11.061744206870136,31317866,176910249.12935796,15.804486245092479,30.070312408538662,12.40602462310341,0,92.85714285714286
2004-05-04,35.21001,35.75,35.03,35.25,34.71622754295925,35.9410603606867,36.15301268671855,36.03298739952273,35.07399955000001,36.450320500000046,36.00946000000002,36.34050049999999,36.34050049999999,37.772331327332914,34.90866967266707,126233312,42.24662550171127,48.49525063554482,NaN,NaN,NaN,NaN,NaN,NaN,-0.19738830769740556,-0.19280663190919967,0.00458167578820589,20.622648337153073,12.434342196277099,157551178,127819516.68491325,16.952559807319687,27.931339664139422,13.552715733197832,57.142857142857146,85.71428571428571
2004-05-05,35.42,35.7,35.2,35.53,34.72432478133777,35.93292055156419,36.12858081665115,35.985083837663424,35.09724955000001,36.46002050000005,35.99286000000002,36.268000499999985,36.268000499999985,37.70977191326284,34.82622908673713,97566816,45.11509044986023,48.227603701822794,NaN,NaN,NaN,NaN,NaN,NaN,-0.16899411828621005,-0.2066609720695567,-0.03766685378334663,31.517632364328303,22.308906519740017,255117994,159040897.80491257,16.09628127809532,26.520519898940965,15.21150278807597,50,78.57142857142857
2004-05-06,35.2,35.52299,34.85001,35.25999,34.72965478351352,35.91959519410747,36.09451843168444,35.91602728169548,35.116849500000015,36.45962040000005,35.966459800000024,36.18399999999999,36.18399999999999,37.65484358112004,34.71315641887994,102722496,42.902208082776326,47.84602919189376,NaN,NaN,NaN,NaN,NaN,NaN,-0.15922624541145985,-0.23669966054767144,-0.07747341513621159,21.011365802979864,24.383882168153747,152395498,181475669.21280074,14.987546862852097,28.239066417205404,16.883440286495105,42.857142857142854,71.42857142857143
2004-05-07,35.09,35.64,34.91,34.97,34.732046278204926,35.900791328877624,36.0504196696576,35.825929445343526,35.133699450000016,36.45692030000005,35.93245980000002,36.08549999999999,36.08549999999999,37.603730496374624,34.567269503625354,137713120,40.5989673141212,46.96421169134402,NaN,NaN,NaN,NaN,NaN,NaN,-0.16255720302841,-0.2806699189217241,-0.1181127158933141,9.727664309977843,20.752220825762006,14682378,66400322.36348641,15.064348844560222,26.156110154405198,18.775918730712412,35.714285714285715,64.28571428571429
2004-05-10,34.67,34.89999,34.42,34.67101,34.73143895205364,35.87643922335529,35.996325172808284,35.715937117215574,35.15115455000001,36.45583040000005,35.89447980000002,35.96055049999999,35.96055049999999,37.51216342593872,34.408937574061255,157122880,38.31501506665971,46.520213307880326,NaN,NaN,NaN,NaN,NaN,NaN,-0.17412749775532202,-0.3357720880874666,-0.1616445903321446,8.746023505308406,13.161684539422039,-142440502,73611758.11506484,14.213679380377142,29.70997844583935,20.69190405337985,28.571428571428573,100
2004-05-11,34.97,35.38,34.92,35.19,34.73600174855061,35.86284636744727,35.96470457779619,35.66584786795695,35.16810455000001,36.45923030000005,35.85727980000002,35.88855049999999,35.88855049999999,37.4428618458833,34.33423915411667,120803632,44.18466961913898,46.26270428101339,NaN,NaN,NaN,NaN,NaN,NaN,-0.1376570709523664,-0.3337159290226026,-0.1960588580702362,26.829361774779553,15.101016530021932,-21636870,94621085.41941032,18.102033498209334,27.550254709371025,21.23611221194727,21.428571428571427,92.85714285714286
2004-05-12,35.12,35.3495,34.27,35.25999,34.74121556199787,35.85090861759683,35.93706871200026,35.62719473767533,35.18495450000001,36.46273020000005,35.83007960000002,35.81104999999998,35.81104999999998,37.327975269802025,34.294124730197936,197861312,44.9454995559789,45.464650005752574,NaN,NaN,NaN,NaN,NaN,NaN,-0.10132787337971211,-0.32271869979487633,-0.22139082641516422,32.78123437494822,22.78553988501206,176224442,259669861.91756782,16.174135064571228,31.028901141767555,22.764164047262835,14.285714285714286,100
2004-05-13,35.06,35.45,34.92,35.00999,34.7438899345153,35.83425676378303,35.900712684078684,35.568413334087204,35.20175450000001,36.457230100000054,35.80187940000002,35.754049999999985,35.754049999999985,37.30112130868718,34.20697869131279,138093312,42.70619251824317,44.3472699638168,NaN,NaN,NaN,NaN,NaN,NaN,-0.08718169964553443,-0.33036795097208227,-0.24318625132654784,24.503061268414758,28.037885806047512,38131130,168470954.24541688,16.32276821727045,29.37477277876077,23.713748629415203,7.142857142857143,92.85714285714286
2004-05-14,35.2,35.314,34.64,34.75,34.74395073118679,35.81278633281703,35.85558669646775,35.49046920703128,35.218404500000005,36.45013000000005,35.761679600000015,35.687049999999985,35.687049999999985,37.28533796972378,34.08876203027619,133742880,40.44915782048126,43.27084962266157,NaN,NaN,NaN,NaN,NaN,NaN,-0.08811981503230926,-0.35333602011693444,-0.2652162050846252,16.438356164383485,24.57421726924882,-95611750,78383020.23948197,15.21215636498303,30.20270875466915,25.462762012307206,0,85.71428571428571
2004-05-17,34.38,34.61501,34.11,34.42,34.74072734082672,35.785206405434515,35.799289178959214,35.38851975874259,35.23150450000001,36.43862990000005,35.71747960000002,35.58154999999998,35.58154999999998,37.22135902368647,33.94174097631349,150694880,37.72390964650728,42.052758939403,NaN,NaN,37.72390964650728,NaN,NaN,NaN,-0.10273032481072891,-0.39362911109803633,-0.2908987862873074,11.877394636015415,17.606270689604553,-246306630,112696012.55884385,14.222575052805764,33.62508129705029,27.750529561791122,0,100
2004-05-18,34.66,34.89999,34.60001,34.73,34.740620601117,35.76431122908928,35.75735626998042,35.32580359124329,35.247854450000005,36.42752990000005,35.69667960000002,35.53405049999998,35.53405049999998,37.214240435080086,33.85386056491987,96712000,41.69778349986179,41.592184374926305,NaN,NaN,NaN,NaN,NaN,NaN,-0.08406707141647318,-0.39598262555789887,-0.3119155541414257,27.802690582959478,18.706147127786128,-149594630,99800219.50597186,16.47635503206635,31.9465789196737,29.446754827559023,0,92.85714285714286
2004-05-19,35.16,35.511,34.63499,34.69,34.740116913543694,35.74303773940434,35.71549916135373,35.26525086826774,35.26405445000001,36.41543000000005,35.67727960000002,35.469049999999974,35.469049999999974,37.17405510090897,33.764044899090976,141760496,41.33129970160531,41.4433507540503,NaN,NaN,NaN,NaN,NaN,NaN,-0.06767140294338347,-0.396504807820655,-0.32883340487727153,34.31952662721888,24.666537282064592,-291355126,-24156267.670020655,21.236055615524936,29.0922890908388,28.98601550813573,0,85.71428571428571
2004-05-20,34.78,35.02,34.56,34.85001,34.741210377090525,35.72535402179238,35.681558409928094,35.22570411890891,35.287254450000006,36.40543000000005,35.67047980000002,35.365550499999976,35.365550499999976,36.952933482126255,33.7781675178737,95036000,43.471626630218815,41.88522914589659,NaN,NaN,NaN,NaN,NaN,NaN,-0.04063809304639188,-0.3796310211852614,-0.3389929281388695,45.12256097560962,35.74825939526266,-196319126,639864.3299771473,20.21470563437534,28.477147365263715,27.976839288210982,0,78.57142857142857
2004-05-21,35.02,35.17,34.73801,35.019,34.74397445294037,35.71136681344005,35.65557572718581,35.206018012346156,35.31139945000001,36.391220000000054,35.67345980000002,35.25599999999997,35.25599999999997,36.60336511908464,33.9086348809153,111482368,45.72369955940307,42.2436960690405,NaN,NaN,NaN,NaN,NaN,NaN,-0.0076887413101093816,-0.34860385477650624,-0.34091511346639686,55.4268292682926,44.95630562370703,-84836758,34185995.06522373,20.887669329860135,27.156244197277417,26.687574213153074,7.142857142857143,71.42857142857143
2004-05-24,35.3,35.46001,35,35.25999,34.74910893599569,35.70242865871847,35.64006256141382,35.21115820164652,35.33614940000001,36.378219900000055,35.66845980000002,35.17199949999998,35.17199949999998,36.276535788287575,34.06746321171238,100146496,48.85307852731654,42.71558557086945,NaN,NaN,NaN,NaN,NaN,NaN,0.03185380736562338,-0.30109785425936764,-0.332951661624991,72.32641509433962,57.62526844608061,15309738,47241766.385674894,23.016840557157625,25.78468489472641,25.34551979848134,0,64.28571428571429
2004-05-25,35.14999,36.08,34.94901,35.96001,34.761157702801704,35.707529279337905,35.65260951978975,35.282477420537326,35.36559940000001,36.37321990000005,35.68986000000002,35.12649999999998,35.12649999999998,35.99786132813233,34.25513867186763,146419680,56.668429122095546,43.54082404745769,NaN,NaN,NaN,NaN,NaN,NaN,0.10267757936087651,-0.20460468742389537,-0.3072822667847719,93.90913705583749,73.88746047282324,161729418,162593271.77192897,26.767952332058954,22.743280506904856,24.178977572248424,100,57.142857142857146
2004-05-26,35.86,36.19099,35.81,36.19,34.77537503909223,35.71708315499458,35.67368365626858,35.368908142390914,35.39454945000001,36.37151990000005,35.71466000000002,35.12599999999997,35.12599999999997,35.99490480731034,34.2570951926896,93840880,58.89096818777194,44.68287834067166,NaN,NaN,NaN,NaN,NaN,NaN,0.1591648774589579,-0.10832616996107447,-0.2674910474200324,99.9524264893151,88.72932621316409,255570298,255946461.95749736,26.864960987817465,21.81000967435916,22.73106228601051,100,50
2004-05-27,36.28999,36.5,36,36.42,34.79173946656395,35.73100230044024,35.70295096386589,35.469012128829874,35.422349450000006,36.36481990000005,35.73306000000002,35.16499999999998,35.16499999999998,36.18036178978957,34.149638210210384,110216816,61.04293122719492,46.14316147731978,NaN,NaN,NaN,NaN,NaN,NaN,0.20334306317997913,-0.013312218445058477,-0.2166552816250376,96.65271966527204,96.83809440347488,365787114,330893896.8374981,28.78008937571583,20.61445991259663,21.989851550347204,100,42.857142857142854
2004-05-28,36.38,36.55,36.21001,36.55,34.80923459624989,35.747220076669144,35.73616857312605,35.5719633546556,35.45074945000001,36.35691990000005,35.757260000000024,35.25399999999998,35.25399999999998,36.416633030739135,34.09136696926082,56403296,62.24592020566176,47.85251184439135,NaN,NaN,NaN,NaN,NaN,NaN,0.23064501587887798,0.07165098822355986,-0.15899402765531812,100,98.86838205152905,422190410,387297192.8374981,28.236950583138302,19.81890127413663,20.72107625390357,100,35.714285714285715
2004-06-01,36.25999,36.55,36.11,36.5,34.82605813260561,35.76212660980441,35.76612274672895,35.660347797069356,35.478749500000006,36.34512000000005,35.79226000000003,35.32399949999997,35.32399949999997,36.60379497590458,34.044204024095365,90659120,61.45981984648285,49.08645114634448,NaN,NaN,NaN,NaN,NaN,NaN,0.23392519305859896,0.13341246366793058,-0.10051272939066838,97.95081967213126,98.20117977913442,331531290,457351967.38295376,26.795709252295268,19.967463374701673,20.285769642762112,92.85714285714286,28.571428571428573
2004-06-02,36.56,36.66,36.17,36.42,34.84191825068913,35.77515380564987,35.79176499195527,35.732695625919895,35.50499950000001,36.32953000000005,35.83446000000002,35.38249949999998,35.38249949999998,36.7475400467028,34.01745895329716,103543808,60.150897504166124,50.17255099978643,NaN,NaN,NaN,NaN,NaN,NaN,0.21952934166632432,0.17389894769223702,-0.0456303939740873,90.58823529411784,96.17968498874968,227987482,459465106.3217304,26.544978919117597,18.815689711343918,19.255033239384087,100,21.428571428571427
2004-06-03,36.3,36.36099,35.82001,35.98,34.85324244719969,35.77921016593403,35.79914675697663,35.75624842345133,35.52504950000001,36.31203000000005,35.87346000000002,35.40499949999998,35.40499949999998,36.79365380692542,34.01634519307454,97710688,53.413102748364075,50.937330301937926,NaN,NaN,53.413102748364075,NaN,NaN,NaN,0.17133444157445946,0.168537657993987,-0.002796783580472438,73.33333333333331,87.2907960998608,130276794,419548543.6983411,24.66859670559322,21.609020260737292,17.687149721881077,92.85714285714286,14.285714285714286
2004-06-04,36.35001,36.62,36.17,36.19,34.866543517376805,35.787344618093755,35.81447433513441,35.79755809740835,35.54414950000001,36.29063000000005,35.908860000000026,35.45149999999998,35.45149999999998,36.87934845278599,34.02365154721397,91290192,55.94928207525207,52.04448203442155,NaN,NaN,NaN,NaN,NaN,NaN,0.1455723844869289,0.17916869702818872,0.0335963125412598,81.56862745098042,81.83006535947719,221566986,336373035.4316729,25.855341981732543,19.98613303443323,16.243952741330546,85.71428571428571,7.142857142857143
2004-06-07,36.44,37.10001,36.34,37.05,34.88826945252728,35.81234769496319,35.862926321991885,35.91683827860755,35.56794955000001,36.28163990000005,35.94300000000002,35.55549999999998,35.55549999999998,37.12398946573558,33.98701053426438,107680000,64.4778997618611,53.95548132837542,NaN,NaN,NaN,NaN,NaN,NaN,0.17637098097140716,0.25406003875551875,0.07768905778411159,98.03111011373969,84.31102363268445,329246986,429881967.15625525,28.629036763834954,17.924756175994208,14.989864895114092,100,0
2004-06-08,36.89999,37.19,36.85001,37.10201,34.910296721656366,35.83788556238966,35.91151783877652,36.02971177588302,35.5902596,36.27186000000005,35.98064020000002,35.67704999999998,35.67704999999998,37.32718203051243,34.02691796948753,72579312,64.92023890144108,55.61422814277394,NaN,NaN,NaN,NaN,64.92023890144108,NaN,0.1890401667030414,0.31398926616291334,0.12494909945987194,96.65437262357422,92.08470339609808,401826298,464893976.2186404,28.54294705722136,17.210543001192086,14.477026216129815,100,14.285714285714286
2004-06-09,36.98,37.05099,36.37,36.57899,34.92690063487372,35.85256089778788,35.937693217648025,36.082023987703685,35.61095455,36.25585000000005,35.99642020000002,35.746499499999985,35.746499499999985,37.42545703315586,34.06754196684411,98242368,57.20566571746157,56.74811142962081,NaN,NaN,NaN,NaN,NaN,NaN,0.1525541173450708,0.31564174614121043,0.16308762879613964,76.76768060836497,90.48438778189295,303583930,426951091.2898161,26.128973529739707,21.30082442577606,14.089141301146652,92.85714285714286,7.142857142857143
2004-06-10,36.69,36.84,36.55,36.84,34.94593644945209,35.87211414733664,35.973077797348104,36.15421217935096,35.63260460000001,36.23854990000005,36.01502020000002,35.825499999999984,35.825499999999984,37.55343068498771,34.09756931501226,57137008,59.774615037816645,57.912610601592085,NaN,NaN,NaN,NaN,NaN,NaN,0.1368584391967786,0.3341606777921129,0.1973022385953343,85.7258797955948,86.38264434251131,360720938,484088099.2898161,25.2190031127175,20.558999644041762,13.604193518491686,85.71428571428571,0
2004-06-14,36.61,36.61,36.10001,36.32001,34.95960882308938,35.880983372141856,35.986682981765824,36.170002447984196,35.65150470000001,36.21635010000006,36.024620400000025,35.89100099999998,35.89100099999998,37.58937658982689,34.19262541017307,85281184,52.95445879278852,58.42909340397676,NaN,NaN,NaN,NaN,NaN,NaN,0.08486303282255672,0.3033810296235302,0.21851799680097347,61.17831851101542,74.55729297165838,275439754,472384281.434252,23.01631386251338,24.074644764432236,12.832752396026402,78.57142857142857,0
2004-06-15,36.56,36.99001,36.56,36.78999,34.97782157111834,35.898983503386575,36.018185217775006,36.22904888150951,35.67145465000001,36.20045000000005,36.03722020000002,35.99300049999999,35.99300049999999,37.64954015848721,34.33646084151276,91983504,57.65695730968219,59.05794188843145,NaN,NaN,NaN,NaN,NaN,NaN,0.07582549779114284,0.31329986903990203,0.2374743712487592,82.15029964435382,76.351499316988,367423258,478795168.6575272,25.661241669854647,22.185247707879082,12.946556205038657,71.42857142857143,7.142857142857143
2004-06-16,36.75,36.89999,36.64999,36.73,34.99525618235099,35.91543927559674,36.0460995229603,36.27675851184194,35.68965465000001,36.18625010000006,36.02982000000002,36.108500499999984,36.108500499999984,37.626568409594995,34.59043259040497,65478608,56.8754745527161,59.072730847761484,NaN,NaN,NaN,NaN,NaN,NaN,0.06019261786446417,0.3127151435793394,0.2525225257148752,66.6666666666665,69.9984282740119,301944650,455228108.06616426,24.876717530552106,21.506992828900106,12.884847825612093,64.28571428571429,0
2004-06-17,36.64999,36.65601,36.25,36.39,35.0091342302878,35.92483651766413,36.05958581617754,36.287543415476044,35.70465465000001,36.170050200000055,36.00862000000002,36.19150049999999,36.19150049999999,37.57452972823079,34.808471271769186,77857376,52.52979106436577,58.618361053232476,NaN,NaN,NaN,NaN,NaN,NaN,0.023238629730950255,0.281570812878563,0.25833218314761275,41.60541317819835,63.47412649640621,224087274,431064151.6371107,23.39765386515883,25.182799828332463,12.40552664552373,57.142857142857146,0
2004-06-18,36.3,36.84,36.25999,36.44,35.02337170063319,35.93503777474009,36.07450401946469,36.30206309019261,35.71750465000001,36.14855020000006,35.99782000000002,36.27900049999999,36.27900049999999,37.48049727325432,35.077503726745654,78778192,53.097343859904136,58.05081909842598,NaN,NaN,NaN,NaN,NaN,NaN,-0.0003059034955277262,0.2579498037782031,0.2582557072737308,45.25507485456075,51.17571823314185,302865466,401184641.87334675,23.995447130557743,23.374327586848192,11.31836782770078,50,28.571428571428573
2004-06-21,36.52,36.63,36.06,36.14999,35.0345818329652,35.93929425444821,36.07746425399549,36.287579938745694,35.729004550000006,36.132650000000055,35.98201980000002,36.34399949999999,36.34399949999999,37.35475218396425,35.333246816035725,65453808,49.407518446095075,57.13379040131408,NaN,NaN,49.407518446095075,NaN,NaN,NaN,-0.03590935349206284,0.21336901540865227,0.2492783689007151,24.086307199322654,36.98226507736057,237411658,356398160.82745206,22.300535052446076,24.2015759998215,10.359143147243698,42.857142857142854,21.428571428571427
2004-06-22,36.16,36.7,36.015,36.67999,35.05095405353271,35.95396149693438,36.101092714623114,36.32495232553182,35.741604500000015,36.128449800000055,35.97681960000002,36.42704899999999,36.42704899999999,37.24282182288541,35.61127617711457,101630496,55.49440506071472,56.707689345187795,NaN,NaN,NaN,NaN,NaN,NaN,-0.024791740031853082,0.21828869386089877,0.24308043389275186,62.77272096876595,44.03803434088311,339042154,452091062.01004875,21.288602403722777,22.174489176027805,9.46174968111267,35.714285714285715,14.285714285714286
2004-06-23,36.57001,37.19,36.50999,37.12,35.07154157538811,35.97705136828222,36.14104986306926,36.400671151671645,35.75750450000001,36.12724970000005,35.975819600000015,36.520049499999985,36.520049499999985,37.19423033801192,35.84586866198805,95323312,59.816805959816,56.68382566344849,NaN,NaN,NaN,NaN,NaN,NaN,0.009340481020494507,0.25475603516837,0.24541555414787547,94.89047365309231,60.583167273726964,434365466,527789274.84974205,25.461072159309783,20.352076065683562,9.041191382506788,28.571428571428573,7.142857142857143
2004-06-24,37.02,37.35001,36.92,37.05,35.09122772886683,35.99829787584098,36.17669496647831,36.462511994369585,35.77025450000001,36.12704960000005,35.98421960000002,36.57454899999998,36.57454899999998,37.23491229283166,35.91418570716831,92382880,58.837796229039995,57.071303769211056,NaN,NaN,NaN,NaN,NaN,NaN,0.023539609246893245,0.274840065706492,0.25130045645959875,77.5275091572347,78.39690125969764,341982586,491264511.6377223,26.083826465739936,19.273380150845714,9.641461632218064,100,0
2004-06-25,37,37.39,36.98,37.33,35.11350406987313,36.02466821493324,36.22192261485171,36.54512989966772,35.78645450000001,36.130649600000055,35.994619600000014,36.631548999999985,36.631548999999985,37.34404414701473,35.91905385298524,81028368,61.54873142707953,57.47126443719873,NaN,NaN,NaN,NaN,NaN,NaN,0.04678325009872769,0.3097795190830084,0.2629962689842807,95.63636363636347,89.35144881556347,423010954,548577259.7352827,25.240965009493948,18.27860842950152,9.869672084938019,100,78.57142857142857
2004-06-28,37.49001,37.52,36.89999,37.021,35.13248412887937,36.044397557211795,36.25325898289674,36.590450861604126,35.80520950000001,36.131559700000054,36.01203980000002,36.66159899999998,36.66159899999998,37.386458396655684,35.93673960334428,94237872,57.08090302498251,56.94290752742169,NaN,NaN,NaN,NaN,NaN,NaN,0.03678211370225931,0.3089739111121048,0.2721917974098455,66.84385382059791,80.00257553806534,328773082,491125003.7437981,24.9096023526375,16.86132483690449,9.603550286857743,100,71.42857142857143
2004-06-29,37.10001,37.59,37.08,37.37,35.15474796839301,36.07064711053433,36.29705274827334,36.66469363668945,35.823859500000005,36.14195970000005,36.037639800000015,36.70259899999998,36.70259899999998,37.48782041649433,35.917377583505626,68362368,60.56294119385138,56.63167197687956,NaN,NaN,NaN,NaN,NaN,NaN,0.048376259995541626,0.3326621224042725,0.2842858624087309,86.03174603174568,82.83732116290234,397135450,500508073.8614441,24.01224138732037,15.66117305513135,9.337917432736457,100,64.28571428571429
2004-06-30,37.45,37.89999,37.35001,37.74001,35.18047196870751,36.10370380141484,36.35363930716458,36.7671047189095,35.84345950000001,36.15465980000005,36.06184000000002,36.76459949999998,36.76459949999998,37.663616446750346,35.86558255324962,97879376,63.906328794240856,57.11029076807808,NaN,NaN,NaN,NaN,63.906328794240856,NaN,0.07412867663627398,0.3769467082040734,0.3028180315677994,91.51295232335427,81.46285072523261,495014826,541444497.1268709,26.24385472486434,14.58086623375453,10.65140865542706,100,57.142857142857146
2004-07-01,37.66,37.66,36.77,37.03999,35.198974635685545,36.1222441221789,36.3805550206091,36.79309379329907,35.86120940000001,36.15374970000005,36.08904000000001,36.79559899999999,36.79559899999999,37.687678490269114,35.90351950973086,122182816,54.4937139677215,56.733083548785565,NaN,NaN,NaN,NaN,NaN,NaN,0.03894946954179368,0.3515048684950415,0.3125553989532478,54.376415790004266,77.30703804836806,372832010,493392329.42314106,23.2037100090211,19.818479652735522,10.486337159066997,92.85714285714286,50
2004-07-02,37.03999,37.19,36.63,36.82001,35.2151043408031,36.13606126827437,36.39778854921266,36.795657241556306,35.87330950000001,36.15074980000005,36.105640000000015,36.83759949999999,36.83759949999999,37.64743187931157,36.02776712068841,74089872,51.90642481672765,56.65822397906693,NaN,NaN,NaN,NaN,NaN,NaN,-0.0020300890821522977,0.3100177876005574,0.3120478766827097,42.70632735452188,62.86523182262678,298742138,469580373.77571315,21.64481452223369,20.166589876527663,10.578339983312366,85.71428571428571,42.857142857142854
2004-07-06,36.60001,36.60001,35.83,36.03,35.22321275532247,36.133961045140225,36.38336546885138,36.72273750426523,35.88215955000001,36.139249900000046,36.087840000000014,36.829599499999986,36.829599499999986,37.66753675933552,35.99166224066445,130381184,43.85376239742972,55.672281485334615,NaN,NaN,NaN,NaN,NaN,NaN,-0.08087033541702732,0.2109599574114256,0.2918302928284529,9.661882424552893,35.58154185635966,168360954,406928795.36525196,19.1902400379169,27.043389521497037,11.272690460457754,78.57142857142857,100
2004-07-07,35.96001,36.28999,35.92,36.09599,35.23189710601578,36.13320914325626,36.37209584262192,36.66304726576378,35.88873950000001,36.124409800000045,36.06555960000001,36.78189899999998,36.78189899999998,37.671257647228884,35.89254035277108,96161632,44.62653251393757,54.79735705399329,NaN,NaN,NaN,NaN,NaN,NaN,-0.12449575125478052,0.1362106037599773,0.2607063550147578,12.849820530534043,21.73934343653626,264522586,402247936.4438747,18.352604415320044,25.862971435313092,11.967040937603143,71.42857142857143,92.85714285714286
2004-07-08,35.81,36.13,35.55,35.7,35.23655484625443,36.1246307443799,36.345739142911256,36.57132847854818,35.89433950000001,36.109009700000044,36.040759600000015,36.71179849999998,36.71179849999998,37.704224498135794,35.719372501864164,108939504,40.98144699074254,53.97247533444877,NaN,NaN,NaN,NaN,NaN,NaN,-0.17296101050625046,0.044505091881944736,0.2174661023881952,6.383005885131653,9.63156961340618,155583082,349656451.75422114,17.09304986343457,28.466148038992493,13.487664067164047,64.28571428571429,100
2004-07-09,35.84,36.03999,35.63,35.75,35.24166375325687,36.11721231379812,36.3223768235814,36.49310671868645,35.903489500000006,36.09710970000005,36.01835960000002,36.67034899999998,36.67034899999998,37.7471594610193,35.59353853898066,86044880,41.62974787976023,53.15336133586707,NaN,NaN,NaN,NaN,NaN,NaN,-0.1930629078556773,-0.023862532431401462,0.16920037542427585,8.51067451350867,9.247833643058106,241627962,313980534.89966255,16.244354758302947,27.0527618559728,15.177101684425065,57.142857142857146,92.85714285714286
2004-07-12,35.57001,35.69,34.71001,35.60001,35.245229387552826,36.10697068382192,36.29404871285272,36.408049888335356,35.90888955000001,36.07870980000005,36.00635980000001,36.60834949999998,36.60834949999998,37.77775697371639,35.43894202628357,81863808,40.203075284474075,52.49590111003699,NaN,NaN,NaN,NaN,NaN,NaN,-0.20665628994595492,-0.08911998700816781,0.11753630293778711,27.89986144113753,14.264513946592617,159764154,380809650.54174054,14.304200310497336,34.38714340466444,17.831196892545538,50,100
2004-07-13,35.69,35.81,35.41,35.55,35.24826193096026,36.095941561370005,36.26487033195654,36.32633085135104,35.920539550000015,36.058709800000045,36.00455980000002,36.56984899999998,36.56984899999998,37.822437314236375,35.31726068576358,81627872,39.71436954027962,51.36875571572019,NaN,NaN,NaN,NaN,NaN,NaN,-0.20860617169597684,-0.14322141168218394,0.0653847600137929,26.332140013416975,20.914225322687724,78136282,356321288.94174,15.044082236015663,32.766173057270635,20.333289779013175,42.857142857142854,92.85714285714286
2004-07-14,35.2,35.64999,35.05,35.19,35.24768221025419,36.078002124511194,36.22271855423275,36.21810886550808,35.93253960000001,36.04080980000005,36.01295980000002,36.48984949999998,36.48984949999998,37.87349759310168,35.10620140689827,119867680,36.2941417660561,49.68856541616592,NaN,NaN,NaN,NaN,NaN,NaN,-0.22246329892629485,-0.21269436364407568,0.009768935282219178,15.04680280127148,23.092934751941996,-41731398,292392791.9281228,13.979590886334718,34.69325888766638,22.57651212141916,35.714285714285715,85.71428571428571
2004-07-15,35.32001,35.49001,35.06,35.07001,35.245914327565096,36.05804188442186,36.17751429720401,36.10876611641207,35.94498965000001,36.02290990000005,36.01235980000002,36.40684999999998,36.40684999999998,37.91634685861375,34.897353141386205,90553504,35.20584007360506,48.00056854792057,NaN,NaN,NaN,NaN,NaN,NaN,-0.22723332708392988,-0.27427272357269317,-0.04703939648876329,11.285337212145716,17.554760008944722,-132284902,206055192.55843428,13.255660135090475,32.896674339959034,24.543782730225214,28.571428571428573,78.57142857142857
2004-07-16,35.44,35.45,34.619,34.67,35.240183836743554,36.03055590651252,36.11839608947052,35.971740771991875,35.95263965000001,36.00510990000005,36.00075980000002,36.32084999999997,36.32084999999997,38.00971635533031,34.63198364466963,120434128,31.784198484527337,45.87453048059541,NaN,NaN,NaN,NaN,NaN,NaN,-0.24340999633626564,-0.35130189190909533,-0.10789189557282969,1.554408882684857,9.295516298700685,-252719030,100403592.90500517,11.96604439623056,34.85915846423145,26.893237224133486,21.428571428571427,100
2004-07-19,34.78,34.97,34.47,34.60001,35.233813947820735,36.0022282647994,36.058851536942264,35.841099746087885,35.96353970000001,35.98751000000005,35.98216000000002,36.22885049999997,36.22885049999997,38.074882095283535,34.38281890471641,106431632,31.21258900005762,44.02679376452935,NaN,NaN,31.21258900005762,NaN,NaN,NaN,-0.244272233478987,-0.4132321874215634,-0.16895995394257643,3.7903900594461932,5.543378718092256,-359150662,49320666.810284585,11.256444009406865,34.559144467596795,29.14997249409792,14.285714285714286,100
2004-07-20,34.74001,35.58701,34.71001,35.42999,35.23576594833993,35.99089681401129,36.03419030019943,35.80194643693666,35.97493970000001,35.97600990000005,35.98556000000002,36.19285049999998,36.19285049999998,38.0714245535797,34.31427644642025,120053872,44.06027241452993,42.84803170886353,NaN,NaN,NaN,NaN,44.06027241452993,NaN,-0.17749975263217205,-0.3908346447327915,-0.21333489210061946,27.988128245271756,11.11097572913427,-239096790,126385122.6610479,16.994789734234537,30.690181899799313,29.69790320926139,7.142857142857143,92.85714285714286
2004-07-21,35.59,35.64999,34.34,34.39999,35.227449769749484,35.959393708783345,35.970104013917094,35.66842677627603,35.98063970000001,35.95330980000005,35.974159800000024,36.07885049999997,36.07885049999997,38.09688549741334,34.06081550258661,136156320,35.25908642640846,40.80180011116123,NaN,NaN,NaN,NaN,NaN,NaN,-0.19013048514084924,-0.450997998526681,-0.26086751338583175,1.8069277108433501,11.195148671853767,-375253110,2699153.7886135876,14.650461761676551,30.35291892270735,30.149566183737985,0,100
2004-07-22,34.48,35.11,34.25,34.87,35.223893055622625,35.93782155613417,35.926962680037995,35.59238613091641,35.98403970000001,35.936309700000045,35.97813960000003,35.966350499999976,35.966350499999976,37.990530754024824,33.94217024597513,132842496,41.04618029037812,39.841261991350976,NaN,NaN,NaN,NaN,NaN,NaN,-0.15570700987727337,-0.4555012757324235,-0.2997942658551501,21.08843537414959,16.9611637767549,-242410614,61397000.85838037,13.348631200803524,28.585701636913385,32.18292201631111,0,100
2004-07-23,34.64,34.66,34.03,34.21001,35.21380466700946,35.90360746591369,35.859631202389444,35.46073126130532,35.982889750000005,35.90790980000005,35.958539800000025,35.82435099999998,35.82435099999998,37.921667716998236,33.72703428300172,107145184,36.15845777597018,38.71640720272545,NaN,NaN,NaN,NaN,NaN,NaN,-0.16535447657110297,-0.5064873615690288,-0.3411328849979259,7.004252901739528,9.966538662244156,-349555798,15481037.7213635,12.207596545072876,28.380958903253305,34.77661074401882,0,100
2004-07-26,34.24001,34.41,33.7,34.06,35.202324023556635,35.867100387380745,35.78905742974672,35.327328284038146,35.979939800000004,35.88230980000005,35.93454000000003,35.66085099999998,35.66085099999998,37.77295883801384,33.54874316198612,113051312,35.13437842891045,38.093594062116935,NaN,NaN,NaN,NaN,NaN,NaN,-0.16919641124842977,-0.5526283990584631,-0.3834319878100333,13.899667566284016,13.997451947391044,-462607110,17073309.721364327,11.32631536372481,29.687469260737654,36.76107186946524,0,100
2004-07-27,34.19,34.71001,34.03999,34.53,35.19563423227746,35.84062315198707,35.739682628580184,35.2513922569869,35.98043985000001,35.86340980000005,35.92494020000003,35.53630099999998,35.53630099999998,37.60625569655701,33.466346303442954,103529376,40.792386889151786,37.81972651748937,NaN,NaN,NaN,NaN,NaN,NaN,-0.12924492777563146,-0.5449881475295726,-0.41574321975394113,34.15637860082298,18.353433022948842,-359077734,64973531.44608975,13.612682413621888,27.65827545689636,37.978703062449846,0,92.85714285714286
2004-07-28,34.41,34.62601,33.81,34.38,35.18751846877222,35.81169992125465,35.68636174118488,35.16840251822624,35.97888985000001,35.83960990000005,35.917540200000026,35.38680099999998,35.38680099999998,37.333651647019465,33.43995035298049,155066192,39.605040184549665,37.721411745618454,NaN,NaN,NaN,NaN,NaN,NaN,-0.10321127723916074,-0.544757316302892,-0.4415460390637313,29.059953247663437,25.705333138256815,-514143926,126541276.38313758,12.492728741294389,27.70158618253133,38.8983450808885,0,85.71428571428571
2004-07-29,34.71001,34.92,34.5,34.78,35.18346355863518,35.79127021984367,35.65081814349136,35.13141180220469,35.9777399,35.82110990000005,35.92474020000002,35.23880049999998,35.23880049999998,36.872426473404325,33.60517452659564,99079184,44.263986950111715,37.90957167921499,NaN,NaN,NaN,NaN,NaN,NaN,-0.05193082725560838,-0.5064595731332417,-0.45452874587763337,51.18483412322268,38.133721990569704,-415064742,159567671.04980424,14.816131984645672,26.167327205896385,39.09360753737282,0,78.57142857142857
2004-07-30,34.75999,35.10001,34.64999,34.89,35.18054352322588,35.77342328479726,35.620982137864246,35.10842020199472,35.97598985000001,35.81230990000005,35.92794020000002,35.13130099999997,35.13130099999997,36.544801932352684,33.71780006764726,83039808,45.508874733493414,38.28855735414494,NaN,NaN,NaN,NaN,NaN,NaN,-0.005903140062751722,-0.461907670956073,-0.45600453089332127,56.39810426540275,45.54763054542963,-332024934,165103412.21686375,16.00868808040531,24.928222281216865,37.70382764835343,7.142857142857143,71.42857142857143
2004-08-02,34.61,35.02,34.46001,34.96001,35.17834915981069,35.7573160910389,35.59506166186957,35.09428589704284,35.97413990000001,35.80531000000005,35.93334040000003,35.038300999999976,35.038300999999976,36.221055999887895,33.85554600011206,81363008,46.33050026987763,38.7611381205448,NaN,NaN,NaN,NaN,46.33050026987763,NaN,0.03188075583024447,-0.41615358610551567,-0.44803434193576014,64.61622880117305,57.39972239659949,-250661926,229034084.46115223,15.053437021642871,25.465103261281406,36.89157789790737,0,64.28571428571429
2004-08-03,34.84,34.92999,34.188,34.23,35.168912849762826,35.727072208048035,35.541529831992335,35.01197295446733,35.96938995000001,35.79571000000005,35.920940200000025,34.94830099999997,34.94830099999997,36.088689578407156,33.80791242159279,85839184,39.62183461233777,38.99883046670778,NaN,NaN,NaN,NaN,NaN,NaN,0.011388838688867975,-0.43379829357467514,-0.4451871322635431,27.179626562187195,49.397986542921,-336501110,152912674.90015966,13.828369313737788,26.260108374049086,36.066851398648915,0,57.142857142857146
2004-08-04,34.14999,34.461,34.00999,34.24001,35.15967003533733,35.69762543165105,35.49048983858087,34.93845267308949,35.96328995000001,35.78941010000005,35.90536040000003,34.85550199999998,34.85550199999998,35.90570993757583,33.80529406242413,86875312,39.75066294401989,39.3234606717374,NaN,NaN,NaN,NaN,NaN,NaN,0.002645381196750063,-0.44188040576760557,-0.44452578696435563,27.692962528012725,39.82960596379099,-249625798,154652068.85452792,13.154837906131316,26.903476515434953,35.47861110069928,28.571428571428573,50
2004-08-05,34.35001,34.39999,33.59801,33.60001,35.14415103001059,35.65608849241043,35.416353374322796,34.81098194231907,35.95824000000002,35.77031030000005,35.87216080000003,34.750502499999975,34.750502499999975,35.860211376309124,33.640793623690826,109939184,34.658811587260885,39.52879017907552,NaN,NaN,NaN,NaN,NaN,NaN,-0.03976417192006343,-0.4942310018644349,-0.4544668299443715,0.09746683690851463,18.32335197570281,-359564982,45261223.63604239,12.032544505679546,28.990846973600377,34.93915018861701,21.428571428571427,100
2004-08-06,33.39999,33.41,32,32.72,35.12003012423934,35.59794812622409,35.310614026310134,34.61184080495535,35.94664005000001,35.74861030000005,35.807360600000024,34.599002499999976,34.599002499999976,35.92732242387369,33.27068257612626,148859808,29.13286316805113,39.3802383339322,NaN,NaN,29.13286316805113,NaN,NaN,NaN,-0.11627804960253452,-0.5998143919475396,-0.4835363423450051,19.72608144131897,15.838836935413397,-508424790,48428453.59348932,10.16862562030883,39.971260376038096,35.55179509018586,14.285714285714286,100
2004-08-09,32.81,32.96001,32.64999,32.8,35.09694524738124,35.542543212833515,35.21215857429797,34.43928453781675,35.93439005000002,35.72711030000005,35.739560600000026,34.45900199999998,34.45900199999998,35.91945126517443,32.99855273482552,78649008,30.22204023784346,38.39179317845459,NaN,NaN,NaN,NaN,NaN,NaN,-0.14862625667362273,-0.6693191631870334,-0.5206929065134107,21.91786826813215,13.913805515453207,-429775782,45891552.49033334,9.850229633292564,38.71969606686586,37.74596746356725,7.142857142857143,92.85714285714286
2004-08-10,32.97,33.48199,32.92,33.21001,35.07816977228292,35.49635443634176,35.133642943933346,34.32221077231039,35.92759005000001,35.70421040000005,35.67536080000003,34.34200249999997,34.34200249999997,35.80900536303758,32.874999636962364,106347120,35.678360505276174,38.42174132694514,NaN,NaN,NaN,NaN,NaN,NaN,-0.13019731402975465,-0.683439549050604,-0.5532422350208493,38.90707395498383,26.850341221478313,-323428662,49303425.60835824,14.455409434072692,36.04586619125109,38.307436880597486,0,85.71428571428571
2004-08-11,32.85001,33.03999,32.55,32.92,35.05669544619055,35.44533751681024,35.046833416720276,34.18866688923321,35.92134005000001,35.68001040000005,35.60276080000003,34.228502499999976,34.228502499999976,35.765111321450625,32.69189367854933,121295680,33.67267684237693,37.895062509230776,NaN,NaN,NaN,NaN,NaN,NaN,-0.12528520829794487,-0.7098487453932805,-0.5845635370953356,29.677323621536782,30.167421948217584,-444724342,111192715.09753153,13.484885421750542,37.389581938531926,39.06829834449949,0,78.57142857142857
2004-08-12,32.69,32.85699,32.37,32.47,35.03095718304438,35.38641994221994,34.9457811258685,34.02498432835386,35.91269005000001,35.65721040000005,35.52216080000002,34.098501999999975,34.098501999999975,35.762955479118254,32.434048520881696,114044000,30.78115374655026,37.510969364272206,NaN,NaN,NaN,NaN,NaN,NaN,-0.13902733247918408,-0.7583477026943157,-0.6193203702151316,15.161241415350249,27.915212997290283,-558768342,43984995.10328123,12.718564235071634,37.12463149841372,39.71962655360174,35.714285714285715,71.42857142857143
2004-08-13,32.64999,32.74001,32.35001,32.52,35.00597253445687,35.329659151284886,34.85065245426581,33.881652487558256,35.90424000000001,35.63931040000005,35.44416080000003,33.99100199999997,33.99100199999997,35.767850925527846,32.2141530744721,91431184,31.485158921870976,37.2503108280551,NaN,NaN,NaN,NaN,NaN,NaN,-0.13151547839817956,-0.7837147182128561,-0.6521992398146765,16.77413943825999,20.53756815838234,-467337158,32258359.657950424,12.189584452701625,35.793756510994044,40.03563946086508,28.571428571428573,64.28571428571429
2004-08-16,32.61,33.19,32.586,32.88699,34.98488813112895,35.28128946512083,34.77364608351029,33.78692272683842,35.89187495000001,35.627880300000044,35.38230060000003,33.905350999999975,33.905350999999975,35.721235930099375,32.089466069900574,77887120,36.58343250317586,36.949671229056825,NaN,NaN,NaN,NaN,NaN,NaN,-0.09054651467238384,-0.7653823831551563,-0.6748358684827724,28.61248834681172,20.182623066807317,-389450038,31997876.24338067,16.117403580402737,33.23629848027523,40.08231873589041,21.428571428571427,57.142857142857146
2004-08-17,33.12,33.44,32.98779,33.25999,34.967724965645075,35.24126373313824,34.71428702141185,33.73673865761571,35.88157485000001,35.61628020000005,35.32370040000003,33.796850999999975,33.796850999999975,35.49058723311366,32.10311476688629,89590000,41.35955059770815,37.07499340142528,NaN,NaN,NaN,NaN,NaN,NaN,-0.030165025587508332,-0.7125421504671579,-0.6823771248796495,40.64470759771752,28.677111794263073,-299860038,50262182.87083433,17.854573007854608,31.251506231474647,39.32826793250592,14.285714285714286,50
2004-08-18,33.06,33.91,33.00999,33.85001,34.95660342369836,35.21371415426422,34.680393804885895,33.74752640450945,35.87387490000001,35.60135030000006,35.25970060000003,33.76935199999998,33.76935199999998,35.44073690257311,32.097967097426846,107996368,48.02744859198508,37.34381209013053,NaN,NaN,NaN,NaN,NaN,NaN,0.05313702247259966,-0.6159558467888999,-0.6690928692614996,59.677549427259876,42.97824845726304,-191863670,143861595.0229661,21.110790031367394,28.290483088109635,38.38801087045537,7.142857142857143,42.857142857142854
2004-08-19,33.73,33.85001,33.41,33.672,34.94382130007947,35.18318516111047,34.64084894979233,33.740333413603786,35.86633495000001,35.58587030000005,35.191100400000025,33.70945199999997,33.70945199999997,35.30280874942887,32.11609525057107,106839008,46.31629946136621,37.401485284978584,NaN,NaN,NaN,NaN,NaN,NaN,0.0973034114793353,-0.5474636049123305,-0.6447670163916658,55.364238410595874,51.895498478524416,-298702678,164255241.2626424,20.107714902958925,26.946266224876258,37.86979144815526,0,35.714285714285715
2004-08-20,33.57001,34.14101,33.50999,34.00999,34.934529446347334,35.15995357376175,34.616109383133804,33.76601499326057,35.85758495000001,35.56807030000005,35.13972040000002,33.69945099999997,33.69945099999997,35.28259300454759,32.11630899545234,92054880,49.96169822102261,37.660856567203226,NaN,NaN,NaN,NaN,NaN,NaN,0.14733319285459534,-0.46060052532342155,-0.6079337181780169,68.60057542858523,61.21412108881366,-206647798,218083027.42219374,21.885782198441824,25.104060175702347,36.52356469930995,0,28.571428571428573
2004-08-23,34.05,34.27,33.91,34.09,34.92612616827422,35.13876637428132,34.595477642618754,33.79687070818814,35.85043495000001,35.54987030000005,35.08472040000002,33.70095099999997,33.70095099999997,35.28551283046387,32.11638916953606,83583872,50.81318209274082,38.46023853008916,NaN,NaN,NaN,NaN,NaN,NaN,0.1816159081030373,-0.38091383304922033,-0.5625297411522576,84.92482730597337,69.62988038171817,-123063926,218083027.42219537,22.447898296724095,24.092111397789033,34.56086103532441,0,21.428571428571427
2004-08-24,34.25,34.31,33.81,34.08,34.91770700242075,35.11780070350347,34.57526283310429,33.82383540264641,35.841634950000014,35.53227030000006,35.039920200000026,33.678450999999974,33.678450999999974,35.22767092453034,32.12923107546961,86881184,50.69706474899015,39.242124373301316,NaN,NaN,NaN,NaN,NaN,NaN,0.19807334347981131,-0.3149380618024935,-0.5130114052823048,86.66702777928225,80.06414350461363,-209945110,225033522.142194,21.171410844939405,23.859415722606535,32.535696360350514,0,14.285714285714286
2004-08-25,34.06,34.60001,33.89999,34.55,34.91404822627726,35.10655712521627,34.57427213376687,33.8929939357277,35.83468995000001,35.516170300000056,34.995120400000026,33.68695099999998,33.68695099999998,35.253245578474925,32.120656421525034,88421184,55.808490721902004,40.75281574006139,NaN,NaN,NaN,NaN,55.808490721902004,NaN,0.23267654222558365,-0.22216572750032526,-0.4548422697259089,98.076545859439,89.88946698156487,-121523926,300820943.0730244,22.77106226230969,21.975327050631158,29.709995916264457,100,7.142857142857143
2004-08-26,34.46001,34.55,34.31,34.39999,34.90893321905062,35.092565696994164,34.567437540285816,33.941279275182204,35.82853990000001,35.48917010000005,34.948520200000026,33.667950499999975,33.667950499999975,35.18932104341951,32.14657995658044,57789200,53.888187063860265,42.52105316119063,NaN,NaN,NaN,NaN,NaN,NaN,0.23674129040290987,-0.1589156567222716,-0.39565694712518146,91.11022222222245,91.95126528698124,-179313126,286368827.30635875,22.12595917887579,21.35276710693916,25.591377832345362,92.85714285714286,0
2004-08-27,34.46001,34.67999,34.44,34.56,34.90546124672176,35.082019841608144,34.56714587203931,34.00020505849818,35.82538990000001,35.46027010000006,34.911920200000026,33.651450499999974,33.651450499999974,35.12588218589937,32.17701881410058,58623104,55.64149473328781,44.33672848229379,NaN,NaN,NaN,NaN,NaN,NaN,0.24069721942398614,-0.09478542284519875,-0.3354826422691849,94.8501703877289,94.67897948979679,-120690022,286371270.03747505,22.961133028762173,20.61885860241392,21.72964066213652,100,28.571428571428573
2004-08-30,34.41,34.42999,33.944,33.98,34.89625267710264,35.0601976665268,34.54412054372404,33.99828076721264,35.8199899,35.43027010000005,34.86272020000002,33.602449999999976,33.602449999999976,34.96019370267885,32.2447062973211,62423200,48.45020039636616,45.24900276022879,NaN,NaN,48.45020039636616,NaN,NaN,NaN,0.196603259317141,-0.08972856812275865,-0.28633182743989966,69.95725285195581,85.30588182063572,-183113222,233196141.8084978,21.232156020483092,25.129385062344795,19.276345535406797,92.85714285714286,21.428571428571427
2004-08-31,34.02,34.121,33.64999,34.02,34.88753374499216,35.03959969293221,34.52356679691133,34.00034926557334,35.811039900000004,35.401070100000055,34.82012040000002,33.59194999999998,33.59194999999998,34.93326754710138,32.250632452898586,81401184,48.94032108719455,46.33954877771576,NaN,NaN,NaN,NaN,NaN,NaN,0.16382289080679394,-0.08155321393140724,-0.24537610473820118,71.67400578545765,78.82714300838079,-101712038,279687155.81635356,19.992510984623905,27.30667635813816,17.024631751066096,85.71428571428571,14.285714285714286
2004-09-01,33.92999,34.47,33.8,34.27,34.88138913061413,35.02436009505236,34.51362300095403,34.02603028789969,35.803539900000004,35.37437010000006,34.77192060000002,33.59344949999998,33.59344949999998,34.937725429987225,32.24917357001273,96703008,52.011319321124446,47.85598917589964,NaN,NaN,NaN,NaN,NaN,NaN,0.15288038730833098,-0.054275620602787455,-0.20715600791111843,82.40371161984251,74.67832341908532,-5009030,318657024.71187735,22.627593526356716,25.06487015630628,13.892110815383047,78.57142857142857,7.142857142857143
2004-09-02,34.17999,34.88,34.16,34.78,34.880380283543346,35.019521281288945,34.52406915777936,34.097836927147334,35.80223995,35.35047010000005,34.725120600000025,33.652448999999976,33.652448999999976,35.09283985727472,32.21205814272523,83288624,57.61221018403041,49.72220712319673,NaN,NaN,NaN,NaN,NaN,NaN,0.1724432059099869,0.008397999476365214,-0.1640452064336217,95.64080209241494,83.23950649923836,78279594,378809919.82298833,25.60515505816984,22.890072901294428,10.778269891544273,100,0
2004-09-03,34.44,34.67,34.05,34.14101,34.87302336529913,35.00212501829312,34.509047230023306,34.1019486483714,35.79954505,35.325580200000054,34.66694080000003,33.72349949999998,33.72349949999998,35.112160462993366,32.3348385370066,90264816,49.7738049766959,50.66437658559102,NaN,NaN,NaN,NaN,NaN,NaN,0.13638176364277235,0.00643199811984374,-0.1299497655229286,60.94566670718372,79.66339347314705,-11985222,315045106.7396345,23.38928024267952,22.213191954963467,8.484902729205597,92.85714285714286,0
2004-09-07,34.39999,34.61,34.12,34.42999,34.8686150731071,34.990795611990286,34.50594694649298,34.13319068185984,35.802295,35.30178010000006,34.608940600000025,33.80499899999998,33.80499899999998,35.15816790895396,32.451830091046,96621808,52.895119202892126,51.4883457716756,NaN,NaN,NaN,NaN,NaN,NaN,0.12625654854265786,0.02787092015539372,-0.09838562838726414,75.93542280522533,77.50729720160798,84636586,340675520.21685815,22.012259928477,20.905412654023316,6.720430058509106,85.71428571428571,0
2004-09-08,34.31,34.67999,34.17999,34.299,34.86294726143439,34.97709668898058,34.49783137996385,34.14898204549223,35.80273995,35.283270200000054,34.554500600000026,33.859448499999985,33.859448499999985,35.200049902182066,32.518847097817904,101706816,51.337723895308166,51.724794007627246,NaN,NaN,NaN,NaN,NaN,NaN,0.10582917018262614,0.03390083434101854,-0.0719283358416076,60.476190476190425,65.78575999619981,-17070230,287385216.90549934,21.525270408622237,19.635087388608273,6.0103460876097525,78.57142857142857,0
2004-09-09,34.45,34.75,34.13,34.59,34.86023136828579,34.96943140801067,34.50144583565154,34.19098375544535,35.806279950000004,35.26827020000005,34.49890060000003,33.942948499999986,33.942948499999986,35.24661698605504,32.63928001394493,104577008,54.53995487228538,52.31219796555005,NaN,NaN,NaN,NaN,NaN,NaN,0.10670464227415193,0.06145246700108231,-0.045252175273069614,78.83227129728988,71.7479615262352,87506778,337986994.9700164,20.757209354060564,18.161379546834244,5.448666085641764,71.42857142857143,0
2004-09-10,34.62,35.19,34.47,35.12,34.86281613079041,34.972412964287685,34.52570286170442,34.279461493021984,35.81072,35.254170200000054,34.446500400000026,34.07544849999998,34.07544849999998,35.28891506795076,32.8619819320492,108640192,59.73676093159883,53.0104167305912,NaN,NaN,NaN,NaN,NaN,NaN,0.13589565481877852,0.12461739325040355,-0.011278261568374977,95.45457497029237,78.25434558125755,196146970,425502705.1922385,24.219996693461432,16.60294300358613,6.292228819251171,100,0
2004-09-13,35.25,35.72,35.14,35.58,34.86995228869299,34.98444439073744,34.56704784751993,34.403322303210366,35.81272005,35.25317030000006,34.417300600000026,34.22844849999998,34.22844849999998,35.389360274225226,33.06753672577473,109452816,63.62357129513402,53.92544453076215,NaN,NaN,NaN,NaN,NaN,NaN,0.17652708828935326,0.2093805987933166,0.03285351050396334,93.23674764856204,89.17453130538144,305599786,482116230.7094795,28.8042922822193,15.415782853128388,8.20252106848587,100,42.857142857142854
2004-09-14,35.45,35.73,35.36,35.63,34.87751495248709,34.99722767012877,34.608732245656405,34.52014875052367,35.814970100000004,35.24957020000006,34.39350040000003,34.365598999999975,34.365598999999975,35.50815851657724,33.22303948342271,76928624,64.03003476136325,54.87779953164594,NaN,NaN,NaN,NaN,64.03003476136325,NaN,0.19563160596853102,0.2773930179646271,0.0817614119960961,95.19233080610215,94.62788447498552,382528410,517461814.7094816,27.62103713989163,14.716944022703851,9.953200239869476,100,35.714285714285715
2004-09-15,35.42,35.45,35.10001,35.25301,34.88125122161657,35.002292666759885,34.63399803994439,34.5899450599976,35.814535150000005,35.232900300000054,34.37796060000003,34.46524999999998,34.46524999999998,35.55095086401504,33.379549135984924,90500000,58.703891340716915,55.084613861561294,NaN,NaN,NaN,NaN,NaN,NaN,0.17254659121414448,0.2974446510137767,0.12489805979963223,77.06789871202567,88.49899238889661,292028410,506086932.5699937,25.815747914222676,16.961294304615194,11.304682805066108,92.85714285714286,28.571428571428573
2004-09-16,35.25999,35.57001,35.13,35.32001,34.88561698060546,35.00858409910127,34.66090046975049,34.65947505428355,35.814235200000006,35.21400030000006,34.36244100000003,34.53874999999998,34.53874999999998,35.646701373537894,33.430798626462064,67154320,59.35104609866139,55.4748180783328,NaN,NaN,NaN,NaN,NaN,NaN,0.15216928547151382,0.3151096666390245,0.1629403811675107,80.28903707193741,84.18308886335507,359182730,496931259.61528826,25.89627968266784,16.024853293079893,12.859632149519545,85.71428571428571,21.428571428571427
2004-09-17,35.23,35.52,35.16,35.42999,34.89103362756461,35.016928770406196,34.691060843485765,34.73285743006607,35.8118852,35.198900200000054,34.35704080000003,34.626649499999985,34.626649499999985,35.72449356576771,33.52880543423226,84071184,60.446778430772376,55.818052628153126,NaN,NaN,NaN,NaN,NaN,NaN,0.1369533899279461,0.3341321185774433,0.1971787286494972,85.57651165138624,80.9778158117831,443253914,538962180.9939526,24.69497105955203,15.281472595889362,14.157700580262736,78.57142857142857,14.285714285714286
2004-09-20,35.28999,35.77,35.17999,35.433,34.89642632778785,35.02516780465558,34.7201564966824,34.79953767482168,35.8105502,35.184530200000054,34.350700800000034,34.69779999999999,34.69779999999999,35.81090307524649,33.58469692475348,111328816,60.478178421512155,56.67719391566356,NaN,NaN,NaN,NaN,NaN,NaN,0.11863148871444767,0.3454680895425568,0.22683660082810914,84.10384856675189,83.32313243002518,554582730,523114132.2221693,26.032780958247148,14.124970750920365,15.675301570095327,100,7.142857142857143
2004-09-21,35.543,35.85001,35.42,35.57001,34.90312865288449,35.03595675901884,34.753484085047795,34.87291599150533,35.81215025,35.17823030000005,34.350100800000035,34.77180049999999,34.77180049999999,35.90993935310224,33.63366164689774,93737008,61.9585645537668,57.60706844899015,NaN,NaN,NaN,NaN,NaN,NaN,0.10760444944959208,0.3613421626400992,0.25373771319050714,86.34153004131717,85.34063008648509,648319738,494777875.69343877,25.61639708289286,13.332993586655789,16.823388251667254,100,0
2004-09-22,35.44,35.46001,34.87,34.95,34.903595034447825,35.03425464497886,34.76119059151651,34.88025732564768,35.80875025,35.17133030000006,34.33810080000003,34.815300499999985,34.815300499999985,35.91002625330125,33.72057474669872,101516192,52.394269679212314,57.63442204599642,NaN,NaN,NaN,NaN,NaN,NaN,0.05317124377907845,0.3202017679143552,0.2670305241352767,49.99972222376573,73.48170027727826,546803546,420791031.87398,23.32376612547126,19.17163989789649,17.156271316118353,92.85714285714286,0
2004-09-23,34.98,35.14999,34.877,34.91901,34.90374841718964,35.03197257280106,34.76737958792763,34.88394805653838,35.80814535,35.17282040000006,34.33268100000003,34.833750999999985,34.833750999999985,35.92239100117489,33.74511099882508,92599184,51.9625028872756,57.23087152479966,NaN,NaN,NaN,NaN,NaN,NaN,0.011854064832410582,0.28184810517578995,0.26999404034337937,48.278065121860585,61.53977246231449,454204362,356691732.26417583,22.47884292382333,18.477130988990826,17.45427892477294,85.71428571428571,7.142857142857143
2004-09-24,34.99001,35.19,34.75,34.799,34.90270614438178,35.027359254527774,34.76861960408733,34.875857765439484,35.80596535,35.16981030000006,34.32726080000003,34.853701499999985,34.853701499999985,35.92428861356589,33.78311438643408,103282000,50.236024092316406,57.26388717591541,NaN,NaN,NaN,NaN,NaN,NaN,-0.02478439411426231,0.2390135477005515,0.2637979418148138,39.24832804434668,45.84203846332432,350922362,276413450.4459939,21.149003831971243,19.091592370377043,17.635262827012877,78.57142857142857,0
2004-09-27,34.62,34.74001,34.38,34.5,34.89869911806952,35.016916497012375,34.75808550196626,34.84006178777858,35.8063154,35.16231030000006,34.32386080000003,34.850701499999985,34.850701499999985,35.924894035690706,33.776508964309265,86108880,46.124165726685405,56.780247641900644,NaN,NaN,46.124165726685405,NaN,NaN,NaN,-0.06793590844581474,0.17887805625754538,0.24681396470336012,21.51150284009968,36.34596533543564,264813482,247708895.88139796,19.939294685114096,23.05058187278585,17.967995276768747,71.42857142857143,0
2004-09-28,34.55,34.69,34.23,34.57001,34.89542857958127,35.00806686340817,34.75070999208523,34.814342569894904,35.80636545,35.15271040000005,34.323260800000035,34.88020199999998,34.88020199999998,35.88744666191078,33.872957338089186,87265184,47.21364293824135,56.48567043068159,NaN,NaN,NaN,NaN,NaN,NaN,-0.08920341022527215,0.13530970192176994,0.2245131121470421,25.581828012627962,28.780552965691438,352078666,289448212.8024437,18.676275868064046,23.656023426738436,18.480225924992904,64.28571428571429,7.142857142857143
2004-09-29,34.56,35.12,34.53,35.08,34.89726511112772,35.00949128195454,34.76362332572894,34.83964327752396,35.80526545,35.15091050000006,34.31626100000003,34.93320199999998,34.93320199999998,35.86234147335622,34.00406252664374,95886128,54.44107296703914,56.47860743744972,NaN,NaN,NaN,NaN,NaN,NaN,-0.06735775097229058,0.14031592343167887,0.20767367440396944,52.468811920914135,33.18738092454726,447964794,372332831.921088,23.03733487760324,21.75278273466724,18.208657317179174,57.142857142857146,0
2004-09-30,35.05,35.27,34.89,35.14,34.899680383653816,35.012075613004946,34.7783831953082,34.86824867966454,35.8047654,35.15261050000006,34.33106120000003,34.97670199999998,34.97670199999998,35.85779045466731,34.095613545332654,74676816,55.217929192383494,56.155833741791476,NaN,NaN,NaN,NaN,NaN,NaN,-0.048198571782966326,0.14742545967526155,0.19562403145822788,56.17249276239056,44.741044231977554,522641610,395914984.34213996,23.906075535546538,20.603042825747313,17.40596205970227,50,85.71428571428571
2004-10-01,35.45,36.14999,35.36,36.10001,34.91162396192592,35.03361886819297,34.83021169745298,34.98555928160125,35.81136545,35.16690050000006,34.35566140000003,35.042702499999976,35.042702499999976,36.04446017437059,34.04094482562936,118325680,65.38762120869333,56.281837307045706,NaN,NaN,NaN,NaN,NaN,NaN,0.025818807823278223,0.22789754123732564,0.20207873341404742,97.39686144198642,68.67938870843038,640967290,499268531.8179294,32.2139686785906,17.895654610703993,17.28431826049099,100,78.57142857142857
2004-10-04,36.36,36.62,36.25,36.313,34.92556800210576,35.05895314803073,34.88836025833718,35.11198220716303,35.8186804,35.17813050000006,34.39772120000003,35.15130199999998,35.15130199999998,36.2079307462245,34.09467325377546,108512624,67.16899845212822,56.506048999243205,NaN,NaN,NaN,NaN,NaN,NaN,0.08260821381330782,0.3053390006806822,0.22273078686737438,87.15481171548139,80.24138863995279,749479914,427708855.45036346,36.1646358630303,16.680345347524803,17.740881918588933,100,71.42857142857143
2004-10-05,36.23,36.49001,36.16,36.36,34.93984095730869,35.08471645203012,34.946071620755326,35.230841044576074,35.8259304,35.189130600000055,34.443721200000034,35.247802499999985,35.247802499999985,36.37356752526837,34.1220374747316,89827184,67.56568954512392,57.13903458527228,NaN,NaN,NaN,NaN,NaN,NaN,0.1148410903536663,0.3662821498094573,0.251441059455791,89.12133891213398,91.22433735653392,839307098,446759807.26443076,34.560518074841575,17.150144149117814,18.667292587551714,92.85714285714286,64.28571428571429
2004-10-06,36.31,36.95,36.11,36.64999,34.95685736569368,35.11571196783151,35.012891949353154,35.365998087949784,35.831380349999996,35.20553060000006,34.48612100000003,35.36535199999998,35.36535199999998,36.559192890800425,34.171511109199535,88007808,69.97617330382275,57.8979722427838,NaN,NaN,NaN,NaN,69.97617330382275,NaN,0.14523801737962733,0.4329885811803251,0.2877505638006978,88.9702205882353,88.41545707195023,927314906,471902799.840431,36.750353334219824,15.290954764564077,19.93070000474586,100,57.142857142857146
2004-10-07,36.53999,36.67,36.17,36.24001,34.96962505359723,35.13797529520118,35.06101422584911,35.44923731766885,35.83528035,35.22043070000006,34.52332120000003,35.44785249999998,35.44785249999998,36.644013827396286,34.25169117260368,82456128,62.86306494874372,58.0705641369246,NaN,NaN,NaN,NaN,NaN,NaN,0.1278892727122879,0.44761215469105764,0.31972288197876975,73.89742647058812,83.9963286569858,844858778,412537685.92554975,34.36245700757153,14.297407454115534,21.194107421940004,92.85714285714286,50
2004-10-08,36.08,36.24001,35.5,35.58,34.9756984361485,35.14672825965264,35.08136660914914,35.461690906462294,35.835330299999995,35.23203070000005,34.539321200000025,35.470852499999985,35.470852499999985,36.658573452563104,34.28313154743687,115122624,53.44449917501397,57.56815847646045,NaN,NaN,NaN,NaN,NaN,NaN,0.06527609987168709,0.4013180068183786,0.3360419069466915,49.632352941176414,70.83333333333327,729736154,322306103.72228175,31.137728589230534,21.4522931610352,20.391556503922082,85.71428571428571,42.857142857142854
2004-10-11,35.69,35.86,35.60001,35.75,34.98340292932115,35.158674234709025,35.10758752643741,35.48914891537065,35.834880299999995,35.24223070000006,34.55652120000003,35.47935249999998,35.47935249999998,36.672497122901,34.28620787709897,51312096,55.302128897107785,57.09269878669909,NaN,NaN,NaN,NaN,NaN,NaN,0.03039486806313102,0.37403549202560527,0.34364062396247425,55.882352941176464,59.804044117647,781048250,330198602.3531527,29.99088715717484,20.662178412004042,19.454416365858176,78.57142857142857,35.714285714285715
2004-10-12,35.42999,35.84,35.2,35.69,34.99043374594482,35.169195536992014,35.13042723128301,35.50827759009725,35.83383034999999,35.25223070000006,34.571121000000026,35.482352499999976,35.482352499999976,36.677297532694055,34.2874074673059,98308192,54.47593898972813,57.241389451735934,NaN,NaN,NaN,NaN,NaN,NaN,-0.000023327284227270262,0.3436114648571902,0.34363479214141746,53.676470588235205,53.06372549019603,682740058,382424829.35315096,27.49788653360718,24.140088554322226,19.22097421720437,71.42857142857143,28.571428571428573
2004-10-13,36.06,36.14,35.42999,35.61,34.99659858429363,35.1779243382397,35.14923400652681,35.51796543865942,35.8326303,35.25983060000006,34.598721000000026,35.50020199999998,35.50020199999998,36.69157028602584,34.30883371397412,132823120,53.331880179321104,57.33920211545347,NaN,NaN,NaN,NaN,NaN,NaN,-0.02732590588605771,0.3094774097838453,0.336803315669903,50.735294117647044,53.43137254901958,549916938,316951436.3462926,28.83086032151594,21.959267193524635,19.489447253130532,64.28571428571429,21.428571428571427
2004-10-14,35.69,35.78,35.33,35.45,35.00111004116633,35.18331197510624,35.161028751368896,35.51149253973947,35.82768029999999,35.26414060000006,34.62292080000003,35.50670149999998,35.50670149999998,36.69548223492779,34.31792076507217,99445632,51.023900609655094,57.39547900954909,NaN,NaN,51.023900609655094,NaN,NaN,NaN,-0.05628756182406869,0.2664438633898172,0.32273142521388587,44.85294117647071,49.75490196078433,450471306,270543474.74629426,27.156358957239707,21.974410600113433,19.87762445688068,57.142857142857146,14.285714285714286
2004-10-15,35.49001,35.856,35.28,35.63,35.00736765269701,35.192157282529884,35.17941978072698,35.52277896452619,35.82303029999999,35.26784070000006,34.66352060000003,35.51670199999998,35.51670199999998,36.70609813624232,34.327305863757644,129195008,53.463806779445164,57.91973908474622,NaN,NaN,NaN,NaN,NaN,NaN,-0.06294458099638789,0.24405069896840104,0.3069952799647889,51.470588235294215,49.01960784313733,579666314,298356288.968517,26.121409521251277,20.345521966257113,20.24854215536919,50,7.142857142857143
2004-10-18,35.50999,36.25,35.39999,36.14,35.01863762630202,35.21092644525206,35.21708959324749,35.5815619202856,35.82143024999999,35.26964060000006,34.731920600000024,35.55205199999998,35.55205199999998,36.771053047295496,34.33305095270447,109313312,59.60433888224696,58.80478879503233,NaN,NaN,NaN,NaN,NaN,NaN,-0.03406922151908215,0.26440875306593625,0.2984779745850184,66.52892561983464,54.28415167719985,688979626,379377076.5982156,28.253530053756165,18.201330654229494,20.953911298875617,42.857142857142854,0
2004-10-19,36.38,36.57001,35.78999,35.88,35.02720839618956,35.2241754265342,35.243086079786806,35.609984594544116,35.81903025,35.266540600000056,34.79352060000003,35.56755149999998,35.56755149999998,36.79492597239837,34.34017702760159,130141504,55.5780380642147,58.886000587687725,NaN,NaN,NaN,NaN,NaN,NaN,-0.033498500031083234,0.25660484954616436,0.2901033495772476,48.05825242718451,55.35258876077112,558838122,279270794.1952001,29.45829782911602,16.48446633723445,22.76613856359057,35.714285714285715,0
2004-10-20,35.83,36.23,35.64999,36.048,35.037365526575734,35.24048878442461,35.27465133155987,35.651700347444674,35.81382024999999,35.26282060000006,34.85028040000003,35.62245149999998,35.62245149999998,36.832527628470736,34.41237537152923,106851808,57.57237127300064,59.054175022017525,NaN,NaN,NaN,NaN,NaN,NaN,-0.023308185474715692,0.260968117733853,0.28427630320856867,48.4571428571428,54.348106968053976,665689930,319065037.47735155,27.389441031441645,17.021940076304055,23.903511329433424,28.571428571428573,0
2004-10-21,36.24001,36.78999,36.10001,36.60001,35.05291422780383,35.26740999661423,35.32662618130262,35.74201555244994,35.810120299999994,35.26332070000006,34.923880600000025,35.70650149999999,35.70650149999999,36.94269920348138,34.47030379651859,124414320,63.388567544901356,58.91138547460381,NaN,NaN,NaN,NaN,63.388567544901356,NaN,0.016937055678757695,0.30544762280701576,0.28851056712825807,80.00057142857112,58.83865557096615,790104250,374966552.7189513,31.631166646550696,15.52028645122124,24.303110149918275,21.428571428571427,50
2004-10-22,36.61,36.64999,35.74001,35.8,35.06034791707942,35.27795633331493,35.34518986046722,35.747537880788045,35.80072034999999,35.25632070000006,34.990480600000026,35.756551499999986,35.756551499999986,36.92068265734125,34.59242034265872,114377632,52.21654973105316,57.84335342309845,NaN,NaN,NaN,NaN,NaN,NaN,-0.012410940291433081,0.2729968917639667,0.28540783205539977,34.28571428571396,54.24780952380928,675726618,275669503.02555114,28.330283770914335,18.029096848954218,23.256655241122946,14.285714285714286,42.857142857142854
2004-10-25,35.73,35.81,35.49001,35.625,35.0659663457652,35.284828485130475,35.35616280711557,35.73586760642728,35.78895034999999,35.24837070000006,35.05258060000003,35.812801499999985,35.812801499999985,36.82779998595607,34.7978030140439,102980000,50.134989754883804,56.598303438081295,NaN,NaN,50.134989754883804,NaN,NaN,NaN,-0.043925193495580495,0.23050134018592416,0.27442653368150466,24.285714285714125,46.190666666666395,572746618,259575156.95223644,27.25326639901852,20.313823741065757,21.893792345375342,7.142857142857143,35.714285714285715
2004-10-26,35.64999,35.84,35.41,35.82001,35.07346926769788,35.29542613889027,35.37435289311104,35.74388116771992,35.77940039999999,35.24677080000006,35.11124100000003,35.875301499999985,35.875301499999985,36.715361721944085,35.035241278055885,98245184,52.41158344727697,55.34368987689946,NaN,NaN,NaN,NaN,NaN,NaN,-0.05143189734849779,0.21013666199588243,0.2615685593443802,38.994584871602996,32.522004481010356,670991802,348685823.61195755,25.832089768427092,20.224816756418665,19.818031294768186,0,28.571428571428573
2004-10-27,35.84,36.89999,35.71001,36.73,35.08995216055661,35.323833542080564,35.427515524753744,35.83779724698469,35.77140039999999,35.25217080000006,35.180641200000025,35.95780149999999,35.95780149999999,36.793311635481786,35.12229136451819,152572880,61.29235645343416,55.23149641294877,NaN,NaN,NaN,NaN,NaN,NaN,0.002247956422635089,0.2643785048726741,0.262130548450039,90.00052941487857,51.09360952406522,823564682,457668283.82137156,34.33894582309638,17.504415321664332,19.192073751955743,100,21.428571428571427
2004-10-28,36.67999,37.12,36.57001,36.96001,35.108559701247586,35.356233075900754,35.48761334731242,35.94467465203377,35.7664554,35.25127090000006,35.24284120000002,36.04880199999999,36.04880199999999,36.904417181787785,35.19318681821219,111151184,63.16356375829711,55.92571531175471,NaN,NaN,NaN,NaN,NaN,NaN,0.04806451390534727,0.3222111908317231,0.27414667692637584,91.66718749999995,73.55410059549384,934715866,504152554.1387219,34.694328981867635,16.40603712344573,20.43293771046563,100,14.285714285714286
2004-10-29,36.91,37.24001,36.67,36.89999,35.1263848783496,35.38680251994232,35.54300066702566,36.03565706612579,35.76055535,35.249250700000054,35.30740100000002,36.08880099999999,36.08880099999999,37.021569679639555,35.156032320360424,100828496,62.316988473957245,56.426776710101095,NaN,NaN,NaN,NaN,NaN,NaN,0.06793214417365512,0.35906185714344474,0.2911297129697896,83.33243464492838,88.33338385326897,833887370,484689458.0265843,33.80155218793702,15.332239925108338,21.80243540748788,100,7.142857142857143
2004-11-01,36.98,37.17999,36.8,37.03799,35.14540582483368,35.419499301725644,35.60162769969132,36.131117345542386,35.75484534999999,35.25384070000006,35.36796100000002,36.12505049999999,36.12505049999999,37.142370615764015,35.10773038423597,72528496,63.527401110219394,57.07330971870761,NaN,NaN,NaN,NaN,NaN,NaN,0.08297633826119438,0.3948501357962826,0.3118737975350882,89.69290973005252,88.23084395832696,906415866,503011019.99147964,32.28454505237009,14.644131957719964,24.022954117566417,92.85714285714286,0
2004-11-02,37.09,37.55,37.00999,37.161,35.16546148826817,35.45398446406771,35.662779554605386,36.229201407871685,35.747800299999994,35.25705070000006,35.42938100000002,36.165100499999994,36.165100499999994,37.27511051244935,35.055090487550636,109171680,64.61836837078984,57.879487446669664,NaN,NaN,NaN,NaN,NaN,NaN,0.09306290784279325,0.4282024323385798,0.33513952449578654,82.86343612334818,85.29626016610969,1015587546,454897525.56878406,34.613377884612916,13.70293828383318,26.1478704330375,100,14.285714285714286
2004-11-03,37.77,37.89999,37.14999,37.41,35.18779520480282,35.49271744497726,35.731298003444394,36.34165841664581,35.742150349999996,35.267950600000056,35.49598100000002,36.20310099999999,36.20310099999999,37.4234605631273,34.98274143687268,141197632,66.78424047118864,59.00522600820778,NaN,NaN,NaN,NaN,NaN,NaN,0.10734165805720342,0.4693165970672908,0.36197493901008737,81.29802022145101,84.61812202495058,1156785178,411600683.6923018,35.67032903066043,12.501196675598738,28.830005877097175,100,7.142857142857143
2004-11-04,37.25999,37.78,37.11,37.62,35.2119962475411,35.53484185200741,35.80536474840736,36.46340523410811,35.73835034999999,35.276250700000055,35.55738100000002,36.272100499999986,36.272100499999986,37.64012164007795,34.90407935992202,112608496,68.53370519049304,60.08164732328263,NaN,NaN,NaN,NaN,NaN,NaN,0.12076592795488789,0.5129323489536972,0.39216642099880933,88.8003999999998,84.32061878159966,1269393674,470426017.423644,32.894934989471295,11.992920666679524,31.26821029625477,92.85714285714286,0
2004-11-05,38.02,38.16,37.61,37.96001,35.23933966796358,35.58286498365083,35.88986064062667,36.60593902133591,35.737400449999996,35.28855080000006,35.62858140000002,36.391100999999985,36.391100999999985,37.90399373886731,34.87820826113266,117078368,71.18041207269545,60.90850969402895,NaN,NaN,NaN,NaN,NaN,NaN,0.1409725882281715,0.5683821562840237,0.4274095680558522,92.72763636363638,87.6086855283624,1386472042,502360738.8188437,35.22442181726355,11.221084808871293,33.414067839612585,100,0
2004-11-08,37.95,38.10001,37.85001,38,35.26680892499876,35.63072904338051,35.972611203739355,36.73870673358963,35.73735049999999,35.30465080000006,35.69738140000002,36.50360099999999,36.50360099999999,38.1387549803078,34.86844701969218,66505680,71.48421362543264,62.0446650912588,NaN,NaN,NaN,NaN,NaN,NaN,0.14490317232773425,0.60853853346552,0.46363536113778575,94.1818181818183,91.90328484848483,1452977722,515656554.36444503,34.14861309076264,10.87837539490799,35.0884625488684,92.85714285714286,35.714285714285715
2004-11-09,37.92999,38.14999,37.81,37.92,35.293208836192804,35.67606114153139,36.048979391828006,36.85121085420014,35.73400049999999,35.319450800000055,35.77618140000002,36.61510099999999,36.61510099999999,38.315938278317915,34.91426372168206,85250192,69.89682616731953,62.924983297995865,NaN,NaN,NaN,NaN,NaN,NaN,0.13043843436600233,0.6266834040952887,0.49624496972928633,91.27272727272747,92.72739393939405,1367727530,485569873.76183873,33.31593566614712,10.412615757239633,37.1621682309944,85.71428571428571,28.571428571428573
2004-11-10,37.92999,38.06,37.64,37.78999,35.318052429862526,35.71792111892681,36.117254317638675,36.94061839189536,35.73425039999999,35.33585080000006,35.85158120000002,36.72410049999999,36.72410049999999,38.4327113719478,35.01548962805218,95167008,67.28199811331356,63.203085481453876,NaN,NaN,NaN,NaN,NaN,NaN,0.10171331343423429,0.6233866115220792,0.5216732980878449,86.54509090909114,90.66654545454564,1272560522,458374768.2852682,31.520543459299354,12.032738580781881,37.91762398821643,78.57142857142857,21.428571428571427
2004-11-11,37.91,38.38,37.86,38.28999,35.34762394797335,35.76885317597777,36.20245963851559,37.06912997361962,35.7402003,35.351950800000054,35.93198100000002,36.866099999999996,36.866099999999996,38.599429526707986,35.132770473292005,99805808,71.67125451974073,64.59270725207442,NaN,NaN,NaN,NaN,NaN,NaN,0.10552982019759938,0.6535855733348441,0.5480557531372447,96.9693602693603,91.59572615039296,1372366330,523628573.2926532,33.23289605172789,11.125692909948308,39.89028074720536,100,14.285714285714286
2004-11-12,38.34,38.75999,38.17,38.66,35.38058291366515,35.82610360813662,36.29883377033851,37.220641404703464,35.747300249999995,35.367350800000054,36.00958100000002,37.017599999999995,37.017599999999995,38.82055564231576,35.21464435768423,102697504,74.4074429334708,66.32645390768776,NaN,NaN,NaN,NaN,NaN,NaN,0.12100653924678961,0.6993139271957318,0.5783073879489422,97.01521497079081,93.50988871641408,1475063834,591516255.3466523,35.5734584223146,10.290350016901506,42.78583388378808,100,7.142857142857143
2004-11-15,38.64,38.86,38.5,38.83,35.41490547173814,35.8855867050052,36.39809519110955,37.37391365187456,35.7561002,35.385150800000055,36.10336080000002,37.1521,37.1521,39.07074807824619,35.233451921753804,82736368,75.57473128203817,67.98096446731357,NaN,NaN,NaN,NaN,NaN,NaN,0.12994036895403605,0.7407328491414873,0.6107924801874512,99.04761602417781,97.67739708810966,1557800202,660463228.679985,35.20705107757912,9.806517497677602,45.946830520772565,100,0
2004-11-16,38.66,38.67999,38.32001,38.593,35.44652830286512,35.939198849460546,36.48416988949741,37.49001711360079,35.764215199999995,35.397780800000056,36.18662100000002,37.287749999999996,37.287749999999996,39.21107983082928,35.364420169170714,97452624,70.73122614183194,68.65516944505627,NaN,NaN,NaN,NaN,NaN,NaN,0.10803496670401203,0.7458361885674663,0.6378012218634542,88.34056043912871,94.80113047803245,1460347578,710816548.4866438,32.85063225489896,11.512325543247645,47.06307809867205,92.85714285714286,0
2004-11-17,38.83,39.32001,38.83,39.11,35.48298075756298,36.00198699105539,36.58714361932104,37.64430119801977,35.77511525,35.41867080000006,36.28284100000002,37.44085,37.44085,39.43136807280337,35.45033192719662,125450128,74.56128312619585,69.46929225704903,NaN,NaN,NaN,NaN,NaN,NaN,0.1158207336774475,0.7825771389602636,0.6667564052828161,92.07512424481402,93.15443356937352,1585797706,728735069.4529905,37.99250485832492,10.439641488384439,48.570267685871904,100,0
2004-11-18,38.98,39.36,38.88699,39.28999,35.52086144654245,36.06709596152954,36.69313759503394,37.801033464875026,35.789915199999996,35.437870700000055,36.37684080000002,37.575348999999996,37.575348999999996,39.68064319344502,35.47005480655497,94980192,75.75098285926828,70.42886328457125,NaN,NaN,NaN,NaN,75.75098285926828,NaN,0.12003703777313779,0.8168027024992384,0.6967656647261006,97.26523437500015,92.56030635298096,1680777898,795599309.3931203,36.18224851427029,9.799843978382599,49.983521430538474,100,0
2004-11-19,39.24001,39.28999,38.59,38.67999,35.55229556150223,36.11883643753885,36.771053375620845,37.884743611077404,35.800965149999996,35.44727050000005,36.44804060000002,37.71934849999999,37.71934849999999,39.710075440183026,35.72862155981695,118558368,64.70626478984974,70.51306783311627,NaN,NaN,64.70626478984974,NaN,NaN,NaN,0.07110614113183289,0.7856483411408917,0.7145422000090588,71.063527389245,86.80129533635306,1562219530,707524426.9752549,32.962761039932744,12.703066849841486,50.46746942554205,92.85714285714286,0
2004-11-22,38.61,39.07001,38.48,39.05,35.58709859074101,36.17687928035986,36.86042383147885,37.995720410022415,35.81056014999999,35.46737060000005,36.517440600000015,37.890598499999996,37.890598499999996,39.7133862153876,36.06781078461239,79973120,67.7754399139142,70.73857294333945,NaN,NaN,NaN,NaN,NaN,NaN,0.05380853059638546,0.7818028632545406,0.7279943326581552,86.22222222222211,84.85032799548908,1642192650,782073021.5224643,30.49936517778815,13.14703022744845,50.21592741905761,85.71428571428571,0
2004-11-23,39.00999,39.14999,38.61,38.99001,35.62095840575851,36.232584839164616,36.94393701455811,38.090414656686946,35.8199102,35.489070600000055,36.58464080000002,38.0490985,38.0490985,39.663514752819594,36.434682247180405,91926496,66.76175754828478,70.73696702027489,NaN,NaN,NaN,NaN,NaN,NaN,0.029680584313542258,0.765095063050083,0.7354144787365408,83.55599999999994,80.28058320382235,1550266154,819530357.611798,29.423091816200863,12.24507863045347,49.72511248453537,78.57142857142857,7.142857142857143
2004-11-24,39.09,39.39,39.07001,39.33,35.65786429226837,36.29391979284453,37.037508112026416,38.20847040366914,35.830660249999994,35.522070600000056,36.66618060000002,38.179098499999995,38.179098499999995,39.76619566065799,36.592001339342,74091008,69.54211863693526,70.80899655216362,NaN,NaN,NaN,NaN,NaN,NaN,0.02799448384188552,0.7704075835388977,0.7424130996970122,96.62921348314595,88.80247856845601,1624357162,865836369.330663,31.00986145341778,11.609711008412313,49.65042537079183,100,0
2004-11-26,39.37,39.48,39.17,39.21001,35.693209025678634,36.35166415338226,37.122704264495965,38.30385512712922,35.8388103,35.55321080000006,36.74398060000002,38.29159849999999,38.29159849999999,39.835480861894744,36.74771613810524,31303200,67.39931570973152,70.53891824052333,NaN,NaN,NaN,NaN,NaN,NaN,0.011044231632523549,0.7562183892376666,0.745174157605143,85.32663043478259,88.50394797264282,1593053962,842613434.0532428,30.9277719343351,11.127796586785859,49.321844224140015,100,0
2004-11-29,39.46001,39.64,38.97,39.203,35.72813231895547,36.408126249354886,37.204284489417695,38.38948797216453,35.84862525,35.58824080000005,36.819440800000024,38.40674899999999,38.40674899999999,39.85910911104559,36.95438888895439,94786880,67.26890707952606,70.23782491581572,NaN,NaN,NaN,NaN,NaN,NaN,-0.007399787320276685,0.7359244234547972,0.7433242107750739,78.15000000000012,86.70194797264288,1498267082,813752951.1875721,28.202934456058948,12.77734945808092,48.31904671859242,100,14.285714285714286
2004-11-30,39.3,39.39,39.06,39.12199,35.76190204712506,36.46186612560528,37.27948862708759,38.45925007005362,35.859535199999996,35.62196070000005,36.89322060000002,38.51094899999999,38.51094899999999,39.85017752036384,37.171720479636136,87703872,65.68716146647611,69.93713458004119,NaN,NaN,NaN,NaN,NaN,NaN,-0.03051884588837961,0.7051756534145994,0.735694499302979,74.09949999999981,79.19204347826084,1410563210,758999158.1286602,26.943792997587867,12.206894973739619,47.26657214835962,92.85714285714286,7.142857142857143
2004-12-01,39.27,39.961,39.27,39.92,35.80327615610889,36.530344024108146,37.383038092692,38.59836911100089,35.871935199999996,35.66516060000006,36.98022040000002,38.648898999999986,38.648898999999986,39.97178399249055,37.32601400750942,102435008,72.5375591759103,70.31253179879809,NaN,NaN,NaN,NaN,NaN,NaN,0.0008103720079027932,0.7367074643128575,0.7358970923049547,98.04854831032857,83.43268277010951,1512998218,849278347.5237406,31.422027769610462,10.87724585208391,47.53980884055691,100,0
2004-12-02,39.82001,40.39,39.75999,40.07001,35.845731219232185,36.60043641967036,37.48840954003741,38.738525386143664,35.88453525,35.71036070000005,37.08262060000002,38.78189949999999,38.78189949999999,40.11464303113359,37.449155968866386,122306128,73.60437075211378,70.45061152968188,NaN,NaN,NaN,NaN,NaN,NaN,0.023268692226876664,0.7649829575885505,0.7417142653616738,85.58603603603616,85.91136144878818,1635304346,847342835.2363809,34.390756757440656,9.996697175498733,47.90549628862972,100,0
2004-12-03,40.31,40.59,40.08,40.13,35.88836075933933,36.670328767795695,37.59200132278104,38.871046777939505,35.900285249999996,35.75976070000006,37.186840400000015,38.90739949999998,38.90739949999998,40.251526436632375,37.56327256336759,114276496,74.03869929147638,70.42427269811085,NaN,NaN,NaN,NaN,NaN,NaN,0.03319170322984499,0.7832038943989801,0.7500121911691351,79.73559354887023,87.79005929841166,1749580842,755473495.314814,34.66406104095266,9.325660500198937,48.082227587524905,100,0
2004-12-06,40.12,40.42599,39.91,40.27,35.93195915974391,36.741609386255185,37.69702087875041,39.00428041813574,35.917335249999994,35.81176060000005,37.29626040000002,39.02289899999998,39.02289899999998,40.41758295536722,37.62821504463274,70505184,75.0696743442001,70.38819720255098,NaN,NaN,NaN,NaN,75.0696743442001,NaN,0.039768045308146704,0.7997222478043184,0.7599542024961717,85.90302159921409,83.74155039470683,1820086026,783349544.4394883,32.34392515938532,10.906642804364171,47.591992177825965,92.85714285714286,7.142857142857143
2004-12-07,40.33,40.5,39.53,39.58,35.9682580735773,36.797815140982806,37.77086319723078,39.059110854503764,35.932985249999994,35.86086060000005,37.39786040000002,39.10189899999998,39.10189899999998,40.433434642541755,37.77036335745821,121669504,62.00113407057221,69.76461919746102,NaN,NaN,62.00113407057221,NaN,NaN,NaN,-0.009157282966586688,0.7485075987879384,0.7576648817545251,52.13270142180085,72.59043885662841,1698416522,674223288.2745391,28.48422537337668,14.280023321698676,46.52883182418337,85.71428571428571,0
2004-12-08,39.66,39.98,38.81,39.81,36.00648436140241,36.85746236591384,37.850829346358985,39.130624106455784,35.95023525,35.912960500000054,37.502660200000015,39.19639899999998,39.19639899999998,40.444666008039476,37.94813199196048,96436624,64.2360997202151,69.02710609703385,NaN,NaN,NaN,NaN,NaN,NaN,-0.03157211440667673,0.7181997387461792,0.7497718531528559,63.0331753554503,67.02296612548842,1794853146,742635594.1890697,24.66145425583189,20.6224177630856,43.10238555329988,78.57142857142857,21.428571428571427
2004-12-09,39.5,40.19,39.24001,40.05,36.046718347856114,36.92068093292545,37.93707133277628,39.21818371536476,35.96758525,35.959160600000054,37.60206020000001,39.309399499999984,39.309399499999984,40.43065939393251,38.18813960606746,134422560,66.45336314828265,68.36299040339202,NaN,NaN,NaN,NaN,NaN,NaN,-0.03548552164834151,0.705414951092429,0.7409004727407705,74.40758293838842,63.19115323854654,1929275706,837438456.2975128,24.393009218639524,18.45650391840708,39.99373719091034,71.42857142857143,14.285714285714286
2004-12-10,39.85001,40.07001,39.74001,39.92999,36.08535786678292,36.98027121148138,38.01522500600073,39.28597479009193,35.9838852,36.014460600000056,37.69786000000001,39.391399499999984,39.391399499999984,40.43997716414378,38.34282183585619,86252368,64.30643394860944,68.33443105758914,NaN,NaN,NaN,NaN,NaN,NaN,-0.05049156582956127,0.6777860154538189,0.7282775812833802,68.71990521326991,68.72022116903621,1843023338,850496542.0710862,23.47084163932391,17.758763455616574,37.81439457818378,64.28571428571429,7.142857142857143
2004-12-13,40.22,40.34,39.98,40.28,36.12709559945175,37.04561237561046,38.104039711647765,39.38064385770222,36.00243515,36.068560600000055,37.781459800000015,39.47239949999998,39.47239949999998,40.5326844813816,38.41211451861836,74339248,67.59468319634126,68.32151986347678,NaN,NaN,NaN,NaN,NaN,NaN,-0.041552959472614726,0.6763363819426118,0.7178893414152265,84.34343434343425,75.82364083169753,1917362586,900056040.7377523,25.5112984875899,16.90371294368082,36.42418719892239,57.142857142857146,0
2004-12-14,40.25999,40.59,40.25,40.47701,36.170378329805466,37.11356084342015,38.19709737001452,39.4850596807782,36.0195702,36.13123060000006,37.86474000000001,39.554749999999984,39.554749999999984,40.65765110624814,38.45184889375183,92019744,69.30857852521504,68.50343564754324,NaN,NaN,NaN,NaN,69.30857852521504,NaN,-0.02774428152305597,0.6832089895114066,0.7109532710344626,93.65224719101104,82.23852891590508,2009382330,930915132.534457,27.49086372427526,16.206850859135606,35.32398337321467,50,0
2004-12-15,40.49001,40.67999,40.155,40.33,36.21176760015566,37.17725270790688,38.280740610406106,39.565530187370754,36.0381202,36.19393060000006,37.94414000000002,39.64159999999998,39.64159999999998,40.70057547665877,38.582624523341195,95230000,66.4829092514311,68.2849206914358,NaN,NaN,NaN,NaN,NaN,NaN,-0.03349832864095126,0.6690803602332736,0.7025786888742248,81.28385713292587,86.42651288912373,1914152330,899173008.4939985,25.727206595611268,16.328021133647194,33.66900329778547,100,64.28571428571429
2004-12-16,40.32001,40.45,39.82001,39.95,36.24896394244267,37.232158594879024,38.3462017629392,39.60214636000211,36.0557702,36.24813060000006,38.010140200000016,39.683599999999984,39.683599999999984,40.72132610074292,38.64587389925705,86265056,59.706812108364105,67.73545614848098,NaN,NaN,NaN,NaN,NaN,NaN,-0.06600480420602728,0.6200726836166908,0.686077487822718,60.9628928496946,78.63299905787717,1827887274,848507230.6712393,23.757532332198913,19.148937585155966,31.073325947328925,92.85714285714286,57.142857142857146
2004-12-17,39.64999,39.81,37.21001,39.47501,36.28106390321439,37.27657149399033,38.39046875262786,39.59003813524,36.0693453,36.299080700000054,38.07484020000002,39.69285099999998,39.69285099999998,40.71961744245843,38.66608455754154,102214000,52.503336877912155,66.68077256265141,NaN,NaN,NaN,NaN,NaN,NaN,-0.11948674206346066,0.5367190602433922,0.6562058023068529,65.27415143603136,69.1736338062173,1725673274,924382154.0901752,17.48686524007199,39.23692187359091,31.123491871906307,85.71428571428571,100
2004-12-20,39.57001,39.771,39.09,39.2,36.31010804348091,37.31465918717864,38.42221507605422,39.55289164616953,36.0821953,36.34328070000006,38.14724020000001,39.718851499999985,39.718851499999985,40.66486849981225,38.77283450018772,106719872,48.83005623045708,65.47669361722149,NaN,NaN,48.83005623045708,NaN,NaN,NaN,-0.17027749090120425,0.4433589386803476,0.6136364295815518,57.34874552591099,61.19526327054567,1618953402,852138599.0358433,16.332984850320294,36.647852072766526,31.173657796483692,78.57142857142857,92.85714285714286
2004-12-21,39.38,39.71001,39.278,39.67999,36.34363920722737,37.3614974210959,38.47153958287562,39.564996251296236,36.10174525,36.391180600000055,38.22584000000002,39.75035099999998,39.75035099999998,40.64578880764482,38.85491319235514,83240688,54.7770136567846,64.20808322299823,NaN,NaN,NaN,NaN,NaN,NaN,-0.16814848658890869,0.403450821345416,0.5715993079343247,71.1813900944674,64.60142901880327,1702194090,923810640.6908047,15.507684464383201,34.796048086134746,30.443210909934272,71.42857142857143,85.71428571428571
2004-12-22,39.535,39.92999,39.48801,39.73,36.377334339493764,37.40839846226231,38.52089097178246,39.58071089402993,36.12209525,36.43888050000006,38.306640000000016,39.78735049999998,39.78735049999998,40.61245180332176,38.9622491966782,75507440,55.35914600410069,62.904852883854424,NaN,NaN,NaN,NaN,NaN,NaN,-0.1600190868266541,0.37157544940100706,0.5315945362276612,72.62260877584309,67.05091479874051,1777701530,930985880.4754095,17.050728791214684,33.22903429636468,28.816030184177844,64.28571428571429,78.57142857142857
2004-12-23,39.61,39.91,39.53999,39.758,36.410972803777405,37.45492522538583,38.5694050513204,39.59759557078898,36.144935249999996,36.494160500000056,38.389600000000016,39.80875049999998,39.80875049999998,40.6070604117151,39.01044058828486,45816384,55.70295961475471,61.59515719266003,NaN,NaN,NaN,NaN,NaN,NaN,-0.14959482292528864,0.3446010075710504,0.49419583049633903,73.42952985319818,72.41117624116957,1823517914,939159550.1271495,16.385460131049097,31.93253633456911,27.000019119115304,57.142857142857146,71.42857142857143
2004-12-27,39.98,40.02,39.39999,39.59,36.442604915182606,37.49720393379403,38.60942838264117,39.596872183094796,36.16853525,36.54766040000006,38.472400000000015,39.82774999999998,39.82774999999998,40.585197760657586,39.070302239342375,67278368,53.062299120302235,60.02320181952446,NaN,NaN,NaN,NaN,NaN,NaN,-0.1504459450263264,0.306138399213431,0.4565843442397574,68.58800338906872,71.54671400603668,1756239546,913117816.0642797,15.307672497066674,31.317372334993916,25.912290901029184,50,64.28571428571429
2004-12-28,39.67,40.00101,39.61,39.97,36.477703373738,37.54617019253079,38.662784132341514,39.632408165657196,36.1908353,36.61136030000006,38.55920000000001,39.866099999999975,39.866099999999975,40.56882947862362,39.16337052137633,62616688,57.9213865810743,59.73179128456032,NaN,NaN,NaN,NaN,NaN,NaN,-0.12300466689330808,0.3028285106231223,0.4258331775164304,79.53907515317097,73.8522027984793,1818856234,965802566.2883654,14.621090067823772,29.912720022280475,25.992433178177027,42.857142857142854,57.142857142857146
2004-12-29,39.92,40.16,39.89999,40.02,36.51295010633763,37.59515692139156,38.71600828401439,39.66932167368984,36.2164853,36.68436030000006,38.636800000000015,39.911000499999986,39.911000499999986,40.52724850535408,39.29475249464589,50112176,58.529719015358204,59.32419266278483,NaN,NaN,NaN,NaN,58.529719015358204,NaN,-0.10004825409544621,0.30077285989712266,0.40082111399256887,80.98000564844772,76.36902806356248,1868968410,961949859.0915666,16.000632048500965,29.02578888633267,27.42160729656219,35.714285714285715,50
2004-12-30,40.07001,40.123,39.92999,39.99001,36.54754771721984,37.642579754631335,38.765969135621674,39.69986341905272,36.241685350000004,36.75626040000006,38.71900020000001,39.91450099999998,39.91450099999998,40.53170833317107,39.29729366682889,41728208,57.98820418379002,58.71953845103536,NaN,NaN,NaN,NaN,NaN,NaN,-0.08598302581593631,0.29334233172264845,0.37932535753858476,80.11573553738066,80.21160544633312,1827240202,946173954.5386424,15.63014632132463,28.353712903970013,28.49828561047435,28.571428571428573,42.857142857142854
2004-12-31,40.03,40.121,39.89999,39.91499,36.581054605605715,37.6875779773119,38.811028777362,39.72035166485722,36.26376030000001,36.82331020000006,38.796340000000015,39.90674999999998,39.90674999999998,40.51983075987138,39.29366924012858,44145568,56.57804819692586,58.167510897343675,NaN,NaN,NaN,NaN,NaN,NaN,-0.08090567894304967,0.27819325885977264,0.3590989378028223,77.95376342226776,79.68316820269872,1783094634,908020726.4327651,15.196248443733815,27.9434246196728,29.61930728810636,21.428571428571427,35.714285714285715
2005-01-03,40.08,40.29201,39.37,39.49899,36.61008878863451,37.72344752231563,38.838007648837994,39.69926960153748,36.28455525000001,36.88910010000006,38.85431960000001,39.87519949999999,39.87519949999999,40.50382642667586,39.246572573324116,101052192,49.40362101805515,56.86814931318038,NaN,NaN,NaN,NaN,NaN,NaN,-0.10330407152533982,0.2299688483961475,0.33327291992148733,65.96522170156608,74.67824022040485,1682042442,835243113.3333848,13.511150309447903,31.218932858201054,30.997475771906757,14.285714285714286,28.571428571428573
2005-01-04,39.69,39.74001,38.55,38.78,36.63167994496651,37.744369353556905,38.83573283907964,39.61172011567677,36.30470525000001,36.95220010000006,38.913919600000014,39.80069949999998,39.80069949999998,40.563385356000616,39.03801364399934,136759312,39.96983838002867,54.77252501709564,NaN,NaN,NaN,NaN,NaN,NaN,-0.16085022763868712,0.13221013537312842,0.29306036301181554,45.24492936558725,63.05463816314037,1545283130,751348301.2283444,11.706779063643262,36.25205248073082,32.80868947412998,7.142857142857143,21.428571428571427
2005-01-05,38.67999,38.96001,38.47,38.53999,36.650668104718086,37.76012421784291,38.82413508068436,39.50965058085041,36.32585520000001,37.01240000000006,38.972219400000014,39.74869899999998,39.74869899999998,40.6862540873201,38.81114391267986,128424256,37.40230210595768,52.695338792418966,NaN,NaN,NaN,NaN,NaN,NaN,-0.20647566159316616,0.034965786020357825,0.24144144761352399,41.04889212621038,50.7530143977879,1416858874,659610699.2861824,11.052258036116518,35.13800641777669,34.93690506601774,0,14.285714285714286
2005-01-06,38.63,38.71001,38.34,38.347,36.66754702904925,37.77174552045988,38.80542390104968,39.398921954102754,36.34744020000001,37.067000100000065,39.02275920000001,39.67554899999998,39.67554899999998,40.793496363054054,38.55760163694591,103981120,35.4314102842237,50.961381519266084,NaN,NaN,35.4314102842237,NaN,NaN,NaN,-0.23876635084967499,-0.057016490948569754,0.18174985990110523,36.89130434782622,41.061708613207955,1312877754,559563893.7101158,10.571617045898003,35.13784025628889,38.00856682488817,0,7.142857142857143
2005-01-07,38.57001,38.873,38.21001,38.55,36.686277904382095,37.787156500252756,38.7954072774791,39.31807224418821,36.36809020000001,37.11990020000006,39.05915920000001,39.60054899999999,39.60054899999999,40.80580237857106,38.395295621428915,123159248,39.06848596841383,50.001749311444776,NaN,NaN,NaN,NaN,NaN,NaN,-0.23519099567156043,-0.11223888468834531,0.12295211098321512,16.3299711815562,31.423389218530943,1436037002,562720013.1440741,11.656459390022974,32.41747526191519,38.63436488988911,71.42857142857143,0
2005-01-10,38.44,38.87,38.38901,38.53,36.70462339787083,37.801866272524975,38.78499914895051,39.243017744741714,36.3840252,37.166700100000064,39.090559000000006,39.530549499999985,39.530549499999985,40.8113870167605,38.24971198323947,88824624,38.83637887771257,49.28791521482016,NaN,NaN,NaN,NaN,NaN,NaN,-0.2230182158869595,-0.15582065887548424,0.06719755701147526,15.369356388088574,22.863543972490344,1347212378,525968753.40428835,10.991604366891112,30.568464293491555,39.260162954890056,64.28571428571429,92.85714285714286
2005-01-11,38.37,38.496,38.069,38.259,36.720089831722866,37.81091842554428,38.76437173134461,39.14930176905202,36.3992202,37.212570100000065,39.11773920000001,39.429499499999984,39.429499499999984,40.77513420159665,38.08386479840332,107283376,35.73812127777359,47.927994330605095,NaN,NaN,NaN,NaN,NaN,NaN,-0.22160478414195375,-0.20980842316596693,0.011796360975986825,8.546970099099786,13.415432556248199,1239929002,514160044.5705637,10.380483061222435,32.72837224637047,40.22421994305738,57.142857142857146,100
2005-01-12,38.44,38.60001,38.00999,38.58,36.73859640056145,37.826147763652315,38.75714146737031,39.09508255295183,36.41317025000001,37.25827020000006,39.14857940000001,39.334648999999985,39.334648999999985,40.63834394565186,38.03095405434811,127885808,41.67370716101325,46.950462984670274,NaN,NaN,NaN,NaN,NaN,NaN,-0.18872405862346792,-0.22410871230334806,-0.035384653679880154,24.9783086914224,16.298211726203586,1367814810,633371587.2301348,10.896366102526091,30.398814525210632,41.29924573567251,50,100
2005-01-13,38.60001,38.85001,38.00999,38.07001,36.751844297073276,37.830976718827515,38.73019513531657,38.997456595527844,36.42397030000001,37.29807030000006,39.16675960000001,39.221649499999984,39.221649499999984,40.55216165730715,37.891137342692815,102117504,35.986589919416346,45.54215086357469,NaN,NaN,NaN,NaN,NaN,NaN,-0.1904456051063309,-0.2734416600627938,-0.0829960549564629,2.630125941052297,12.051801577191496,1265697306,545846813.3796079,12.752570776842036,27.407723620204926,41.6074651850977,42.857142857142854,92.85714285714286
2005-01-14,38.2,38.52,38.19,38.42999,36.76854226426658,37.842838367959644,38.718422384911996,38.943412157858525,36.43692025000001,37.34157020000006,39.18715940000001,39.14564899999998,39.14564899999998,40.47471045808249,37.816587541917464,93530064,42.0029942339088,44.75220051454658,NaN,NaN,NaN,NaN,NaN,NaN,-0.15781142196220593,-0.2802603324092203,-0.12244891044701439,18.40474667180811,15.337727101427603,1359227370,588354810.3454232,12.067570526655414,25.935526534188412,41.7613596231102,35.714285714285715,85.71428571428571
2005-01-18,38.28,38.78999,38.22,38.72,36.78795975417437,37.86020790522777,38.71848425217035,38.92213480949105,36.44972025000001,37.38327020000006,39.20915940000001,39.10789849999998,39.10789849999998,40.44028119237245,37.775515807627514,92042128,46.37566942494726,43.92750643196608,NaN,NaN,NaN,NaN,46.37566942494726,NaN,-0.10946010865952593,-0.2592740462714218,-0.14981393761189588,31.11322424869187,17.38269895385076,1451269498,657792932.8761331,14.477508036253179,24.164899700808782,41.09937408508022,28.571428571428573,78.57142857142857
2005-01-19,38.73,38.75,38.06,38.08,36.800815876023385,37.86456022393613,38.69344565404602,38.84193149430143,36.45462020000001,37.42007030000006,39.21155920000002,39.05189849999998,39.05189849999998,40.45629095474157,37.64750604525839,105302880,39.328692654184906,42.55600454902513,NaN,NaN,NaN,NaN,NaN,NaN,-0.11289384220287371,-0.290931240365488,-0.1780373981626143,3.067895986888655,17.528622302462882,1345966618,558594567.6587406,13.294292809596229,24.08509297905035,41.09512480201447,21.428571428571427,71.42857142857143
2005-01-20,37.64999,37.811,37.32001,37.35001,36.806280494172405,37.85437111059086,38.640761902906966,38.699843732939385,36.45412025000001,37.44797040000006,39.198559400000015,38.93539949999998,38.93539949999998,40.490524963023226,37.380274036976736,121107312,33.142546904027995,40.78131474332783,NaN,NaN,NaN,NaN,NaN,NaN,-0.15409108154442025,-0.3706512500931396,-0.21656016854871935,1.00942126514112,11.730180500240548,1224859306,452286821.27107203,12.119409175806297,30.561506830794194,42.11522675226532,14.285714285714286,100
2005-01-21,37.49001,37.55,36.99001,37.05,36.808705563882135,37.83844296978708,38.578379083185126,38.54271575837373,36.454470250000014,37.47867040000006,39.18115940000001,38.80139949999999,38.80139949999999,40.51349163237524,37.089307367624734,115496688,30.98543934841797,38.95327125414871,NaN,NaN,NaN,NaN,NaN,NaN,-0.189006603525523,-0.45281842295562313,-0.2638118194301001,1.8167777104784708,1.9646983208360822,1109362618,361535740.5609162,11.32520397953081,32.42051707903508,43.44908098552987,7.142857142857143,100
2005-01-24,37.12,37.2,36.46001,36.53,36.80593237419177,37.81253320800912,38.49805049168767,38.35102854329052,36.45242025000001,37.503770400000064,39.15595960000002,38.63999949999999,38.63999949999999,40.55726157497604,36.72273742502394,137586432,27.62883061400248,37.397929082430664,NaN,NaN,27.62883061400248,NaN,NaN,NaN,-0.2317630009864865,-0.5535155706632082,-0.3217525696767217,2.133841463414762,1.653346813011451,971776186,249975807.23165634,10.359141319671222,35.76453264097069,44.555719519350404,0,100
2005-01-25,36.77,37.09,36.66,36.71001,36.80497792270727,37.79070106527627,38.427931256719525,38.19474106297714,36.45127030000001,37.52817050000006,39.12436000000002,38.49599999999999,38.49599999999999,40.53497575860096,36.45702424139902,120045504,30.438094296959022,36.717090219354255,NaN,NaN,NaN,NaN,NaN,NaN,-0.2319913086796334,-0.6117417055262635,-0.3797503968466301,10,4.650206391297744,1091821690,157853445.8132375,9.685790788710195,33.43981611281207,44.83437242243404,0,92.85714285714286
2005-01-26,36.96001,37.28999,36.82401,37.14999,36.808410878700236,37.778013717449014,38.377815913318756,38.09524096174122,36.45117025000001,37.551870400000055,39.094159800000014,38.354999499999984,38.354999499999984,40.35642673179785,36.353572268202115,107711312,36.88673997505101,36.68026435286091,NaN,NaN,NaN,NaN,NaN,NaN,-0.1884324321636155,-0.6152909370511495,-0.42685850488753396,28.594399479484185,13.57608031429965,1199533002,200842736.78229195,11.361967355467668,31.179368541131353,44.43717446594235,0,85.71428571428571
2005-01-27,37.09,37.27,36.87,37.10001,36.81131236249426,37.764587901261905,38.32770587750233,38.000457060623006,36.453520300000015,37.58146040000006,39.05956000000001,38.20899999999999,38.20899999999999,40.12759374131183,36.29040625868815,109788752,36.47310450369096,36.75467108282287,NaN,NaN,NaN,NaN,NaN,NaN,-0.15055065210385676,-0.6150468200173549,-0.4644961679134981,26.52311033199476,21.705836603826317,1089744250,217316539.0198902,10.818790893610961,29.688790496216615,43.92571600354044,7.142857142857143,78.57142857142857
2005-01-28,37.21001,37.27,36.62,36.92,36.81239383152417,37.74786338836563,38.27250172544342,37.89755638818272,36.45407030000001,37.60636050000006,39.026100000000014,38.05549949999998,38.05549949999998,39.86786182751115,36.243137172488815,111793312,34.95285382956607,36.46069735861945,NaN,NaN,NaN,NaN,NaN,NaN,-0.12616806706345518,-0.6222062517428171,-0.4960381846793619,19.086801190046625,24.734770333841855,977950938,208717053.48142922,9.983552304731163,30.366069288570426,44.16927251756077,0,71.42857142857143
2005-01-31,37.36,37.53,37.25999,37.39999,36.81824055956871,37.740974806417796,38.2382855793476,37.8501691131177,36.460320300000014,37.63737040000006,38.99189980000001,37.929749499999986,37.929749499999986,39.54709377787678,36.31240522212319,89381312,41.90618067749582,36.67996891574683,NaN,NaN,NaN,NaN,NaN,NaN,-0.06911747067077989,-0.5824350230178368,-0.5133175523470569,39.32970711297094,28.313206211670774,1067332250,212024039.5444646,12.345913812247819,28.168245906835445,43.59419091823164,0,64.28571428571429
2005-02-01,37.47,37.64819,37.37,37.52,36.82522324056802,37.73659906767685,38.2101175174124,37.81872443567792,36.467470300000016,37.66667040000006,38.95650000000001,37.83079999999999,37.83079999999999,39.2860368467575,36.37556315324248,76815312,43.53150683742447,37.236639312864746,NaN,NaN,NaN,NaN,NaN,NaN,-0.017397434105985266,-0.5350643449795385,-0.5176669108735532,44.35104602510485,34.25585144270747,1144147562,218046333.49723318,13.38049836392348,27.20132568308125,42.32391187243467,14.285714285714286,57.142857142857146
2005-02-02,37.64999,37.73,37.31,37.58,36.83273345707978,37.73349809603968,38.18540702653348,37.79598877513717,36.47272030000001,37.69127040000006,38.93450020000001,37.77079999999999,37.77079999999999,39.162093743305796,36.37950625669418,101911120,44.36950300728139,37.42919615902675,NaN,NaN,NaN,NaN,NaN,NaN,0.024480215314527598,-0.4870666417303937,-0.5115468570449213,46.86150627615067,43.514086471408824,1246058682,247163796.35437578,13.70284976050391,25.763431248261583,41.13335963413061,7.142857142857143,50
2005-02-03,37.38,37.41299,37,37.15401,36.83593023860138,37.722023084236916,38.14496008431648,37.73484793940982,36.480090400000016,37.70701050000005,38.896580400000005,37.701500999999986,37.701500999999986,39.07053138832508,36.33247061167489,90926368,39.84807127900896,37.70501625614052,NaN,NaN,NaN,NaN,NaN,NaN,0.026923009768286432,-0.4778930948345632,-0.5048161046028496,29.78566339625236,40.33273856583596,1155132314,224052968.3707439,12.704126577207514,27.78122292116332,41.18687556103823,0,42.857142857142854
2005-02-04,37.14999,37.82001,37.14999,37.75,36.845025460107834,37.72257708256886,38.12947145355897,37.73629099279936,36.48889035000001,37.72821050000005,38.87178020000001,37.67165099999998,37.67165099999998,39.00874364935487,36.334558350645096,99370368,47.854398674794105,38.12297371620375,NaN,NaN,NaN,NaN,NaN,NaN,0.06967975887033384,-0.4177164060149323,-0.48739616488526616,55.36485291719241,44.00400752986514,1254502682,302657032.4882319,16.698209028288254,25.471630052399206,40.06639840847515,7.142857142857143,35.714285714285715
2005-02-07,37.8,37.91,37.52,37.674,36.85327396299233,37.72161516014175,38.11160982792921,37.73035851729466,36.492660350000016,37.75242040000006,38.838660200000014,37.62785099999998,37.62785099999998,38.90293715526938,36.35276484473058,71633056,46.99538844727861,38.167239360655984,NaN,NaN,NaN,NaN,NaN,NaN,0.0924194881206783,-0.3718718047344183,-0.46429129285509657,53.01289525281774,46.054470522087506,1182869626,287595723.2779751,17.014030572820964,24.209976921127783,39.52256914850735,0,28.571428571428573
2005-02-08,37.64999,38.00999,37.62,37.74001,36.862097207141666,37.72197941439637,38.09703728565747,37.73127770612374,36.49531035000001,37.77662040000006,38.80926020000001,37.58835149999998,37.58835149999998,38.7963851195542,36.38031788044576,73225184,47.87065347472161,38.77737941926575,NaN,NaN,NaN,NaN,NaN,NaN,0.11027298666993679,-0.3264500595176756,-0.4367230461876124,82.58171073175119,63.65315296725378,1256094810,259437101.66080514,17.450799330438635,22.98399973953709,38.437993072366716,0,21.428571428571427
2005-02-09,37.77,37.8,37.065,37.11,36.86456390159797,37.7098610101509,38.05832994112188,37.672108400778626,36.49616035000001,37.79342050000005,38.76740020000001,37.530901499999985,37.530901499999985,38.71494261641982,36.34686038358015,93432496,40.924673366709314,39.333245595171554,NaN,NaN,NaN,NaN,NaN,NaN,0.07945827576939718,-0.3374002014758659,-0.4168584772452631,41.93537981135243,59.17666193197379,1162662314,177445319.45672393,15.824377490918911,27.87946408311295,37.32187520496702,92.85714285714286,14.285714285714286
2005-02-10,37.25999,37.32001,36.88,37.14999,36.86740396227859,37.69877445549445,38.02270876696024,37.62238283879971,36.49756030000002,37.81059040000005,38.72796020000001,37.459400999999986,37.459400999999986,38.55045611363886,36.36834588636111,110426560,41.50486646788098,40.08463324656178,NaN,NaN,NaN,NaN,NaN,NaN,0.062331365384522885,-0.3389442705146095,-0.4012756358991324,44.51541310210476,56.344167881736126,1273088874,202534165.6265834,14.927438206334784,28.6823504071772,36.13032575097763,85.71428571428571,7.142857142857143
2005-02-11,37.06,37.85001,36.927,37.7,36.87568849996736,37.69879872370248,38.010053521197094,37.62977494939021,36.50506030000002,37.831890300000055,38.68356020000001,37.440900499999984,37.440900499999984,38.5020513340385,36.37974966596147,108768880,48.933461961182985,41.60639262850324,NaN,NaN,NaN,NaN,NaN,NaN,0.08708774323959567,-0.29241595684963784,-0.3795037000892335,77.69840070791889,54.716397873792026,1381857754,275948239.74409145,19.750909066994023,25.426585766683925,33.09332856075479,78.57142857142857,0
2005-02-14,37.71001,37.94,37.688,37.869,36.8855721964851,37.7021690460054,38.004522010561914,37.65255828754352,36.51620530000002,37.861080300000054,38.63954000000001,37.41285099999998,37.41285099999998,38.39462909272689,36.43107290727308,55056976,50.992891125238124,43.07459240195175,NaN,NaN,NaN,NaN,NaN,NaN,0.11228432584014392,-0.23914829278905358,-0.3514326186291975,89.85676155943555,70.69019178981974,1436914730,299981046.72821873,20.266346619156202,24.605388839803886,29.84967539149456,71.42857142857143,21.428571428571427
2005-02-15,37.89,38.48,37.82001,38.12,36.897855060201664,37.710442926282525,38.00905055916733,37.69707654587271,36.53295530000002,37.89309020000005,38.59934000000001,37.38285099999998,37.38285099999998,38.23053753602507,36.535164463974894,133212256,53.96246545229325,44.294287078897625,NaN,NaN,NaN,NaN,53.96246545229325,NaN,0.14141310349335245,-0.1746662392625069,-0.31607934275585936,80.6451612903226,82.73344118589235,1570126986,287868639.7484754,25.405234032187625,22.551156403272227,26.94735615939709,100,14.285714285714286
2005-02-16,38.03,38.16,37.83,37.98,36.90862267154294,37.715780690118514,38.007911321552925,37.72402163674197,36.54735525000002,37.92490020000005,38.55354000000001,37.377850999999986,37.377850999999986,38.2100688220623,36.545633177937674,80616368,52.06733350857194,45.408160579246264,NaN,NaN,NaN,NaN,NaN,NaN,0.14620451054818479,-0.13332370457062837,-0.27952821511881315,73.11827956989247,81.20673413988355,1489510618,280539879.0212023,24.31226937905695,21.58097770683628,24.045036927299613,92.85714285714286,7.142857142857143
2005-02-17,38.05,38.14,37.42999,37.47,36.91420851560719,37.71091374575973,37.9868167599234,37.6998290999094,36.558455250000016,37.95460020000006,38.51134000000001,37.38385049999999,37.38385049999999,38.21690859565667,36.550792404343305,116323056,45.7623646026662,46.180268491610555,NaN,NaN,NaN,NaN,NaN,NaN,0.11154478646373367,-0.14009723203914604,-0.2516420185028797,36.8749999999999,63.54614695340499,1373187562,177326738.29157948,22.108448043405225,24.73163729420887,20.83686137746961,85.71428571428571,0
2005-02-18,37.48,37.57001,37.25999,37.35001,36.91854484878523,37.703767136932804,37.96184394580876,37.666512995156125,36.567555300000016,37.98240020000006,38.462140200000015,37.398850999999986,37.398850999999986,38.2180112623154,36.57969073768457,69387120,44.4001010682265,46.35840566237703,NaN,NaN,NaN,NaN,NaN,NaN,0.07861007161956346,-0.15337942897842538,-0.23198950059798884,29.375624999999786,46.456301523297384,1303800442,148235267.2329359,21.20460902998869,25.96233195839674,18.767800939235467,78.57142857142857,57.142857142857146
2005-02-22,37.03,37.5482,36.78999,36.89,36.91826082043911,37.68765293620146,37.91981084989469,37.59255937656983,36.575705350000014,38.00050020000006,38.39894020000001,37.41685099999999,37.41685099999999,38.172187343198324,36.66151465680165,122635008,39.540488886992435,46.07333295163188,NaN,NaN,39.540488886992435,NaN,NaN,NaN,0.026604601016702034,-0.1987337493271113,-0.22533835034381333,5.917716463216067,24.056113821071918,1181165434,57952053.98657863,19.143338542420306,29.46434700091058,17.8518432172743,71.42857142857143,100
2005-02-23,37.03999,37.07001,36.69701,36.94,36.9184771306835,37.67284792756381,37.88138689499686,37.53041086451556,36.58555535000002,38.018500200000055,38.33914040000001,37.42835049999998,37.42835049999998,38.14637318260955,36.71032781739041,95421056,40.3052767920411,45.78303107911472,NaN,NaN,NaN,NaN,NaN,NaN,-0.002140827673427742,-0.228014384935598,-0.22587355726217026,13.628231229563777,16.307190897593216,1276586490,86854656.95408323,18.20573972135029,29.242147745590646,17.330475899296598,64.28571428571429,100
2005-02-24,36.85001,37.44,36.75999,37.41,36.923367905502566,37.6676430181071,37.862901134408744,37.51894316313312,36.599250300000016,38.03160010000006,38.28174040000002,37.44135099999998,37.44135099999998,38.14806944133084,36.73463255866913,99841008,47.081620878700726,46.299713193378416,NaN,NaN,NaN,NaN,NaN,NaN,0.012007868339680955,-0.21086372183756907,-0.22287159017725003,39.98844637378777,19.844798022189206,1376427498,177886293.79777634,21.38166683343091,26.676918482839383,15.4574370549352,57.142857142857146,92.85714285714286
2005-02-25,37.38,37.7,37.28999,37.62,36.93029956813438,37.66669959200597,37.85337559972605,37.52856762378711,36.611400300000014,38.044670100000054,38.22460020000001,37.46735049999998,37.46735049999998,38.160046260561984,36.77465473943798,80143680,49.82240882971326,46.44028534730121,NaN,NaN,NaN,NaN,NaN,NaN,0.035680111741391796,-0.1782714505005103,-0.2139515622419021,51.76641484248367,35.12769748194507,1456571178,226755154.1592288,23.646810166763636,25.239254870295234,14.204043812167345,50,85.71428571428571
2005-02-28,37.46001,37.60001,36.923,37.22,36.933182159496226,37.657854055530606,37.828537340913265,37.49918023104548,36.62120035000001,38.053270100000056,38.16240020000001,37.48235049999998,37.48235049999998,38.1390432414711,36.82565775852886,96018816,45.037550884534994,46.30043980710524,NaN,NaN,NaN,NaN,NaN,NaN,0.025070494908083718,-0.18261344360679743,-0.20768393851488115,29.33218918782498,40.36235013469881,1360552362,214982031.28636104,21.523303801006854,27.701017463462662,13.853644310752202,42.857142857142854,78.57142857142857
2005-03-01,37.37,37.7,37.33,37.63,36.94011567034701,37.65730249007456,37.82075156283823,37.511639256660196,36.634300400000015,38.063070200000055,38.11600020000001,37.49385099999998,37.49385099999998,38.15242501655234,36.83527698344761,79293568,50.305715296445264,46.47437279437122,NaN,NaN,NaN,NaN,NaN,NaN,0.045165012838599194,-0.15122767246663216,-0.19639268530523135,52.32727048385043,44.4752915047197,1439845930,264272627.61068562,21.480090998862003,25.97132739439612,13.552262985680496,35.714285714285715,71.42857142857143
2005-03-02,37.42999,38.02,37.356,37.61,36.94678118606495,37.65636580710278,37.81248679566811,37.521006946502084,36.648600400000014,38.07677010000006,38.07870000000001,37.49835099999997,37.49835099999997,38.158805464199084,36.83789653580086,107985184,50.053680743338106,47.12644474984471,NaN,NaN,NaN,NaN,NaN,NaN,0.05590636412481215,-0.12650973014921618,-0.18241609427402833,51.20555920111732,44.288339624264246,1331860746,238902614.50225097,23.753474951290258,23.76103629920256,11.583143562209898,28.571428571428573,64.28571428571429
2005-03-03,37.71001,37.73,37.02,37.3,36.95029580112898,37.64930905844728,37.79238927426936,37.499958665882836,36.663000400000016,38.093970100000064,38.04070000000001,37.484350999999975,37.484350999999975,38.14914526236898,36.81955673763097,90101312,46.190772735726625,47.461152340405114,NaN,NaN,NaN,NaN,NaN,NaN,0.041587707955997505,-0.13043145932903144,-0.17201916728502895,33.81903431875664,45.78395466790814,1241759434,219867126.05154586,21.63338290391832,25.864119431889876,9.966457817443793,21.428571428571427,57.142857142857146
2005-03-04,37.59,37.75,37.39999,37.52,36.95596449962521,37.64674848303248,37.78170734194507,37.501867364370185,36.67695040000002,38.11167010000006,37.99750020000001,37.50265049999997,37.50265049999997,38.149984308373114,36.85531669162683,86649872,49.18780861505999,47.479319958539186,NaN,NaN,NaN,NaN,NaN,NaN,0.04604110724882832,-0.11446778322399354,-0.16050889047282185,46.157858428819296,43.72748398289775,1328409306,192637562.8354099,20.64634811818109,24.378932569308017,9.661237305515925,14.285714285714286,50
2005-03-07,37.61,38.28999,37.56,38.06,36.96694992748964,37.65493168138828,37.79262077951585,37.55502285347779,36.693800400000015,38.13537010000006,37.96410020000001,37.518150499999976,37.518150499999976,38.20223484966823,36.83406615033172,94886368,55.70873154565538,47.8161657028547,NaN,NaN,NaN,NaN,55.70873154565538,NaN,0.08234372810511775,-0.05757923034142465,-0.1399229584465424,76.44406306260859,52.14031860339485,1423295674,227734301.45330864,25.381304774738418,22.04615411482592,9.472825219224031,7.142857142857143,42.857142857142854
2005-03-08,37.97,38.21001,37.64999,37.67999,36.97404485358427,37.65542788571722,37.7882038862015,37.566924486479905,36.70795030000002,38.15607000000006,37.92254000000001,37.51844999999998,37.51844999999998,38.20281220678896,36.834087793211,89618432,50.77084111008909,47.588192535554406,NaN,NaN,NaN,NaN,NaN,NaN,0.0778052137412391,-0.04266644126999353,-0.12047165501123262,61.70698941606267,61.43630363583019,1333677242,147717501.3950232,23.61165102418746,20.50903615888237,9.550018577270748,0,35.714285714285715
2005-03-09,37.67,37.92999,37.47,37.57001,36.97997485504114,37.653736442435694,37.77964726321321,37.567218344910394,36.720705350000024,38.17727010000006,37.88214020000001,37.50994999999998,37.50994999999998,38.18728045855104,36.83261954144893,98090880,49.4059414297824,47.39809310135515,NaN,NaN,NaN,NaN,NaN,NaN,0.06496153340831622,-0.03926973825083735,-0.10423127165915357,54.80294793406084,64.31800013757737,1235586362,92280022.15938982,22.24001474305199,21.590704309598138,9.230733065001331,85.71428571428571,28.571428571428573
2005-03-10,37.61,37.67,37.08,37.52,36.9853482395681,37.65108819605083,37.769465017597,37.562721359680836,36.73200540000002,38.19617010000006,37.83314020000001,37.53044999999998,37.53044999999998,38.18246514559185,36.87843485440811,98047632,48.763973573064625,47.612493742097904,NaN,NaN,NaN,NaN,NaN,NaN,0.051264707714160265,-0.04015038701645324,-0.0914150947306135,51.663548820449854,56.05782872352446,1137538730,140472926.02379736,20.58799593729321,24.897041755550973,9.50739286730489,78.57142857142857,21.428571428571427
2005-03-11,37.69,37.82201,37.0199,37.17,36.98718557051767,37.64156169711913,37.74595658553437,37.52531932542552,36.738055350000025,38.206470100000054,37.776140200000015,37.531450499999984,37.531450499999984,38.18118477203721,36.881716227962755,102865440,44.41433527289224,47.6135104710026,NaN,NaN,NaN,NaN,NaN,NaN,0.01848965366425502,-0.06830302765029472,-0.08679268131454974,29.692149305076125,45.38621535319561,1034673290,76106202.02035698,20.427454106965186,22.454967073823365,9.12461346934965,71.42857142857143,14.285714285714286
2005-03-14,37.24001,37.36,37.0305,37.34,36.9906961618558,37.635590178364296,37.730036719434985,37.50766986586119,36.743805350000024,38.221070100000055,37.723140000000015,37.51345049999998,37.51345049999998,38.16345626632727,36.863444733672694,71602368,46.89220182563806,48.138632823763,NaN,NaN,NaN,NaN,NaN,NaN,0.00861790170358824,-0.07602030418506445,-0.08463820588865269,40.363971926829144,40.57322335078504,1106275658,139016325.04312038,19.57791419767095,21.521106662672256,7.945669878422899,64.28571428571429,7.142857142857143
2005-03-15,37.44,37.48,36.99001,37.03999,36.99118664780749,37.62379611542639,37.70297606377087,37.463128926255365,36.74690530000002,38.230990000000055,37.66564000000001,37.47199999999998,37.47199999999998,38.13168537961781,36.81231462038215,93917504,43.22977016746738,48.34752520772202,NaN,NaN,NaN,NaN,NaN,NaN,-0.016395592780309526,-0.10513269686403959,-0.08873710408373006,18.3006535947713,29.452258275558858,1012358154,64258382.87058823,19.884658000120503,20.177264361297002,6.336407254278735,57.142857142857146,0
2005-03-16,36.92,37.17999,36.53,36.61501,36.98744359658552,37.603820152744674,37.66031072793672,37.38235569518343,36.747230350000024,38.23114000000005,37.60796040000002,37.39675049999998,37.39675049999998,38.08627238007329,36.707228619926674,159757440,38.62739735425531,47.74365209883307,NaN,NaN,NaN,NaN,NaN,NaN,-0.057526313994648665,-0.1606449965770409,-0.10311868258239223,4.830141080346867,21.1649222006491,852600714,-53710783.54243474,18.25612538993577,24.32090845543858,6.566831047925269,50,100
2005-03-17,36.60001,36.89,36.53999,36.71001,36.98468306328616,37.58612094179924,37.62304403272351,37.31832277183263,36.74828040000002,38.24024010000006,37.56656060000001,37.333250999999976,37.333250999999976,38.030099752685395,36.63640224731456,101801120,40.161034924790236,47.05355396276713,NaN,NaN,NaN,NaN,NaN,NaN,-0.0732878373718268,-0.19472847929717574,-0.12144064192534894,10.227899022153284,11.11956456575715,954401834,-56610578.30944426,17.428385378137826,23.218188758796956,7.35160231944895,42.857142857142854,92.85714285714286
2005-03-18,36.74001,36.785,36.35001,36.50999,36.97995974922361,37.564811418199255,37.57939485496965,37.24133869832476,36.748730350000024,38.24909000000005,37.52596060000002,37.285250499999975,37.285250499999975,38.06511822541349,36.50538277458646,109185312,38.00749960496805,46.55140744279806,NaN,NaN,NaN,NaN,NaN,NaN,-0.09098264330110423,-0.23516894605172922,-0.144186302750625,8.246476767801935,7.7681722901006935,845216522,-85483854.56719491,16.431281774080457,24.38852830881701,7.847564152963623,35.714285714285715,100
2005-03-21,36.61,36.75,36.25,36.58,36.97598005022636,37.54531020199729,37.5402028998728,37.17835406038907,36.751730350000024,38.256689900000055,37.490620600000014,37.24674999999998,37.24674999999998,38.08394854880614,36.40955145119381,92838624,39.23569364591451,45.7606916106173,NaN,NaN,NaN,NaN,NaN,NaN,-0.09152155070537513,-0.2585882411323439,-0.16706669042696878,16.17654988504835,11.550308558334521,938055146,-55775494.88719554,15.344572578878799,24.09841821797042,8.756760656449845,28.571428571428573,100
2005-03-22,36.63,36.75,36.11,36.13,36.96756233828381,37.51728425740328,37.48490082536799,37.07851081654249,36.75143035000002,38.250689900000054,37.44222060000001,37.208749999999974,37.208749999999974,38.16744568170756,36.250054318292385,114134320,34.50382965629129,44.64998796154253,NaN,NaN,34.50382965629129,NaN,NaN,NaN,-0.11425645009737931,-0.3098872530486929,-0.1956308029513136,0.9174354010799634,8.446820684643413,823920826,-162776419.88719445,14.062536589025736,23.912652067673307,10.608359131360398,21.428571428571427,100
2005-03-23,36.09,36.494,36.07001,36.25999,36.96052181750487,37.492387341415096,37.4368651067261,37.00055645306225,36.74748030000003,38.243689700000054,37.39682040000001,37.174749499999976,37.174749499999976,38.214007441582645,36.13549155841731,97524000,36.872221401246364,43.98437715193679,NaN,NaN,NaN,NaN,NaN,NaN,-0.11243754586662383,-0.3361777352845934,-0.22374018941796955,8.55773475436709,8.5505733468318,921444826,-172903974.12196407,13.271449832475712,23.098034485870212,11.902036314479579,14.285714285714286,100
2005-03-24,36.39,36.64999,36.27,36.27,36.9536509536491,37.468181651486084,37.39110569077606,36.9309796480087,36.743320250000025,38.23738980000005,37.35704040000001,37.11774949999998,37.11774949999998,38.22215288696576,36.0133461130342,77711680,37.06096252905502,43.118173860079295,NaN,NaN,NaN,NaN,NaN,NaN,-0.10272471857075874,-0.35214608763141797,-0.24942136906065923,9.008639717474919,6.161269957640658,999156506,-250615654.12196407,14.682156904145257,21.878825566443126,12.71589620480287,7.142857142857143,92.85714285714286
2005-03-28,36.41,36.61099,36.31,36.34,36.9475449740108,37.445841420763585,37.34988585976523,36.87469587200788,36.742125300000026,38.230409900000055,37.31224040000001,37.053749499999974,37.053749499999974,38.18239939484953,35.925099605150415,59773984,38.44690305216886,41.885186110544545,NaN,NaN,NaN,NaN,NaN,NaN,-0.08451074361979921,-0.35505979858540826,-0.27054905496560905,12.616355140186952,10.060909870676321,1058930490,-298474162.3918729,13.986989997597515,20.842912683396104,13.619603648527585,0,85.71428571428571
2005-03-29,36.27,36.58,35.94,36.05,36.9386141782495,37.41820099659005,37.298909943696,36.79615340800713,36.73817530000002,38.21929990000005,37.271840200000014,36.99524949999998,36.99524949999998,38.20195424895146,35.7885447510485,119633312,35.00759256977986,40.75923978623673,NaN,NaN,NaN,NaN,NaN,NaN,-0.08470496257220705,-0.37643025818086784,-0.2917252956086608,5.527665968170669,9.05088694194418,939297178,-376983523.3918731,12.76531989578668,24.07195906926887,15.309700855621445,0,100
2005-03-30,36.23,36.78,36.22,36.73,36.936538415281845,37.40457325408332,37.27659974982557,36.78985308343502,36.74022525000002,38.212499900000054,37.23784040000001,36.95024949999998,36.95024949999998,38.12563291452584,35.774866085474116,115019568,46.983685399562646,40.5862214983639,NaN,NaN,NaN,NaN,46.983685399562646,NaN,-0.034330705911955195,-0.3346386779986048,-0.3003079720866496,41.97639757493312,20.04013956109691,1054316746,-282503163.9633033,14.183064453785518,21.73953506474615,16.70641640206252,0,92.85714285714286
2005-03-31,36.75,36.75,36.44,36.57001,36.93289136637357,37.388047249051965,37.24889034787163,36.7689156469174,36.73912535000002,38.202000000000055,37.19484060000001,36.898249999999976,36.898249999999976,38.043925630431175,35.75257436956878,86651184,44.88788332773208,40.30935790941157,NaN,NaN,NaN,NaN,NaN,NaN,-0.008429762992551493,-0.31084517582733895,-0.30241541283478746,33.47538004580238,26.993147862968723,967665562,-296473570.98368776,13.581254361777905,20.8170918480388,17.53226475297223,7.142857142857143,85.71428571428571
2005-04-01,36.82001,36.884,36.13,36.2,36.92559891496686,37.36452156095193,37.207757393053136,36.71473320435384,36.73647535000002,38.18439990000005,37.157240600000016,36.84324999999997,36.84324999999997,38.01188281237813,35.674617187621806,143853504,40.39955076975051,40.02258758775859,NaN,NaN,NaN,NaN,NaN,NaN,-0.012609761846098244,-0.3181776151424103,-0.30556785329631203,16.883116883117225,30.778298167950908,823812058,-413616875.30199,12.222773599425105,22.847319528040096,19.358486160954964,0,78.57142857142857
2005-04-04,36.25999,36.60001,36.03,36.46001,36.920966189444805,37.34661044093308,37.17843396587458,36.69047385155824,36.73682540000002,38.169000000000054,37.139440600000015,36.79025049999997,36.79025049999997,37.92701931079006,35.65348168920988,100153680,44.59219597236682,39.85830145538207,NaN,NaN,NaN,NaN,NaN,NaN,0.004810354965111896,-0.29955490958992215,-0.30436526455503404,33.766883116883086,28.0417933486009,923965738,-362660631.1364495,11.302368757670296,22.447932809912324,21.379594987430384,7.142857142857143,71.42857142857143
2005-04-05,36.5,36.66901,36.41499,36.56,36.917374486067246,37.33103399655816,37.15418165348734,36.678047770457454,36.73742540000002,38.15540000000006,37.129640600000016,36.715250499999975,36.715250499999975,37.69397090398861,35.73653009601134,66463056,46.160712444606816,40.06765447517775,NaN,NaN,NaN,NaN,NaN,NaN,0.02463274816649591,-0.27357432934691417,-0.2982070775134101,50.00040322905871,33.55013440968634,990428794,-353241412.1143248,11.855575528010249,21.664976602317537,23.417698970734598,0,64.28571428571429
2005-04-06,36.66,36.905,36.42,36.5,36.913221506106375,37.314577877814436,37.12852747099764,36.6610908399377,36.73917545000002,38.142500100000056,37.12904060000002,36.656250999999976,36.656250999999976,37.5320888617984,35.78041313820155,82219312,45.331440390908384,40.54651469208154,NaN,NaN,NaN,NaN,NaN,NaN,0.03465538801288487,-0.254887842497304,-0.2895432305101889,58.03108808290158,47.26612480961446,908209482,-408336827.3720573,14.31828364539508,20.21521063977477,23.619963586550504,0,57.142857142857146
2005-04-07,36.52,36.952,36.50999,36.94,36.913487958781936,37.307160494095335,37.12113423684087,36.68765361708649,36.740475500000024,38.12900020000006,37.13364040000002,36.62475049999997,36.62475049999997,37.40720460801279,35.84229639198715,88708944,52.12393201256932,41.40100734120862,NaN,NaN,NaN,NaN,52.12393201256932,NaN,0.06984017423624639,-0.20224301271488088,-0.27208318695112726,98.81422924901182,68.94857352032405,996918426,-324444549.63752663,14.07157585467922,18.942970379940576,23.65646632362172,100,50
2005-04-08,37.02,37.07001,36.60001,36.64,36.910766685560226,37.29394939520236,37.10226622755299,36.683115177363966,36.73807550000002,38.108800200000054,37.123440600000016,36.58075049999997,36.58075049999997,37.24726577150069,35.91423522849925,92409808,47.766154801632666,42.09805414097037,NaN,NaN,NaN,NaN,NaN,NaN,0.07156741059361482,-0.18262392370910874,-0.25419133430272356,61.946354457040144,72.93055726298452,904508618,-401128960.9485043,14.798195147497692,17.695855305764173,22.901032008329015,100,42.857142857142854
2005-04-11,36.75,36.78,36.39999,36.48,36.90648044988301,37.27783158539637,37.07786363039405,36.66377087475787,36.73522550000003,38.085300200000056,37.11104040000002,36.54625049999997,36.54625049999997,37.15622488072766,35.93627611927228,71013440,45.577574554506896,42.55104563444126,NaN,NaN,NaN,NaN,NaN,NaN,0.06100491462059293,-0.1779351910269824,-0.23894010564757534,47.78718772400212,69.51592381001804,833495178,-442239054.5397276,13.99588783150273,19.590160506301636,22.50552281648647,92.85714285714286,35.714285714285715
2005-04-12,36.44,36.74001,35.91,36.66,36.904027908093134,37.265597296576644,37.06147682135899,36.663411743828554,36.73187550000003,38.06597020000006,37.10584040000002,36.51225049999997,36.51225049999997,37.0062392459685,36.01826175403144,145341312,48.43973852453309,43.54646769645853,NaN,NaN,NaN,NaN,NaN,NaN,0.06485211916471756,-0.1578749566916784,-0.22272707585639595,64.65461504642163,58.129385742487976,978836490,-324918509.4536689,12.412897848984263,24.051439794953712,22.93261631617727,85.71428571428571,100
2005-04-13,36.56,36.60001,35.98,36.06,36.895629620450414,37.241724082783044,37.02220322052138,36.60594395870203,36.727070500000025,38.035470200000056,37.07904060000002,36.46325099999997,36.46325099999997,36.93189306396902,35.99460893603092,109071056,40.74707875940722,43.82324322204145,NaN,NaN,NaN,NaN,NaN,NaN,0.027603779135704276,-0.18822235193676562,-0.2158261310724699,12.930923009284816,41.79090859323619,869765434,-405842650.1458494,11.28660503748248,21.869115886637573,23.28253336881112,78.57142857142857,92.85714285714286
2005-04-14,36.08,36.10001,35.5,35.55,36.882240270993194,37.20822459599526,36.96446976089309,36.50537786739707,36.71797050000003,37.99807030000005,37.03964060000002,36.41000049999997,36.41000049999997,37.01867302287589,35.801327977124046,158933936,35.57543540366791,43.71713414165665,NaN,NaN,NaN,NaN,NaN,NaN,-0.027769157397192268,-0.25053757781896024,-0.22276842042176798,3.1846930911266202,26.92341038227769,710831498,-538288038.288315,10.39070908244201,26.483260641336294,24.993820783394472,71.42857142857143,100
2005-04-15,35.23,35.37,34.67999,34.74001,36.86092454690371,37.1593490594409,36.877236044779636,36.337247594311634,36.70297050000003,37.95867050000006,36.98284080000002,36.311500499999966,36.311500499999966,37.24501308915159,35.37798791084834,170274368,29.230076334040575,43.05878937607606,NaN,NaN,29.230076334040575,NaN,NaN,NaN,-0.11068086849628356,-0.3611195060421224,-0.25043863754583884,2.5112760562673677,6.20896405222627,540557130,-678940031.0550278,9.244818672607426,33.95692048540098,27.673651012945758,64.28571428571429,100
2005-04-18,34.72,35.10001,34.64,34.75,36.83992032255641,37.11163917707573,36.79381502341573,36.18608115675814,36.69152055000003,37.915670500000054,36.934760600000025,36.22350099999996,36.22350099999996,37.37252112692659,35.074480873073334,110713936,29.39733844227007,42.65805693839679,NaN,NaN,NaN,NaN,NaN,NaN,-0.1539255090128694,-0.44284552381192555,-0.28892001479905616,4.526730342673458,3.407566496689149,651271066,-736704974.8157287,8.698590025303456,32.46422283604503,29.605237943346538,57.142857142857146,100
2005-04-19,35.02,35.10001,34.75,34.99001,36.82151325467028,37.069626718123736,36.723077571517074,36.072169618019274,36.68237055000003,37.875670500000055,36.879560800000014,36.144001499999966,36.144001499999966,37.398532596504616,34.88947040349532,97511440,33.46590676868955,41.69250132190586,NaN,NaN,NaN,NaN,NaN,NaN,-0.15501047625063302,-0.48268311011234744,-0.3276726338617144,14.403644429446672,7.147216942795835,748782506,-700484688.7827584,8.296901105186006,30.965069688749956,32.226685404716235,50,92.85714285714286
2005-04-20,35.21001,35.28999,34.59,34.70399,36.80044337153923,37.02278242667574,36.6438976667517,35.941866797255535,36.67574050000003,37.82941040000006,36.82016060000002,36.07270099999997,36.07270099999997,37.475626743765815,34.66977525623412,140456064,31.161344352749694,40.71203425226425,NaN,NaN,NaN,NaN,NaN,NaN,-0.1628304067376366,-0.5312106422837601,-0.36838023554612354,4.596352434062526,7.842242402060887,608326442,-795195565.7504889,10.00149103160726,28.163956129363942,34.123352745991085,42.857142857142854,100
2005-04-21,35.09,35.71001,34.96001,35.62,36.78869766634978,36.99500455684058,36.60374481707516,35.91121281656453,36.67336055000003,37.79351030000006,36.77776040000002,36.04070149999997,36.04070149999997,37.45423500710044,34.627167992899494,125000944,44.37306802433745,40.99585691330618,NaN,NaN,NaN,NaN,44.37306802433745,NaN,-0.09737987816048677,-0.49010508324673197,-0.3927252050862452,41.53209059640864,20.177362486639282,733327386,-700198181.6689954,13.900748807977283,24.70501452589369,33.95842221409592,35.714285714285715,92.85714285714286
2005-04-22,35.47,35.47,34.817,35.09,36.77179520200799,36.957281694328884,36.544382275229076,35.833002072129815,36.670310550000025,37.752380300000056,36.73736040000003,35.98170149999997,35.98170149999997,37.44949034165749,34.513912658342456,115150752,39.63339175403968,40.6416566119971,NaN,NaN,NaN,NaN,NaN,NaN,-0.08149490180321528,-0.4945938323402643,-0.41309893053704905,20.161209027382952,22.096550685951375,618176634,-719066681.6138638,12.573369997535899,24.04656028674415,33.8374833035248,28.571428571428573,85.71428571428571
2005-04-25,35.3,35.463,35.149,35.375,36.75789674228652,36.9259493835501,36.49852414678872,35.78938282716507,36.66843555000003,37.71491040000005,36.701860600000025,35.933451499999975,35.933451499999975,37.41434096673725,34.4525620332627,72220000,43.14991897584222,40.426599935656775,NaN,NaN,NaN,NaN,NaN,NaN,-0.04531223066504486,-0.4697392188683551,-0.42442698820331026,31.6530981729911,31.1154659322609,690396634,-687326681.6138643,12.000150004215438,22.950277497830047,33.985098494484276,21.428571428571427,78.57142857142857
2005-04-26,35.28,35.7,35.03999,35.05,36.740902744850835,36.88880187100455,36.4417192782872,35.718965415054114,36.66568550000002,37.666210400000054,36.64886060000002,35.883451499999964,35.883451499999964,37.41198485347858,34.35491814652135,108099440,40.26912261333583,40.0650058086873,NaN,NaN,NaN,NaN,NaN,NaN,-0.03712961226936323,-0.4708390035400143,-0.43370939127065106,18.548312305192066,23.454206501855378,582297194,-792147154.9485127,13.911176740068893,21.115834385877086,34.23459123387516,14.285714285714286,71.42857142857143
2005-04-27,34.87,35.25,34.73,35.10001,36.7245754538573,36.853380249796544,36.38910322815829,35.66001728028706,36.663435550000024,37.61651040000005,36.593480800000016,35.80195199999997,35.80195199999997,37.31498629667258,34.288917703327364,112639744,40.922721394574566,39.26491933597339,NaN,NaN,NaN,NaN,NaN,NaN,-0.022908942853771097,-0.4623455698378649,-0.4394366269840938,20.564836432110923,23.588748970098035,694936938,-744487546.3429749,13.027649613480092,23.560896980807662,35.23695378663754,7.142857142857143,64.28571428571429
2005-04-28,34.92999,35.14999,34.72,34.75,36.704927936903495,36.81172915574117,36.3248246701913,35.573348967878765,36.66123555000003,37.56271040000005,36.52608080000002,35.71095149999997,35.71095149999997,37.24701347879361,34.17488952120633,98661312,37.80478405762942,38.55339285425887,NaN,NaN,37.80478405762942,NaN,NaN,NaN,-0.031125338790272294,-0.4783433004719342,-0.4472179616816619,7.305936073059213,15.473028270120736,596275626,-829381843.4821638,12.330271437533591,22.424160242360955,36.67452151733445,0,57.142857142857146
2005-04-29,35,35.064,34.35001,34.98,36.687764474844755,36.775457291271046,36.27208644783085,35.516839542366505,36.660785500000024,37.50981040000005,36.466080800000015,35.649951499999965,35.649951499999965,37.200314920200675,34.099588079799254,144508368,40.986673172014626,38.225471326938,NaN,NaN,NaN,NaN,NaN,NaN,-0.01588831142533753,-0.46707835096333383,-0.4511900395379963,26.35941422594139,18.07672891037051,740783994,-718875920.6480637,11.253081689738654,24.992226566540168,38.19233995111422,0,100
2005-05-02,35.07001,35.2636,34.886,35.12,36.67216482832889,36.742675958770626,36.2269065871316,35.47904530023636,36.66303550000002,37.46521040000005,36.41908080000002,35.582950999999966,35.582950999999966,37.10301719279604,34.06288480720389,68205376,42.901534723563266,37.829885341154444,NaN,NaN,NaN,NaN,NaN,NaN,0.007542740076182386,-0.4417616144427683,-0.4493043545189507,34.221777777777774,22.62904269225946,808989370,-702547091.2243354,13.225155345176484,23.807656479890394,37.95365506725805,0,92.85714285714286
2005-05-03,35.05,35.60001,35.03,35.3,36.65851144695248,36.71410811800289,36.19055730920487,35.46199336688051,36.666535450000026,37.420110400000056,36.37808060000001,35.51995099999996,35.51995099999996,36.97590860050959,34.063993399490336,104075312,45.356551872026465,38.15913342062724,NaN,NaN,NaN,NaN,NaN,NaN,0.037416867846530866,-0.40253326971078707,-0.43995013755731793,54.28514285714284,38.288778286954,913064682,-708026468.9775686,16.501231003983953,22.104437629758795,36.7105369582625,0,85.71428571428571
2005-05-04,35.28999,35.832,35.24001,35.728,36.6492526265848,36.69458122457709,36.17241780688311,35.48732733193951,36.66802550000002,37.37689040000005,36.35484060000002,35.48135099999997,35.48135099999997,36.870743084071385,34.09195891592855,90934880,50.776088585117535,39.24489436215936,NaN,NaN,NaN,NaN,NaN,NaN,0.08550483987298196,-0.33306908771609045,-0.4185739275890724,92.98240878818352,60.49644314103472,1003999562,-649042221.6571743,18.182032494370915,20.466791190022253,34.01550477993114,0,78.57142857142857
2005-05-05,35.75999,35.924,35.53,35.75999,36.64040424224067,36.67607446765477,36.156244167397496,35.51329520508813,36.674825500000026,37.33519040000005,36.33124040000001,35.422350499999965,35.422350499999965,36.649739063049076,34.194961936950854,79625248,51.16594261671078,40.81174195377866,NaN,NaN,NaN,NaN,NaN,NaN,0.11702072978877132,-0.27229801535310827,-0.3893187451418796,89.57998462506131,78.94917875679589,1083624810,-635708024.0352447,18.44263468363104,19.434774511845866,30.11676963291992,100,71.42857142857143
2005-05-06,35.97,36.02,35.72301,35.85699,36.63260907565121,36.659854973245764,36.144508709852495,35.54602804269878,36.679760450000025,37.29096030000005,36.30018020000002,35.38319999999997,35.38319999999997,36.49747100658875,34.26892899341118,77397632,52.39706662967593,42.454579681450504,NaN,NaN,NaN,NaN,NaN,NaN,0.14037951707599172,-0.21384434879688996,-0.3542238658728817,90.23886370577074,90.93375237300519,1161022442,-643273441.2444433,18.9885018011537,18.670544263297533,26.053099549560347,100,64.28571428571429
2005-05-09,35.87,36.06,35.657,36.03,36.62661296544572,36.64738259753793,36.14001817221122,35.5921206100608,36.688860400000024,37.24649020000005,36.26838020000002,35.360699999999966,35.360699999999966,36.40120510624631,34.32019489375362,66371680,54.59573533460847,43.96385315044471,NaN,NaN,NaN,NaN,NaN,NaN,0.16193191154830489,-0.15180897643750058,-0.31374088798580546,98.24560377546061,92.68815070209756,1227394122,-586783400.9466767,17.956648626387693,18.546055040559555,22.044457081544845,100,57.142857142857146
2005-05-10,35.85001,35.96001,35.619,35.76601,36.618049751859196,36.629929674814406,36.12535118506568,35.60868150434073,36.69739045000003,37.20085030000005,36.23930040000002,35.31600049999997,35.31600049999997,36.19342732665953,34.438573673340414,77475632,50.744368511505506,45.362640590355845,NaN,NaN,NaN,NaN,NaN,NaN,0.1529648871978086,-0.1225347789885447,-0.2754996661863533,82.80750179825613,90.43065642649583,1149918490,-597459275.4010316,16.94530651183473,18.022249159036832,18.86524769438402,92.85714285714286,50
2005-05-11,35.83,36.026,35.3,35.95,36.61140249064667,36.61646572085768,36.11847466800428,35.64118802773685,36.70449045000002,37.16085030000005,36.20570040000002,35.310500499999975,35.310500499999975,36.170407970685794,34.450593029314156,132093936,53.22120112899016,45.994650097831034,NaN,NaN,NaN,NaN,NaN,NaN,0.1535793477398252,-0.0835254815115718,-0.237104829251397,93.56721384335586,91.54010647235754,1282012426,-493021370.0787175,15.305475426861136,20.53030291509657,17.907659979113784,85.71428571428571,42.857142857142854
2005-05-12,36.00999,36.2,35.65601,35.85001,36.60382644596362,36.6012883798506,36.107946641808034,35.661075834619055,36.71184050000003,37.124600300000054,36.17050060000002,35.325500999999974,35.325500999999974,36.211662890490985,34.439339109508964,116671440,51.699687941285724,46.856528396920034,NaN,NaN,NaN,NaN,NaN,NaN,0.14169410778095265,-0.05998719452520618,-0.20168130230615883,81.08151935956387,85.81874500039196,1165340986,-526477091.554482,16.513680823045597,19.043239484140216,16.17792119380523,100,35.714285714285715
2005-05-13,35.99001,36.47,35.888,36.24001,36.60020638182468,36.59413435252683,36.11312559703125,35.71621242179819,36.71914055000003,37.09500040000006,36.14930080000002,35.40050099999998,35.40050099999998,36.328664938190535,34.47233706180942,133310000,56.87794089661929,47.83710139126125,NaN,NaN,NaN,NaN,NaN,NaN,0.15354440918624399,-0.009750790823353839,-0.16329520000959782,89.1513639215279,87.93336570814921,1298650986,-498527802.5510458,18.72095684520652,17.488475271117686,14.183157243838064,100,28.571428571428573
2005-05-16,36.24001,36.53799,36.13,36.48399,36.59904999991598,36.59195327623917,36.127669299108454,35.78933409591265,36.72711050000002,37.063040400000055,36.128580600000014,35.48720049999997,35.48720049999997,36.47794792259659,34.49645307740335,79136944,59.782764985298044,49.23093298925854,NaN,NaN,NaN,NaN,NaN,NaN,0.1699818616653586,0.04918212707210046,-0.12079973459325816,97.5319701276976,89.25495113626313,1377787930,-440339386.58359647,18.608486326775537,16.53194821273779,13.13604249149863,100,21.428571428571427
2005-05-17,36.349,36.74001,36.21001,36.7,36.60005447752875,36.59409281532354,36.15011364031989,35.87606418201621,36.735810450000024,37.03274040000006,36.10138060000001,35.572699999999976,35.572699999999976,36.666809978092594,34.47859002190736,91709008,62.20994603293265,50.751449034855554,NaN,NaN,NaN,NaN,NaN,NaN,0.18626037004558146,0.11202572796371868,-0.07423464208186278,98.32594142259434,95.00309182393995,1469496938,-362476708.43295324,19.995112296882425,15.356889400818725,12.016881109480751,100,14.285714285714286
2005-05-18,36.8,37.36,36.71001,37.2,36.60602408471752,36.60609097739634,36.19128565442499,36.00215330753847,36.750660450000034,37.00716040000006,36.091780800000016,35.697500499999975,35.697500499999975,36.9277304094647,34.46727059053525,128146752,67.1517254486296,52.84765913421271,NaN,NaN,NaN,NaN,NaN,NaN,0.21928496232328656,0.19987156082224544,-0.01941340150104113,94.68436772215202,96.847426424148,1597643690,-297418558.78068006,26.430024436518977,14.020447193934075,12.133666161558883,100,7.142857142857143
2005-05-19,37.3,37.52,37.2,37.51199,36.615038670939235,36.62402957190334,36.24307798170244,36.14594727824909,36.76702035000003,36.98638030000006,36.09062040000001,35.79209999999998,35.79209999999998,37.25324425439836,34.33095574560159,93998432,69.80507884551656,54.90611668231999,NaN,NaN,NaN,NaN,NaN,NaN,0.24857631810434147,0.2913069961293857,0.042730678025044246,99.69589977220936,97.56873630565191,1691642122,-208125923.2826835,27.454490793865755,13.411050021397486,11.880737512368055,100,0
2005-05-20,37.45,37.69,37.35001,37.66,36.62543629610402,36.644543837806246,36.29864355104744,36.2901427755587,36.787320300000026,36.96328030000005,36.09342040000002,35.92059999999997,35.92059999999997,37.55403647937813,34.28716352062182,66708496,71.00178855634704,56.913277670375976,NaN,NaN,NaN,NaN,NaN,NaN,0.2629608760787907,0.3714317731235326,0.10847089704474192,98.87218045112778,97.75081598182975,1758350618,-153189861.06014797,28.522682476250928,12.77568456721791,12.563153141693672,100,0
2005-05-23,37.66,37.98599,37.60001,37.85001,36.63762110907811,36.66841445487939,36.35948145100637,36.43870155883882,36.81297035000003,36.94158040000005,36.10702060000002,36.04435049999997,36.04435049999997,37.858695203958675,34.23000579604127,93084816,72.50814925203647,58.85267748323383,NaN,NaN,NaN,NaN,NaN,NaN,0.2693290805345876,0.44513224771297644,0.17580316717838884,95.04803385312336,97.87203802548686,1851435434,-125692242.73712716,31.159625473418256,12.076205607014892,14.679155004715795,100,0
2005-05-24,37.75,38,37.7,37.97,36.65087861048032,36.6941884260699,36.42263904116298,36.58453950561608,36.838820350000034,36.92138030000005,36.11962060000002,36.19035049999998,36.19035049999998,38.12696128195392,34.25373971804604,100988432,73.44622375790509,60.47197285271866,NaN,NaN,NaN,NaN,73.44622375790509,NaN,0.265256589832215,0.5073739044686576,0.2421173146364426,98.88888888888884,97.60303439771336,1952423866,-44901497.137128115,29.998852912063157,11.547027566050444,17.429265148703227,100,0
2005-05-25,37.83,37.881,37.59,37.81,36.66241215664469,36.71628370476159,36.477045353274235,36.70125002889074,36.86182030000003,36.90033040000005,36.135020800000014,36.325849999999974,36.325849999999974,38.31680587147555,34.3348941285244,76490880,70.01548935923897,61.81836904861353,NaN,NaN,NaN,NaN,NaN,NaN,0.23638067925025086,0.5375931636992561,0.3012124844490053,92.96296296296306,95.63329523499176,1875932986,-5736063.735065594,28.306817728839363,12.528464723432926,20.00209912320367,92.85714285714286,28.571428571428573
2005-05-26,37.98,38.27,37.98,38.19,36.677612035683055,36.745466205657394,36.544220045302694,36.84303574042495,36.888170300000034,36.88724050000005,36.16652060000002,36.49784999999998,36.49784999999998,38.508799945215344,34.48690005478461,84087872,73.21548712641382,63.30539908409481,NaN,NaN,NaN,NaN,NaN,NaN,0.22739496763636396,0.5854561939944602,0.3580612263580963,97.30639730639713,96.3860830527497,1960020858,31958499.575277098,32.16015399411752,11.67034597571335,23.280922340987168,100,21.428571428571427
2005-05-27,38.14999,38.25,38.02,38.21001,36.69285977662153,36.7744670728721,36.609545141565334,36.973223765146386,36.91687035000003,36.88154060000005,36.196520600000014,36.659350499999974,36.659350499999974,38.67556345620827,34.643137543791674,50134128,73.37661259635854,64.64689031707695,NaN,NaN,NaN,NaN,NaN,NaN,0.2078550933232291,0.6178800930121326,0.41002499968890355,97.98013468013447,96.0831649831649,2010154986,64659029.49944943,31.01624000231452,11.255240001617507,26.504717943426584,92.85714285714286,14.285714285714286
2005-05-31,38.19,38.24001,37.92,38.08,36.706662166903904,36.80031921004295,36.667210037974534,37.07863102560864,36.94467035000003,36.87694070000005,36.22792080000002,36.80735049999997,36.80735049999997,38.7840213610142,34.83067963898574,75294944,70.41282833731745,66.05178030463495,NaN,NaN,NaN,NaN,NaN,NaN,0.17267671706954713,0.6258708960258375,0.45319417895629033,93.60269360269345,96.29640852974171,1934860042,64656676.605976604,29.446837607598965,12.266912971946946,29.22653546115509,85.71428571428571,7.142857142857143
2005-06-01,38.03,38.67999,38.02,38.41,36.72361080205909,36.83219407717081,36.73555474236769,37.20542807078876,36.97228540000003,36.87757070000005,36.26452080000002,36.96285049999997,36.96285049999997,38.93002681918979,34.995674180810155,110985248,73.35474687925401,67.48989071536809,NaN,NaN,NaN,NaN,NaN,NaN,0.1585037377460461,0.6513238511388479,0.49282011339280185,91.07170020965745,94.21817616416182,2045845290,84837799.97523889,33.2069411361869,11.027590609746696,31.766566480604855,100,0
2005-06-02,38.33,38.66,38.3,38.66,36.74287835626746,36.868388253860495,36.81102318384347,37.343958730713645,36.99928545000003,36.87867070000005,36.31512080000002,37.10945049999997,37.10945049999997,39.12313085308026,35.09577014691968,76148752,75.35407070900901,69.17948948449119,NaN,NaN,NaN,NaN,75.35407070900901,NaN,0.15277283008634934,0.6837861510007386,0.5310133209143892,99.28402322357887,94.65280567864328,2121994042,160986551.9752389,31.346613410380286,10.4098001160056,34.839869530276204,92.85714285714286,0
2005-06-03,38.63,38.64,38.02,38.10001,36.75638215371754,36.892776803289,36.86157168643784,37.41596361350282,37.02053545000003,36.87437080000005,36.35192120000002,37.226451499999975,37.226451499999975,39.184048119524476,35.26885488047547,97066496,63.80509206821417,69.67428599674795,NaN,NaN,NaN,NaN,NaN,NaN,0.10059380334660717,0.6567555750976481,0.556161771751041,77.25559708077284,89.20377350466974,2024927546,88972605.47510819,28.310169819482912,13.63935588752212,37.09478238072906,85.71428571428571,0
2005-06-06,38.12,38.19,37.96001,38.11,36.769850988008905,36.91688023292684,36.91052965951871,37.48206231697874,37.042725450000034,36.87288080000005,36.38872120000002,37.33910199999997,37.33910199999997,39.22655282440524,35.4516511755947,53078544,63.9113539124229,69.96918520582831,NaN,NaN,NaN,NaN,NaN,NaN,0.05818282461747959,0.6288903025228905,0.5707074779054109,76.9232949254651,84.48763840993895,2078006090,105125339.48337033,27.28723540505429,14.08901025876684,38.95112649426597,78.57142857142857,0
2005-06-07,38.14999,38.47099,37.73801,37.78999,36.78000162494414,36.934169535245125,36.9450183003219,37.511388762980765,37.06162545000004,36.86498070000005,36.41772100000002,37.42710149999997,37.42710149999997,39.224156133274654,35.63004686672529,109623120,58.0338368061663,69.67089168963071,NaN,NaN,NaN,NaN,NaN,NaN,0.002925083242357851,0.5743638319583582,0.5714387487160003,54.82187636422737,69.66692279015511,1968382970,11050282.943765044,28.506188358752162,12.534542695743411,40.79373064500987,71.42857142857143,0
2005-06-08,37.88,37.95,37.56,37.71001,36.789255439621314,36.94953271276503,36.97501797481908,37.53030507126831,37.07972550000003,36.86138070000005,36.45092120000002,37.524301499999964,37.524301499999964,39.15395681465275,35.89464618534718,79250432,56.63205399374021,68.91948658571003,NaN,NaN,NaN,NaN,NaN,NaN,-0.04217657097438687,0.5187180349980167,0.5608946059724036,34.46036797545904,55.40184642171719,1889132538,-7234214.162288502,26.811171085173978,14.503252294920028,40.730330882581654,64.28571428571429,0
2005-06-09,37.66,38.06,37.5,37.95,36.80080513673951,36.96934394617562,37.01325256404186,37.570276016861804,37.099075500000026,36.856580800000046,36.47532120000002,37.62430149999997,37.62430149999997,39.092748041271975,36.15585495872797,99440624,59.77201433324759,68.20283912054796,NaN,NaN,NaN,NaN,NaN,NaN,-0.05803241644694279,0.48835408541372516,0.546386501860668,45.112708461781814,44.79831760048943,1988573162,53140450.40914043,26.207558794067182,13.281997001599693,40.61365956216546,57.142857142857146,0
2005-06-10,37.89999,37.89999,37.38,37.547,36.808229961249566,36.98078267991472,37.03418383604022,37.56805925335116,37.11406050000003,36.844850800000046,36.49486100000002,37.70915099999997,37.70915099999997,38.93353269414567,36.48476930585427,86005680,52.85191088377626,66.90641928679291,NaN,NaN,52.85191088377626,NaN,NaN,NaN,-0.09562821800618138,0.4268512293529412,0.5224794473591226,12.846252663481662,30.806443033574197,1902567482,22377942.6239889,23.992953743802904,13.93863529110902,39.783418146876464,50,0
2005-06-13,37.48,37.95,37.46001,37.73,36.817401802431164,36.99561866645106,37.0614707444308,37.58348218160343,37.13071055000003,36.84135080000005,36.525461000000014,37.78365049999997,37.78365049999997,38.8060602571633,36.76124074283664,82360368,55.37825205945327,65.6828552016084,NaN,NaN,NaN,NaN,NaN,NaN,-0.10726426177617282,0.38839912013890654,0.49566338191507936,26.92328402526142,28.294081716841657,1984927850,30780552.465658024,22.992691843545717,12.927344431781782,38.632244307820734,42.857142857142854,92.85714285714286
2005-06-14,37.69,37.84,37.5,37.58,36.824989844198015,37.007190574046085,37.08180522504136,37.583150545260246,37.14581055000003,36.84365070000005,36.54786080000001,37.83845099999998,37.83845099999998,38.677367297682785,36.99953470231717,62764608,52.877208381641985,64.21363981758961,NaN,NaN,NaN,NaN,NaN,NaN,-0.12302605674724404,0.3418808109810243,0.46490686772826834,15.384733728720734,18.384756805821297,1922163242,-2447769.4166958444,21.81021625842492,12.262512785489776,37.461416562703086,35.714285714285715,85.71428571428571
2005-06-15,37.83,37.87,37.25,37.7,36.83369641291246,37.020909572579825,37.10604815739268,37.59427906475927,37.16441055000003,36.85015070000005,36.57066080000001,37.888450999999975,37.888450999999975,38.55056893097428,37.22633306902567,104082256,54.64206714860616,63.11553823111585,NaN,NaN,NaN,NaN,NaN,NaN,-0.12303636280483476,0.3111114142222249,0.43414777702705964,31.468751529731254,24.5922564279045,2026245498,44557120.38975735,19.80955091262051,14.836481090186423,35.72676781244085,28.571428571428573,100
2005-06-16,37.74001,38,37.66,37.89999,36.84430629935114,37.03831710579607,37.137183131612574,37.62339439192505,37.18381050000003,36.86385060000005,36.59866060000001,37.92345049999997,37.92345049999997,38.50545906380409,37.34144193619586,90509312,57.498937000366716,61.99292750782677,NaN,NaN,NaN,NaN,NaN,NaN,-0.10778820082064355,0.29941252600125523,0.4072007268218988,45.45416401513326,30.76921642452844,2116754810,81820336.54787686,20.75644048588744,14.074041871754423,33.75802915552225,21.428571428571427,92.85714285714286
2005-06-17,38.12,38.21001,37.75,37.87,36.85451220682028,37.05478607399812,37.165921048019925,37.64688064031314,37.20181050000003,36.87545050000005,36.617260600000016,37.941350999999976,37.941350999999976,38.49286138006408,37.389840619935875,89171248,56.91996878223725,60.81745294967525,NaN,NaN,NaN,NaN,NaN,NaN,-0.09820677573291664,0.284442257155753,0.38264903288866964,43.356946552073715,40.0932873656461,2027583562,39172206.567049675,22.49078031818926,13.093632389644489,32.30518734559811,14.285714285714286,85.71428571428571
2005-06-20,37.72,38.08,37.58,37.87,36.86461656297132,37.07092892401796,37.193531987313264,37.66813010314046,37.21726050000003,36.882650600000055,36.641860600000015,37.95185099999998,37.95185099999998,38.48935375842758,37.41434824157237,68165248,56.91996878223725,59.853677267169516,NaN,NaN,NaN,NaN,NaN,NaN,-0.0905417008396322,0.26947190683912936,0.36001360767876156,43.356946552073715,44.05601903976026,2027583562,50078646.24704944,20.795124862712537,14.669833650390956,30.597052386369285,7.142857142857143,78.57142857142857
2005-06-21,37.83,38.011,37.7,37.85001,36.8744214727925,37.08635627205721,37.2192762231049,37.685451998079465,37.235805500000026,36.890150600000055,36.66926080000001,37.95185099999998,37.95185099999998,38.48935375842758,37.41434824157237,97916256,56.48032815899321,58.64836164429374,NaN,NaN,NaN,NaN,NaN,NaN,-0.08554892526299984,0.2530774511000118,0.3386263763630116,42.55390070921978,43.089264604455764,1929667306,46621667.17669239,19.79541765090586,13.96459438911599,28.249269271637996,0,71.42857142857143
2005-06-22,38.00999,38.10001,37.63,37.81,36.88373071186919,37.100685850828356,37.24244186141451,37.69731371254809,37.25270555000003,36.89905060000005,36.692260800000014,37.943850999999974,37.943850999999974,38.48478692903207,37.40291507096788,75517504,55.55541701084742,57.234172094425055,NaN,NaN,NaN,NaN,NaN,NaN,-0.08357547099708007,0.2341570376166615,0.3177325086137416,40.28776978417281,42.06620568182213,1854149802,28946127.049802005,19.733191652532796,12.951255832516036,26.149939296832397,0,64.28571428571429
2005-06-23,37.88,38.17999,37.33,37.39,36.88876821722373,37.10641484388126,37.24822845508453,37.66804573992446,37.26816055000003,36.89895070000005,36.718860800000016,37.92285099999997,37.92285099999997,38.51328698071148,37.33241501928847,122223744,46.87721041626546,56.025037690714434,NaN,NaN,NaN,NaN,NaN,NaN,-0.10765750923843376,0.18316062206569939,0.29081813130413314,11.466105373508425,31.43592528896703,1731926058,-76022297.1464349,17.28972838880646,15.717913026670537,23.9920418619423,0,57.142857142857146
2005-06-24,37.38,37.41,36.95799,36.97,36.88957649366926,37.10371355984401,37.23731753527729,37.60156519326499,37.28006055000003,36.89345070000005,36.747260800000014,37.86185099999998,37.86185099999998,38.56969415728597,37.15400784271399,142330000,40.126898384367365,54.326148010139036,NaN,NaN,NaN,NaN,NaN,NaN,-0.14656283192585812,0.10761459139681051,0.2541774233226686,0.7937871777922365,17.515887445157848,1589596058,-210788821.5596137,16.144844960960953,20.126900126986826,22.497779074676792,7.142857142857143,100
2005-06-27,36.95,37.06,36.7,36.8,36.88868518527454,37.09769942994611,37.22016782801152,37.525225651049276,37.28846055000003,36.88565070000005,36.788460600000015,37.79135049999998,37.79135049999998,38.61743961426064,36.96526138573932,72888192,37.75692730205871,52.87779733127421,NaN,NaN,37.75692730205871,NaN,NaN,NaN,-0.17643115853106991,0.03363847515883123,0.21006963368990114,6.622472698855948,6.294121750052203,1516707866,-243183573.55961594,15.277173618877645,22.896649128237705,21.14373456452102,0,100
2005-06-28,36.95,37.25999,36.89999,37.14999,36.89128523318225,37.098734886778864,37.21741575632479,37.489488922377916,37.296310500000025,36.885610500000055,36.836460400000014,37.74484999999998,37.74484999999998,38.60472149628447,36.88497850371549,73382064,44.963806484578285,52.04435108061978,NaN,NaN,NaN,NaN,NaN,NaN,-0.1654828547247546,0.003216065283957903,0.1686989200087125,29.800464897583556,12.405574924743915,1590089930,-214646104.22628245,17.219015511814206,21.319986163775127,19.775894558183516,50,92.85714285714286
2005-06-29,37.25,37.25999,36.97,37.06799,36.8930434895685,37.09812607713968,37.21155592274343,37.449346167865734,37.30350045000003,36.87879040000005,36.878020000000014,37.677749499999976,37.677749499999976,38.528932247206114,36.82656675279384,71580368,43.687496188352256,50.89545692741298,NaN,NaN,NaN,NaN,NaN,NaN,-0.156716829595698,-0.027197116985909986,0.129519712609788,24.37003728452132,20.264324960320277,1518509562,-237851285.07969028,16.44997114949521,20.367782180177997,18.1980014336368,42.857142857142854,85.71428571428571
2005-06-30,37.14,37.21001,36.75,36.78,36.89191867872702,37.091826550859686,37.19463216106722,37.385598913783284,37.31113540000003,36.869850400000054,36.919540200000014,37.58374949999998,37.58374949999998,38.39454891609482,36.772950083905144,87963248,39.45194565314277,49.938316553796305,NaN,NaN,NaN,NaN,NaN,NaN,-0.16256675520081937,-0.07368873139123622,0.08887802380958315,5.297978159084947,19.822826780396607,1430546314,-314341315.36703134,15.283847244822251,22.31420341707306,17.640306659589708,35.714285714285715,78.57142857142857
2005-07-01,36.86,37.00101,36.67999,36.72501,36.89025789585412,37.08456285678326,37.17621560573125,37.32268568389916,37.31816040000003,36.85970040000006,36.94164040000001,37.51499949999997,37.51499949999997,38.37096163008669,36.65903736991326,55292736,38.68079522890146,48.74564106589975,NaN,NaN,NaN,NaN,NaN,NaN,-0.16203097461284854,-0.11366069445647753,0.048370280156371015,2.9424451967948744,10.87015354680038,1375253578,-354125491.3102123,14.510775700756273,22.28863002351061,17.14846914541727,28.571428571428573,100
2005-07-05,36.64,37.19,36.60001,37.11,36.89244438445259,37.08506656258953,37.17361891531042,37.30242990448019,37.326560450000024,36.85970040000006,36.98204040000002,37.464999499999976,37.464999499999976,38.292447968572006,36.63755103142795,79288688,46.5569196845718,48.29419187325188,NaN,NaN,NaN,NaN,NaN,NaN,-0.129073046505364,-0.11297102797533398,0.016102018530030016,31.67639751552808,13.305606957135966,1454542266,-296339184.8421022,16.10529749990657,20.260336104831836,15.963054030831419,21.428571428571427,100
2005-07-06,37.03,37.28,36.864,36.92999,36.89281797266699,37.08199573956796,37.16406484020021,37.26695943738684,37.33404540000003,36.857500400000056,37.01314020000002,37.42199949999998,37.42199949999998,38.26662855239042,36.57737044760953,79331936,43.72869175343779,47.51466505931129,NaN,NaN,NaN,NaN,NaN,NaN,-0.11328404998100368,-0.12550304394622458,-0.012218993965220904,20.49565217391299,18.371498295411982,1375210330,-350502301.3390258,16.462680526762004,18.950825529887958,15.439628314964688,14.285714285714286,92.85714285714286
2005-07-07,36.58,37.09,36.5498,37.06,36.894481475426524,37.08156018036859,37.15998386607471,37.24724901477857,37.34149535000003,36.85110040000006,37.05334020000002,37.38949899999997,37.38949899999997,38.237314914051936,36.54168308594801,120216320,46.267511862660356,46.71242040661798,NaN,NaN,NaN,NaN,NaN,NaN,-0.08904094304169177,-0.12352017276733562,-0.03447922972564385,30.731052095819496,27.63436726175352,1495426650,-243638404.88586068,15.098009442595298,22.20136532946832,15.429533961968671,7.142857142857143,100
2005-07-08,37.08,37.81,36.993,37.77,36.903193102536704,37.09519265204446,37.18390606740511,37.297034822894894,37.35559535000002,36.850110400000055,37.106740000000016,37.38049899999997,37.38049899999997,38.20789959954022,36.553098400459724,101469248,57.53531187069026,46.75637348436462,NaN,NaN,NaN,NaN,NaN,NaN,-0.023553278045287243,-0.0639208272822529,-0.04036754923696566,74.85017083898235,42.025625036238274,1596895898,-152104946.16370624,23.785119786515786,19.560428765743243,14.239426386155662,0,92.85714285714286
2005-07-11,37.87,38.16,37.8,38.12,36.91530063385475,37.11548586685546,37.22061563338922,37.37541245880966,37.371600300000026,36.850110400000055,37.17414000000002,37.40914899999997,37.40914899999997,38.29522816763719,36.52306983236275,96455504,61.789170241068625,47.10417358856686,NaN,NaN,NaN,NaN,NaN,NaN,0.041432028999728254,0.01142248701269466,-0.030009541987033594,96.32006085180261,67.30042792886816,1693351402,-77083998.60815027,27.58612786188393,18.433214205662633,14.426418213866187,21.428571428571427,85.71428571428571
2005-07-12,38.12,38.46001,38.00999,38.3,36.929078737000474,37.13894159226426,37.26294443207984,37.4634684151135,37.389105300000026,36.853310400000055,37.24054000000002,37.43764899999997,37.43764899999997,38.396826418061856,36.47847158193809,86105568,63.79770930546098,47.62684367045741,NaN,NaN,NaN,NaN,NaN,NaN,0.09175239581074304,0.0846809527763952,-0.007071443034347834,91.62343407269358,87.59788858782618,1779456970,-52210162.24532254,30.19765915760188,17.201403446064532,15.151233462372458,100,78.57142857142857
2005-07-13,38.33,38.42999,38.17,38.39,36.943615266980565,37.16371502608081,37.30714268964534,37.55170951843603,37.40855530000003,36.86251040000005,37.30594000000002,37.478148999999966,37.478148999999966,38.52256368934595,36.43373431065398,72552496,64.79417650833085,48.286755063134805,NaN,NaN,NaN,NaN,NaN,NaN,0.12429047339825214,0.14829164871346734,0.024001175315215204,96.33495793656213,94.75948428701945,1852009466,-1976788.6349511072,28.99225034689869,16.514769983446396,15.627595570953046,92.85714285714286,71.42857142857143
2005-07-14,38.64999,38.88,38.52,38.77,36.961788249398666,37.19552264932673,37.36450964299258,37.66773718334688,37.42955525000003,36.87671030000005,37.37534000000002,37.531648999999966,37.531648999999966,38.7162524236489,36.34704557635103,103210944,68.71028196139272,49.84626017350104,NaN,NaN,NaN,NaN,NaN,NaN,0.16220109618376294,0.22675254554491886,0.06455144936115594,95.27937516093043,94.41258905672872,1955220410,38160800.69838245,33.70238443344225,15.277043938476861,17.9744923479071,100,64.28571428571429
2005-07-15,38.85001,39,38.649,38.89,36.98097443597182,37.229076656270756,37.424332794247775,37.784143165885276,37.44860525000003,36.89671030000005,37.43858000000002,37.58114949999997,37.58114949999997,38.89848489491797,36.26381410508196,67732880,69.85078946782714,51.96939525089102,NaN,NaN,NaN,NaN,NaN,NaN,0.1845295070244377,0.29521333314170306,0.11068382611726536,95.51057056566813,95.70830122105356,2022953290,63440023.718325585,33.728928091853696,14.442062283475776,20.05020289433681,100,57.142857142857146
2005-07-18,38.75999,38.89,38.688,38.733,36.99840752616115,37.258857316542624,37.47565307682629,37.87451048342001,37.466570250000025,36.91464030000005,37.49804020000001,37.624299499999964,37.624299499999964,39.030211960043324,36.2183870399566,59117168,66.43869772834806,54.01809313848312,NaN,NaN,NaN,NaN,NaN,NaN,0.17782272415299882,0.3329622313085139,0.15513950715551506,89.10293037303066,93.29762536654307,1963836122,30662187.995550383,32.6238283783298,13.968880365310463,21.484373821501425,92.85714285714286,50
2005-07-19,38.92,39.196,38.84,39.17999,37.020114814458054,37.296899547898214,37.542489818911534,37.99884186595144,37.48197015000003,36.93234020000005,37.56450020000002,37.68979899999997,37.68979899999997,39.249090488631495,36.13050751136845,78687504,70.81048566810591,55.86428450873508,NaN,NaN,NaN,NaN,NaN,NaN,0.19140876181957864,0.39440045942998836,0.20299169761040972,99.39498148288106,94.66949414052662,2042523626,102272237.28184177,35.1279367628829,12.923680278428728,24.02495127390907,100,42.857142857142854
2005-07-20,38.94,39.57001,38.89999,39.46001,37.0443923784933,37.33973341823686,37.61768668875814,38.13800073586083,37.49770520000003,36.95074030000005,37.63310040000002,37.77029899999997,37.77029899999997,39.510145208870036,36.03045279112991,91982320,73.1684736615173,57.97006861396117,NaN,NaN,NaN,NaN,NaN,NaN,0.2059098491039475,0.4603790089903441,0.2544691598863966,96.35786915479368,94.95192700356847,2134505946,164052308.99074423,37.28890015248553,11.574050446983456,27.023907376259327,100,35.714285714285715
2005-07-21,39.56,39.69299,39.21001,39.47,37.06852777771227,37.38191691490544,37.6903264264539,38.26485780863599,37.51325520000003,36.97324030000005,37.70718020000002,37.85329899999997,37.85329899999997,39.74459228622488,35.96200571377506,127792688,73.25149226031961,60.38432194304522,NaN,NaN,NaN,NaN,NaN,NaN,0.20252230684586242,0.5076220434437246,0.3050997365978622,92.90561499622986,96.21948854463487,2262298634,173842216.34922662,36.40206183832244,10.706116837134338,29.58447520132145,100,28.571428571428573
2005-07-22,39.46001,39.59,39.22,39.42,37.09192551126737,37.4222749957984,37.7581567626714,38.37487135067065,37.527105250000034,36.99114030000005,37.77658020000002,37.954798999999966,37.954798999999966,39.95073549861937,35.95886250138056,71717376,72.0499123007499,62.76783030532011,NaN,NaN,NaN,NaN,NaN,NaN,0.18381008775796048,0.5348623462953128,0.35105225853735234,91.31487437921349,93.52611951007901,2190581258,179657138.72760516,34.281190646952574,10.082352862660398,31.97096518171851,92.85714285714286,21.428571428571427
2005-07-25,39.44,39.62601,39.2,39.27,37.11359789423983,37.45886360974299,37.817444732762716,38.46012169822583,37.54225520000003,37.007740300000044,37.84498000000002,38.069798999999975,38.069798999999975,40.09040470783071,36.04919329216924,52058528,68.42373595077815,64.32974575290628,NaN,NaN,NaN,NaN,NaN,NaN,0.14967287681378583,0.5381433545545846,0.3884704777407988,86.54265252816413,90.25438063453583,2138522730,144706645.56246835,32.54100888791703,9.40305530473667,35.095115504876425,85.71428571428571,14.285714285714286
2005-07-26,39.36,39.53,39.19,39.42,37.13654716892401,37.49769799370848,37.880290037360254,38.551538679347175,37.56145520000003,37.028940300000045,37.90857980000002,38.200798999999975,38.200798999999975,40.214833278387346,36.186764721612604,69662880,70.04718191120645,66.20963790703262,NaN,NaN,NaN,NaN,NaN,NaN,0.12646127319594386,0.5465470692357286,0.42008579603978474,91.31487437921349,89.72413376219704,2208185610,169293544.38599846,30.759758822977183,9.049340945953174,38.48871136146664,78.57142857142857,7.142857142857143
2005-07-27,39.44,39.75999,39.226,39.72,37.16225316724317,37.54170397403108,37.95243552609122,38.66282070988554,37.58130520000003,37.05094030000005,37.973300000000016,38.329299499999976,38.329299499999976,40.38624845058234,36.27235054941761,83631440,73.0333779755056,68.12148548652155,NaN,NaN,NaN,NaN,NaN,NaN,0.12059883795361148,0.5708343434817991,0.4502355055281876,98.55474721628907,92.1374247078889,2291817050,240398827.39579177,31.802912068287803,8.28251790540702,41.31953279733961,100,0
2005-07-28,39.75,39.92101,39.64,39.91,37.18959393174821,37.58860092504037,38.02920276036215,38.78159968989644,37.602405200000035,37.069440300000046,38.03750000000002,38.471399999999974,38.471399999999974,40.55270037718816,36.39009962281179,67122752,74.75031225313441,69.35112837098185,NaN,NaN,NaN,NaN,74.75031225313441,NaN,0.11862303171614874,0.5985142951733735,0.47989126345722477,99.48090768077445,96.45017642542568,2358939802,302261827.0772238,32.97127803873928,7.9029906208705,45.0040828927491,100,0
2005-07-29,39.87,39.92,39.52,39.575,37.21332931551191,37.627935560188085,38.089822259955795,38.85716162419202,37.62223020000003,37.08839040000005,38.08500000000002,38.61114999999997,38.61114999999997,40.592339241361366,36.62996075863857,74758624,66.68814754423782,69.70105532120822,NaN,NaN,NaN,NaN,NaN,NaN,0.08541222488172584,0.5866565445593821,0.5012443196776563,81.89396238657892,93.3098724278808,2284181178,248061824.67722374,30.807279942084154,9.353279753794688,47.39917541846987,92.85714285714286,0
2005-08-01,39.64,39.83,39.52,39.64999,37.23757469545707,37.667976242164556,38.15100530858498,38.93266908855468,37.64323015000003,37.10919020000005,38.12776000000002,38.75739899999997,38.75739899999997,40.58602925767393,36.928768742326014,59877296,67.53232372195441,69.9678134938149,NaN,NaN,NaN,NaN,NaN,NaN,0.060334822419148115,0.5766628477015914,0.5163280252824433,84.52207583052068,88.63231529929135,2344058474,238400333.23877266,29.207354653992727,8.867532591668656,49.2564445233949,85.71428571428571,0
2005-08-02,39.69,40.14,39.65401,40.08,37.265857534308246,37.71573908885437,38.226652159228706,39.04193869916852,37.66548015000003,37.134790200000054,38.17616000000002,38.90589899999997,38.90589899999997,40.65597031491292,37.15582768508702,79724688,71.9257413653838,70.4772109836044,NaN,NaN,NaN,NaN,NaN,NaN,0.06418891086591794,0.5965641638648407,0.5323752529989227,96.29629629629615,87.5707781711319,2423783162,298439508.0389119,31.973570198951563,8.147276810954681,51.53983836353118,100,0
2005-08-03,39.89,40.13,39.88,40.06,37.293659946902196,37.76216009699587,38.298548152984445,39.13889691829532,37.685080150000026,37.16369020000005,38.22035980000002,39.06239949999997,39.06239949999997,40.627751386849816,37.49704761315012,61975632,71.44152648472591,70.6722998781282,NaN,NaN,NaN,NaN,NaN,NaN,0.057109773227059124,0.6037624695327466,0.5466526963056875,94.63447350771305,91.81761521150996,2361807530,325708786.11891174,30.607624807389875,7.799216361513039,53.094680359255605,92.85714285714286,0
2005-08-04,39.88,39.94,39.57001,39.673,37.317334972306156,37.799998510916744,38.352448225416424,39.189763878457676,37.70404515000003,37.18702020000005,38.25441980000002,39.19304949999997,39.19304949999997,40.479398862445,37.90670013755494,72061744,62.65219704889916,70.15811470534763,NaN,NaN,NaN,NaN,NaN,NaN,0.019997754035879667,0.571649888850537,0.5516521348146574,67.83746556473834,86.25607845624917,2289745786,293765094.03685546,28.075946597211814,12.38697492587791,53.00434877397959,85.71428571428571,0
2005-08-05,39.61,39.78999,39.427,39.48,37.33885402730809,37.83326586713621,38.39666594206676,39.217405413842656,37.72120515000003,37.21142030000006,38.28781980000002,39.27854949999997,39.27854949999997,40.390713078015615,38.16638592198432,71262816,58.76904263573145,69.61028219873216,NaN,NaN,NaN,NaN,NaN,NaN,-0.021657772253943608,0.5245799194972278,0.5462376917511714,49.230769230768836,70.56756943440674,2218482970,243312378.85505855,26.3379347989744,14.059050236306012,52.31557771005193,78.57142857142857,0
2005-08-08,39.52,39.61,39.14,39.19,37.35727339022044,37.86013188956916,38.427777081593554,39.214795374429066,37.734155100000024,37.23717020000005,38.30781980000002,39.33204949999997,39.33204949999997,40.311120303499536,38.3529786965004,64634752,53.41214052254414,68.36754325976347,NaN,NaN,NaN,NaN,NaN,NaN,-0.0701183801966564,0.45858971650535096,0.5287080967020074,23.387714615204366,46.81864980357051,2153848218,192429701.7486748,24.245121182878325,17.7940523697917,50.1110204641525,71.42857142857143,0
2005-08-09,39.37,39.59,39.306,39.45,37.37809654056651,37.891614426409376,38.467864254864395,39.237195814959634,37.752405100000026,37.26457010000005,38.332619600000015,39.38954949999997,39.38954949999997,40.24693615038802,38.53216284961193,64615440,57.18061480148364,67.22555334118962,NaN,NaN,NaN,NaN,NaN,NaN,-0.08504436726567177,0.4224026376199177,0.5074470048855895,31.000000000000227,34.539494615324465,2218463658,193339778.36839423,22.599271774487097,16.58612561435086,47.448084568310456,64.28571428571429,0
2005-08-10,39.55,39.685,38.97,39.11,37.39532941080963,37.91574087341117,38.49304604879128,39.22508192782062,37.76983010000003,37.290570200000055,38.35321960000002,39.425549499999974,39.425549499999974,40.16429005815494,38.68680894184501,104471008,51.332988633789505,65.65994593929462,NaN,NaN,NaN,NaN,NaN,NaN,-0.11626582371333549,0.3621147252439201,0.47838054895725557,11.965811965811996,22.11784219367219,2113992650,129780493.7809816,19.987395095129624,20.100354973482606,43.57202076762961,57.142857142857146,100
2005-08-11,39.13,39.541,39.10001,39.43201,37.415594889309034,37.94576600463075,38.529868164524956,39.24478936326627,37.78789010000003,37.319090300000056,38.37365980000002,39.45864999999997,39.45864999999997,40.133493950913405,38.783806049086536,93638064,55.92974483483831,64.50850540601522,NaN,NaN,NaN,NaN,NaN,NaN,-0.11355135937950067,0.33644134973287976,0.44999270911238043,39.48803418803408,27.484615384615424,2207630714,177133550.88576907,18.562441553748606,18.66734822767315,39.695956966948756,50,92.85714285714286
2005-08-12,39.12,39.32001,38.97,39.21001,37.433449766032325,37.97080053919252,38.556540393367115,39.2414770429552,37.80029015000003,37.34989040000005,38.38466000000002,39.47465049999997,39.47465049999997,40.108749939761275,38.84055106023866,86470128,52.26458752298315,63.354280518315576,NaN,NaN,NaN,NaN,NaN,NaN,-0.12416745483002467,0.2947833905748496,0.41895084540487426,20.51367521367502,23.989173789173687,2121160586,209252579.88859504,17.18050604232105,19.37257384638145,36.18403632836145,42.857142857142854,85.71428571428571
2005-08-15,39.14,39.63,39.077,39.446,37.45347514149469,38.00001240970356,38.591421162254676,39.260955419816604,37.81272010000002,37.38175050000005,38.41157980000002,39.51030049999997,39.51030049999997,40.04616754218829,38.97443345781165,63066320,55.59577721412309,62.32203732566676,NaN,NaN,NaN,NaN,NaN,NaN,-0.11307151903383961,0.27761144661257475,0.39068296564641436,40.683760683760546,33.5618233618232,2184226906,230350715.87412778,20.58451858519089,17.67627678391052,32.83152073360408,35.714285714285715,78.57142857142857
2005-08-16,39.3,39.33,38.74001,38.81,37.46697290128081,38.01605176792725,38.599992881381944,39.21800728459598,37.82227015000002,37.40715050000005,38.425579800000015,39.49180099999997,39.49180099999997,40.09350500836449,38.890096991635446,94913008,46.23202703478747,60.40765511561547,NaN,NaN,NaN,NaN,NaN,NaN,-0.14433922178222502,0.21025893841863308,0.3545981602008581,4.999321423724747,22.06558577372009,2089313898,157956602.87207824,18.37271742233217,20.9058607223809,29.101056713299865,28.571428571428573,100
2005-08-17,38.92,39.17,38.78999,39.03999,37.48262481271085,38.03632777252275,38.61724767034736,39.2010532574916,37.832280150000024,37.43415040000005,38.45057980000002,39.47079999999997,39.47079999999997,40.10397300012356,38.83762699987638,75633808,49.54164325515659,58.6070359014742,NaN,NaN,NaN,NaN,NaN,NaN,-0.1449260908320696,0.17344054666077113,0.3183666374928407,21.427295909256816,22.37012600558069,2164947706,181838344.46287885,17.29546198749365,19.68007840801364,25.180980409281684,21.428571428571427,92.85714285714286
2005-08-18,38.87,39.10001,38.77,38.843,37.49616088422617,38.05230147999755,38.62610070288276,39.16695294725431,37.84069015000002,37.462080400000055,38.47323960000002,39.439449999999965,39.439449999999965,40.129234892620346,38.749665107379585,72727120,46.879932494764525,57.192163397940384,NaN,NaN,NaN,NaN,NaN,NaN,-0.15317059328116672,0.12690339589138233,0.28007398917254905,7.356481117722646,11.261032816901393,2092220586,141286490.4245171,16.39635893233796,18.971904275533312,21.885373954872673,14.285714285714286,85.71428571428571
2005-08-19,38.89,39.00101,38.78999,38.82001,37.50933351224382,38.06750362890849,38.63370498904422,39.133910761801516,37.847740200000025,37.48298050000005,38.49063980000002,39.40945049999997,39.40945049999997,40.15030732848012,38.66859367151982,52177680,46.56549512687096,55.69453278400585,NaN,NaN,NaN,NaN,NaN,NaN,-0.15432918128053577,0.08716251257187935,0.24149169385241512,5.7143265309041675,11.499367852627868,2040042906,103954549.72505766,15.829688091425009,18.31622059637617,18.589767500463665,7.142857142857143,78.57142857142857
2005-08-22,38.88,39.17999,38.597,38.84,37.52257397480856,38.08280058675189,38.64179498947386,39.10591926067756,37.85384020000002,37.50568040000005,38.51649980000002,39.38795049999997,39.38795049999997,40.16768463822038,38.608216361779554,93266688,46.899004728725004,53.90690873853022,NaN,NaN,NaN,NaN,NaN,NaN,-0.1478910896697852,0.0566278317651836,0.2045189214349688,15.851272015655702,9.640693221427496,2133309594,88438098.20938975,14.35374120036847,19.694972658609817,15.46838975290383,0,100
2005-08-23,38.84,38.92,38.61,38.73,37.53458816411395,38.0956164167172,38.645254009494494,39.070117426327315,37.857690150000025,37.53098040000006,38.53649980000002,39.353450499999965,39.353450499999965,40.18387127545461,38.523029724545324,57532048,45.226214938315636,52.0343864852152,NaN,NaN,NaN,NaN,NaN,NaN,-0.14498762626324244,0.02328438860591575,0.1682720148691582,9.903201787043628,10.489600111201156,2075777546,75446990.59648524,13.626198709364113,18.69670124850944,12.347012005344,0,92.85714285714286
2005-08-24,38.649,39.17999,38.46001,38.5,37.544194252033215,38.10362401242577,38.639557773828045,39.015820528581855,37.86019015000002,37.55138030000006,38.554899800000015,39.292450499999966,39.292450499999966,40.1832470583151,38.401653941684835,95038000,41.863908089253464,50.54950870238337,NaN,NaN,NaN,NaN,NaN,NaN,-0.15177946721736776,-0.021452319152551524,0.13032714806481624,3.0068121325134882,9.587095311737597,1980739546,-9033578.308205739,16.15597940882356,16.593096630651775,9.672801080721145,0,100
2005-08-25,38.53,38.692,38.49001,38.588,37.554580378878654,38.11321561614011,38.637535900344595,38.975075716335965,37.86353015000002,37.571660300000055,38.57265980000002,39.22635049999997,39.22635049999997,40.120228731475606,38.33247226852433,52338688,43.59184745387572,49.46542333225081,NaN,NaN,NaN,NaN,NaN,NaN,-0.14365214438806892,-0.04923803242026992,0.094414111967799,10.448248557131363,7.786087492229484,2033078234,-10590860.920611318,15.62483964524692,16.04758631534428,7.597029634749954,0,92.85714285714286
2005-08-26,38.53,38.60001,38.27,38.4599,37.5635885343127,38.12008065344427,38.63056978660559,38.92601136239921,37.86687970000002,37.591259300000054,38.58385800000001,39.17059549999997,39.17059549999997,40.108551677881024,38.232639322118914,63884160,41.65113733388886,48.62535167591829,NaN,NaN,41.65113733388886,NaN,NaN,NaN,-0.14006341128012278,-0.08066515213235448,0.059398259147768306,13.420494699646255,8.958518463097027,1969194074,-952388.370083455,14.770458945656321,18.81553973117394,7.361213544231792,14.285714285714286,100
2005-08-29,38.25999,38.85001,38.25999,38.75999,37.575493026508596,38.13275212565329,38.635645089091646,38.910199804075475,37.86922970000002,37.60945920000006,38.60165780000001,39.12609549999997,39.12609549999997,40.05323969030941,38.19895130969053,74971184,47.54291836940214,47.936944787912466,NaN,NaN,NaN,NaN,NaN,NaN,-0.11186218728573065,-0.08042947495939501,0.03143271232633564,35.08747307036441,19.652072109047342,2044165258,51141923.71479599,17.39958313635508,17.023270769956763,6.343201405321413,7.142857142857143,100
2005-08-30,38.56,38.655,38.32001,38.62,37.58588613072244,38.14240059841263,38.63503155618609,38.88256172749686,37.86902970000002,37.62925920000006,38.61665780000001,39.05309549999997,39.05309549999997,39.89423765304293,38.21195334695701,87506256,45.24761512756303,47.50227525175343,NaN,NaN,NaN,NaN,NaN,NaN,-0.09754260652966898,-0.09049554583575059,0.007047060693918392,26.27791038021586,24.928626050075508,1956659002,120362744.56747611,16.16316915743996,15.813597539173784,6.401160225414296,0,92.85714285714286
2005-08-31,38.64,39.00999,38.478,38.98,37.59975791051625,38.15898672517673,38.64855973045331,38.89184156297335,37.86977970000002,37.654259200000055,38.63925760000001,38.99909549999997,38.99909549999997,39.702055938165216,38.29613506183472,93452000,51.7048675679099,47.20049830411568,NaN,NaN,NaN,NaN,NaN,NaN,-0.060543913845172194,-0.06863283161254685,-0.008088917767374656,52.555090838752605,37.973491429777624,2050111002,203278360.50010467,20.445711393962803,14.474297801853647,7.602480366722356,14.285714285714286,85.71428571428571
2005-09-01,38.99001,39.14999,38.78,38.92,37.61289464772505,38.17405629497521,38.65920444690612,38.89452331888065,37.87141470000002,37.67685920000006,38.66145760000001,38.96144549999997,38.96144549999997,39.593034806610696,38.32985619338924,74917184,50.63307084431239,47.08396139849635,NaN,NaN,NaN,NaN,NaN,NaN,-0.03793535275629496,-0.055508108712743365,-0.0175727559564484,48.175560762330164,42.336187327099545,1975193818,185056794.00328046,21.483206861320546,13.610910829049258,8.776409576174393,7.142857142857143,78.57142857142857
2005-09-02,38.98,39.03101,38.74001,38.77,37.62440813381734,38.18585716042124,38.66354937055686,38.88266395517773,37.86971470000002,37.70395920000006,38.68905760000001,38.92594549999997,38.92594549999997,39.51536434447713,38.33652665552281,53270336,47.95664929119799,46.5383094040017,NaN,NaN,NaN,NaN,NaN,NaN,-0.031188552900654955,-0.056558447082267094,-0.02536989418161214,47.66404052298604,49.4648973746896,1921923482,142766371.2447942,20.449996139597342,13.617228306737072,9.66609663149645,0,71.42857142857143
2005-09-06,38.94,39.41,38.89999,39.34,37.64147869965,38.20871147407627,38.690076846221295,38.92621976897033,37.869964750000015,37.74185920000006,38.736457600000016,38.93344549999997,38.93344549999997,39.53969037150482,38.32720062849512,78129744,57.21230904520927,47.32261526188898,NaN,NaN,NaN,NaN,NaN,NaN,0.011282526879958493,-0.011266735581664022,-0.022549262461622515,93.91309640785789,63.250899231058035,2000053226,199449155.0675446,24.41438034667595,12.224712549236196,11.581839134963122,100,64.28571428571429
2005-09-07,39.3,39.479,39.21001,39.409,37.6590659762704,38.23247956369852,38.71826991107536,38.9721988385922,37.87360980000002,37.78854910000006,38.78863760000001,38.93139549999997,38.93139549999997,39.53087922823958,38.33191177176037,57470400,58.18184936008529,47.93977284081245,NaN,NaN,NaN,NaN,NaN,NaN,0.04192012430736914,0.029850892922588912,-0.012069231384780228,94.25763529421413,78.61159074168602,2057523626,227008197.76801687,24.4691093268949,11.683907957027477,13.647193499323922,100,57.142857142857146
2005-09-08,39.28999,39.57001,39.27,39.39999,37.67638860337218,38.255598582239145,38.74500403220966,39.01294085396437,37.87535975000002,37.835049000000055,38.83363760000001,38.945894999999965,38.945894999999965,39.57524072853619,38.31654927146374,73544560,57.997044550885825,48.73385227339254,NaN,NaN,NaN,NaN,NaN,NaN,0.05846069036778241,0.06100663157494779,0.0025459412071653746,87.0215721897375,91.7307679639365,1983979066,217195229.07763952,24.765104188214618,11.094399816079571,15.850113475600475,100,50
2005-09-09,39.41,39.69,39.31,39.619,37.69571807000529,38.2825966301156,38.77927838388771,39.07066077263443,37.87850470000002,37.88133890000006,38.88465780000001,38.95524449999997,38.95524449999997,39.61787479132686,38.29261420867308,75389936,61.22139176672146,49.78070203338187,NaN,NaN,NaN,NaN,NaN,NaN,0.07971688643234082,0.1021920492475914,0.02247516281525058,95.0349997552466,92.10473574639941,2059369002,264413136.36185053,25.203688174113175,10.380015008009629,18.305579284180215,100,42.857142857142854
2005-09-12,39.63,39.86301,39.58,39.73,37.71595968124902,38.311258082984594,38.81656158451956,39.133454984764484,37.88050470000002,37.93159900000006,38.94365780000001,38.981243999999975,38.981243999999975,39.718429954790196,38.244058045209755,51700992,62.780844393497354,50.915119152294174,NaN,NaN,NaN,NaN,62.780844393497354,NaN,0.09573982632647113,0.1421499457233395,0.046410119396868364,91.7025364624268,91.25303613580364,2111069994,267516913.0979362,26.968100833055164,9.870261833237857,20.500301175388326,100,35.714285714285715
2005-09-13,39.679,39.91,39.53999,39.63,37.73500485855002,38.33737178431163,38.84846113022468,39.18074498621549,37.88260465000002,37.971699000000065,39.00175760000001,38.990443999999975,38.990443999999975,39.75469645406228,38.226191545937674,66186128,60.42337192238909,52.000630365442284,NaN,NaN,NaN,NaN,NaN,NaN,0.09395897615619252,0.163858839592109,0.06989986343591649,83.03040587632833,89.92264736466724,2044883866,233532149.28420183,26.045320163383888,9.231924059229524,22.784137801071953,100,28.571428571428573
2005-09-14,39.64999,39.67999,39.14999,39.17999,37.74938282015649,38.35405729353318,38.86146226237273,39.18067308276639,37.88248960000002,38.012598900000064,39.04315740000001,39.00894349999997,39.00894349999997,39.77274086667286,38.24514613332708,98671680,51.12042068444341,52.661809836527276,NaN,NaN,NaN,NaN,NaN,NaN,0.05856143837348603,0.14310166140277403,0.084540223029288,55.757237834922066,76.8300600578924,1946212186,146030848.1521243,23.68266898345695,15.069581149178582,24.276372521965353,92.85714285714286,21.428571428571427
2005-09-15,39.25999,39.34,39.05,39.16,37.76341881199573,38.37001655504738,38.873169624632624,39.17870421774102,37.88267965000002,38.05044890000006,39.08775760000001,39.01494399999997,39.01494399999997,39.78150334508729,38.248384654912655,80476192,50.74665577352189,53.17286757364486,NaN,NaN,NaN,NaN,NaN,NaN,0.0312586079120578,0.12361348291936025,0.09235487500730245,54.545730025878484,64.44445791237628,1865735994,126605560.42798471,22.480980319900087,16.05445542806219,25.372242245175094,85.71428571428571,14.285714285714286
2005-09-16,39.25,39.46001,39.10899,39.39999,37.77970310242363,38.390412068808814,38.89382924719605,39.19977905414664,37.88007960000002,38.093948800000064,39.134557400000006,39.04279349999997,39.04279349999997,39.822697332235464,38.26288966776448,71052752,55.00045748646565,54.126390441686056,NaN,NaN,NaN,NaN,NaN,NaN,0.02698071421655754,0.12608076777799937,0.09910005356144183,69.09049036066475,59.79781940715509,1936788746,173360060.6187452,23.207329905260845,15.058453371427264,26.03306477607183,78.57142857142857,7.142857142857143
2005-09-19,39.32001,39.38,38.91,39.09,37.79274088249902,38.40426529516903,38.90152221789425,39.18932390613267,37.87517955000003,38.133848700000065,39.16095740000001,39.056292999999975,39.056292999999975,39.82962361150303,38.28296238849692,73395504,49.10149717317529,54.23771749909842,NaN,NaN,NaN,NaN,NaN,NaN,0.0021987258234173607,0.10184846084071353,0.09964973501729617,48.42734859967693,57.35452299540672,1863393242,156182389.46981046,21.227601473125926,17.23824606496423,26.695775997453914,71.42857142857143,0
2005-09-20,39.16,39.541,38.80901,38.92999,37.804056794115944,38.414675685363704,38.90263860150624,39.16462543888194,37.86917950000002,38.17564860000006,39.17715720000001,39.06079249999998,39.06079249999998,39.83007346939817,38.29151153060178,115514320,46.338771203740144,54.31565721882536,NaN,NaN,NaN,NaN,NaN,NaN,-0.02456935723554489,0.06893803847286506,0.09350739570840995,31.56354748603328,49.69379548212498,1747878922,78851439.27977943,21.320190343270507,15.157956817192463,27.824328890334588,64.28571428571429,0
2005-09-21,38.82001,38.87,38.47,38.5,37.81098160213469,38.41636527575254,38.88684885242756,39.101327778036044,37.86032950000003,38.21084860000006,39.18115720000001,39.04929249999998,39.04929249999998,39.8444510501505,38.25413394984946,116424064,39.84993763305093,53.46887650919257,NaN,NaN,39.84993763305093,NaN,NaN,NaN,-0.06835255315037553,0.008066704270440539,0.07641925742081607,2.0833333333334156,27.35807647301454,1631454858,-20109015.12021984,19.71045244834726,19.578012335936553,26.626959831022127,57.142857142857146,100
2005-09-22,38.44,38.73,38.24001,38.64,37.81923054141693,38.42079368613368,38.87716850527354,39.05739179917547,37.85562950000002,38.24604860000006,39.18615720000001,39.05629249999997,39.05629249999997,39.834264697369626,38.27832030263031,119165184,42.665051168032754,52.89973224660116,NaN,NaN,NaN,NaN,NaN,NaN,-0.08397408519323286,-0.02854834907072501,0.055425736122507854,23.951640428984778,19.19950708278382,1750620042,55280309.94388521,18.13933396890529,21.758850111047124,25.672669029148523,50,100
2005-09-23,38.5,38.88,38.41,38.75,37.82849192906452,38.42731262304192,38.872181505066735,39.02811638973019,37.85032950000002,38.28054860000006,39.185757200000005,39.064392499999975,39.064392499999975,39.82589216899465,38.3028928310053,70170128,44.84909722075203,52.677764241569314,NaN,NaN,NaN,NaN,NaN,NaN,-0.082848661368342,-0.04813509058791965,0.03471357078042235,30.538506218600254,18.857826660306145,1820790170,86632920.32686366,19.18731507653419,20.103537047724597,24.40661019856984,42.857142857142854,92.85714285714286
2005-09-26,38.97,39.03,38.55,38.75999,37.83776056658626,38.433900293872775,38.867781838201374,39.002580543089216,37.843879450000024,38.31086850000006,39.18315700000001,39.07939699999998,39.07939699999998,39.80357318414803,38.35522081585193,69345120,45.05380646753265,51.80929977173527,NaN,NaN,NaN,NaN,NaN,NaN,-0.07747914232516305,-0.062135357126031465,0.015343785199131585,31.136713393493633,28.542286680359553,1890135290,77961890.94686455,20.11867812964275,18.551337702235017,22.319720763307295,35.714285714285715,85.71428571428571
2005-09-27,38.8,38.89999,38.50999,38.67,37.846041555973464,38.438575535578266,38.860025687683674,38.97090620565215,37.837579500000025,38.33996860000006,39.181897000000006,39.07489749999998,39.07489749999998,39.808019030224166,38.34177596977579,64094336,43.487896867975,50.759731736584534,NaN,NaN,NaN,NaN,NaN,NaN,-0.07593488507261234,-0.07957482114163383,-0.0036399360690215,25.748058371607257,29.141092661233714,1826040954,66461066.24614644,18.845495691297955,18.026567073022576,19.952354090454264,28.571428571428573,78.57142857142857
2005-09-28,38.77,38.95,38.558,38.67999,37.85433955044139,38.443356020022264,38.85296546463726,38.94319990035194,37.829579450000026,38.368198600000056,39.17189700000001,39.07789699999997,39.07789699999997,39.80400665403909,38.35178734596085,72059504,43.721743839039526,49.74006740002409,NaN,NaN,NaN,NaN,NaN,NaN,-0.07031561932811853,-0.09153446022916967,-0.021218840901051136,26.34626554650021,27.743679103867027,1898100458,39251250.47553264,18.45520715309556,16.870892897579495,17.54963025986865,21.428571428571427,71.42857142857143
2005-09-29,38.63,39.211,38.44501,39.2,37.8677292066559,38.45833906913074,38.866574662102465,38.96765705269938,37.82319440000003,38.399898600000064,39.16669680000001,39.08889699999997,39.08889699999997,39.81540666524207,38.36238733475786,117774064,54.31827390838347,49.24698755299995,NaN,NaN,NaN,NaN,NaN,NaN,-0.02972823998250509,-0.0583791408791825,-0.02865090089667741,57.48477535793661,36.52636642534802,2015874522,153642725.39734754,20.31180431867923,14.865401759168535,15.67992731790267,14.285714285714286,64.28571428571429
2005-09-30,39.16,39.48,39.13,39.46001,37.88357279663943,38.47817413706874,38.88984663613766,39.01454780958515,37.81884445000002,38.436838600000065,39.16649700000001,39.115897499999974,39.115897499999974,39.855316135225564,38.376478864774384,79260128,58.523489741338686,48.94289079213148,NaN,NaN,NaN,NaN,NaN,NaN,0.014123982110321513,-0.01099592325877552,-0.025119905369097032,73.0543296666447,52.29512352369384,2095134650,223849082.2046617,23.436593052835956,14.043915123021414,14.154715314988783,7.142857142857143,57.142857142857146
2005-10-03,39.55,39.75,39.50999,39.56,37.900253664334556,38.49959643138421,38.91612716021069,39.06649563724371,37.81689445000002,38.47293860000006,39.16929700000001,39.15539749999998,39.15539749999998,39.901061840113485,38.40973315988647,81694192,60.0466654930749,48.91598319003761,NaN,NaN,NaN,NaN,60.0466654930749,NaN,0.047479444465797285,0.034229400213149574,-0.01325004425264771,87.41713521281615,72.65208007913249,2176828842,176199526.19416264,26.710500980151192,13.383969068349073,13.12450738647093,0,50
2005-10-04,39.62,39.88,39.28999,39.3,37.91418148857004,38.515446007000364,38.93118099706518,39.08873414798241,37.81601940000002,38.50743850000006,39.16989700000001,39.15339749999997,39.15339749999997,39.897283020843076,38.40951197915686,85379632,54.447454276869394,49.15362844663946,NaN,NaN,NaN,NaN,NaN,NaN,0.04942525666421368,0.04853152657761939,-0.0008937300865942896,64.63393069469913,75.03513185805332,2091449210,93716964.12965354,24.217041262595437,15.6153948476798,13.079403457923467,100,42.857142857142854
2005-10-05,39.31,39.34,38.73,38.75999,37.92259749365889,38.520288462307285,38.92446762463125,39.057425181507895,37.813819350000024,38.532638300000066,39.156696800000006,39.12094699999998,39.12094699999998,39.873968176944125,38.367925823055835,106227376,45.05115174573705,48.74680673036911,NaN,NaN,NaN,NaN,NaN,NaN,0.013599871756252185,0.016106109608720942,0.0025062378524687567,31.706290892017783,61.25245226651102,1985221834,-2065300.374475956,21.93695245546795,22.788500820870798,12.02419080728165,92.85714285714286,35.714285714285715
2005-10-06,38.73,38.86,37.92,38.25,37.9258552300404,38.51493621552892,38.898017913861395,38.98052754517381,37.806669400000025,38.55029840000007,39.12729680000001,39.063447499999974,39.063447499999974,39.89408151033144,38.23281348966851,162273376,38.324480135195536,47.55566549099267,NaN,NaN,NaN,NaN,NaN,NaN,-0.042136932463668605,-0.050164927727117004,-0.008027995263448396,16.836734693877457,37.72565209353146,1822948458,-50402050.67234861,18.97253863849167,31.353483719705117,12.26033455010686,85.71428571428571,100
2005-10-07,38.41,38.57001,38.179,38.34,37.92997607352258,38.5114721320531,38.87613485841585,38.91952492182392,37.79971940000002,38.566698400000064,39.09589680000001,38.999497499999976,38.999497499999976,39.84598553306273,38.15300946693722,91132560,40.02632711008518,46.90743905791481,NaN,NaN,NaN,NaN,NaN,NaN,-0.06904601447566167,-0.09433551335802548,-0.025289498882363814,21.428571428571505,23.323865671488914,1914081018,-66486186.53997312,17.889590571654207,29.5638342041686,13.276785650838928,78.57142857142857,92.85714285714286
2005-10-10,38.28999,38.461,38.06,38.13,37.93196636134823,38.503918228448086,38.84687466788974,38.844332072126406,37.791579400000025,38.57599840000006,39.06699680000001,38.91949749999998,38.91949749999998,39.77706405142245,38.061930948577505,64031808,37.43095259064035,46.271166299836246,NaN,NaN,NaN,NaN,NaN,NaN,-0.09546374946102812,-0.14461918570864896,-0.049155436247620844,10.714285714285753,16.326530612244905,1850049210,-108162749.85169351,16.82869229139988,29.57047468212823,14.03166317998559,71.42857142857143,85.71428571428571
2005-10-11,38.21001,38.24001,37.8,37.94,37.93204629805123,38.49275153085505,38.81131095542348,38.75820520811437,37.78332940000002,38.58027850000007,39.032797000000016,38.83499749999998,38.83499749999998,39.728182643247244,37.94181235675271,114769632,35.20663014760676,45.93950147944737,NaN,NaN,NaN,NaN,NaN,NaN,-0.11869472185619767,-0.19752383856786793,-0.07882911671167026,6.730769230769241,12.957875457875497,1735279578,-149898821.34170496,15.726616415904537,31.503618268439254,16.39361724869853,64.28571428571429,100
2005-10-12,37.75999,38.056,37.42999,37.487,37.92761797667759,38.47283565895693,38.7593771924657,38.63713804543681,37.770914400000024,38.57854850000007,38.98093700000001,38.75034799999998,38.75034799999998,39.80331192896667,37.69738407103329,146123808,30.545945476801265,45.07385107293084,NaN,NaN,30.545945476801265,NaN,NaN,NaN,-0.155224003540829,-0.2728591211377065,-0.1176351175968775,2.3269292778398944,6.590661407631628,1589155770,-269407980.0738633,14.292535029406977,34.02063668446971,18.662325350452043,57.142857142857146,100
2005-10-13,37.47,37.91,37.33,37.78,37.92614914108876,38.45911614095778,38.720970243741554,38.5555058506333,37.75971440000002,38.577848400000065,38.93533700000001,38.68134799999998,38.68134799999998,39.79689321723932,37.565802782760635,138583632,36.40963148348515,44.471032091697495,NaN,NaN,NaN,NaN,NaN,NaN,-0.1502117184387192,-0.3053997656452765,-0.1551880472065573,17.647058823529495,8.901585777379543,1727739402,-192948045.17730963,13.10057858100499,32.6211509331558,21.54535417627339,50,100
2005-10-14,37.87,38.07001,37.64,38.06,37.92748099043116,38.45121285103782,38.6950498420262,38.50831481723966,37.750064350000024,38.578748400000066,38.90307700000001,38.61434849999998,38.61434849999998,39.70998110370153,37.518715896298424,131480624,41.493047729656006,44.21669218184916,NaN,NaN,NaN,NaN,NaN,NaN,-0.11991200307462038,-0.30507805104983277,-0.18516604797521238,28.627450980392265,16.200479693920553,1859220026,-67588772.05863865,14.605766755788785,30.58462683549228,23.781487010631253,42.857142857142854,92.85714285714286
2005-10-17,38.06,38.19,37.82001,38.17999,37.92999351788956,38.44584210151232,38.6748514168487,38.477045787026356,37.74138935000002,38.58244830000007,38.87707680000001,38.568847999999974,38.568847999999974,39.65724783999786,37.48044816000209,64214160,43.57470798989419,44.22289297627196,NaN,NaN,NaN,NaN,NaN,NaN,-0.0852891381452903,-0.29177747065682524,-0.20648833251153495,33.33294117647046,26.535816993464078,1923434186,-6849212.678115316,15.58050690149214,28.912125736298982,25.763105187185158,35.714285714285715,85.71428571428571
2005-10-18,38.14,38.17999,37.91,37.91,37.92979457741304,38.43523136682891,38.64485724363895,38.42304142635718,37.733444400000025,38.579648300000066,38.851476800000015,38.51784849999997,38.51784849999997,39.62912787274809,37.40656912725185,88096064,40.11604831439117,43.96534329593993,NaN,NaN,NaN,NaN,NaN,NaN,-0.07446481595052179,-0.2995693524496872,-0.2251045364991654,22.74509803921558,28.235163398692766,1835338122,-94945276.67811531,14.938538414228322,27.720850398476983,27.583021499367685,28.571428571428573,78.57142857142857
2005-10-19,37.74001,38.672,37.61,38.67,37.93715980549848,38.43988025065408,38.64584323408448,38.44656129051364,37.73289440000002,38.58424820000007,38.835876800000015,38.526348499999976,38.526348499999976,39.6395507036872,37.41314629631275,132942256,51.73045754078238,43.78049926968271,NaN,NaN,NaN,NaN,NaN,NaN,-0.01322311220939243,-0.24163342676090593,-0.2284103145515135,52.549019607843185,36.209019607843075,1968280378,37496255.19382559,19.603182904773135,23.601463509835515,27.13813030998793,21.428571428571427,71.42857142857143
2005-10-20,38.67,38.85001,38.10001,38.306,37.940829857185065,38.43722915658172,38.632516048434105,38.433174500940915,37.73172445000002,38.58650820000007,38.81979680000001,38.509648499999976,38.509648499999976,39.62554766475149,37.393749335248465,132676944,47.02612177243074,42.959258700475,NaN,NaN,NaN,NaN,NaN,NaN,0.0047079222472088955,-0.2225254117425024,-0.2272333339897113,38.27450980392147,37.85620915032674,1835603434,-22300358.95401445,20.022701621203765,21.2049260312536,25.552943656189917,14.285714285714286,64.28571428571429
2005-10-21,38.69901,38.86,38.3288,38.55,37.946891251640935,38.439462242590004,38.6292801249661,38.444300738946545,37.732739450000025,38.58790820000007,38.80215660000001,38.49964849999997,38.49964849999997,39.61032524230401,37.388971757695934,110053008,50.289541163842856,42.26232124838699,NaN,NaN,NaN,NaN,NaN,NaN,0.033343103101539956,-0.18555445511278634,-0.2188975582143263,47.84313725490183,46.222222222222165,1945656442,-40697774.4479917,18.661011159105406,19.620106427665032,23.357770091512595,7.142857142857143,57.142857142857146
2005-10-24,38.71201,39.181,38.467,39.16,37.95896198545545,38.45373031699416,38.650092669085076,38.51246257333259,37.73578945000003,38.59290820000007,38.80115640000002,38.51964899999997,38.51964899999997,39.662303815453605,37.37699418454634,111785120,57.361472161976174,42.47046538303748,NaN,NaN,NaN,NaN,57.361472161976174,NaN,0.09046760132709711,-0.10581305655545492,-0.19628065788255203,91.04477611940267,59.05414105940866,2057441562,64511750.25789039,21.132496217542677,17.776137478771922,22.431461461419325,0,50
2005-10-25,39.08,39.19009,38.77,39.00999,37.96941997564993,38.464745360222,38.664206289905266,38.55984613777711,37.738189400000024,38.60200800000007,38.79243620000002,38.53664849999997,38.53664849999997,39.69771261101877,37.37558438898117,86963936,55.278786150201775,43.201010697642104,NaN,NaN,NaN,NaN,NaN,NaN,0.11374583451919754,-0.054098364733555115,-0.16784419925275265,90.31767280077868,76.40186205836106,1970477626,76909736.70612842,20.066399464772786,16.777064888686372,22.933169944080536,0,42.857142857142854
2005-10-26,38.96001,39.274,38.75999,38.81,37.97778395599172,38.47158208576216,38.66992369030114,38.58367031513167,37.74094440000002,38.609008000000074,38.79243620000002,38.54314899999997,38.54314899999997,39.70879718675247,37.37750081324747,90028064,52.53995079335539,44.21640145893923,NaN,NaN,NaN,NaN,NaN,NaN,0.11114074444716737,-0.028918268693793436,-0.1400590131409608,76.13168724279845,85.83137872099326,1880449562,4400022.468351096,19.808394570702173,15.620255796587756,22.02030248520881,100,35.714285714285715
2005-10-27,38.78,38.8,38.03,38.03,37.97830351861867,38.4628378860441,38.64482864362267,38.53093980892865,37.73819440000002,38.61140810000007,38.77223640000002,38.484648999999976,38.484648999999976,39.62982166264906,37.339476337350895,135443120,43.48962701596185,44.4637800236447,NaN,NaN,43.48962701596185,NaN,NaN,NaN,0.05518085649382387,-0.07108294252368097,-0.12626379901750484,36.008230452674994,67.4858634987507,1745006442,-131043097.5316489,17.802390748536144,23.516126315895658,21.25080485705801,92.85714285714286,28.571428571428573
2005-10-28,38.17,38.392,37.92,38.32201,37.98172348360754,38.46004921503332,38.6321690889708,38.51104173188783,37.73945440000002,38.617528100000065,38.76181660000002,38.42774899999997,38.42774899999997,39.48297146947259,37.37252653052735,95367504,47.15932731649627,45.15866393263441,NaN,NaN,NaN,NaN,NaN,NaN,0.03700013013380818,-0.08001363635024461,-0.11701376648405279,51.02932098765428,54.389746227709246,1840373946,-63958524.06114205,16.70024888059542,23.50306078140621,20.497932973529768,85.71428571428571,21.428571428571427
2005-10-31,38.42999,39.05,38.42,38.87,37.990562055909955,38.4681670523594,38.6414957913641,38.5452282336128,37.74165445000003,38.626728100000065,38.76281640000002,38.393248999999976,38.393248999999976,39.33741645552782,37.44908154447213,115431008,53.289547710841234,46.450300901436876,NaN,NaN,NaN,NaN,NaN,NaN,0.05970342887763677,-0.04238448038700682,-0.10208790926464359,79.21810699588463,55.41855281207129,1955804954,-14488092.061142422,23.57094398769977,21.311555968637524,18.47147247160225,78.57142857142857,14.285714285714286
2005-11-01,38.75999,39.00999,38.71001,38.84,37.999014174756624,38.475530081025546,38.649280270134135,38.57330173517348,37.742254450000026,38.63965810000007,38.76281640000002,38.37024899999997,38.37024899999997,39.244785448685874,37.49571255131407,73633504,52.92753590731061,48.04898593218754,NaN,NaN,NaN,NaN,NaN,NaN,0.06981985036464697,-0.014813096308834872,-0.08463294667348184,77.67489711934172,69.30744170096021,1882171450,-24306547.15814677,22.634378501063352,20.464764775329268,15.914344706610354,71.42857142857143,7.142857142857143
2005-11-02,38.72501,39.46001,38.71001,39.347,38.012426969037655,38.49278691110425,38.67664182816809,38.64698728420458,37.748589450000026,38.65582810000007,38.77515640000002,38.39959949999998,38.39959949999998,39.3597021437111,37.43949685628886,101555808,58.10709255375368,49.59880458006387,NaN,NaN,NaN,NaN,NaN,NaN,0.10562769341247102,0.04740167009210694,-0.058226023320364084,93.89138437089552,83.59479616204062,1983727258,46644402.54297441,26.245790752398907,18.48697275277804,14.103667675556892,100,0
2005-11-03,39.74001,40.0901,39.67999,39.94,38.03160680019151,38.52144459603288,38.726185285886984,38.77013135237557,37.761539400000025,38.67942810000007,38.80395640000002,38.48409949999997,38.48409949999997,39.651715371964684,37.31648362803526,137054000,63.20658724659042,51.14977168841632,NaN,NaN,NaN,NaN,NaN,NaN,0.1609088876755993,0.14291008627413504,-0.01799880140146426,93.94782468448845,88.50470205824189,2120781258,83375048.3209359,31.718735458782643,16.758798883556043,13.782278335369478,100,21.428571428571427
2005-11-04,39.994,40.23,39.84,40.08,38.051988822080155,38.55230707927975,38.77927605898945,38.89488074738742,37.77668940000002,38.70322810000007,38.83379640000002,38.571099499999974,38.571099499999974,39.92693045276034,37.21526854723961,100944432,64.31111750287386,52.6309437964863,NaN,NaN,NaN,NaN,NaN,NaN,0.19622152405492238,0.2272781036671887,0.031056579612266336,94.2748091603054,94.03800607189646,2221725690,106669917.24401227,31.92715162089213,15.917779240559366,14.032085733878006,100,14.285714285714286
2005-11-07,40.2,40.28999,39.95,40.13,38.07266555021866,38.58354852325441,38.83224562530359,39.01251115239814,37.79468940000002,38.72552820000007,38.86719840000002,38.671099499999976,38.671099499999976,40.16956470562253,37.172634294377424,65366512,64.71848040752789,54.388260374567494,NaN,NaN,NaN,NaN,NaN,NaN,0.21097629016911326,0.2947769423236579,0.08380065215454466,94.03020160522986,94.08427848334122,2287092202,110517041.88038376,31.28452277503583,15.201573159769088,14.363062783062245,100,7.142857142857143
2005-11-08,40.064,40.35001,39.99001,40.14,38.09323604225629,38.614369344576104,38.8835301105858,39.11989104264594,37.81183935000002,38.74822820000007,38.894798600000016,38.781099499999975,38.781099499999975,40.36906373525948,37.19313526474047,78859632,64.80500590501492,55.32215668629839,NaN,NaN,NaN,NaN,NaN,NaN,0.20903874805833242,0.3450990872274602,0.13606033916912777,91.35764873395594,93.22088649983039,2365951834,97369388.7897183,30.5713978595959,14.459689940564038,16.257690921048226,100,0
2005-11-09,40.13,40.33,40.03,40.159,38.113790907507465,38.644956090228064,38.933548537621654,39.218853800489185,37.82688440000002,38.771118200000075,38.925578600000016,38.914699499999976,38.914699499999976,40.494262042877544,37.33513695712241,72458752,64.98073438056677,56.60462901545096,NaN,NaN,NaN,NaN,NaN,NaN,0.19683827707831314,0.3821081855170192,0.18526990843870605,92.13953852041766,92.5091296198678,2438410586,87225163.50971782,29.28862592819098,13.85296320606009,18.608514059711553,92.85714285714286,42.857142857142854
2005-11-10,40.17999,40.69,39.92,40.60001,38.138529405940226,38.683670029035426,38.998899967518845,39.350392486156885,37.84438440000002,38.79861820000007,38.957978800000014,39.05569999999997,39.05569999999997,40.70677206629028,37.40462793370967,120763056,68.86643723628517,57.93155016348255,NaN,NaN,NaN,NaN,NaN,NaN,0.20532782801606642,0.4419296934587891,0.23660186544272266,96.75126353790613,93.41615026409325,2559173642,179761031.43325007,31.10368395715628,12.413256478728966,21.49739787428362,100,35.714285714285715
2005-11-11,40.77,40.918,40.67999,40.71001,38.16411627752291,38.723795573014925,39.06600232173379,39.47987986842766,37.86333445000002,38.827618300000076,38.99377900000001,39.18820049999997,39.18820049999997,40.92165890887584,37.4547420911241,80107120,69.76752115895152,58.81769652040936,NaN,NaN,NaN,NaN,NaN,NaN,0.204748179017184,0.4925370892142027,0.2877889101970187,93.06237491661099,93.98439232497826,2639280762,119861598.02120858,32.89720273062327,11.864851871446035,24.237451625852003,100,28.571428571428573
2005-11-14,40.75999,40.86,40.603,40.714,38.18948825486099,38.763205561668094,39.1306296816658,39.59741511905359,37.87990450000002,38.860858300000075,39.03265900000002,39.31490099999997,39.31490099999997,41.1045884388787,37.52521356112124,53652320,69.80166279616243,59.855044852263696,NaN,NaN,NaN,NaN,NaN,NaN,0.19128254429838049,0.5268920905699943,0.3356095462716138,93.19546364242827,94.33636736564847,2692933082,112554861.83443733,31.67907669593651,12.534779906621333,26.692555191560007,92.85714285714286,21.428571428571427
2005-11-15,40.73,40.89999,40.38,40.52,38.21267742645441,38.797993570347934,39.18511479218871,39.6852803458104,37.894904500000024,38.89635830000008,39.05625900000001,39.44540099999997,39.44540099999997,41.186252367831784,37.70454963216815,79543440,65.9045794310777,60.80966118352958,NaN,NaN,NaN,NaN,NaN,NaN,0.1573748833260301,0.5323281504291515,0.3749532671031214,86.72448298865922,90.99410718256615,2613389642,75843328.60187533,29.313951317502372,14.800727155510643,28.198092479156966,85.71428571428571,14.285714285714286
2005-11-16,40.64999,40.78,40.46001,40.76801,38.23810362121606,38.83700379667768,39.247189114063666,39.78839745573322,37.91084455000002,38.93603840000007,39.083439200000015,39.550301499999975,39.550301499999975,41.34366610221959,37.756936897780356,65912624,68.33824583118772,62.58456252747429,NaN,NaN,NaN,NaN,NaN,NaN,0.14028140833501235,0.5503050275218868,0.41002361918687447,94.99699799866568,91.63898154325106,2679302266,136816470.98207298,27.931948332954292,14.102948514860966,29.560259936032995,78.57142857142857,7.142857142857143
2005-11-17,40.91,41.32001,40.85001,41.30701,38.26864000309451,38.88591481060485,39.32796640370823,39.93302722185386,37.93160955000002,38.977608600000075,39.12157960000001,39.70035199999997,39.70035199999997,41.55336136114998,37.84734263884995,94448320,72.87047123468471,64.42107280734488,NaN,NaN,NaN,NaN,NaN,NaN,0.15287337986553562,0.601115344018794,0.44824196415325834,99.55172568370436,93.75773555700975,2773750586,226039990.30121988,33.560691108838455,12.967233651204834,31.51307428638932,100,0
2005-11-18,41.5,41.651,41.0253,41.45,38.30029532644681,38.93668877475129,39.41118340748438,40.077500819772546,37.95010955000002,39.02142870000008,39.15819960000001,39.84535199999998,39.84535199999998,41.76814563752498,37.92255836247497,108820128,73.93636305623119,65.89584533201561,NaN,NaN,NaN,NaN,NaN,NaN,0.157790659813966,0.6454802889207159,0.48768962910674984,93.16556669692858,95.90476345976622,2882570714,264945316.54958177,35.291585281888786,11.806597952599732,34.715208972653365,100,0
2005-11-21,41.397,41.58099,41.24001,41.549,38.33262074608415,38.98841770990473,39.495019352288914,40.217643598841825,37.96948455000002,39.06911870000008,39.19457960000001,39.96480199999998,39.96480199999998,41.996206438142984,37.93339756185697,69731376,74.67815222083598,67.4494607829817,NaN,NaN,NaN,NaN,NaN,NaN,0.15447284395908445,0.6807806840556054,0.526307840096521,96.53178011485915,96.41635749849736,2952302090,321592601.2935549,33.53028552726399,11.217365196100717,37.917343658917396,92.85714285714286,0
2005-11-22,41.45,41.87,41.36,41.7,38.36612700731715,39.042112408718495,39.58148918161092,40.358820398952126,37.989284500000025,39.11886860000008,39.23597960000001,40.09930249999997,40.09930249999997,42.21450737945731,37.984097620542634,88819184,75.80905367302928,68.71388657721567,NaN,NaN,NaN,NaN,NaN,NaN,0.14913379864503917,0.71272508840282,0.5635912897577808,92.23747836767893,93.97827505982222,3041121274,351198995.9602232,35.25191932039241,10.382724794677863,40.57102099935745,100,0
2005-11-23,41.73,42.02,41.71001,41.8,38.4002948977916,39.096724044189415,39.668489605861474,40.49607559905192,38.01273450000002,39.16576860000008,39.28837980000001,40.248802499999975,40.248802499999975,42.40070976846647,38.09689523153348,64101104,76.55579904456499,69.66740170564243,NaN,NaN,NaN,NaN,NaN,NaN,0.13921316049294907,0.7376077403739671,0.5983945798810181,89.90825688073367,92.8925051210906,3105222378,324314952.82644403,35.80832333033801,9.88569738265489,42.41897588612492,100,0
2005-11-25,41.84,41.94,41.73,41.89,38.43501833164442,39.15203643935398,39.75560766053357,40.62883030390412,38.036434550000024,39.21536870000008,39.34297980000001,40.44180249999998,40.44180249999998,42.45073202391991,38.43287297608005,22930176,77.236849433687,70.59066827212908,NaN,NaN,NaN,NaN,77.236849433687,NaN,0.12598545336431832,0.7558763965864159,0.6298909432220976,93.8095238095237,91.98508635264545,3128152554,336325997.3978733,34.63651341843799,9.562192758543528,44.08111406869676,92.85714285714286,0
2005-11-28,41.96001,42,41.5,41.53999,38.46591357212557,39.19932264847568,39.82558343855186,40.71560741781801,38.055634500000025,39.26016860000008,39.38577980000001,40.60270149999998,40.60270149999998,42.412326595895145,38.793076404104816,74716192,68.8590929216104,70.88642630884927,NaN,NaN,NaN,NaN,NaN,NaN,0.08301080114633508,0.7336544446550164,0.6506436435086813,77.14238095238096,86.95338721421278,3053436362,273561407.4701942,31.955185575784316,12.382964754311264,44.76295240780767,85.71428571428571,21.428571428571427
2005-11-29,41.75999,41.85001,41.34,41.343,38.49454129777607,39.241771704941506,39.88508997037336,40.77535909231154,38.073004500000025,39.29589860000008,39.43083980000001,40.72635149999998,40.72635149999998,42.37642518741331,39.076277812586646,77444752,64.61132994409431,70.87259231164066,NaN,NaN,NaN,NaN,NaN,NaN,0.0332203228321577,0.6921690470488784,0.6589487242167207,67.7619047619048,79.57126984126982,2975991610,197027752.33496162,29.450773306655524,13.871180404094865,44.776043328816606,78.57142857142857,14.285714285714286
2005-11-30,41.28999,41.49001,41.189,41.24001,38.521859394315605,39.28134078009118,39.93822408918224,40.81961155971044,38.08860455000002,39.327098700000086,39.47704020000001,40.84635199999998,40.84635199999998,42.262772597317536,39.42993140268243,88044368,62.44255153910719,70.69129353725069,NaN,NaN,62.44255153910719,NaN,NaN,NaN,-0.012308939523182794,0.6435625498127422,0.655871489335925,62.85761904761883,69.2539682539682,2887947242,138823876.09058338,28.053325044247558,15.593307049957561,44.259501356267165,71.42857142857143,7.142857142857143
2005-12-01,41.50999,42.05,41.5,42.007,38.55653741029256,39.33531422999036,40.019352556273134,40.93269617307135,38.108739550000024,39.36416870000008,39.54718020000001,40.97935199999997,40.97935199999997,42.30422964737348,39.65447435262646,91914064,70.40872132612405,70.80145668652489,NaN,NaN,NaN,NaN,NaN,NaN,0.002767510628317593,0.659330877621322,0.6565633669930044,97.42514970059884,76.01489117004083,2979861306,216365922.81058356,33.019491314994106,13.70832642960981,44.143582774011854,100,0
2005-12-02,41.94,42.133,41.87,42.10699,38.59186529675731,39.390198898703424,40.101220691321245,41.04453368039789,38.13192450000002,39.40133860000008,39.61652000000001,41.08770149999997,41.08770149999997,42.409293456594774,39.76610954340517,72929184,71.26442791570044,70.90837859772124,NaN,NaN,NaN,NaN,NaN,NaN,0.012467425338832605,0.6721476486665452,0.6596802233277126,98.51625784369655,86.26634219730475,3052790490,274870102.4315728,32.96025779938193,13.15237897310475,43.855612407772576,100,14.285714285714286
2005-12-05,42.05,42.06,41.629,41.8,38.62378703509803,39.437917732392464,40.16783948774002,41.11648285369333,38.15417445000002,39.431638600000085,39.67752,41.17370149999998,41.17370149999998,42.44468642034093,39.90271657965903,61585504,65.04530104774844,70.56863847283452,NaN,NaN,NaN,NaN,NaN,NaN,-0.00771198236649373,0.6500402453695955,0.6577522277360892,81.00399315459181,92.31513356629574,2991204986,262152910.1902728,30.536359904676786,15.893001074124168,43.01559035990099,92.85714285714286,7.142857142857143
2005-12-06,42.03999,42.31,41.89999,41.936,38.65674437803238,39.48738470798865,40.23717911567178,41.19453210572254,38.17940445000002,39.46209860000008,39.7410402,41.26400149999997,41.26400149999997,42.48102390905253,40.04697909094741,81509376,66.44246084878782,70.60705857409953,NaN,NaN,NaN,NaN,NaN,NaN,-0.01727316854422667,0.6361607670558058,0.6534339356000325,79.78367450634862,86.434641834879,3072714362,194961002.68986937,31.97651168163042,14.654672517680373,43.31899147023558,100,0
2005-12-07,42.00999,42.03,41.629,41.86,38.688617568300714,39.53436718901858,40.300819150351316,41.25791000041563,38.20400445000001,39.49336860000008,39.80484020000001,41.35000149999997,41.35000149999997,42.47691166151969,40.223091338480245,83885440,64.88175003930857,70.36016601753673,NaN,NaN,NaN,NaN,NaN,NaN,-0.0331678216832797,0.6119741584959328,0.6451419801792125,69.17787108130868,76.6551795807497,2988828922,207721630.71979445,29.9973907349532,17.930288154054896,42.76748268064636,92.85714285714286,0
2005-12-08,41.96001,42,41.27,41.561,38.717198488019115,39.57449853181029,40.35023800720028,41.28677571466176,38.22475945000002,39.51717870000009,39.8624604,41.42010149999997,41.42010149999997,42.40776421111973,40.43243878888021,112043184,59.00905230530605,69.37006466543826,NaN,NaN,59.00905230530605,NaN,NaN,NaN,-0.06635468808838241,0.5621986200687346,0.628553308157117,41.698451000233376,63.55333219596357,2876785738,185006026.2923966,26.751375599867643,21.31160932564283,40.414451939795505,85.71428571428571,0
2005-12-09,41.571,41.77,41.3799,41.715,38.7470273587851,39.61688469949722,40.40375808534929,41.327558979932064,38.24523445000002,39.53972860000008,39.9127604,41.47585099999997,41.47585099999997,42.3955947769955,40.55610722300444,56531744,60.96863264969612,68.4437982078286,NaN,NaN,NaN,NaN,NaN,NaN,-0.07957963092143328,0.5290787695053254,0.6086584004267587,46.92239072256934,52.59957093470381,2933317482,225597006.7958575,25.18312842392102,20.062257829117076,37.661173572847886,78.57142857142857,0
2005-12-12,41.87,41.94,41.67999,41.867,38.778071862677784,39.66144143812104,40.461140121217944,41.37893431517663,38.26846945000002,39.56369860000008,39.960900200000005,41.533700499999966,41.533700499999966,42.397320426418275,40.67008057358166,44869984,62.85606161724738,67.59936316471514,NaN,NaN,NaN,NaN,NaN,NaN,-0.0795458106812107,0.5092261370752453,0.588771947756456,60.481712756467076,49.70085149308994,2978187466,245271738.05942425,26.806363482001487,19.25214357947438,35.2709924433551,71.42857142857143,42.857142857142854
2005-12-13,41.83,42.211,41.75999,42.045,38.81057861031283,39.708640617564186,40.523252273327046,41.44236914230267,38.29054445000001,39.58994860000008,40.010600200000006,41.60025049999997,41.60025049999997,42.404008810130016,40.79649218986993,76611632,64.9910570304991,66.82664911882013,NaN,NaN,NaN,NaN,NaN,NaN,-0.06936286727220142,0.5020683636662042,0.5714312309384056,76.36039250669045,61.25483199524229,3054799098,265487587.6510526,29.140687902225558,17.901800912471302,33.08489411419639,64.28571428571429,35.714285714285715
2005-12-14,41.97,42.09599,41.70799,41.899,38.84130917140425,39.752014070681724,40.57720316456912,41.4858577954167,38.31198945000001,39.61623860000008,40.062580200000006,41.669200499999974,41.669200499999974,42.310662139775864,41.02773886022408,73581568,61.850754185879126,65.77628877177114,NaN,NaN,NaN,NaN,NaN,NaN,-0.07387128787394548,0.47909212109597377,0.5529634089699192,63.336306868867034,66.72613737734152,2981217530,264353521.21641323,27.362602803750452,17.627239138543047,30.578332204610444,57.142857142857146,28.571428571428573
2005-12-15,42,42.07001,41.608,41.97,38.87244042343008,39.79593458413357,40.631822648311505,41.53196657680559,38.33533945000001,39.64173860000008,40.12678040000001,41.729299999999974,41.729299999999974,42.231985229627234,41.22661477037271,72678256,62.79229889270773,64.74453516170118,NaN,NaN,NaN,NaN,NaN,NaN,-0.07333483130473428,0.46129486983900136,0.5346297011437356,69.66993755575355,69.78887897710369,3053895786,305566863.5454527,25.37697888979043,17.918606777448257,27.756599431937353,50,21.428571428571427
2005-12-16,41.87,41.94,41.549,41.58,38.89938131473923,39.831262612170526,40.66900607386792,41.536541188538386,38.35563945000002,39.66033860000008,40.19338040000001,41.742949499999966,41.742949499999966,42.212778760335404,41.27312023966453,63742944,54.79269323087665,63.739792326648775,NaN,NaN,NaN,NaN,NaN,NaN,-0.09891726350537611,0.41098312176201546,0.5099003852673916,34.879571810882915,55.961938745167835,2990152842,251931496.34340632,23.689962270902583,17.659052171170856,25.64533571164481,42.857142857142854,14.285714285714286
2005-12-19,41.69,41.71001,40.89999,40.92,38.91948697329904,39.85282176836517,40.678848972931924,41.47782298010616,38.36993945000002,39.67043860000008,40.24498040000001,41.71644949999997,41.71644949999997,42.29629070918227,41.13660829081766,75415008,44.468064673395524,62.300987664456,NaN,NaN,44.468064673395524,NaN,NaN,NaN,-0.1565347525894184,0.31423194453061853,0.47076669712003694,1.4191388713554653,35.32288274599732,2914737834,180242456.3690846,20.821844555400173,25.22145899163582,23.759123804244492,35.714285714285715,100
2005-12-20,40.94,41.14999,40.75,40.95,38.93969108301746,39.8745480699817,40.689482346542434,41.427554124857956,38.38628950000001,39.684188600000084,40.301380400000006,41.68649949999997,41.68649949999997,42.35321452012878,41.019784479871156,70257632,44.97560327724068,61.05334850289411,NaN,NaN,NaN,NaN,NaN,NaN,-0.18681982832055394,0.2372419117193445,0.42406174003989844,12.820512820512985,16.373074500917124,2984995466,180244212.8537973,19.562362510364057,25.96407494519549,22.724412173210244,28.571428571428573,100
2005-12-21,41.02,41.41,40.95,41.13,38.9614852015944,39.89940850423949,40.70675754863881,41.39921563677625,38.404089450000015,39.698988700000086,40.36518040000001,41.657999499999974,41.657999499999974,42.367338490937236,40.94866050906271,68934944,48.043909293088056,59.45586192910583,NaN,NaN,NaN,NaN,NaN,NaN,-0.1883874334142282,0.1885774482721132,0.3769648816863414,24.35897435897449,12.866208683614312,3053930410,165258355.4624936,22.13834201237344,24.154547912839565,20.08358442742372,21.428571428571427,92.85714285714286
2005-12-22,41.11,41.46201,40.98,41.397,38.98571917968799,39.92906378138326,40.73382588006474,41.39900462374994,38.423474450000015,39.71215870000009,40.44338040000001,41.63784949999997,41.63784949999997,42.352782387384785,40.92291661261516,59156976,52.29347550269663,58.10079389960556,NaN,NaN,NaN,NaN,NaN,NaN,-0.16589179799309517,0.16960013419497244,0.3354919321880676,41.474358974358815,26.21794871794877,3113087386,208458006.88516104,21.31093383191712,22.393402531231875,17.192254063710976,14.285714285714286,85.71428571428571
2005-12-23,41.50999,41.59,41.299,41.403,39.00977172516373,39.95825063719746,40.760068002415146,41.399385135773755,38.44463945000002,39.72558870000009,40.51584040000001,41.613499499999975,41.613499499999975,42.32558954070012,40.90140945929983,38000400,52.38771908665705,57.19668090238474,NaN,NaN,NaN,NaN,NaN,NaN,-0.14577135727309187,0.15327773559670277,0.29904909286979464,41.858974358974216,35.89743589743584,3151087786,197619404.8233048,22.337037333391628,21.3799027837376,15.095852976742345,7.142857142857143,78.57142857142857
2005-12-27,41.5,41.67999,40.97,41.03799,39.02995300153026,39.979631614678695,40.77096690428122,41.36496655141435,38.463129400000014,39.739238600000085,40.57540020000001,41.588399499999966,41.588399499999966,42.34319330871055,40.83360569128938,55669200,46.38448902295182,55.76396862911075,NaN,NaN,NaN,NaN,NaN,NaN,-0.15153913836983934,0.10962516990749549,0.26116430827733483,19.71184120465441,34.34839151266248,3095418586,152612182.9018696,19.963069632337294,24.032507605358475,13.103223101127204,0,71.42857142857143
2005-12-28,41.06,41.23,40.87,40.99001,39.049456056241404,39.999639107457334,40.77955682960352,41.3292564036606,38.48287950000002,39.75433870000008,40.63160060000001,41.57074999999996,41.57074999999996,42.36323816400609,40.77826183599383,50315392,45.64406587966338,54.38984833199323,NaN,NaN,NaN,NaN,NaN,NaN,-0.15265329643755027,0.07034768773039701,0.22300098416794728,16.427789185489274,25.999534916372635,3045103194,135843180.86809203,18.868075496372544,24.23793938273204,12.194623841520906,28.571428571428573,64.28571428571429
2005-12-29,41.03,41.12,40.64999,40.72,39.06607838404,40.01390367958689,40.777221267658284,41.271231984264354,38.50340445000001,39.76963870000009,40.68780060000001,41.544749499999966,41.544749499999966,42.40974123930577,40.679757760694166,47308160,41.61790004110956,53.14762317026491,NaN,NaN,NaN,NaN,NaN,NaN,-0.16461375589561933,0.01723378929842312,0.18184754519404245,4.484916816676161,13.541515735606618,2997795034,102628526.45988737,17.51713324113889,25.85405901900721,12.759214593472441,21.428571428571427,100
2005-12-30,40.55,40.58,40.36,40.412,39.07947063892517,40.02178677504062,40.76289886500502,41.18940036671537,38.521914400000014,39.779258700000085,40.722640600000005,41.46499949999996,41.46499949999996,42.43281127925747,40.49718772074245,60052832,37.549133203364924,51.47480178124125,NaN,NaN,37.549133203364924,NaN,NaN,NaN,-0.18479472488968743,-0.04914586091806683,0.1356488639716206,2.809292274446225,7.907332758870556,2937742202,70964305.9507964,16.540274049018794,28.90438383421219,13.894140641580833,14.285714285714286,100
2006-01-03,40.64,41.49001,40.16,41.31,39.101664960925916,40.04729594781209,40.78435381147541,41.20088604607581,38.54591445000001,39.80125870000009,40.782720600000005,41.42514999999996,41.42514999999996,42.348557991112244,40.501742008887675,109422192,52.21698448273895,50.714867700204934,NaN,NaN,NaN,NaN,NaN,NaN,-0.13168494313879037,-0.028957314951867374,0.10272762818692299,56.070209653827625,21.12147291498334,3047164394,150767038.2746744,25.961081831990956,23.65578492279303,13.054486330653265,7.142857142857143,100
2006-01-04,41.39999,41.74001,41.3158,41.74001,39.12791715036944,40.08081503795442,40.82183052475089,41.252231184544776,38.57171450000001,39.82433870000009,40.84652080000001,41.422150499999965,41.422150499999965,42.34104722404941,40.50325377595052,92780128,57.379204183966664,50.17116392545262,NaN,NaN,NaN,NaN,NaN,NaN,-0.06498793308535675,0.02149271183022705,0.0864806449155838,81.61250832907186,46.8306700857819,3139944522,243547166.2746744,27.874499528307318,22.249088978053763,12.14964008270445,0,92.85714285714286
2006-01-05,41.75,42,41.7065,41.92,39.155699069271236,40.11723454215335,40.864895994368496,41.31582821458813,38.600664500000015,39.851438600000094,40.90172080000001,41.42135049999996,41.42135049999996,42.33848254756466,40.50421845243526,77692064,59.35839768770807,49.99313846129754,NaN,NaN,NaN,NaN,NaN,NaN,-0.009078650701321925,0.0751323315389314,0.08421098224025332,92.14611441824906,76.60961080038284,3217636586,278885805.2661576,30.416901571858773,21.317316991447697,11.860359800851326,0,85.71428571428571
2006-01-06,42.25999,42.7,42.06,42.67999,39.19076664072127,40.167982174981994,40.936076151452085,41.44574838462736,38.632764500000015,39.88377850000009,40.975120800000006,41.462349999999965,41.462349999999965,42.517224095847205,40.407475904152726,110120944,66.44405790808489,50.25397839096735,NaN,NaN,NaN,NaN,NaN,NaN,0.07417317309988002,0.17692744861510334,0.10275427551522333,99.2122047244092,90.99027582391004,3327757530,382120748.9866555,36.76663622723949,19.035724833993854,12.899491824140105,100,78.57142857142857
2006-01-09,42.64999,42.9201,42.52,42.8499,39.22717592787827,40.221089458645714,41.011128067081415,41.57947710990094,38.665664000000014,39.92417750000009,41.05591880000001,41.526794999999964,41.526794999999964,42.7430430676204,40.31054693237953,80775248,67.79587146529065,51.18277683628263,NaN,NaN,NaN,NaN,NaN,NaN,0.13237199124682258,0.26821926457375156,0.13584727332692897,97.45661389080105,96.27164434448643,3408532778,434550971.19510305,37.78511477388743,17.973083520084852,14.395682719387207,100,71.42857142857143
2006-01-10,42.64,42.92,42.55,42.88,39.26352243605859,40.273741152533916,41.084417162489984,41.70333643276752,38.69836400000001,39.96257760000009,41.15291880000001,41.585044999999965,41.585044999999965,42.93590977561221,40.23418022438772,84420432,68.04149279911621,52.866593130976966,NaN,NaN,NaN,NaN,NaN,NaN,0.16259314246830897,0.3390887014123152,0.1764955589440062,98.54715408862013,98.40532423461013,3492953210,500718336.8167253,35.79508952224833,17.026496741962767,16.251158911681774,92.85714285714286,64.28571428571429
2006-01-11,43.00999,43.31,42.87,43.21001,39.302790969033126,40.3318850901075,41.16777374435312,41.846829153456326,38.73416405000001,40.00624770000009,41.2506788,41.65219549999996,41.65219549999996,43.17502228241145,40.12936871758848,100777632,70.68170331957288,54.70274313400069,NaN,NaN,NaN,NaN,70.68170331957288,NaN,0.19246316428793658,0.41707451430392695,0.22461135001599036,96.82571428571413,97.60982742171177,3593730842,555692535.0727234,39.1339613842736,15.950646626050832,18.252959689271314,100,57.142857142857146
2006-01-12,43.14999,43.28999,42.85001,43,39.33957911859498,40.384719048719234,41.23962575437849,41.95665494836525,38.76551405000001,40.04804760000009,41.33327880000001,41.69994549999997,41.69994549999997,43.32547233097726,40.07441866902268,82429120,66.89432320476791,56.049201270549254,NaN,NaN,NaN,NaN,NaN,NaN,0.1856457918018069,0.456668589768249,0.2710227979664421,90.15873015873011,95.17719951102146,3511301722,529463895.58911073,36.640767914922144,15.223899297992077,20.891418961629448,92.85714285714286,50
2006-01-13,42.94,43.05,42.73,42.98,39.3758022119423,40.436110750724794,41.30787572479502,42.05411638185427,38.79756400000001,40.08944760000009,41.416078800000015,41.75399549999997,41.75399549999997,43.4716786005829,40.036312399417035,64586064,66.52871517269207,57.06600410412035,NaN,NaN,NaN,NaN,NaN,NaN,0.16789371923885849,0.4808899470150152,0.3129962277761567,89.52380952380936,92.16941798941787,3446715658,565793556.5891106,34.89928039333539,16.282801601588744,23.312578960316927,85.71428571428571,42.857142857142854
2006-01-17,42.67,42.78999,42.5,42.7,39.40887880684835,40.48094024080945,41.362468833626586,42.11562910739196,38.830064000000014,40.129147600000096,41.48313880000001,41.79049549999996,41.79049549999996,43.55536363899163,40.0256273610083,78109632,61.46394638157526,57.714306053757376,NaN,NaN,NaN,NaN,NaN,NaN,0.12724332514561953,0.47205038420818113,0.3448070590625616,80.63492063492069,86.77248677248672,3368606026,595425063.2490648,32.410867740396284,18.538381349999256,25.101054548459484,78.57142857142857,35.714285714285715
2006-01-18,42.03999,42.46001,42.02,42.21001,39.43675075901901,40.51517924594194,41.395705742111815,42.12461776383082,38.85881400000001,40.16624770000009,41.52853900000001,41.82199599999997,41.82199599999997,43.59318973137522,40.05080226862472,122426496,53.75207790067309,58.24056240216605,NaN,NaN,NaN,NaN,NaN,NaN,0.06068058305959789,0.420657787887059,0.3599772048274611,65.07968253968244,78.41280423280415,3246179530,578733702.8367085,29.231046860823977,23.644977497806423,25.194969770330093,71.42857142857143,28.571428571428573
2006-01-19,42.39999,42.82001,42.28999,42.52,39.4674298559442,40.554878666814375,41.43979571300939,42.162273214894554,38.88861400000001,40.205567700000095,41.57733900000001,41.90199599999996,41.90199599999996,43.64734690857544,40.15664509142448,111105184,57.39418877517504,59.079856894702594,NaN,NaN,NaN,NaN,NaN,NaN,0.0322803635648124,0.4003276592834766,0.3680472957186642,74.920634920635,73.54507936507936,3357284714,564059986.9769297,31.80970238006705,21.59792219295547,25.67090629660158,64.28571428571429,21.428571428571427
2006-01-20,42.45,42.49001,41.14999,41.25,39.48516687230296,40.56864344568934,41.43235274387177,42.07539005157126,38.91236400000001,40.233468700000095,41.59973900000002,41.91699599999997,41.91699599999997,43.634293374965374,40.199698625034564,188671120,42.59443424644778,59.149609337941044,NaN,NaN,42.59443424644778,NaN,NaN,NaN,-0.07161638379912721,0.27852681596975515,0.35014319976888236,34.60317460317465,58.201164021164026,3168613594,403551131.288208,26.30213038594501,32.265700573101455,25.025196654135932,57.142857142857146,14.285714285714286
2006-01-23,41.36,41.45,41.08,41.25999,39.502826803921835,40.58233347646777,41.42559342058268,41.99773290380257,38.93396395000001,40.258468700000094,41.62213880000002,41.923495499999966,41.923495499999966,43.629778048720055,40.217212951279876,111432064,42.719557895732926,59.518925387395896,NaN,NaN,NaN,NaN,NaN,NaN,-0.13553725330745786,0.18072163313456002,0.3162588864420179,34.92031746031757,48.1480423280424,3280045658,400533430.52799267,25.041124607417537,31.62568485318134,23.911826879404817,50,7.142857142857143
2006-01-24,41.36,41.7,41.31,41.44,39.522102159106694,40.59931697198326,41.4261583844814,41.944615484392806,38.957963950000014,40.28666870000009,41.64775880000002,41.92564549999996,41.92564549999996,43.629375444407245,40.22191555559267,77967248,45.04398772338547,59.006568476013506,NaN,NaN,NaN,NaN,NaN,NaN,-0.15989198341455046,0.1163939071738298,0.27628589058838027,16.14349775784748,28.555663273779896,3358012906,374544347.86132413,26.879306190563174,29.79618524011537,23.947572312556538,42.857142857142854,0
2006-01-25,41.64,41.67,41.08,41.25999,39.53939457543399,40.61239960620141,41.41964197724683,41.87941305730778,38.981863900000015,40.30946860000009,41.66095840000002,41.918494999999965,41.918494999999965,43.63211076500339,40.20487923499654,99830944,43.15792838636365,57.99076306189901,NaN,NaN,NaN,NaN,NaN,NaN,-0.18078191782655945,0.050308493305180946,0.2310904111317404,8.071300448430643,19.711705222198564,3258181962,335623816.10051143,24.807057892904616,30.50444260660638,23.881676773267667,35.714285714285715,85.71428571428571
2006-01-26,41.52,41.69,41.23,41.55,39.55940059955903,40.63096595063306,41.424754056570485,41.84804038518323,39.00631390000001,40.335768600000094,41.677758200000014,41.94409549999996,41.94409549999996,43.61919470591836,40.26899629408156,112779808,47.00767808982451,57.10856880490733,NaN,NaN,NaN,NaN,NaN,NaN,-0.16799748363355477,0.021093556589796947,0.18909104022335171,21.076233183856413,15.097010463378178,3370961770,379755045.31790257,23.563220674981302,28.64989785214155,23.321179756023177,28.571428571428573,78.57142857142857
2006-01-27,41.81,42.39,41.74001,42.11,39.584779698070875,40.66025375359082,41.4516264465089,41.872988919927685,39.03656390000001,40.369168600000094,41.70567820000001,42.000094999999966,42.000094999999966,43.61776697108311,40.382423028916826,110836128,53.54968498391601,56.187542167466695,NaN,NaN,NaN,NaN,NaN,NaN,-0.11716375744380128,0.04263634341860012,0.1598001008624014,46.18834080717485,25.111958146487307,3481797898,395100117.02472883,29.946115015069225,25.59035416531904,21.611792731249505,21.428571428571427,71.42857142857143
2006-01-30,42.14,42.32001,42.07001,42.19,39.61070228813982,40.690545758470215,41.480582272136,41.90318045136314,39.06976390000001,40.397668600000095,41.739078200000016,42.07359499999997,42.07359499999997,43.58181837404822,40.56537162595172,53942768,54.41545456011192,55.23179810281107,NaN,NaN,NaN,NaN,54.41545456011192,NaN,-0.07551169882285341,0.06541047733383465,0.14092217615668806,49.77578475336311,39.01345291479813,3535740666,392938090.88328636,28.955047439448844,24.743440625812248,19.634007974922188,14.285714285714286,64.28571428571429
2006-01-31,42.14,42.27,41.81,42,39.634476394725496,40.7164755454312,41.50095159479733,41.91240136075713,39.10606385000001,40.4235786000001,41.76371800000001,42.15299499999996,42.15299499999996,43.45623095792499,40.849759042074936,101424256,51.93940722566196,54.081649133278624,NaN,NaN,NaN,NaN,NaN,NaN,-0.05885666408995216,0.06735134604424786,0.12620801013420002,41.25560538116592,45.739910313901305,3434316410,375299089.8398069,27.173063099596963,26.69931047129622,17.15881850760139,7.142857142857143,57.142857142857146
2006-02-01,41.75999,42.17,41.7,42.14999,39.65950638084763,40.74486197027415,41.526404081275864,41.93502885020883,39.14306380000001,40.451078600000095,41.78057760000001,42.194994499999964,42.194994499999964,43.43967993095326,40.95030906904667,89240256,53.72933620270914,52.87076576778836,NaN,NaN,NaN,NaN,NaN,NaN,-0.036910850334783696,0.0800694472157204,0.1169802975505041,48.41605618124977,46.482482105259606,3523556666,456940632.9778497,25.449662129993524,26.490327728964463,14.29573665277583,0,50
2006-02-02,42.03,42.08,41.41,41.42999,39.67712313327701,40.75842886195189,41.5226231369121,41.886929912093706,39.17526370000001,40.469188500000094,41.780177400000014,42.179493499999964,42.179493499999964,43.45382661813668,40.90516038186325,94051504,45.05486108699214,51.31080418794723,NaN,NaN,NaN,NaN,NaN,NaN,-0.06823591665918727,0.03168540172652001,0.09992131838570728,17.76598984771566,35.81255047004379,3429505162,368501336.63444674,22.978598396344477,27.72338946885365,12.01462524856081,0,42.857142857142854
2006-02-03,41.11,41.23,40.78,40.92,39.68949006727425,40.76162829042809,41.4989908570332,41.79484134903716,39.20634375000001,40.4810885000001,41.76759740000001,42.12949349999996,42.12949349999996,43.514312006513194,40.744674993486726,121104000,40.1146188148695,49.42408301953133,NaN,NaN,NaN,NaN,NaN,NaN,-0.11775015581495438,-0.0472663763829857,0.07048377943196868,6.862711457296798,24.34825249542075,3308401162,322750936.63444775,21.045611203862492,33.54467541649838,11.051989030659682,0,100
2006-02-06,40.89,41.00999,40.59,40.81,39.70063941983869,40.76258614606318,41.47197160773778,41.70104693484315,39.23229375000001,40.49288850000009,41.749797400000006,42.03599399999996,42.03599399999996,43.509207158366834,40.562780841633085,58171408,39.118291181707235,47.827964790969325,NaN,NaN,NaN,NaN,NaN,NaN,-0.15027459410969868,-0.11735946320515467,0.03291513090454401,9.865426612436664,11.498042639149709,3250229754,325522454.704116,19.881811223224403,34.191368695492905,10.997365393338965,14.285714285714286,100
2006-02-07,40.74001,40.92999,40.44,40.63,39.709886788795515,40.7599606778243,41.438953113316686,41.59904246485809,39.259993750000014,40.5073886000001,41.7263974,41.92499899999996,41.92499899999996,43.46900440158622,40.380993598413696,87377376,37.47792956008231,46.66552562378427,NaN,NaN,37.47792956008231,NaN,NaN,NaN,-0.1745698998422333,-0.18529724389824764,-0.010727344056014325,7.983159734623148,8.23709926811887,3162852378,305908508.3251305,18.590194424757236,33.958892417147666,12.331786818633118,7.142857142857143,100
2006-02-08,40.925,41.14999,40.69,41.10001,39.72371886054879,40.76669432776838,41.42566122651995,41.55151556344303,39.288618800000016,40.5267887000001,41.71059760000001,41.83599949999996,41.83599949999996,43.354546510846106,40.31745248915381,89928256,44.07274308623337,45.71399378885986,NaN,NaN,NaN,NaN,NaN,NaN,-0.15055374486526082,-0.19891952513759037,-0.04836578027232954,32.195452705108735,16.68134635072285,3252780634,376294538.4729146,20.229464151036574,31.61185416956783,12.534341011552778,0,92.85714285714286
2006-02-09,41.2,41.37,40.63,40.71001,39.73353270273239,40.76557186583237,41.39759647253877,41.471372176448455,39.316918850000015,40.53988890000009,41.693998,41.71099949999996,41.71099949999996,43.16684101752484,40.255157982475076,78220256,40.27642754184395,45.54842188138816,NaN,NaN,NaN,NaN,NaN,NaN,-0.15205655541418917,-0.238436474540066,-0.08637991912587684,13.846666666666605,18.008426368799498,3174560378,314988884.3176703,21.139505027586463,28.584150601885955,12.876463104714665,0,85.71428571428571
2006-02-10,40.69,41.06,40.25999,40.96001,39.745736456934054,40.7694221259149,41.380436218713726,41.422671016786694,39.346218850000014,40.55858900000009,41.6863382,41.608999999999966,41.608999999999966,42.97221367370196,40.245786326297974,102575872,43.62848907109341,45.61334553677106,NaN,NaN,NaN,NaN,NaN,NaN,-0.12828550686701154,-0.24673680270964127,-0.11845129584262973,32.864634438335756,26.302251270037033,3277136250,391923673.22800756,19.01873582476106,30.356501192421376,13.686653792170656,28.571428571428573,100
2006-02-13,40.72,40.74001,40.3,40.49001,39.75314216383023,40.763889212530444,41.34551754347005,41.333846158045105,39.37491890000002,40.5741892000001,41.6713382,41.48450049999996,41.48450049999996,42.77711434109456,40.19188665890536,70656000,39.17668151173051,45.194252235938556,NaN,NaN,NaN,NaN,NaN,NaN,-0.13557574004812173,-0.2879209709027819,-0.15234523085466017,10.799010333284645,19.170103812762335,3206480250,382290588.88901544,17.462271688524147,27.87217174786796,14.959212393324922,21.428571428571427,92.85714285714286
2006-02-14,40.55,41.02,40.41,40.89999,39.76455358508565,40.76658427762885,41.32804587509868,41.29252652394557,39.40451885000002,40.5981891000001,41.649198,41.394499999999965,41.394499999999965,42.58247848474148,40.20652151525845,94758496,44.496938885472694,45.28989584301777,NaN,NaN,NaN,NaN,NaN,NaN,-0.10548514444762139,-0.2842016614141869,-0.17871651696656551,30.046807291984592,24.570150687868335,3301238746,439763946.8399665,19.604213369263636,25.772828025838106,15.194468734512592,14.285714285714286,85.71428571428571
2006-02-15,40.77,41.25999,40.73,41.16,39.77843862404002,40.77437468797284,41.321455840781084,41.279904950236464,39.43471885000002,40.6233891000001,41.6302582,41.341999499999964,41.341999499999964,42.472598636824074,40.211400363175855,92268320,47.625838825140576,45.334050181254625,NaN,NaN,NaN,NaN,NaN,NaN,-0.06287268135861954,-0.25730736866483994,-0.1944346873062204,42.25379223571698,27.699869953662073,3393507066,497216857.806587,21.29471689351601,24.076066532297684,14.936477439817878,7.142857142857143,78.57142857142857
2006-02-16,41.31,41.55,41.14999,41.53999,39.79596649842768,40.7895353872209,41.33002580780928,41.30467495497585,39.46591880000002,40.6512890000001,41.625057999999996,41.292998999999966,41.292998999999966,42.29247547506387,40.293522524936066,103879184,51.89399977047022,45.21578695172279,NaN,NaN,NaN,NaN,51.89399977047022,NaN,-0.006845427182099489,-0.20299147128384476,-0.19614604410174527,62.1353190745721,44.81197286742455,3497386250,595897018.6229696,23.895642497208154,22.85316113358354,14.535541702332088,0,71.42857142857143
2006-02-17,41.46001,41.46001,41.2,41.21001,39.81003658302044,40.79786161717692,41.325319305542244,41.295659244978154,39.49332885000002,40.6757892000001,41.6105382,41.29099949999996,41.29099949999996,42.29097194173432,40.291027058265605,81770128,48.21912010733985,44.773191633667636,NaN,NaN,NaN,NaN,NaN,NaN,0.009359892248414936,-0.1844461787912266,-0.19380607103964154,47.26444147044017,50.55118426024308,3415616122,520422948.32290065,22.83402100524361,21.837854387946727,14.134605964846301,0,64.28571428571429
2006-02-21,41.22,41.27,40.61,40.75,39.819389452841136,40.79691386238134,41.30275776414843,41.24369169783738,39.51827890000002,40.69658920000009,41.588338199999995,41.26549999999996,41.26549999999996,42.29296667109459,40.23803332890533,85106064,43.58538501903302,44.176475761765566,NaN,NaN,NaN,NaN,NaN,NaN,-0.0085634590773144,-0.20451039488628453,-0.19594693580897013,25.654839503458,45.018200016156754,3330510058,471422487.2319915,20.893474182783855,27.57910101577873,15.056977297385886,0,57.142857142857146
2006-02-22,40.81,41.53999,40.67999,41.25999,39.83372378664371,40.80608368688864,41.30108059692692,41.24524391709096,39.54529390000002,40.722389200000094,41.582317999999994,41.25649949999997,41.25649949999997,42.280843068451254,40.23215593154868,90997680,49.39184570577944,43.86665501198488,NaN,NaN,NaN,NaN,NaN,NaN,0.014984223401177915,-0.17721665655749774,-0.19220087995867566,54.94475305080752,42.6213446749019,3421507738,503165863.9761778,22.012319802374005,24.640561537295717,15.316264334295544,0,50
2006-02-23,41.22,41.53999,41.08,41.14999,39.84682096289601,40.81289371289085,41.29515547547881,41.23617211546325,39.57089385000002,40.741889100000094,41.5710178,41.25099949999996,41.25099949999996,42.276389749723904,40.22560925027602,66530560,48.23857816706524,44.09406337484724,NaN,NaN,NaN,NaN,NaN,NaN,0.023690272548059915,-0.16258803927360077,-0.18627831182166069,68.99171324253331,49.86376859893294,3354977178,456881282.7774571,20.739451937879817,23.215714941139478,15.050222576383254,0,42.857142857142854
2006-02-24,41.14999,41.28999,41.00999,41.25999,39.86088234634978,40.82174710471479,41.293776437224736,41.238440485419126,39.59836375000002,40.75988890000009,41.5588776,41.23649899999997,41.23649899999997,42.25272732682696,40.220270673172976,57087920,49.50821701653028,44.76503467496587,NaN,NaN,NaN,NaN,NaN,NaN,0.03662337908725208,-0.14049908796259558,-0.17712246704984766,77.51877892419468,67.15174840584517,3412065098,501736077.06317097,19.982007215009883,23.2810109029474,13.95946019894399,64.28571428571429,35.714285714285715
2006-02-27,41.37,41.87,41.33,41.72,39.87938102947068,40.83953429076004,41.31049108674534,41.28430329633159,39.62721375000002,40.78148890000009,41.5523776,41.21699899999997,41.21699899999997,42.17895162681898,40.25504637318097,64960240,54.53104441971915,45.86594562053814,NaN,NaN,NaN,NaN,54.53104441971915,NaN,0.07378129691625135,-0.08489584590453347,-0.15867714282078482,90.68328768144303,79.06459328272366,3477025338,530607294.84094906,25.90924874963233,21.443566160544684,12.74284172309534,100,28.571428571428573
2006-02-28,41.59,41.72,40.97,41.10001,39.89152659136649,40.844692225596475,41.302236926480816,41.26675155382382,39.65346375000002,40.799489000000094,41.5363978,41.16249949999997,41.16249949999997,42.01506220752839,40.30993679247155,117638944,47.650855748742934,46.59258320544247,NaN,NaN,NaN,NaN,NaN,NaN,0.055083738272792976,-0.0898224699797936,-0.14490620825258657,52.17483121222836,73.45896593928869,3359386394,453752988.466122,23.457872026005514,23.95617563084049,10.728884329093669,92.85714285714286,21.428571428571427
2006-03-01,41.22,41.7701,41.14999,41.66,39.909123341701154,40.8608369340005,41.31626685093255,41.30420378679298,39.680563700000015,40.8284891000001,41.530197799999996,41.14549949999997,41.14549949999997,41.94232263110705,40.348676368892896,80979376,53.37318160074264,47.25690024219313,NaN,NaN,NaN,NaN,NaN,NaN,0.07753522596689286,-0.047987175793970493,-0.12552240176086335,86.95660275402007,76.60490721589714,3440365770,505976726.60316133,22.124399829705816,21.95727909039292,9.187663156515537,85.71428571428571,14.285714285714286
2006-03-02,41.55,41.84,41.41,41.69,39.926843507455374,40.87725600461435,41.33092305285676,41.340946283288886,39.70659375000002,40.862889100000096,41.5323978,41.122499999999974,41.122499999999974,41.82271933724091,40.422280662759036,69878128,53.66539099028685,48.21325477422477,NaN,NaN,NaN,NaN,NaN,NaN,0.09060175252115703,-0.012270211109417062,-0.10287196363057409,88.81994521773156,75.98379306132666,3510243898,527102672.2775789,21.804451960328418,20.760196043390632,8.293470368582781,78.57142857142857,7.142857142857143
2006-03-03,41.44,42.00999,41.39,41.45,39.94199929345084,40.88859746986952,41.335592737058455,41.351332351547086,39.73034375000002,40.8939891000001,41.5429978,41.12350049999997,41.12350049999997,41.825529236039934,40.42147176396001,112081680,50.916295331485536,48.733812364252785,NaN,NaN,NaN,NaN,NaN,NaN,0.07966372938487692,-0.003292301899477934,-0.08295603128435486,67.2518552740076,81.0094677485864,3398162218,436714570.56110036,22.24258620938658,19.139927642022943,7.188831693777915,100,0
2006-03-06,41.53,41.63,40.96001,41.09,39.953422186053324,40.89258563878299,41.32596164933067,41.32644355616165,39.749793750000016,40.9235891000001,41.5457978,41.13200049999997,41.13200049999997,41.828058911505195,40.43594208849474,99593632,47.02494945602797,49.29440293170261,NaN,NaN,NaN,NaN,NaN,NaN,0.046413819383298666,-0.02493875705523152,-0.07135257643853019,42.50026562666045,66.1906887061332,3298568586,375766817.5255044,20.390537105531582,22.890111011741755,5.961175735142634,92.85714285714286,0
2006-03-07,41.03,41.07001,40.64999,40.85001,39.96234345783389,40.89174255682689,41.30729687876868,41.281068931765304,39.766483850000014,40.9526892000001,41.540198000000004,41.13400099999997,41.13400099999997,41.82656736378211,40.44143463621783,96498128,44.57899354383938,49.3002639787288,NaN,NaN,NaN,NaN,NaN,NaN,0.008475237524619914,-0.06075852953275529,-0.0692337670573752,17.14369388352757,42.29860492806521,3202070458,371176482.3094646,19.25650933838943,25.535589541949655,5.9914717991670035,85.71428571428571,0
2006-03-08,40.77,41.09,40.5,40.87,39.97137486621365,40.89131201114715,41.290147981562065,41.241919509692416,39.78253385000002,40.9865192000001,41.52965800000001,41.14600099999997,41.14600099999997,41.81098827224161,40.48101372775833,104013376,44.83637509610432,49.10101656951191,NaN,NaN,NaN,NaN,NaN,NaN,-0.013841310409220375,-0.08653540506890067,-0.0726940946596803,24.503473532937104,28.04914434770838,3306083834,397620560.9535307,17.824986195709105,25.52714784937692,6.822632165888575,78.57142857142857,100
2006-03-09,41,41.1501,40.47,40.52,39.97683382276874,40.883959298055125,41.25994609993218,41.17316527067409,39.79588380000001,41.0139192000001,41.511998000000006,41.117000499999975,41.117000499999975,41.83588600703446,40.39811499296549,108641568,41.22629186658987,48.33903743352045,NaN,NaN,41.22629186658987,NaN,NaN,NaN,-0.048776750098694116,-0.13366503228304794,-0.08488828218435382,3.24677432970371,14.964647248722807,3197442266,304953344.9605898,17.065611365896963,23.370431700589975,7.777069069215609,71.42857142857143,100
2006-03-10,40.48,40.78999,40.19,40.56,39.982636471298406,40.87754426245007,41.23249723326817,41.11476857822894,39.808833800000016,41.0389192000001,41.50243820000001,41.109499999999976,41.109499999999976,41.848074979406995,40.370925020592956,124486256,41.80301035159428,47.880743879538635,NaN,NaN,NaN,NaN,NaN,NaN,-0.06479003222654971,-0.16587582246754096,-0.10108579024099125,20.329782031769607,16.026676631470153,3321928522,334002696.9540569,15.797560582794551,25.101503306337662,9.242682151812478,64.28571428571429,100
2006-03-13,40.75999,40.94,40.62,40.67999,39.98957531238001,40.873632296857004,41.21083028294393,41.07336109458809,39.82318375000002,41.0639192000001,41.49623780000001,41.095498999999975,41.095498999999975,41.85519315174983,40.33580484825012,69171056,43.5911353859787,47.881154620034756,NaN,NaN,NaN,NaN,NaN,NaN,-0.06285138535016793,-0.17965002192870116,-0.11679863657853323,26.922675399315253,16.833077253596205,3391099578,290766463.7630565,16.939721636276445,23.89071501911132,9.473500141404674,57.142857142857146,92.85714285714286
2006-03-14,40.64999,41.42,40.64,41.37,40.00331088141105,40.88346136028558,41.217072232632404,41.10161241891303,39.839083750000015,41.0985192000001,41.50923780000001,41.13949849999997,41.13949849999997,41.85443776607795,40.424559233922,118215312,52.60873030181928,48.11093209118046,NaN,NaN,NaN,NaN,NaN,NaN,-0.01324184848321859,-0.13335094718255647,-0.12010909869933788,64.83552107429145,37.362659501792116,3509314890,393825966.53228605,21.23692380311883,21.588783785791687,9.129785750362021,50,85.71428571428571
2006-03-15,41.53,41.72,41.32001,41.72,40.02039236517811,40.90002648186408,41.236794890176235,41.160506474254646,39.85663370000002,41.129019200000094,41.53539780000001,41.180498999999976,41.180498999999976,41.929055961201065,40.43194203879889,84396128,56.414824284026245,48.69494967096339,NaN,NaN,NaN,NaN,56.414824284026245,NaN,0.04197780176937162,-0.06763684648762336,-0.10961464825699498,84.06639596920849,58.60819748093841,3593711018,478222094.53228605,23.953276957735568,20.498059074166793,9.282601764859942,42.857142857142854,78.57142857142857
2006-03-16,41.85001,41.9201,41.33,41.37,40.033821296867885,40.9093328881638,41.242018619973244,41.180458238611344,39.87308370000001,41.1596592000001,41.53659780000001,41.19099899999998,41.19099899999998,41.94398944360575,40.4380085563942,101385936,51.92392456733404,48.8675002103065,NaN,NaN,NaN,NaN,NaN,NaN,0.053051016519897326,-0.04330087760712331,-0.09635189412702064,64.83552107429145,71.24581270593048,3492325082,390581074.44484293,24.693071497830456,18.974957224417203,9.673248249579126,35.714285714285715,71.42857142857143
2006-03-17,41.32001,41.59,41.23,41.45,40.04791262724731,40.920039167606106,41.250174752523314,41.206128882553124,39.88828370000002,41.1886592000001,41.53079760000001,41.186499499999975,41.186499499999975,41.9321341197343,40.44086488026565,78228432,52.84787362308707,48.74727372483279,NaN,NaN,NaN,NaN,NaN,NaN,0.06319430598529927,-0.01735901164539655,-0.08055331763069581,69.23114962170133,72.71102222173377,3570553514,407965170.44484377,23.543720018477707,19.38468895124473,9.691650835592627,28.571428571428573,64.28571428571429
2006-03-20,41.58,41.67999,41.39999,41.55,40.06285877025977,40.9325136395347,41.26193260536554,41.23887851278616,39.90273370000001,41.21255920000009,41.52339760000001,41.20349899999998,41.20349899999998,41.96581850527477,40.44117949472519,60240176,54.03698417040448,49.20342575495147,NaN,NaN,NaN,NaN,NaN,NaN,0.073355328972986,0.011140843585536686,-0.06221448538744931,74.72568530596301,69.59745200065196,3630793690,412272343.02884287,23.866259125561005,18.65729991290925,10.491552431413776,21.428571428571427,57.142857142857146
2006-03-21,41.50999,42.00999,41.08,41.11,40.07327808597858,40.93602822093005,41.25597446397865,41.226604368711286,39.91778365000001,41.233559300000096,41.49199780000001,41.22149899999997,41.22149899999997,41.95665284248707,40.48634515751288,136566000,48.26896974373238,48.838839193736455,NaN,NaN,NaN,NaN,NaN,NaN,0.048366079279048055,-0.0017568862886392367,-0.05012296556768729,50.54972829521039,64.83552107429159,3494227690,284517147.446095,25.241083393326864,16.449473843212743,11.97074212091378,14.285714285714286,50
2006-03-22,40.88,41.28,40.86,41.21001,40.084588851292224,40.94145360269381,41.25417193597949,41.22502395264355,39.93328370000001,41.25755940000009,41.45920000000001,41.21899999999997,41.21899999999997,41.95395325030037,40.48404674969957,112323504,49.586195287475135,48.547468072107044,NaN,NaN,NaN,NaN,NaN,NaN,0.03700723796399016,-0.0038639181126995936,-0.04087115607668975,56.044813433040666,60.440075678071366,3606551194,359404832.1843786,23.867429241567663,18.4049138654608,12.718517543916118,7.142857142857143,42.857142857142854
2006-03-23,41.09,41.22,40.82001,41.09,40.09459294232414,40.94439511551175,41.247733820843045,41.21216452858226,39.94978375000001,41.2881594000001,41.4234,41.21600049999997,41.21600049999997,41.95254378868515,40.479457211314795,75220688,48.006519615974206,48.339626949570516,NaN,NaN,48.006519615974206,NaN,NaN,NaN,0.020661612412981853,-0.015044140560462438,-0.03570575297344429,49.45082115835821,52.01512096220309,3531330506,385730850.6176406,22.6056842336771,17.96047148327643,13.000906484788086,0,35.714285714285715
2006-03-24,41.23,41.50011,41.02,41.3,40.10658704240052,40.951436796392706,41.24978347492763,41.22052981157442,39.96773370000001,41.3179393000001,41.3851998,41.21800099999997,41.21800099999997,41.95522835711903,40.48077364288091,81809184,50.95109707699369,48.62006606535378,NaN,NaN,NaN,NaN,NaN,NaN,0.023060607056557582,-0.006879994152747315,-0.029940601209304897,60.98934609530804,55.49499356223564,3613139690,399343847.0346271,24.891574218331712,16.811649890467873,13.97230292860989,78.57142857142857,28.571428571428573
2006-03-27,41.28,41.50999,41.24001,41.31,40.118561300685094,40.95853705785028,41.25214490728341,41.22905078190067,39.984533700000014,41.34233930000009,41.35139980000001,41.197500999999974,41.197500999999974,41.89972271718332,40.495279282816625,54405616,51.09313662868733,49.08536199998578,NaN,NaN,NaN,NaN,NaN,NaN,0.024266514679391477,0.00039254213993444864,-0.023873972539457028,61.53879966373452,57.32632230580026,3667545306,373146609.90595216,24.099807641773126,16.18472473179808,14.37442214380313,71.42857142857143,21.428571428571427
2006-03-28,41.37,41.67,40.99001,41.14,40.1287248698325,40.962130383437405,41.2477470677821,41.220569755052985,40.00249870000001,41.365339300000095,41.3145998,41.19950049999997,41.19950049999997,41.90082761488118,40.49817338511876,100534368,48.52072265415924,49.34852968270399,NaN,NaN,NaN,NaN,NaN,NaN,0.013118915018561973,-0.007475328766254563,-0.020594243784816536,52.19808900048905,58.242078253177205,3567010938,316963334.8817905,21.886057908806393,18.075201425703018,13.786555456044395,64.28571428571429,14.285714285714286
2006-03-29,41.2,42.10001,41.17,41.92,40.1465485029685,40.98109809861686,41.27410992786908,41.28718215933365,40.02344870000001,41.3910693000001,41.298999800000004,41.21250049999997,41.21250049999997,41.955868289233145,40.46913271076679,130733504,58.77621517910996,50.602095633598275,NaN,NaN,NaN,NaN,NaN,NaN,0.055409631880066874,0.048667796065267055,-0.0067418358147998195,90.57544201339282,68.10411022587213,3697744442,397088053.9116514,24.69310821285536,15.860166393455561,14.228626969761322,100,7.142857142857143
2006-03-30,42,42.30009,41.78999,42.05,40.16548831885936,41.00226447290168,41.30453698952127,41.35983147749235,40.045798700000006,41.412169300000095,41.29579960000001,41.23050049999997,41.23050049999997,42.0342290599436,40.42677194005634,115943440,60.19935516777323,51.91612026332535,NaN,NaN,NaN,NaN,NaN,NaN,0.08736972976481026,0.102470326391213,0.015100596626402746,85.11448791433791,75.96267297607326,3813687882,399342825.3776371,25.645269847873188,14.820878986811667,14.514391397607431,100,0
2006-03-31,42.14,42.19,41.84,41.92999,40.18304554951747,41.02063527541848,41.32906455855965,41.414132289159745,40.06694865000001,41.4306692000001,41.28399940000001,41.25449999999997,41.25449999999997,42.11000967270338,40.398990327296566,71090432,58.20181707528893,52.959740383990365,NaN,NaN,NaN,NaN,NaN,NaN,0.0950252072513259,0.13388210569056014,0.038856898439234226,77.70602798643438,84.46531930472172,3742597450,364809124.6672349,24.46087289694085,14.136393934158859,15.209048559426323,92.85714285714286,0
2006-04-03,42.14999,42.37,41.89999,41.98,40.20092569330337,41.03963259669732,41.35459143861613,41.46802445209691,40.08734870000001,41.4491692000001,41.2985994,41.29899999999997,41.29899999999997,42.20665290727744,40.391347092722505,80733312,58.81510622745922,53.4030529501075,NaN,NaN,NaN,NaN,NaN,NaN,0.09767940428437845,0.1609561537947073,0.06327674951032884,74.83854734546661,79.21968774874631,3823330762,311562343.9883541,25.32713838526976,13.25133273140911,17.38621425745756,100,0
2006-04-04,42.035,42.31,41.92999,42.21001,40.22091658192721,41.062808386861725,41.38813726455275,41.5386897423734,40.10904875000001,41.4698693000001,41.31759980000001,41.366999999999976,41.366999999999976,42.33188716443302,40.40211283556693,90039808,61.60541584302707,53.77380949003613,NaN,NaN,NaN,NaN,NaN,NaN,0.10832430659209585,0.19868213275044866,0.0903578261583528,89.67799792256717,80.7408577514894,3913370570,354218765.22526705,24.017832594960087,12.5662949505659,19.06684954994822,92.85714285714286,42.857142857142854
2006-04-05,42.3,42.67,42.21001,42.61,40.2446885562364,41.09344584454763,41.436053450256566,41.64071929071879,40.13274875000001,41.4943793000001,41.340999800000006,41.45399999999998,41.45399999999998,42.53119043817036,40.376809561829596,91662256,65.92849212612151,54.77413574423524,NaN,NaN,NaN,NaN,NaN,NaN,0.13402043828068638,0.2578833740092108,0.12386293572852441,96.75673922561731,87.09109483121703,4005032826,421968608.5206424,27.442572993205793,11.772922186717928,20.985656302050938,100,35.714285714285715
2006-04-06,42.58,42.94,42.4404,42.73,40.269418023338524,41.12585285752689,41.48679645220729,41.74446031065033,40.157148700000015,41.51567920000011,41.37040000000001,41.56449999999998,41.56449999999998,42.68818244628353,40.440817553716435,91713008,67.12444168615721,55.79389060588311,NaN,NaN,NaN,NaN,67.12444168615721,NaN,0.1496295878897857,0.31089992059075655,0.16127033270097085,90.09429289760794,92.17634334859748,4096745834,436581009.3148776,29.27184830290922,10.963321425370506,23.543905870577902,100,28.571428571428573
2006-04-07,42.895,43.05,42.3,42.32001,40.28982192360381,41.14949953361546,41.519471493297196,41.79927456677887,40.179698750000014,41.5317792000001,41.38580020000001,41.65250049999998,41.65250049999998,42.722098980788076,40.582902019211886,116609376,59.44681796737666,56.18030730566683,NaN,NaN,NaN,NaN,NaN,NaN,0.12393439538889334,0.31618832693708754,0.1922539315481942,67.26487562724516,84.70530258349014,3980136458,326193909.6182396,26.343130454223246,11.739395513790113,25.408049888826408,100,21.428571428571427
2006-04-10,42.39999,42.5,42.09,42.25999,40.30942558605551,41.1714894438409,41.548511434736525,41.843152227085646,40.204048700000016,41.5472391000001,41.38880000000001,41.73150049999998,41.73150049999998,42.73336390091997,40.729637099079994,58988048,58.393836906367255,56.9035121029979,NaN,NaN,NaN,NaN,NaN,NaN,0.09574922215155648,0.3119404592376398,0.21619123708608332,64.57338373714691,73.97751742066667,3921148410,316119902.006142,24.877764754537786,13.935520568287089,25.915495277123675,92.85714285714286,14.285714285714286
2006-04-11,42.39999,42.42999,41.71001,41.92,40.32545120211466,41.18631143505197,41.56307961376647,41.8504710626013,40.22879870000001,41.5612391000001,41.38340000000001,41.75900049999998,41.75900049999998,42.74979571804737,40.76820528195258,91488624,52.69938026071002,57.12588245822896,NaN,NaN,NaN,NaN,NaN,NaN,0.0493956273980552,0.2779357713336523,0.22854014393559713,49.32712702747552,60.38846213062254,3829659786,277998583.08061755,22.50981825059076,17.632660194339984,25.860311123744967,85.71428571428571,7.142857142857143
2006-04-12,41.95,42.08,41.8,41.92999,40.34141676229262,41.20103774326876,41.577468256363865,41.85804429473451,40.254448650000015,41.5728589000001,41.38199980000001,41.76949999999998,41.76949999999998,42.76286673999381,40.77613326000615,58884688,52.844892006154346,57.471480486098976,NaN,NaN,NaN,NaN,NaN,NaN,0.01630667340805822,0.2489234856956699,0.2326168122876117,45.63031859377953,53.176943119467325,3888544474,273788327.88861704,21.646883053924117,16.956695469828734,25.910215581183262,78.57142857142857,0
2006-04-13,41.89999,42.33,41.78999,42.10001,40.35891520246881,41.21883917409512,41.59796008944763,41.88108864761694,40.279198750000006,41.5807889000001,41.38100020000001,41.80600049999998,41.80600049999998,42.79158441633751,40.82041658366246,63482400,55.36174382232191,57.786526682193845,NaN,NaN,NaN,NaN,NaN,NaN,0.003441891448436152,0.23691917659815687,0.23347728514972071,53.88375671726561,49.61373411284023,3952026874,283196480.4635687,23.464717329711686,15.706136924739694,25.94108732507462,71.42857142857143,14.285714285714286
2006-04-17,42.03999,42.21001,41.39,41.66,40.371861319857175,41.22757503203383,41.600393027116354,41.86003258593914,40.30215880000001,41.5828889000001,41.385600400000015,41.81650049999998,41.81650049999998,42.79110329814014,40.84189770185982,104085120,48.19275540696234,57.57935659492778,NaN,NaN,48.19275540696234,NaN,NaN,NaN,-0.035010912387027776,0.189713644665936,0.22472455705296376,32.52394429099164,44.01267320067893,3847941754,247654384.08523113,20.93933196463241,19.26556184790847,24.835026974504082,64.28571428571429,7.142857142857143
2006-04-18,41.785,42.56,41.77,42.46001,40.39263891866457,41.25197968486485,41.6341034966412,41.917173292040175,40.33055885000001,41.591999000000094,41.41640060000002,41.862000999999985,41.862000999999985,42.86708100883447,40.8569209911655,124333376,58.67161659472385,58.30442044782525,NaN,NaN,NaN,NaN,NaN,NaN,-0.008271056656114578,0.21438573623282053,0.2226567928889351,68.61755319148928,51.67508473324886,3972275130,340514103.7150016,22.964879739000764,17.091372710350633,25.201224779927408,57.142857142857146,0
2006-04-19,42.53999,42.64999,42.3,42.64999,40.415100123453975,41.27966305744178,41.67394218304743,41.98696535946492,40.36018375000001,41.601498900000095,41.453200400000014,41.939000499999985,41.939000499999985,42.93777693353408,40.94022406646589,79128320,60.70428234032265,58.44213953076901,NaN,NaN,NaN,NaN,60.70428234032265,NaN,0.019016709628867923,0.24642767992502002,0.2274109702961521,75.90301204819305,59.014836510224676,4051403450,419642423.7150016,23.088862561255404,16.320052003433844,24.8722786722548,50,0
2006-04-20,42.62,42.82001,42.38,42.5,40.43584539585742,41.30382814541323,41.706336607241646,42.03582580142064,40.38713375000001,41.60849890000009,41.49060040000001,42.00349999999999,42.00349999999999,42.97178316114826,41.03521683885172,81413008,58.26768147928076,58.30416283873384,NaN,NaN,NaN,NaN,NaN,NaN,0.023477991738772352,0.25675845996961755,0.2332804682308452,66.86746987951817,70.46267837306685,3969990442,382635501.75849956,23.98434250410208,15.38029758054613,24.522853289391122,42.857142857142854,78.57142857142857
2006-04-21,42.67,42.86,41.82001,42,40.451409123261826,41.31761372669217,41.71785281872236,42.03241382033296,40.41248380000001,41.6095989000001,41.50860020000001,42.04899999999999,42.04899999999999,42.92215364063901,41.175846359360975,130187008,50.92893269198607,57.78467109706934,NaN,NaN,NaN,NaN,NaN,NaN,-0.00899212359499893,0.22204031373709654,0.23103243733209547,36.74698795180727,59.83915662650617,3839803434,297511156.9954915,20.918347065459418,20.29745464548217,22.719795702815926,35.714285714285715,71.42857142857143
2006-04-24,41.96001,42.07001,41.72,41.96001,40.46642007725922,41.3303344449755,41.727349178772464,42.02551821839649,40.43698385000001,41.613799100000094,41.53360020000001,42.082000499999985,42.082000499999985,42.88662761374988,41.27737338625009,78556496,50.38237127417865,57.18233288612073,NaN,NaN,NaN,NaN,NaN,NaN,-0.03353072786492153,0.18911902750094356,0.2226497553658651,34.33795180722877,45.98413654618474,3761246938,326690694.8514362,19.992077109369323,20.66391877067954,20.601979576339847,28.571428571428573,64.28571428571429
2006-04-25,42.08,42.10001,41.64999,41.87,40.48038604663973,41.341020891609645,41.73294332862452,42.01070695950159,40.45748385000001,41.6190691000001,41.551800000000014,42.110000499999984,42.110000499999984,42.840808737626205,41.37919226237376,77660816,49.10497991209014,56.28944460533952,NaN,NaN,NaN,NaN,NaN,NaN,-0.05492739670776853,0.15399050948115445,0.20891790618892297,28.915662650602282,33.33353413654611,3683586122,324964975.63895583,18.837132760485602,20.36889653708618,18.64519605419849,21.428571428571427,57.142857142857146
2006-04-26,41.87,42.06,41.7,41.86,40.494113548663215,41.35129770563718,41.737925943188266,41.99635391573953,40.47618385000001,41.625269000000095,41.579199800000005,42.146000499999985,42.146000499999985,42.74032073033142,41.55168026966855,82566688,48.95647206348959,55.07715745800867,NaN,NaN,NaN,NaN,NaN,NaN,-0.06800187062744983,0.12391556790461067,0.1919174385320605,28.313253012048182,30.52228915662641,3601019434,315790899.1945099,17.944074929767844,19.403218650391935,16.070135730136784,14.285714285714286,50
2006-04-27,41.67,42.49001,41.5,42.25999,40.51168445862677,41.369291612456244,41.75839904345539,42.02146211424053,40.49598380000001,41.6277989000001,41.606399800000005,42.16299999999999,42.16299999999999,42.74989358507428,41.5761064149257,174122000,54.83968597243735,54.19967490702867,NaN,NaN,NaN,NaN,NaN,NaN,-0.048855174462455825,0.13084847045399073,0.17970364491644655,52.4090361445785,36.54598393574299,3775141434,409001509.5317805,21.082495133905173,17.014303504776507,13.58261974709723,7.142857142857143,42.857142857142854
2006-04-28,42,42.22,41.78,41.85001,40.52500113068023,41.37881078844721,41.761991629986554,42.00513334145572,40.513283850000015,41.6252291000001,41.620200000000004,42.15300049999998,42.15300049999998,42.753902212613774,41.55209878738619,88883248,48.65017188955135,53.42848590146973,NaN,NaN,NaN,NaN,NaN,NaN,-0.06209561690497706,0.10208412378522524,0.1641797406902023,31.29319727891138,37.33849547851269,3686258186,348403335.13396096,19.80908403161192,15.986616656367115,11.606260106335332,0,35.714285714285715
2006-05-01,41.92999,42.3,41.31,41.44,40.53410559704162,41.38002245600271,41.749364507241985,41.951311118459934,40.52663385000001,41.6216291000001,41.61820020000001,42.128500999999986,42.128500999999986,42.79962630290422,41.45737569709575,92933680,43.37737194609822,52.35588126145051,NaN,NaN,43.37737194609822,NaN,NaN,NaN,-0.09480199057025013,0.04567725247738963,0.14047924304763976,8.387096774193271,30.696443399227718,3593324506,279876480.1844653,17.465810173864828,19.71143874598433,10.023997460466871,57.142857142857146,100
2006-05-02,41.61,41.73,41.39999,41.55,40.54421399906111,41.383388347963056,41.74154629127171,41.91309101193994,40.53993385000002,41.617769100000096,41.62500000000001,42.10700099999999,42.10700099999999,42.82190123373708,41.3921007662629,85173568,45.09662143758494,51.81282705979872,NaN,NaN,NaN,NaN,NaN,NaN,-0.10459281438113802,0.009738225071217244,0.11433103945235526,15.483870967741634,18.38805500694876,3678498074,272136244.1179204,16.75433077832432,18.908482433931198,9.58761970830933,50,92.85714285714286
2006-05-03,41.58,41.64,41.28,41.49001,40.553624904543085,41.38549966780537,41.73168212298655,41.87279758223137,40.553718900000014,41.614069200000095,41.63980020000001,42.07100099999999,42.07100099999999,42.83252037086156,41.30948162913842,74982432,44.30651190239831,51.20294276667328,NaN,NaN,NaN,NaN,NaN,NaN,-0.1101173408199679,-0.023315636572604603,0.08680170424736329,13.291772151898554,12.387579964611154,3603515642,284637481.80858594,15.98915840593787,19.567140308794293,9.438565787100044,42.857142857142854,100
2006-05-04,41.53,41.99001,41.53,41.83,40.56632515424912,41.394301654581504,41.73553772600668,41.86872162201886,40.56696895000002,41.6167592000001,41.65120040000001,42.032000999999994,42.032000999999994,42.75818283962104,41.305819160378945,88713504,49.68670677364018,50.79758297748174,NaN,NaN,NaN,NaN,NaN,NaN,-0.08690146104517518,-0.021825122059105695,0.06507633898606949,34.810126582278336,21.195256567306174,3692229146,311634728.4444414,19.442854412656203,18.315975727317987,8.236950591701376,35.714285714285715,92.85714285714286
2006-05-05,42.11,42.2101,41.94,42.16,40.58218261540087,41.40946399805514,41.75218330537897,41.896462419921825,40.580468900000014,41.621209200000095,41.671400600000005,42.00350099999999,42.00350099999999,42.65918941090653,41.34781258909346,80394368,54.301266112945804,51.23390517076627,NaN,NaN,NaN,NaN,NaN,NaN,-0.04732813868354999,0.005916165631631998,0.05324430431518199,55.69620253164534,34.59936708860741,3772623514,362204899.20786196,21.356023119723435,17.404866734016753,8.667705409096559,28.571428571428573,85.71428571428571
2006-05-08,42.08,42.28,42.07001,42.2,40.598280300819766,41.42511817631147,41.769744744383715,41.92537076088165,40.59411890000001,41.6245392000001,41.6902008,41.997500499999994,41.997500499999994,42.64361972288372,41.35138127711627,45093328,54.84191306677989,50.96035491877027,NaN,NaN,NaN,NaN,54.84191306677989,NaN,-0.01797603926039225,0.030774255239691684,0.04875029450008393,58.22784810126599,49.57805907172989,3817716842,372939769.75750756,21.698985091429332,16.904567581222846,8.507454055414417,21.428571428571427,78.57142857142857
2006-05-09,42.10001,42.1801,41.97,42.03999,40.61262567096086,41.43729385598847,41.780342597545136,41.93628687889292,40.60721885000001,41.6244891000001,41.696600600000004,41.98650049999999,41.98650049999999,42.62176971394126,41.35123128605872,48566784,52.18238059153494,50.35164765099972,NaN,NaN,NaN,NaN,NaN,NaN,-0.009292289821407694,0.03713493222332431,0.04642722204473201,48.10063291139258,54.008227848101306,3769150058,356730807.8627921,20.987392440211718,17.77616312641074,7.872333295694635,14.285714285714286,71.42857142857143
2006-05-10,41.92999,41.98,41.55,41.67,40.62314680856324,41.441901898444144,41.776015436857094,41.910926223760264,40.61921885000001,41.622199100000095,41.70800040000001,41.9740005,41.9740005,42.62368659664737,41.32431440335264,92440496,46.55985009683724,49.51537398082519,NaN,NaN,NaN,NaN,NaN,NaN,-0.02739753227511811,0.012180306700834365,0.039577838975952476,24.683544303797532,43.670675105485365,3676709562,315885007.30465454,19.51883798130082,22.530131590718312,6.822626395800946,7.142857142857143,64.28571428571429
2006-05-11,41.63,41.64999,40.63,40.74001,40.62430962638848,41.428003048970005,41.73538777266662,41.79941039292595,40.62581890000001,41.6098992000001,41.689600600000006,41.91450149999999,41.91450149999999,42.758356123837316,41.07064687616267,141027568,36.04644596434394,48.452339214565036,NaN,NaN,NaN,NaN,NaN,NaN,-0.0970199363511208,-0.08169708146294852,0.015322854888172276,5.914484330729177,26.232887181973094,3535681994,205278213.53906736,16.82742660533071,31.621274140076782,8.896100197061301,0,100
2006-05-12,40.57001,40.75999,39.96001,40.19,40.6199881375687,41.403488137109214,41.67478433060126,41.646133212647285,40.62816890000001,41.595999200000094,41.659600600000005,41.819001,41.819001,42.94305956082007,40.69494243917993,153954432,31.5141854767775,47.10461165760781,NaN,NaN,NaN,NaN,NaN,NaN,-0.17081201385397848,-0.19819216242930082,-0.027380148575322345,9.090513833992123,13.229514156172945,3381727562,139845944.13233194,15.102375868606316,36.96529700264719,11.777309534713366,21.428571428571427,100
2006-05-15,40.03,40.34,39.78999,40.16,40.61541114117498,41.3788646096417,41.61538102351886,41.50459671620469,40.62941890000001,41.5883992000001,41.6338006,41.744001,41.744001,43.08056684130923,40.40743515869077,127902496,31.283139666704898,45.83162306865172,NaN,NaN,NaN,NaN,NaN,NaN,-0.20977412074934376,-0.28959779951200204,-0.07982367876265828,13.703972563165983,9.56965690929576,3253825066,184031964.8682427,14.03692760131883,36.53825831606159,14.676158925970496,14.285714285714286,100
2006-05-16,40.16,40.25999,39.77,39.86,40.60789461240707,41.3487880827181,41.54654255200831,41.347968457518526,40.630843900000016,41.57749920000009,41.6092006,41.614000499999996,41.614000499999996,43.13917783530861,40.088823164691384,132405504,28.993938751081288,44.40572783205113,NaN,NaN,NaN,NaN,NaN,NaN,-0.24161567038795476,-0.3818432667476017,-0.14022759635964696,3.308811364663971,8.701099253940694,3121419562,100266210.08761264,13.147076010950261,34.48059137352543,17.596538529830518,7.142857142857143,100
2006-05-17,39.67999,39.81,39.23,39.32001,40.595079840144315,41.30861425929794,41.45922754996877,41.154829556802476,40.62919400000001,41.559399300000095,41.57860060000001,41.4475015,41.4475015,43.19481425681477,39.70018874318523,207927808,25.392121232013224,42.302330350592264,NaN,NaN,NaN,NaN,NaN,NaN,-0.2820899161913903,-0.4928399915988848,-0.21075007540749452,2.9319218241044487,6.648235250644802,2913491754,-43125108.26383151,12.086180497304548,38.61486400025534,20.571193958149006,0,100
2006-05-18,39.49001,39.66,39,39.05,40.57970591138666,41.26388922446036,41.36474803820529,40.95436959901176,40.62404400000001,41.5359293000001,41.54220060000001,41.275001499999995,41.275001499999995,43.24023149675098,39.30977150324901,139722880,23.800020180252588,40.52731951421377,NaN,NaN,23.800020180252588,NaN,NaN,NaN,-0.30798080900486435,-0.595726086663575,-0.2877452776587106,1.5151515151514303,2.585294901306618,2773768874,-161677854.93049926,11.077671045137121,38.300585310155164,23.746395004497494,7.142857142857143,100
2006-05-19,39.17999,39.47,38.75,39.35001,40.567470131173856,41.22599062595619,41.28573870337371,40.80157344672493,40.62049405000001,41.5153994000001,41.51880080000001,41.142502,41.142502,43.246759199142595,39.038244800857406,194311808,29.118016971028197,39.50879415885163,NaN,NaN,NaN,NaN,NaN,NaN,-0.28629460001559776,-0.6456135276782078,-0.35931892766261003,16.997450424929102,7.148174588061662,2968080682,-32131252.04694453,10.088667288542128,37.98111251465452,27.459579095599768,0,100
2006-05-22,39.02,39.24001,38.62,38.97,40.55157490598805,41.18131754425409,41.19492542088847,40.62713788037018,40.61697905000001,41.4947195000001,41.48700080000001,40.9930015,40.9930015,43.26209512612679,38.72390787387321,169606624,26.586938960614646,38.186673981925175,NaN,NaN,NaN,NaN,NaN,NaN,-0.2786695766923883,-0.7076558985280954,-0.4289863218357071,9.562841530054675,9.358481156711738,2798474058,-10249614.88986583,9.192546958727354,36.189244677504995,31.27726626003569,28.571428571428573,100
2006-05-23,39.25999,39.3801,38.57001,38.59,40.53205674771951,41.130004325555994,41.092771482814406,40.43312474890635,40.61252905000001,41.4707194000001,41.44520100000002,40.8290015,40.8290015,43.28710236288766,38.370900637112335,142649440,24.311195485839193,36.7584370950281,NaN,NaN,NaN,NaN,NaN,NaN,-0.27962176594560434,-0.7785135292677126,-0.4988917633221082,0.538815468505305,9.033035807829696,2655824618,-145858942.54284263,9.969910771467276,32.71638680804356,34.36474282195278,21.428571428571427,100
2006-05-24,38.53,39.03999,38.23,38.85001,40.51531996416011,41.08485592306974,41.004820052115804,40.282351915677175,40.61082910000002,41.4520195000001,41.39480120000001,40.678501999999995,40.678501999999995,43.2323910626148,38.12461293738519,234998192,28.80190029366169,35.26666520360106,NaN,NaN,NaN,NaN,NaN,NaN,-0.2444188129532321,-0.8044152795136483,-0.5599964665604162,15.308888888888887,8.470181962482956,2890822810,-21096572.012640953,9.036176565860586,33.5836973461135,38.2656004723524,14.285714285714286,100
2006-05-25,39.08,39.38,38.82001,39.36,40.503824243123695,41.050700360236675,40.94031730497401,40.194508876088875,40.61037910000002,41.4414995000001,41.347601200000014,40.5335025,40.5335025,43.04063603655371,38.02636896344629,123529872,36.73110133844509,34.01165343399386,NaN,NaN,NaN,NaN,NaN,NaN,-0.17188969469210968,-0.7748585849255534,-0.6029688902334437,27.90123456790127,14.582979641765155,3014352682,93609580.13521743,12.404967089862522,31.39456619271946,40.63431784230014,7.142857142857143,92.85714285714286
2006-05-26,39.45,39.58,39.23,39.49001,40.493736539212016,41.01979560062803,40.88344250870052,40.12741374503279,40.61227915000001,41.4232996000001,41.31000140000001,40.415502499999995,40.415502499999995,42.885555027804756,37.945449972195235,91329312,38.60813321412257,32.85209773023262,NaN,NaN,NaN,NaN,NaN,NaN,-0.1036250199099793,-0.7325001651209178,-0.6288751452109385,31.898179792916615,25.036101083235593,3105681994,137974750.4959032,14.285334822574395,30.07502856630592,42.289640778526504,0,85.71428571428571
2006-05-30,39.31,39.33,38.61,38.64,40.47529139951836,40.97267093526906,40.79546437110442,39.9857552931249,40.60831910000001,41.3922995000001,41.253801400000015,40.2755025,40.2755025,42.8138725065421,37.737132493457906,105610192,31.936900397632087,31.405992002096706,NaN,NaN,NaN,NaN,NaN,NaN,-0.10391816725160852,-0.758772854275449,-0.6548546870238405,10.933333333333431,23.577582564717105,3000071802,41165407.829236865,12.825674652592253,34.200882429537835,44.9445934092385,0,78.57142857142857
2006-05-31,38.72,39.06,38.53999,38.82001,40.45882093783161,40.93004398605581,40.717995572237584,39.87473193187491,40.606369100000016,41.3612996000001,41.199201600000016,40.139002999999995,40.139002999999995,42.68215394796276,37.59585205203723,137104496,34.517438259413225,30.545819727994992,NaN,NaN,NaN,NaN,NaN,NaN,-0.08119634143751164,-0.75635011382073,-0.6751537723832184,17.251804829838846,20.02777265202963,3137176298,51719614.43080264,12.042621670411629,32.93477343723693,47.750946298787355,0,71.42857142857143
2006-06-01,38.91,39.74001,38.84,39.74001,40.451668590191495,40.90647895662896,40.679643196855714,39.86190127169635,40.60783915000001,41.3318998000001,41.17180180000001,40.05150299999999,40.05150299999999,42.522087312288534,37.580918687711446,119438752,45.822939649327616,31.244140705493827,NaN,NaN,NaN,NaN,45.822939649327616,NaN,0.0021692039561512777,-0.6724422674380293,-0.6746114713941805,59.68442563014076,29.28985459777101,3256615050,171158366.43080264,18.48983346409648,29.502863274264335,47.20896256219775,0,64.28571428571429
2006-06-02,39.97,40,39.31,39.642,40.44361218630899,40.88143976936898,40.63895130678294,39.84095829343955,40.61199915000002,41.2998208000001,41.14044160000001,39.94210299999999,39.94210299999999,42.278091362497996,37.60611463750198,128865504,44.932927114809175,32.20262225106752,NaN,NaN,NaN,NaN,NaN,NaN,0.05420293427602685,-0.606857803549147,-0.6610607378251738,66.91943127962094,47.95188724653351,3127749546,166302564.83080333,19.9795523242267,27.212542571400373,45.304481477472386,0,57.142857142857146
2006-06-05,39.55,39.56,38.78,38.78,40.42705883122134,40.83982710066861,40.56605125553655,39.73991464644531,40.61069920000002,41.2588208000001,41.09424160000001,39.773103,39.773103,41.924586415163255,37.62161958483674,103300560,37.95123559035232,32.678914817042326,NaN,NaN,NaN,NaN,NaN,NaN,0.03499119934934325,-0.6173217386384948,-0.6523129379878381,27.093729525761354,51.232528811841014,3024448986,63002004.830803335,18.090178702597754,30.45352227573871,43.94574079434223,0,50
2006-06-06,38.85001,38.95,38.35001,38.75,40.41037167867187,40.79844438580388,40.494833559241,39.645637061069564,40.610234200000015,41.2142207000001,41.04324160000001,39.60060299999999,39.60060299999999,41.48242074508689,37.718785254913094,127304192,37.73150086361769,33.30302639650922,NaN,NaN,NaN,NaN,NaN,NaN,0.025147842225875072,-0.6208781352054942,-0.6460259774313692,29.378531073446453,41.13056395960958,2897144794,105435320.9828721,16.892739147067623,33.18150438391949,43.06980897955843,0,42.857142857142854
2006-06-07,38.8,39.17,38.45,38.46001,40.39096509480449,40.75213875440183,40.415036556917826,39.53272019811056,40.60843420000001,41.16882080000009,40.986241800000016,39.421603999999995,39.421603999999995,40.99740352687329,37.8458044731267,130867568,35.58660698064142,34.031203949982654,NaN,NaN,NaN,NaN,NaN,NaN,0.005043136424340622,-0.6397220569009434,-0.644765193325284,12.994915254237268,23.15572528448169,2766277226,-21793401.584685594,17.969395623104226,30.566737376043264,41.18629630247433,78.57142857142857,35.714285714285715
2006-06-08,38.27,38.56,37.49001,38.39999,40.37115439734375,40.70556155134437,40.3360151233132,39.42484113162384,40.60623415000001,41.1230207000001,40.931441600000014,39.2581035,39.2581035,40.51265386301001,38.003553136989986,280562176,35.14134282499835,34.84129842460735,NaN,NaN,NaN,NaN,NaN,NaN,-0.00577460821356246,-0.6519834535922371,-0.6462088453786746,36.254327706485036,26.20925801138959,2485715050,174856300.87488925,15.956972385039148,37.19135943617964,40.10213086024586,71.42857142857143,100
2006-06-09,38.53999,38.74001,38.11,38.14999,40.349053259061726,40.654956174090024,40.25028864788916,39.30342673813586,40.60333410000001,41.0775206000001,40.85604140000001,39.12860249999999,39.12860249999999,40.27454678667111,37.982658213328875,144146192,33.273833849065824,35.13814248732432,NaN,NaN,NaN,NaN,NaN,NaN,-0.022315299734923633,-0.6741029700473291,-0.6517876703124055,26.294128661867337,25.181123874196548,2341568858,49009520.68765558,16.793443707911827,34.72540217715416,38.4436803107277,64.28571428571429,92.85714285714286
2006-06-12,38.2,38.25999,37.39,37.39999,40.319709346036234,40.59050139836547,40.13851223032488,39.12214704878959,40.59783405000002,41.0294204000001,40.7630412,38.989101999999995,38.989101999999995,40.2570349850516,37.721169014948394,145634496,28.398104057742046,35.26751142283343,NaN,NaN,NaN,NaN,NaN,NaN,-0.07343390393599791,-0.7435800502324028,-0.6701461462964049,0.38275862068972966,20.977071663014037,2195934362,-93280365.3397234,15.286165089436798,39.0366606845053,37.317471266051776,57.142857142857146,100
2006-06-13,37.52499,37.8,37.16,37.25,40.28916497443388,40.52435285582358,40.025237240900374,38.94384732985725,40.59114405000002,40.9767204000001,40.669441400000004,38.843602,38.843602,40.205096686945375,37.48210731305462,207140256,27.529308069838237,35.49737660740478,NaN,NaN,27.529308069838237,NaN,NaN,NaN,-0.10508694502906213,-0.8015048275827326,-0.6964178825536704,3.1690140845071584,9.94863378902141,1988794106,-242162424.3397212,14.271388584045825,38.83092200311163,36.81475178252431,50,100
2006-06-14,37.36,37.71001,37.2,37.63,40.26270562145444,40.46703893788648,39.9313063687082,38.81871901272799,40.586994550000014,40.9405204000001,40.58244140000001,38.732102,38.732102,40.10756256525858,37.35664143474141,201888256,33.11246252587041,35.80527390970541,NaN,NaN,NaN,NaN,NaN,NaN,-0.08881780550703766,-0.8074401394374675,-0.7186223339304298,16.549295774648076,6.7003561599483215,2190682362,-103618335.5621641,13.502154813377965,36.73791918316493,36.004254979131204,42.857142857142854,92.85714285714286
2006-06-15,37.84,38.78999,37.8,38.64999,40.24665869984793,40.43105777079962,39.88105866797454,38.80264958294437,40.58644455000002,40.9144204000001,40.511241000000005,38.698601,38.698601,40.047535324343954,37.34966667565604,200727632,45.2950803408182,36.41698669558921,NaN,NaN,NaN,NaN,NaN,NaN,-0.0023197263481933295,-0.7215219918656715,-0.7192022655174781,52.464436619718455,24.0609154929579,2391409994,40337271.508291274,22.78565762683572,32.45330885010614,34.1575260697887,35.714285714285715,85.71428571428571
2006-06-16,38.55,38.67999,38.2,38.34,40.22768697149123,40.38965068622933,39.82062499472064,38.758587717902046,40.58504455000001,40.8834204000001,40.425841000000005,38.663101,38.663101,40.01054506020897,37.315656939791026,120017376,42.74686494486504,36.71261039064223,NaN,NaN,NaN,NaN,NaN,NaN,0.03879118997490194,-0.6707132780488507,-0.7095044680237527,41.54929577464808,36.85434272300487,2271392618,-9668509.916820548,21.659971571468727,30.850009185844662,32.865194467380995,28.571428571428573,78.57142857142857
2006-06-19,38.5,38.53999,37.91,38.03,40.20581943943659,40.342924930066374,39.750404406692375,38.689198411435186,40.58029455000002,40.8511205000001,40.33184100000001,38.597100499999996,38.597100499999996,39.93275607378279,37.2614449262172,129464816,40.304888247058,37.31032380845837,NaN,NaN,NaN,NaN,NaN,NaN,0.0492101586165522,-0.6479917697530624,-0.6972019283696146,30.633802816901532,41.549178403756024,2141927802,-89812613.14360055,20.246181296511622,31.84099963377737,31.208546216921857,21.428571428571427,71.42857142857143
2006-06-20,38.09,38.48,37.94,38.08,40.18466700720339,40.29811453541159,39.68489835152797,38.63117951510802,40.576094550000015,40.81642050000009,40.24704080000001,38.5526005,38.5526005,39.89488310428922,37.21031789571077,102888560,40.89140560849007,37.765607190535285,NaN,NaN,NaN,NaN,NaN,NaN,0.06270802856926061,-0.6188168926580389,-0.6815249212272995,32.39436619718312,34.85915492957758,2244816362,-139351549.43989655,19.095630249860942,30.031537645932843,29.48069402959181,14.285714285714286,64.28571428571429
2006-06-21,38.14,38.99001,38.13,38.67999,40.16969509668395,40.26607246540344,39.64549018087981,38.63582813271678,40.57564450000002,40.782120400000096,40.175440800000004,38.5571,38.5571,39.90045679556731,37.21374320443269,129566320,47.55086702510811,37.88903057451961,NaN,NaN,NaN,NaN,47.55086702510811,NaN,0.11238426620985753,-0.5410445884649775,-0.653428854674835,53.52077464788726,38.849647887323975,2374382682,-103198446.78946319,22.550027009263026,27.223846420403085,28.51232276564695,7.142857142857143,57.142857142857146
2006-06-22,38.60001,38.67999,37.99001,38.19,40.14999663801048,40.224962119553865,39.5884121345708,38.59336831055328,40.56989450000001,40.7421204000001,40.10084080000001,38.5240995,38.5240995,39.86947847135964,37.178720528640355,143831504,43.26397286948957,37.76981955699678,NaN,NaN,NaN,NaN,NaN,NaN,0.11231616967888791,-0.5130336425762252,-0.6253498122551131,42.916666666666615,42.94393583724567,2230551178,-163651121.0119044,20.950672412825387,26.731993870721123,28.28359975948951,0,50
2006-06-23,38.16,38.53,37.92999,38.14999,40.13009607444818,40.183873562731016,39.53200342341116,38.551141804786305,40.56359945000001,40.7036203000001,40.025240800000006,38.463599,38.463599,39.76115400422567,37.16604399577433,88050192,42.923684323659344,38.124994466518714,NaN,NaN,NaN,NaN,NaN,NaN,0.1095335390245028,-0.4884328884744846,-0.5979664274989874,49.25323383084594,48.56355838179994,2142500986,-187132248.3629806,19.645782996563167,25.690057401867993,27.41672399464006,0,42.857142857142854
2006-06-26,38.17,38.39,38.07001,38.25,40.11138865082183,40.14557903673634,39.48172877935582,38.522461632901894,40.55784950000002,40.664620400000096,39.948240600000005,38.4015985,38.4015985,39.61266981886097,37.190527181139025,65157616,44.10709951489493,38.580394370181374,NaN,NaN,NaN,NaN,NaN,NaN,0.11388146126376353,-0.45561460091928296,-0.5694960621830465,54.22885572139307,48.79958540630188,2207658602,-178989328.07222226,18.96729262628095,24.802820860457857,26.045509148841354,7.142857142857143,35.714285714285715
2006-06-27,38.28,38.33,37.49001,37.53,40.085703191609674,40.09378539244454,39.40519039585167,38.42794147738743,40.54740450000001,40.625620500000096,39.8656406,38.3460985,38.3460985,39.60900881881483,37.083188181185164,128227504,37.99874524443484,38.75268996045234,NaN,NaN,37.99874524443484,NaN,NaN,NaN,0.06988006925342716,-0.4821459756162625,-0.5520260448696896,20.21846875153711,41.23351943459205,2079431098,-295007596.5218934,17.280176727243145,28.73841097129826,25.97012197157278,0,28.571428571428573
2006-06-28,37.63499,37.84,37.38,37.81,40.063059378757835,40.04856191932682,39.34263390973984,38.369089908112436,40.537804500000014,40.594520500000094,39.77264040000001,38.295598,38.295598,39.55944259873054,37.031753401269455,91578368,41.39766459468336,39.1995700868584,NaN,NaN,NaN,NaN,NaN,NaN,0.06153928243589191,-0.4751019418248248,-0.5366412242607167,35.51893159053804,36.65541868782275,2171009466,-215374233.04363292,16.4188824410059,28.498008969777267,25.037200925751414,64.28571428571429,21.428571428571427
2006-06-29,37.96001,38.96001,37.89999,38.96001,40.0520837630488,40.027006435775796,39.327629050534355,38.42536801210173,40.53445455000002,40.57602060000009,39.6988408,38.256598,38.256598,39.38009371683261,37.13310228316738,182431056,52.83422916816312,40.59674118107964,NaN,NaN,NaN,NaN,NaN,NaN,0.13136885514516383,-0.37243015532926194,-0.5037990104744258,98.36066469582127,51.366021679298804,2353440522,-32943177.043632925,25.99924417700797,25.126229396299127,22.672986128057428,57.142857142857146,14.285714285714286
2006-06-30,39.12,39.14,38.67999,38.77,40.03932671068016,40.00211521922578,39.30576124463105,38.45819010618728,40.53240460000002,40.55742060000009,39.62424080000001,38.212998,38.212998,39.17398050147479,37.25201549852521,82721248,51.06113953749428,42.21552942963337,NaN,NaN,NaN,NaN,NaN,NaN,0.16071715114199642,-0.30290257154693023,-0.46361972268892665,81.31313131313148,71.73090919983026,2270719274,-83292348.2084316,26.63590729481193,23.907708589333694,19.935606696350224,100,7.142857142857143
2006-07-03,38.88,39,38.81,39,40.02898515136991,39.98227135349853,39.293770607586694,38.509791048455156,40.531604600000016,40.5364205000001,39.56424080000001,38.223998,38.223998,39.21524950397879,37.232746496021214,21598544,53.11234827731906,44.04288944445343,NaN,NaN,NaN,NaN,53.11234827731906,NaN,0.1895918310590799,-0.2266299338650768,-0.4162217649241567,92.78350515463914,90.81910038786395,2292317818,-61693804.2084316,25.958073324026305,23.299302167651557,17.017624475065144,92.85714285714286,0
2006-07-05,38.64,38.67999,38.09,38.14999,40.01028868220205,39.94598855441935,39.2489164661127,38.47552428193562,40.52535460000002,40.51082030000009,39.48804040000001,38.1939975,38.1939975,39.15563113093811,37.23236386906189,93732128,45.519055729691814,44.92907467329781,NaN,NaN,NaN,NaN,NaN,NaN,0.14730016592525075,-0.23209655751759328,-0.37939672344284403,43.74943181818187,72.6153560953175,2198585690,-136364624.86857843,23.418751138688307,28.75999129540293,14.445264944876474,85.71428571428571,0
2006-07-06,38.25999,38.48,38.00999,38.11,39.99138033710551,39.909632345420945,39.204253075284754,38.4407124455608,40.52045460000002,40.482320200000096,39.41284040000001,38.176497,38.176497,39.13084114972819,37.222152850271804,70634560,45.19171091570526,44.92169114293261,NaN,NaN,NaN,NaN,NaN,NaN,0.11397767057639985,-0.2369246352223442,-0.35090230579874404,41.4772727272726,59.33673656669787,2127951130,-176939559.1346583,22.21024439350764,28.154315005011526,14.038163774940825,78.57142857142857,64.28571428571429
2006-07-07,37.89,38.17,37.57001,37.69,39.96848103026864,39.865679229670036,39.144870601744174,38.36921602217406,40.51425465000002,40.454320100000096,39.32944040000001,38.140997500000005,38.140997500000005,39.11211950063124,37.16987549936877,108071632,41.79239121672634,44.85351444806555,NaN,NaN,NaN,NaN,NaN,NaN,0.06351256876215805,-0.2715115948460465,-0.33502416360820453,17.613636363636108,34.28011363636353,2019879498,-241785420.29287955,20.73896857205344,31.14697416028057,14.220870022873816,71.42857142857143,57.142857142857146
2006-07-10,37.78999,37.92999,37.17,37.36,39.942525995141594,39.81606181918152,39.07487567618558,38.27310021053843,40.50855465000002,40.418920200000095,39.231440600000006,38.101498,38.101498,39.13048407575626,37.07251192424374,105125936,39.29157380272227,44.781134844898716,NaN,NaN,NaN,NaN,NaN,NaN,0.010547109101726071,-0.3218402772310469,-0.332387386332773,9.644670050761311,22.91185971389001,1914753562,-294347696.6657795,19.02024723876102,32.92765579002068,14.54311512734173,64.28571428571429,100
2006-07-11,37.28,37.74001,37.08,37.64,39.91961528872228,39.77297148612842,39.01860604182536,38.21280495239191,40.50355465000002,40.3837202000001,39.14724040000001,38.1134985,38.1134985,39.11470261609621,37.11229438390379,136121568,42.43890595773885,44.89167058413078,NaN,NaN,NaN,NaN,NaN,NaN,-0.0023042535663674313,-0.3352677032907323,-0.33296344972436487,27.184466019417556,18.147590811271666,2050875130,-199478588.52450785,17.65207317162955,31.539969920795436,14.969657378280246,57.142857142857146,100
2006-07-12,37.56,37.64,36.84,36.92999,39.88986777341161,39.71667482303677,38.936699530381226,38.09063209978316,40.49445460000002,40.337620200000096,39.0570402,38.097497999999995,38.097497999999995,39.161639983055274,37.033356016944715,154458880,37.17576887887962,44.15059214511445,NaN,NaN,NaN,NaN,NaN,NaN,-0.05251406120808244,-0.39860602623446795,-0.3460919650263855,3.91260869565188,13.580581588610256,1896416250,-319188081.9965104,16.136877078207085,31.407783951176395,16.593155404337196,50,100
2006-07-13,36.66,37.03999,36.31,36.31,39.85424719855179,39.649215915649904,38.83369170566039,37.92104809028,40.482204650000014,40.288620100000095,38.9522402,38.031498,38.031498,39.33927974941385,36.72371625058615,177745440,33.29302566016223,43.438381630162496,NaN,NaN,NaN,NaN,NaN,NaN,-0.11764278105669906,-0.49314544134725935,-0.3755026602905603,0,10.365691571689817,1718670810,-496933521.9965104,14.88161397101189,34.612354227398626,18.574609856245484,42.857142857142854,100
2006-07-14,36.31,36.38,35.78999,35.94,39.81529946523287,39.57576609553802,38.72021359955606,37.73237684358667,40.468554650000016,40.2405201000001,38.84124,37.8959985,37.8959985,39.45651730862993,36.33547969137007,172448496,31.198823287169745,42.60089155612753,NaN,NaN,31.198823287169745,NaN,NaN,NaN,-0.1724863214621768,-0.5911105621182813,-0.4186242406561045,4.4778970809040795,2.796835258851992,1546222314,-581691982.6243672,13.937901264108762,38.0065257614917,20.931975176923373,35.714285714285715,100
2006-07-17,35.955,36.25,35.87,36.03,39.77763479393702,39.50555290552737,38.61471502702445,37.57024571562604,40.45530470000002,40.188220200000096,38.72524,37.7804985,37.7804985,39.52371981873338,36.03727718126662,134358064,32.31411623074709,41.75853560725982,NaN,NaN,NaN,NaN,NaN,NaN,-0.18825906506388873,-0.6539480719859654,-0.46568900692207665,7.164456225503752,3.880784435469284,1680580378,-602906413.7822602,13.350679626466642,36.4052621368008,23.289340497601263,28.571428571428573,92.85714285714286
2006-07-18,36.22,36.33,35.53999,36.14999,39.74153882583814,39.43910611531891,38.51805914361173,37.43498326651879,40.44005465000002,40.1382202000001,38.6050398,37.68649799999999,37.68649799999999,39.563393730748345,35.80960226925164,207274688,33.853639540266386,41.46245662839065,NaN,NaN,NaN,NaN,NaN,NaN,-0.17637318464522866,-0.6861554877286125,-0.5097823030833838,16.94439737667395,9.5289168943606,1887855066,-490090065.7700561,12.19989407248976,36.867934268069085,25.10178368168018,21.428571428571427,100
2006-07-19,36.10001,36.83,36.09,36.62,39.71047873801886,39.38328223184725,38.44362545170539,37.35736581256462,40.42585460000002,40.091820300000094,38.493439800000004,37.61349799999999,37.61349799999999,39.53649992826257,35.690496071737414,193014688,39.64460518405305,41.33723809905991,NaN,NaN,NaN,NaN,NaN,NaN,-0.12503504316533154,-0.6660761070400483,-0.5410410638747167,30.00019444390419,18.03634934869397,2080869754,-406624254.7430303,16.629051628588844,33.91867020596798,25.624096268973705,14.285714285714286,92.85714285714286
2006-07-20,36.745,36.8,36.03999,36.08,39.674354571471405,39.31787070250374,38.35093425752086,37.2357119256537,40.40845460000002,40.0354203000001,38.37424,37.483498499999996,37.483498499999996,39.45153791070498,35.515459089295014,152346624,35.76993668735008,40.11836006471612,NaN,NaN,NaN,NaN,NaN,NaN,-0.1158317174553064,-0.6858307106938497,-0.5699989932385433,15.000236110455127,20.648275977011096,1928523130,-542930593.9408848,15.27733765916713,31.696425392066548,27.998821197099883,7.142857142857143,85.71428571428571
2006-07-21,35.88,35.96001,35.62,35.7,39.634808754839845,39.246229698493764,38.24697605134357,37.089453647020015,40.39045460000003,39.981420200000095,38.25484,37.3589985,37.3589985,39.44406987242039,35.273927127579604,119379872,33.30326267906615,38.84994028911411,NaN,NaN,NaN,NaN,NaN,NaN,-0.12304530139904746,-0.7238056199873526,-0.6007603185883051,4.6245531082280085,16.541661220862448,1809143258,-606133354.9147346,14.508620374839222,34.69563704501344,30.543768320653786,0,78.57142857142857
2006-07-24,35.85001,36.4301,35.8,36.41,39.60272110553796,39.190066734167154,38.17493777482029,37.02474377587525,40.378704650000024,39.9289202000001,38.168239799999995,37.271998999999994,37.271998999999994,39.362987545179905,35.18101045482008,130301504,41.43019757457532,38.01550095320385,NaN,NaN,NaN,NaN,NaN,NaN,-0.07032883958251701,-0.6886713680664514,-0.6183425284839343,27.707324840764183,15.777371353149112,1939444762,-484145008.2878525,18.458728087349847,31.947927286879935,32.06969964682408,0,71.42857142857143
2006-07-25,36.47,36.74001,36.24001,36.62,39.573042288567436,39.139174323589586,38.113959822866555,36.98619674960142,40.370554650000024,39.878220200000094,38.09683979999999,37.190498999999996,37.190498999999996,39.24947628109689,35.1315217189031,108869568,43.61848595606774,37.87974596937356,NaN,NaN,NaN,NaN,NaN,NaN,-0.014561408416979171,-0.6365442890051582,-0.6219828805881791,36.73490906493504,23.022262337975747,2048314330,-427537187.7105728,20.860528821031213,30.18490369455377,32.643298635725415,0,64.28571428571429
2006-07-26,36.5,36.87,36.23,36.59,39.54336027574587,39.08869562411257,38.054196692558065,36.94846372582985,40.361804650000025,39.82962020000009,38.025439799999994,37.14349899999999,37.14349899999999,39.2122230193111,35.074774980688886,107193120,43.369199407896964,37.74956657595868,NaN,NaN,NaN,NaN,NaN,NaN,0.024911839415416415,-0.5908430813189085,-0.6157549207343249,39.92418279778407,34.78880556782777,1941121210,-414138047.7105707,20.82167715320746,28.05107478067627,32.85688412299929,0,57.142857142857146
2006-07-27,36.73,37.03999,36.25,36.35001,39.51158564613646,39.03446422561529,37.98736584186951,36.89146813289368,40.352904700000025,39.78222030000009,37.95523999999999,37.07049949999999,37.07049949999999,39.14303022404195,34.99796877595803,99707248,41.334065657053905,37.71682903598207,NaN,NaN,NaN,NaN,NaN,NaN,0.03864510558132661,-0.5674485387576667,-0.6060936443389933,33.89205020920488,36.85038069064134,1841413962,-488600110.6513175,20.881490339819774,25.64150445008201,32.15489384138053,0,50
2006-07-28,36.55499,37.14,36.5,37.11,39.487689271548035,38.99635602312786,37.95295933826679,36.91228069166571,40.34875470000003,39.74482020000009,37.91103979999999,36.97799899999999,36.97799899999999,38.8614586635115,35.09453933648848,93570320,49.42738019215574,38.4408152066559,NaN,NaN,NaN,NaN,NaN,NaN,0.09925343685109378,-0.482026848275126,-0.5812802851262198,71.3634421505259,48.39322505250495,1934984282,-403802008.15131783,20.185313819092592,23.470333382932218,30.780108575944904,0,42.857142857142854
2006-07-31,37.08,37.32001,36.89,37.10001,39.46393126884607,38.95880461672929,37.919510344609265,36.93015967341183,40.34681975000003,39.707120300000085,37.87203999999999,36.89449949999999,36.89449949999999,38.59163103824294,35.19736796175704,78096496,49.33104099982548,38.93311056680494,NaN,NaN,NaN,NaN,NaN,NaN,0.13670041848554937,-0.410404762019283,-0.5471051805048324,74.28631292231924,59.84726842735001,1856887786,-405616347.34119874,21.210358772503223,22.36046125997681,28.95208129645065,0,35.714285714285715
2006-08-01,36.78999,36.8,36.25999,36.48,39.43424041044959,38.90971937679406,37.863058958546155,36.887287323563086,40.34031975000003,39.66672030000009,37.81463979999999,36.76849949999998,36.76849949999998,38.170101067529004,35.36689793247096,98573504,43.64525704183698,39.395216864159046,NaN,NaN,NaN,NaN,NaN,NaN,0.11842566303558022,-0.39907310171035704,-0.5174987647459373,52.8089572027277,66.15290409185762,1758314282,-423868536.49503034,19.291208934521034,27.123323642646202,27.863166601260566,0,28.571428571428573
2006-08-02,36.61,37.13,36.61,36.89,39.40892458546999,38.86972493368923,37.824899783701206,36.88754567369993,40.33446975000003,39.63002030000009,37.77303979999999,36.70549999999999,36.70549999999999,37.95844073286808,35.452559267131896,87399008,47.92000809161506,40.44000132354853,NaN,NaN,NaN,NaN,NaN,NaN,0.1316465110365469,-0.35294062595025366,-0.48458713698680056,75.84240626509799,67.64589213004831,1845713290,-417145535.8796459,21.49823177427262,25.221622351388884,25.58492887467462,85.71428571428571,21.428571428571427
2006-08-03,36.53999,37.34,36.48,37.12,39.38614921646034,38.83507691520033,37.79725665492861,36.90968418096661,40.32916980000003,39.59442040000008,37.74363979999999,36.65599999999999,36.65599999999999,37.75139832028308,35.5606016797169,99296000,50.20203425446087,41.797373535497904,NaN,NaN,NaN,NaN,50.20203425446087,NaN,0.15212790589551206,-0.2944272546174105,-0.44655516051292254,87.77784567863479,72.14306971548683,1945009290,-368652140.53080964,21.763480888779437,22.930814541169987,22.461820487009668,100,14.285714285714286
2006-08-04,37.425,37.63,36.62,36.95,39.36190892574929,38.79774865945379,37.764030903754936,36.913523782779315,40.32436980000003,39.550220400000086,37.70563959999999,36.618999999999986,36.618999999999986,37.61793817630531,35.62006182369466,123504688,48.510084314655664,42.954228398634235,NaN,NaN,NaN,NaN,NaN,NaN,0.15021260650559076,-0.25878940238093406,-0.4090020088865248,67.46427050588275,77.02817414987184,1821504602,-411450794.7882345,22.479531979286854,20.568069923695518,19.469321173672313,100,7.142857142857143
2006-08-07,36.92,36.94,36.53,36.71001,39.335521871761735,38.75640729986064,37.72269675066651,36.894141517752715,40.314569850000034,39.50012050000009,37.65263979999999,36.586500499999985,36.586500499999985,37.52750686241162,35.64549413758835,69670944,46.14565717013879,43.83222965791083,NaN,NaN,NaN,NaN,NaN,NaN,0.1295509330097221,-0.24706334262437224,-0.37661427563409433,54.22935323383068,69.82382313944942,1751833658,-419943852.7909671,21.488001811138396,20.60602503782364,16.02802872949392,92.85714285714286,0
2006-08-08,36.81,36.89999,36.25999,36.48,39.307108718808884,38.71132992758617,37.67396354475802,36.85469946844293,40.305439850000035,39.45122050000009,37.59243959999999,36.52850049999999,36.52850049999999,37.336171971637974,35.72082902836201,124510752,43.935380911869004,44.13871363846912,NaN,NaN,NaN,NaN,NaN,NaN,0.09856414197142638,-0.2534090981698114,-0.35197324014123776,42.78606965174116,54.82656446381821,1627322906,-458849571.82996917,20.037626770483445,22.06281469708525,13.928444912421813,85.71428571428571,14.285714285714286
2006-08-09,37.00999,37.31,36.42999,36.53,39.27947579623367,38.66813527555476,37.62910222927731,36.823775709543604,40.29533985000003,39.40202050000009,37.55023959999999,36.50850099999999,36.50850099999999,37.29494551303089,35.72205648696909,145388256,44.557065217960385,44.76636567636985,NaN,NaN,NaN,NaN,NaN,NaN,0.08037508250633618,-0.25150438700831756,-0.33187946951465375,45.273631840796085,47.42968490878932,1772711162,-571192113.6163566,22.450488085421096,20.05804200220501,11.833760179345248,78.57142857142857,7.142857142857143
2006-08-10,36.455,36.88,36.31,36.78999,39.25470479328607,38.63094427999922,37.59619586734487,36.8205580229204,40.28348980000003,39.35442040000009,37.509639199999995,36.53250049999999,36.53250049999999,37.322537049849856,35.742463950150125,102511936,47.79848626783086,45.80173878985305,NaN,NaN,NaN,NaN,NaN,NaN,0.08437877396505666,-0.22640600205833294,-0.3107847760233896,54.09781420765044,47.385838566729234,1875223098,-501055964.84218097,21.11231581353211,20.11722042709259,9.075658628565833,71.42857142857143,0
2006-08-11,36.64999,36.69,36.37,36.53,39.227593302805616,38.58934142296953,37.55438426470389,36.79288583026132,40.27108985000003,39.30862040000009,37.44543899999999,36.562000499999996,36.562000499999996,37.30393488530417,35.82006611469582,86930496,44.967285960727544,46.054387960292495,NaN,NaN,NaN,NaN,NaN,NaN,0.06870634650989027,-0.22490184288602677,-0.29360818939591704,21.428571428571647,40.2666724923394,1788292602,-501055964.84217906,20.15885913067652,19.208703406690866,7.3365728751700345,64.28571428571429,0
2006-08-14,36.86,37.27,36.7,36.77,39.203139638101085,38.55331486013845,37.523624097460605,36.79070622737929,40.26088985000003,39.26422030000008,37.38799899999999,36.599000499999995,36.599000499999995,37.30401006312462,35.89399093687537,109350752,48.02761671903101,46.36932587193273,NaN,NaN,NaN,NaN,NaN,NaN,0.07327448152455995,-0.20201508749021713,-0.2752895690147771,38.57142857142886,38.03260473588366,1897643354,-583548637.4035825,24.754058353135683,17.6925826949528,7.220094895256323,57.142857142857146,7.142857142857143
2006-08-15,37.22,37.75,37.09,37.7,39.188183024786646,38.536417536175314,37.53054079952097,36.877305634295546,40.25923985000003,39.23032030000009,37.366398999999994,36.67650099999999,36.67650099999999,37.498164597877214,35.85483740212276,133719808,57.8167430729289,47.40129327657786,NaN,NaN,NaN,NaN,NaN,NaN,0.13415672045339563,-0.10759366844803253,-0.24175038890142816,96.66666666666686,52.222222222222456,2031363162,-470089406.3732784,27.205161416018274,15.902473772758697,8.036337870849149,100,0
2006-08-16,37.99001,38.61,37.84,38.58,39.18213145240071,38.53728055526095,37.57169606228486,37.039467002457876,40.26052980000003,39.20312030000009,37.36299899999999,36.774500999999994,36.774500999999994,37.94100787270783,35.60799412729216,135470064,64.60945188125726,49.063820864020954,NaN,NaN,NaN,NaN,NaN,NaN,0.22364734766845662,0.03780879568414264,-0.18583855198431398,98.7234096876183,77.98716830857134,2166833226,-345175451.2563957,33.38885148808593,14.441322472672477,10.135098266820563,100,0
2006-08-17,38.47,38.98,38.44,38.73,39.17763263197881,38.54109678188944,37.61711974611682,37.200470145080935,40.25982980000003,39.17732030000009,37.368398799999994,36.907000999999994,36.907000999999994,38.30658744751792,35.50741455248207,129697872,65.62554152472258,50.22083238777573,NaN,NaN,NaN,NaN,NaN,NaN,0.2792812797384352,0.16326304768873,-0.11601823204970518,90.80885732037748,95.39964455822087,2296531098,-335568201.4786181,35.33717689364937,13.64039272178506,12.761854375187243,100,14.285714285714286
2006-08-18,38.64999,38.83,38.28,38.78999,39.17377549136211,38.54602536046589,37.663114658033805,37.35185298840656,40.25957975000003,39.153820200000084,37.37619879999999,37.061500499999994,37.061500499999994,38.571838566161816,35.55116243383817,97774816,66.04541214383286,51.41471604091912,NaN,NaN,NaN,NaN,66.04541214383286,NaN,0.3043973021052985,0.2644783955819179,-0.039918906523380565,93.01436391777993,94.1822103085919,2394305914,-252018732.34465283,33.31077399891372,14.526399297516331,15.378118740384334,92.85714285714286,7.142857142857143
2006-08-21,38.47,38.56,38.25999,38.42,39.16627523771671,38.5435298087735,37.692796436150125,37.453581275224984,40.25494475000003,39.118820200000094,37.38159899999999,37.16200049999999,37.16200049999999,38.75100448743932,35.572996512560664,66671680,61.08930578476083,52.66071952255653,NaN,NaN,NaN,NaN,NaN,NaN,0.28093456439261044,0.3112492989673825,0.03031473457477206,79.41184039764573,87.74502054526772,2327634234,-247571879.5170806,31.43978441587112,13.922544414192856,16.931118659589625,85.71428571428571,0
2006-08-22,38.36501,38.81,38.2,38.42999,39.158949016445895,38.54128149572848,37.72170598767365,37.546572582346414,40.24739470000003,39.082620100000085,37.40219899999999,37.25249999999999,37.25249999999999,38.912313122047,35.59268687795298,102133248,61.174024726504946,53.60743499647724,NaN,NaN,NaN,NaN,NaN,NaN,0.25186268566823833,0.34514309166006996,0.09328040599183164,79.77911845912327,84.06844092484964,2429767482,-272689961.2629187,32.060966161145295,13.016363398910347,19.37962772364859,78.57142857142857,28.571428571428573
2006-08-23,38.47,38.67,37.92,38.14,39.148810220262355,38.53333532749623,37.73810967443155,37.603089479265805,40.23769470000003,39.044720200000086,37.41999899999998,37.32999999999999,37.32999999999999,39.00353057938009,35.65646942061989,96067504,57.27564828713629,54.11269314166834,NaN,NaN,57.27564828713629,NaN,NaN,NaN,0.20108103314735404,0.3446316974260242,0.14355066427867014,69.11776059646847,76.10290648441249,2333699978,-312397862.9162523,29.51714374842306,14.94575170298598,21.53392835746744,71.42857142857143,21.428571428571427
2006-08-24,38.25999,38.35001,37.92,38.25,39.139866834986115,38.52772472695175,37.758183804846,37.664700005050015,40.22829470000003,39.00742020000009,37.43239899999998,37.42499949999999,37.42499949999999,39.08084034383084,35.76915865616914,79002000,58.359638976840436,54.816232760395835,NaN,NaN,NaN,NaN,NaN,NaN,0.16442229613824147,0.34907853445147197,0.1846562383132305,73.16186337550236,74.0195808103647,2412701978,-270143799.1037823,28.138617878013793,14.24774699254105,23.557619916958686,64.28571428571429,14.285714285714286
2006-08-25,38.17,38.64,38.06,38.32001,39.13170905553352,38.523611564041815,37.78021620465596,37.727110480759535,40.21919475000003,38.96852020000009,37.42579939999999,37.48549999999999,37.48549999999999,39.17887871727564,35.79212128272434,73588192,59.07139167823775,55.739499510974326,NaN,NaN,NaN,NaN,NaN,NaN,0.13561042048709765,0.3541692639221026,0.21855884343500492,75.73575097150398,72.67179164782493,2486290170,-277753833.1661266,29.52733118398743,13.342607678690879,26.104607688105155,57.142857142857146,7.142857142857143
2006-08-28,38.28,38.78999,38.24001,38.61,39.12651792065259,38.52532222614,37.81275674564984,37.81119519687768,40.21144975000003,38.92852020000009,37.43119939999999,37.560999499999994,37.560999499999994,39.312544624767895,35.80945437523209,80085872,61.97098656071535,57.0277570573205,NaN,NaN,NaN,NaN,NaN,NaN,0.1269566977543209,0.377254715627906,0.25029801787358513,86.14232209737834,78.34664548146155,2566376042,-250086798.58305144,29.389925754511115,12.52974874564273,28.633881117958712,50,0
2006-08-29,38.58,38.75999,38.17999,38.73,39.1225724687058,38.52937525136495,37.84872706934985,37.89870041622266,40.202099700000026,38.88852020000009,37.445199399999986,37.6734995,37.6734995,39.421894699632304,35.92510430036769,104869184,63.13486879268475,58.354743026943666,NaN,NaN,NaN,NaN,NaN,NaN,0.12025363252045412,0.4006150585241528,0.2803614260036987,90.63670411985017,84.17159239624415,2671245226,-156062534.68015662,27.488041657348827,12.388581033266915,30.936544667387135,42.857142857142854,7.142857142857143
2006-08-30,38.74001,39.03,38.60001,38.91,39.12045731976345,38.53691237510029,37.890345615649856,37.99501466229669,40.19309965000003,38.85442010000009,37.46179939999999,37.7744995,37.7744995,39.56310067916146,35.98589832083854,75714752,64.87158354925029,59.574249975616496,NaN,NaN,NaN,NaN,NaN,NaN,0.11867956484798187,0.428710882063676,0.31003131721569416,95.48872180451112,90.75591600724653,2746959978,-122608161.94479193,29.22255214876509,11.779963381696579,33.80274035347604,100,0
2006-08-31,38.94,39.03,38.75999,38.87,39.11796520712899,38.54350816965276,37.92876343464398,38.078346599220815,40.18387965000002,38.82052020000009,37.46559959999999,37.861999499999996,37.861999499999996,39.68485976016754,36.03913923983245,61215488,64.14836349286156,60.9443269421975,NaN,NaN,NaN,NaN,NaN,NaN,0.10609238793562237,0.4426468021352221,0.33655441419959975,93.13304721030026,93.08615771155382,2685744490,-133941676.4261834,28.282929355243997,11.401190095778984,36.66893603956495,92.85714285714286,0
2006-09-01,39.07001,39.21001,38.89999,39.08,39.11758744387397,38.5541317702537,37.97390996661873,38.17374216119978,40.176679650000025,38.79212020000009,37.48339959999999,37.9684995,37.9684995,39.81452413528995,36.12247486471005,69390560,66.27416476610456,62.24765180270275,NaN,NaN,NaN,NaN,NaN,NaN,0.10297485806618506,0.4652729867823311,0.36229812871614603,93.86748175716157,94.16308359065765,2755135050,-122750372.63933137,29.313274036287446,10.924818186660135,38.74486467497928,100,0
2006-09-05,39.11,39.48,38.85001,39.46001,39.120994633487165,38.57206995302095,38.032188399300345,38.29624386013314,40.170139650000024,38.7674204000001,37.509599999999985,38.1059995,38.1059995,39.9661993559551,36.24579964404491,85588624,69.76755688815084,63.10128136093289,NaN,NaN,NaN,NaN,69.76755688815084,NaN,0.11657108606736571,0.5080119863003532,0.39144090023298744,98.78109756097561,95.2605421761458,2840723674,-42593316.1047197,30.35549179307801,10.084083368726898,40.452576166056964,100,0
2006-09-06,39.08,39.19,38.61,38.67,39.11650712469625,38.57400916187202,38.057200618935624,38.3318396829776,40.15695460000003,38.73312030000009,37.51799999999999,38.2154995,38.2154995,39.932248445564454,36.498750554435546,97898560,56.63395713287925,62.53160316462017,NaN,NaN,NaN,NaN,NaN,NaN,0.06499680485903137,0.4726869063067767,0.4076901014477453,48.07692307692322,80.24183413168679,2742825114,-120237001.62196025,27.302521137231917,11.909706611024225,40.42693071104289,92.85714285714286,0
2006-09-07,38.57001,38.89999,38.36,38.4799,39.11017272544554,38.57214561411218,38.073777065251875,38.34594066555116,40.142104100000026,38.701319300000094,37.53699799999998,38.312994499999995,38.312994499999995,39.84759726748674,36.77839173251325,115901248,53.99971355708909,61.70118688121778,NaN,NaN,53.99971355708909,NaN,NaN,NaN,0.013415233919223835,0.4244591438467751,0.41104390992755124,35.891025641025685,60.916348759641494,2626923866,-184668557.0898761,25.544859625951656,14.12347624165804,39.31927084571506,85.71428571428571,28.571428571428573
2006-09-08,38.53999,38.82001,38.46001,38.72,39.106290409769464,38.57507342373372,38.09911914112435,38.3815653640701,40.12795910000003,38.663919200000095,37.55519799999999,38.409495,38.409495,39.78316833161047,37.03582166838953,96630000,56.73682296341576,61.036287654045125,NaN,NaN,NaN,NaN,NaN,NaN,-0.008043131957243932,0.4009899949809963,0.40903312693824023,51.282051282051256,45.08333333333337,2723553866,-141727258.75654423,24.416326574612214,13.499522539351302,38.57104759114486,78.57142857142857,21.428571428571427
2006-09-11,38.41,39.14999,38.3199,38.96001,39.10483488330409,38.58269593019444,38.13287956696261,38.43665532939676,40.114259150000024,38.62701940000009,37.55519799999999,38.5309955,38.5309955,39.61821304861516,37.443777951384845,142377744,59.34122356182247,60.911424638120955,NaN,NaN,NaN,NaN,NaN,NaN,-0.009483385151008772,0.39717889549947927,0.40666228065048804,66.66730769230759,51.28012820512814,2865931610,-64520577.66567606,25.93241036667574,12.164988018217544,38.393987807244805,71.42857142857143,14.285714285714286
2006-09-12,38.95,39.8,38.95,39.67999,39.11055781978863,38.604424525636134,38.193550564336626,38.55506815516849,40.10365910000002,38.59881930000009,37.57339779999999,38.676495,38.676495,39.53741208196375,37.815577918036254,124108432,65.9609824763896,61.25335019168414,NaN,NaN,NaN,NaN,NaN,NaN,0.03235100597739127,0.4471010381222271,0.41475003214483586,93.61648936170208,70.52194944535361,2990040042,24542553.335923523,30.90041221922441,10.969173710715527,38.776445262646234,100,7.142857142857143
2006-09-13,39.73,39.98199,39.63,39.96001,39.11901008028825,38.63126780235621,38.26282348338225,38.68887214039054,40.094009150000026,38.57841940000009,37.59259799999999,38.7894955,38.7894955,39.69992145748178,37.879069542518224,116096192,68.1340257319173,62.02894858059707,NaN,NaN,NaN,NaN,NaN,NaN,0.07096512402696503,0.5034564371785422,0.43249131315157713,98.9340394473297,86.40594550044642,3106136234,126139502.17469321,31.774059504399332,10.508504631436558,40.0280083636183,100,0
2006-09-14,39.85001,40.22,39.75999,39.99001,39.12767674615603,38.65817358844817,38.330556287955496,38.812790031781915,40.086259250000026,38.55871940000009,37.629398399999985,38.859996,38.859996,39.90329053276301,37.816701467236996,98116000,68.3670216570142,62.7437616291809,NaN,NaN,NaN,NaN,NaN,NaN,0.08941918524270931,0.5442652947049638,0.45484610946225446,89.35231481481476,93.96761454128216,3204252234,126145900.90515459,32.88833027541957,9.922045192919574,41.51904499604633,100,0
2006-09-15,40.35001,40.46001,40,40.11,39.13745110689079,38.686922626300685,38.40033839431018,38.93633383827888,40.08009425000002,38.54111940000009,37.669398399999984,38.928996000000005,38.928996000000005,40.10310915046374,37.75488284953627,137846000,69.33285663617609,63.47672341189078,NaN,NaN,NaN,NaN,NaN,NaN,0.09980906817352614,0.5796074446791621,0.479798376505636,84.64881887001002,90.97839104405148,3342098234,54224815.5809226,33.93997220703192,9.348018744151238,42.880260927052426,100,0
2006-09-18,40.12,40.39999,39.94,40.11011,39.14712930483218,38.715104554492754,38.46738826119998,39.048122044157076,40.074444750000026,38.523620500000085,37.71780059999999,38.99500200000001,38.99500200000001,40.27416424324343,37.71583975675658,117821632,69.3337810265059,64.0026373023044,NaN,NaN,NaN,NaN,NaN,NaN,0.09672187895862283,0.6007007252039145,0.5039788462452917,84.65364338909316,86.2182590246393,3459919866,23546981.574443854,31.9893577477743,9.560422273513359,43.863166382767595,92.85714285714286,7.142857142857143
2006-09-19,40.24001,40.25,39.52,39.85001,39.15412314259504,38.737577929651316,38.52160872154508,39.124492325665926,40.063659800000025,38.49952070000009,37.76760079999999,39.066502500000006,39.066502500000006,40.36876554353281,37.7642394564672,159077184,64.39133590404239,64.09238495311565,NaN,NaN,NaN,NaN,NaN,NaN,0.06852291454807546,0.5896324894303859,0.5211095748823105,71.49679222096063,80.26641816002125,3300842682,8297363.305510506,29.128254259737034,13.851164123558735,43.69742959837601,85.71428571428571,0
2006-09-20,40.2,40.53999,40.19,40.42999,39.16681833520603,38.77109103995525,38.59644720305312,39.248825437507264,40.05527480000003,38.485320500000086,37.823400599999985,39.16650250000001,39.16650250000001,40.56173690129299,37.771268098707026,116644064,69.59592160131547,64.42983767112032,NaN,NaN,NaN,NaN,69.59592160131547,NaN,0.07951837768873649,0.6205075469932311,0.5409891693044946,95.04524591345368,83.73189384116914,3417486746,51620206.47062627,30.204701475059665,12.69539133783774,43.57413424451865,100,50
2006-09-21,40.52,40.67,40.08,40.17999,39.176899645303486,38.79899002926307,38.65854692058045,39.337507776792286,40.047174750000025,38.472720400000085,37.88840059999998,39.268502000000005,39.268502000000005,40.646817402431836,37.890186597568174,126895936,65.1739476028866,64.50309367897924,NaN,NaN,NaN,NaN,NaN,NaN,0.061355125266226884,0.6176830758872782,0.5563279506210513,79.1493978979616,81.89714534412528,3290590810,-32264459.561103545,29.621780177405384,11.789489033433284,43.61135968415993,100,42.857142857142854
2006-09-22,40.14999,40.16,39.7,39.87,39.18379616624574,38.82019814749548,38.70605488447926,39.38822132185969,40.03684475000002,38.45592040000008,37.95960059999999,39.349502,39.349502,40.66798599784818,38.031018002151825,101036320,60.076753101082176,64.06042141719193,NaN,NaN,60.076753101082176,NaN,NaN,NaN,0.02189964013848167,0.5837025007941534,0.5618028606556718,65.95889536615452,80.05117972585657,3189554490,-58621760.43067012,27.878868890144197,15.753981287126331,42.33202494997842,92.85714285714286,35.714285714285715
2006-09-25,40.05,40.66,39.67999,40.57001,39.19758933872091,38.854847887149035,38.77915116351929,39.50077262453972,40.030394800000025,38.44672040000009,38.05220079999999,39.462002,39.462002,40.79381739733655,38.13018660266345,136551744,66.45654133078534,63.82392030595154,NaN,NaN,NaN,NaN,NaN,NaN,0.0355728445238096,0.6062689163104338,0.5706960717866242,95.74528743457734,80.28452689956445,3326106234,52852093.665024705,30.529759470906697,13.949303575505667,41.41412071455037,85.71428571428571,28.571428571428573
2006-09-26,40.52,40.8,40.39999,40.77,39.21323521594757,38.892771691363905,38.85722366691069,39.6216514222026,40.02643980000002,38.436120400000085,38.14700079999999,39.570002,39.570002,40.95710925056885,38.182894749431156,113548944,68.02846901057572,64.63781401150128,NaN,NaN,NaN,NaN,NaN,NaN,0.049838124283965834,0.6329937271415815,0.5831556028576157,98.79037135599395,86.8315180522419,3439655178,149369121.8629229,30.74402115763609,13.280573018851918,41.44357380988323,100,21.428571428571427
2006-09-27,40.705,40.95,40.5,40.72,39.228227900366,38.92895443014878,38.930273719188705,39.7262560486595,40.02146480000002,38.42172040000008,38.23840099999998,39.66950200000001,39.66950200000001,41.086486097503894,38.25251790249612,113144192,67.18081928862483,65.57932156375384,NaN,NaN,NaN,NaN,NaN,NaN,0.04765932693714503,0.642729761529047,0.595070434591902,91.25508535797105,95.2635813828474,3326510986,146854806.48514387,30.88615286981591,12.551579968259466,42.401907420431954,100,14.285714285714286
2006-09-28,40.77,40.89,40.42999,40.83,39.24416593120813,38.96659889687851,39.00477278902444,39.83137452021574,40.016279800000014,38.40802040000008,38.322600999999985,39.765502000000005,39.765502000000005,41.22322707578747,38.30777692421254,86020000,68.12189715312918,66.39254114873337,NaN,NaN,NaN,NaN,NaN,NaN,0.04539011775584201,0.6518080817867045,0.6064179640308625,95.43743583894133,95.16096418430207,3412530986,210435294.3006255,29.12608991368343,12.70359759578097,43.149634809089626,92.85714285714286,7.142857142857143
2006-09-29,40.89,40.92999,40.62,40.64999,39.25815423040009,38.999933374168045,39.06929111102348,39.909337899242814,40.00930475000002,38.394120400000084,38.41400079999998,39.854501500000005,39.854501500000005,41.29996259965202,38.40904040034799,85447808,64.84499901818936,66.78566796704528,NaN,NaN,NaN,NaN,NaN,NaN,0.024571981939623067,0.6371329414553912,0.6125609595157682,84.99949999999998,90.5640070656374,3327083178,141520792.29062802,28.48172281678334,12.199102040256154,43.42733924654356,85.71428571428571,0
2006-10-02,40.60001,40.7,40.08,40.14,39.26692881517223,39.02250895091719,39.111279694904916,39.931305718362545,40.00050975000002,38.37882040000009,38.50280079999998,39.90750150000001,39.90750150000001,41.31265385992638,38.50234914007364,97139184,56.545965099159936,66.1131667258146,NaN,NaN,56.545965099159936,NaN,NaN,NaN,-0.02789549788290613,0.5776915871621355,0.6055870850450417,43.35664335664319,74.59785973186145,3229943994,63182740.67772536,26.23742486632384,18.10087607229498,41.33790490151689,78.57142857142857,0
2006-10-03,40.05,40.48,39.88,40.31,39.27730763293171,39.04800382317626,39.15828833432041,39.967371840423255,39.992209750000015,38.37452030000008,38.580800799999984,39.950001,39.950001,41.34985085073192,38.55015114926808,116268368,58.45469697753785,65.42178610050178,NaN,NaN,NaN,NaN,NaN,NaN,-0.05399078868648288,0.538098599186938,0.5920893878734209,55.2447552447552,61.20029953379941,3346212362,113565700.1443935,24.246276782999814,19.256861396089462,38.56470366866962,71.42857142857143,28.571428571428573
2006-10-04,40.22,41.31,40.14,41.3,39.29743392514134,39.09259780687574,39.24227702709216,40.09428880800199,39.99080975000002,38.385620300000085,38.67440079999999,40.08150100000001,40.08150100000001,41.46974793501971,38.69325406498031,149487184,67.4276414693015,65.35468751566516,NaN,NaN,NaN,NaN,NaN,NaN,-0.009735003803716946,0.5799206331187747,0.5896556369224917,99.44134078212262,66.01424646117363,3495699546,260497547.6657597,30.664877498424254,16.609789298874254,36.85642922695932,100,21.428571428571427
2006-10-05,41.28,41.56,41.17999,41.5,39.3193500054882,39.140269137432654,39.330815182892465,40.228166064382755,39.99370975000002,38.39902030000008,38.772600799999985,40.23250600000001,40.23250600000001,41.54605928877539,38.91895271122463,92177184,68.88948128641192,65.32301784782486,NaN,NaN,NaN,NaN,NaN,NaN,0.025901744646548153,0.6220328177306769,0.5961310730841287,97.05882352941165,83.91497318542979,3587876730,323566913.2399281,32.2761506464169,15.847809672642645,35.23696094848312,100,14.285714285714286
2006-10-06,41.38,41.56,41.24001,41.41,39.34015249299578,39.18521430302805,39.412351842386876,40.34072167729868,39.99600975000002,38.414520300000085,38.87380059999998,40.36700600000001,40.36700600000001,41.58060592849806,39.15340607150196,85451568,67.4230683262828,65.1865383692375,NaN,NaN,NaN,NaN,NaN,NaN,0.03570195297615586,0.6407585143043235,0.6050565613281677,92.64705882352914,96.38240771168778,3502425162,328905132.6977842,30.987053683850014,15.214854289079591,33.81958047193705,92.85714285714286,7.142857142857143
2006-10-09,41.375,41.74001,41.32001,41.55,39.36214102540378,39.232041742572044,39.496181181901115,40.455891041365476,39.99810975000002,38.436820200000085,38.96260059999998,40.49650550000001,40.49650550000001,41.63216025231384,39.360850747686186,62817040,68.54474277306673,65.48321028845352,NaN,NaN,NaN,NaN,NaN,NaN,0.043391266085855085,0.6592956439354865,0.6159043778496314,90.7763031426879,93.49406183187618,3565242202,334884716.6482594,31.621495141509236,14.401802394144722,33.95315440632331,100,0
2006-10-10,41.61,41.75,41.31,41.62,39.38460728385748,39.27932804469933,39.57946819437558,40.56675856123543,39.999224750000025,38.462520200000085,39.05300039999998,40.59350600000001,40.59350600000001,41.76448157378927,39.422530426210756,98189568,69.1173099651126,65.44902374301047,NaN,NaN,NaN,NaN,NaN,NaN,0.04478829052754896,0.6718897410090676,0.6271014504815187,93.71983710223611,92.381066356151,3663431770,375053176.2846216,29.82346628682242,13.712260659252667,33.68120482068785,100,21.428571428571427
2006-10-11,41.42999,41.83,41.17,41.53999,39.40605387804795,39.32409362797261,39.656351402439284,40.6594472696892,39.99990970000002,38.484420000000085,39.154200199999984,40.672505000000015,40.672505000000015,41.874637847256864,39.47037215274317,136568064,67.60260665595385,65.62249938965813,NaN,NaN,NaN,NaN,NaN,NaN,0.03249282668118081,0.6677174838329947,0.6352246571518139,86.51122552918382,90.33578859136924,3526863706,391602742.58571386,27.314560168826556,14.343188192767522,32.82952710190119,100,14.285714285714286
2006-10-12,41.75999,42.25,41.7,42.23,39.43415284443553,39.381636328408796,39.75727879842206,40.80902372019499,40.005869750000016,38.51702000000009,39.261000199999984,40.78450450000001,40.78450450000001,42.121271525495914,39.44773747450411,95322560,73.08144291807153,66.55140580515736,NaN,NaN,NaN,NaN,NaN,NaN,0.06132654474380028,0.7118828380815643,0.650556293337764,99.22179291131151,93.1509518475771,3622186266,479992752.7675309,30.142102306990637,13.06942689520236,33.66674849380952,100,7.142857142857143
2006-10-13,42.22,42.52,42.14,42.42999,39.46396216936652,39.441999767450206,39.862091002405506,40.963401461128804,40.01306965000002,38.55541990000009,39.36719999999998,40.90050400000001,40.90050400000001,42.37822379295496,39.42278420704506,80470128,74.4311131018321,67.12101807451783,NaN,NaN,NaN,NaN,NaN,NaN,0.08301601885151566,0.7543263169021586,0.6713102980506429,96.59053030303005,94.10784958117506,3702656394,522341216.4450021,32.13416013451707,12.433036835939097,34.161637422214596,100,0
2006-10-16,42.42999,42.62,42.39999,42.45,39.4936739885768,39.5015641284908,39.963577629762156,41.10498227435463,40.02171965000002,38.59141980000008,39.47719999999998,41.017498500000016,41.017498500000016,42.593616506408026,39.44138049359201,62026736,74.56850818944845,67.5881637301516,NaN,NaN,NaN,NaN,74.56850818944845,NaN,0.0874155077491473,0.780579682737077,0.6931641749879297,93.79562043795637,96.53598121743259,3764683130,488512808.4060956,32.52659766156014,12.066685037317015,34.60547109566933,100,35.714285714285715
2006-10-17,42.17,42.2,41.75999,42,39.518612555854645,39.551038106144446,40.0434373305558,41.19022205774943,40.02965965000002,38.617819800000085,39.58299979999998,41.12499800000002,41.12499800000002,42.66069958562676,39.58929641437328,146149120,65.98167846730657,67.50251081434315,NaN,NaN,NaN,NaN,NaN,NaN,0.05055316260650611,0.7563556282460624,0.7058024656395563,77.37226277372268,89.25280450490298,3618534010,501802111.58374906,29.582491271311497,19.36984582647537,33.08072568550641,92.85714285714286,28.571428571428573
2006-10-18,42.22,42.31,41.64999,41.8,39.54131292843321,39.59557200503267,40.112322141122235,41.24829614748758,40.032109650000024,38.64091970000008,39.689399799999975,41.19349850000002,41.19349850000002,42.7212839568242,39.665713043175835,121156320,62.53498537307092,67.10344568719614,NaN,NaN,62.53498537307092,NaN,NaN,NaN,0.0056002793774846404,0.7128028148614121,0.7072025354839274,70.07299270072986,80.41362530413625,3497377690,435719683.07993656,27.059506929376532,17.717861303681488,31.76658649723453,85.71428571428571,21.428571428571427
2006-10-19,41.69,42.11011,41.59,41.89999,39.56478235203089,39.64120404453698,40.18242676303901,41.31036222867924,40.03290955000002,38.673519600000084,39.79679959999998,41.279498500000024,41.279498500000024,42.762377643450705,39.79661935654934,108220432,63.559859555847844,67.0116500113146,NaN,NaN,NaN,NaN,NaN,NaN,-0.022935195165193045,0.6785335415274361,0.7014687366926291,73.72226277372276,73.72250608272505,3605598122,456499853.7050743,25.233169629330813,17.30049831957157,30.239803489327365,78.57142857142857,14.285714285714286
2006-10-20,42.05,42.084,41.64,42,39.589013373403716,39.68791287533823,40.253704144880615,41.37604201642407,40.03330955000002,38.70531950000008,39.90099979999998,41.38599850000002,41.38599850000002,42.749834572291526,40.022162427708516,105456128,64.60285969456052,67.58714248241465,NaN,NaN,NaN,NaN,NaN,NaN,-0.039631128970794016,0.6519298254791366,0.6915609544499306,77.37226277372268,73.72250608272505,3711054250,522053663.00237036,23.75895443044658,16.289739150365286,30.261180138602167,71.42857142857143,7.142857142857143
2006-10-23,41.92,42.58,41.82001,42.42999,39.617281797548955,39.74221143226222,40.33904868821863,41.476418014859874,40.032059550000014,38.73221930000008,40.01899959999998,41.47899750000002,41.47899750000002,42.861122595664774,40.096872404335265,126988944,68.74498849162123,68.32216330484917,NaN,NaN,NaN,NaN,NaN,NaN,-0.026882159507571446,0.6579582550654663,0.6848404145730378,92.33830645161285,81.14427733301937,3838043194,598911390.829946,27.794286119034034,14.705968470215506,31.641663283123865,64.28571428571429,0
2006-10-24,42.28999,42.45,41.92,42.13,39.64228396871762,39.78949437419762,40.40928207299437,41.53866391820655,40.028460050000014,38.75709930000008,40.12619959999998,41.54699750000002,41.54699750000002,42.91666867954218,40.17732632045786,103668368,63.189368376462404,68.01942951250352,NaN,NaN,NaN,NaN,NaN,NaN,-0.04287036551835344,0.631252457675096,0.6741228231934494,66.2068965517244,78.63915525901992,3734374826,577395314.4525877,25.902903914851656,13.705237350851199,31.717746105052612,57.142857142857146,0
2006-10-25,42.14,42.52,42.05,42.42999,39.670022337188094,39.84178141629272,40.48852552111224,41.623552116472595,40.02621000000002,38.79359920000009,40.220799399999976,41.632497000000015,41.632497000000015,42.99847967195357,40.26651432804646,125404000,66.13655301353046,67.82279177872627,NaN,NaN,NaN,NaN,NaN,NaN,-0.037645316034177756,0.6270661781507272,0.6647114941849049,86.89586206896541,81.81368835743416,3859778826,654766914.282372,25.23109604419515,12.868917395660409,31.596967659439958,50,28.571428571428573
2006-10-26,42.57001,42.92,42.22,42.82001,39.701365498012095,39.900756239732466,40.57995628499019,41.73750048633235,40.02426000000002,38.83429930000008,40.30559959999998,41.73199750000002,41.73199750000002,43.13896032826075,40.32503467173929,130818368,69.54995047994552,67.97471193255932,NaN,NaN,NaN,NaN,69.54995047994552,NaN,-0.013566809139147873,0.64775298276097,0.6613197919001179,94.28628571428581,82.46301477832515,3990597194,748212343.3786013,28.076007343636576,11.721662363344807,32.09383731474095,100,21.428571428571427
2006-10-27,42.73,42.82001,42.08,42.21001,39.72632713484779,39.94648403696549,40.64387996008861,41.782501392395936,40.02031005000002,38.871799300000085,40.37519979999998,41.80999850000002,41.80999850000002,43.13919333903744,40.4808036609626,129374944,59.45564519026832,67.32549067664515,NaN,NaN,NaN,NaN,NaN,NaN,-0.04272157417907341,0.6079178241762762,0.6506393983553496,59.42914285714259,80.20376354679787,3861222250,664296343.0940639,25.48901446171711,12.384811858439122,31.89272744558164,92.85714285714286,14.285714285714286
2006-10-30,42.17,42.64999,42.06,42.48,39.753726864849305,39.99665266989686,40.715884667536116,41.84892983121537,40.017810050000016,38.91259940000008,40.448999999999984,41.92699850000002,41.92699850000002,43.0423479179512,40.81164908204884,103951248,62.07902760321611,66.82275622222397,NaN,NaN,NaN,NaN,NaN,NaN,-0.04745730471646892,0.5913177674597634,0.6387750721762323,74.85714285714258,76.19085714285698,3965173498,708345990.5668665,23.620323547005874,11.725361781037133,31.653181819289113,85.71428571428571,7.142857142857143
2006-10-31,42.56,42.75999,42.31,42.58,39.78184898559707,40.04780806257217,40.78898722959352,41.918555561575815,40.01721005000002,38.956899500000084,40.53219999999998,42.04049850000002,42.04049850000002,42.90930267017993,41.171694329820106,135825504,63.033099818134694,66.49636287666546,NaN,NaN,NaN,NaN,NaN,NaN,-0.0473796025580856,0.5795505689786253,0.6269301715367109,74.43609022556362,69.57412531328293,4100999002,735514713.4607952,23.66716271746696,11.059386135596876,32.022318612234095,78.57142857142857,0
2006-11-01,42.73,42.77,41.82001,42,39.80392013996924,40.086465328659855,40.836477926472206,41.92631217475907,40.01616000000002,39.002899600000084,40.60360019999999,42.07549850000002,42.07549850000002,42.87586160892136,41.275135391078685,148966624,54.47271170482402,65.16716779000492,NaN,NaN,NaN,NaN,NaN,NaN,-0.08757703101108882,0.5174588827728499,0.6050359137839387,30.827067669172717,60.0401002506263,3952032378,642996057.6578488,20.960497528877973,15.693296315959218,30.22664729529785,71.42857142857143,35.714285714285715
2006-11-02,41.815,42.14,41.74001,42.03999,39.82616959131283,40.125148985518074,40.883674478375255,41.937138634305825,40.01375995000002,39.05079950000009,40.68159999999999,42.10249800000002,42.10249800000002,42.85859169798752,41.346404302012516,100228064,54.92722561095755,63.774032969228166,NaN,NaN,NaN,NaN,NaN,NaN,-0.11114499629076313,0.4661046684204848,0.577249664711248,33.83383458646618,46.36566416040083,4052260442,693103825.2472402,19.927145682089524,15.905641318179894,27.870757221271326,64.28571428571429,28.571428571428573
2006-11-03,42.10001,42.19,41.61,41.92999,39.84710312771768,40.16088841154742,40.92470645961544,41.936457811990984,40.017159900000024,39.09379940000009,40.755199799999986,42.12849750000002,42.12849750000002,42.82060651608402,41.436388483916026,119295808,53.349499173634264,62.258389468098585,NaN,NaN,53.349499173634264,NaN,NaN,NaN,-0.13237315400259742,0.4117832222080011,0.5441563762105985,25.56315789473636,30.074686716791746,3932964634,705440657.2538601,18.50270185704578,16.370984057603764,25.030152148846025,57.142857142857146,21.428571428571427
2006-11-06,42.06,42.71001,42.06,42.53999,39.87389802196925,40.207999334091035,40.988050912179546,41.993937067991844,40.02355990000002,39.13269940000009,40.83959939999999,42.17799700000002,42.17799700000002,42.83841159111439,41.51758240888565,101354944,60.18019574301269,61.843997844934734,NaN,NaN,NaN,NaN,NaN,NaN,-0.10477152741236517,0.41319196694514204,0.5179634943575072,71.42781954887225,43.608270676691596,4034319578,753773747.5012116,23.021232434943105,14.835116969344384,25.084561274106754,50,14.285714285714286
2006-11-07,42.53,43.09,42.47,42.83,39.9033119719994,40.25992013935656,41.060284209741134,42.07356210913548,40.03050990000003,39.17759940000009,40.923999399999985,42.23849700000002,42.23849700000002,42.905022231447795,41.57197176855224,139877120,62.95722240224027,61.87415763273254,NaN,NaN,NaN,NaN,NaN,NaN,-0.06819347962805111,0.43272164482244335,0.5009151244504945,82.66666666666633,59.885881370091646,4174196698,776334573.3076618,25.865905868256167,13.73232509060662,25.783082534795934,100,7.142857142857143
2006-11-08,42.58,43.2,42.47,43.03,39.9344232956611,40.314773205903954,41.137527966221874,42.16465143207496,40.039359950000026,39.22759940000009,41.00999939999999,42.312997500000016,42.312997500000016,42.9836446353459,41.642350364654135,180439312,64.78135049711915,61.961406985680505,NaN,NaN,NaN,NaN,NaN,NaN,-0.03349546783471247,0.45904578965710385,0.4925412574918163,89.30817610062884,81.1342207720558,4354636010,872733657.8008121,24.935829968175902,12.549439435225885,26.81115541328892,100,0
2006-11-09,43.27,43.35001,42.67,42.8,39.9629364966993,40.363985617668234,41.20272294793866,42.225160819496395,40.04560995000003,39.27479940000009,41.08779939999999,42.34149750000002,42.34149750000002,43.04333448260195,41.639660517398084,124279936,61.0576527945165,61.70817792139163,NaN,NaN,NaN,NaN,NaN,NaN,-0.02916000578707728,0.4560912502579697,0.485251256045047,68.39041154935886,80.12175143888467,4230356074,795971822.0640422,24.70708639651486,11.55126729284501,28.070671051579755,100,71.42857142857143
2006-11-10,42.825,43.03999,42.67,43.03,39.993454541508264,40.416777981674805,41.27438087154891,42.30181217002055,40.050209950000024,39.31829950000009,41.17099939999999,42.371498000000024,42.371498000000024,43.134528788457246,41.6084672115428,82421680,63.32776085502988,61.32123309020654,NaN,NaN,NaN,NaN,NaN,NaN,-0.014659886876484562,0.4669263974494413,0.4815862843259259,81.60872638663015,79.76910467887261,4312777754,873942611.0496897,23.606868102534875,11.03688387303257,28.46264935858025,92.85714285714286,64.28571428571429
2006-11-13,43.06,43.53999,43,43.46001,40.02794763064748,40.47704000183966,41.36009181776267,42.41211672525669,40.056560000000026,39.37099960000009,41.25859959999999,42.42199850000002,42.42199850000002,43.32074982498484,41.52324717501521,89165312,67.17988208152863,61.60626978342556,NaN,NaN,NaN,NaN,NaN,NaN,0.01824870562783376,0.5043971663607181,0.4861484607328843,95.85593707739388,81.95169167112762,4401943066,936694687.04991,28.11947947491818,10.31493842529494,29.571836120542752,100,57.142857142857146
2006-11-14,43.5,43.97,43.24001,43.92999,40.06677392287985,40.54541524932799,41.46087213863473,42.55667608475605,40.06620995000002,39.42879960000009,41.34799919999998,42.51849800000002,42.51849800000002,43.609230073505614,41.42776592649443,121965248,70.79117051020687,61.938742461759595,NaN,NaN,NaN,NaN,NaN,NaN,0.06347944948268525,0.5654977725862409,0.5020183231035557,98.30466101694905,91.92310816032436,4523908314,1045290355.8160019,30.79638536105973,9.418056866116764,31.05141979417424,100,50
2006-11-15,43.985,44.39999,43.92,44.11,40.107005028124824,40.61600108597496,41.56475950574709,42.704611695731664,40.076010000000025,39.48739960000009,41.456799199999985,42.63399800000002,42.63399800000002,43.87482969856978,41.393166301430256,116575808,72.05929345808853,62.11798124591267,NaN,NaN,NaN,NaN,NaN,NaN,0.09541251826802322,0.6212839709385847,0.5258714526705615,89.60605593568425,94.58888467667573,4640484122,1021005651.8806686,34.205951607368604,8.871819845015347,32.316883650247114,100,42.857142857142854
2006-11-16,44.25,44.42,44.02,44.3,40.14872637112856,40.68895155952001,41.67202383885505,42.85655343899531,40.09036005000002,39.55509960000009,41.573201199999986,42.753998500000016,42.753998500000016,44.14303478756138,41.36496221243865,113541056,73.3733250225396,63.11210123393204,NaN,NaN,NaN,NaN,NaN,NaN,0.11775695173838263,0.6730676423435398,0.5553106906051571,95.72953736654789,94.54675143972707,4754025178,1066422074.2806659,32.761079061650655,8.432876904401306,34.063888736532355,100,35.714285714285715
2006-11-17,44.06,44.3,43.95,44.3,40.19003257639096,40.760457469232485,41.7750817275274,42.99402454004338,40.10726005000003,39.61999960000009,41.68480119999998,42.86899850000002,42.86899850000002,44.36594311759992,41.37205388240012,95171632,73.3733250225396,63.918836763883725,NaN,NaN,NaN,NaN,NaN,NaN,0.12052633419295689,0.7059686083463532,0.5854422741533963,95.72953736654789,93.68837688959336,4754025178,1161593706.2806659,31.301738833137026,8.948133683026056,35.62702171017382,92.85714285714286,28.571428571428573
2006-11-20,44.16,44.48,44.00999,44.39,40.23182329702389,40.832329598554615,41.87762754213417,43.12697458384877,40.12516005000003,39.674299500000096,41.79340099999999,42.96699900000003,42.96699900000003,44.58766868137951,41.34632931862055,107197504,74.04392827339083,64.70532451068773,NaN,NaN,NaN,NaN,NaN,NaN,0.11635016414613597,0.7308799793360663,0.6145298151899303,96.86411149825797,96.1077287437846,4861222682,1227737720.52513,31.725105331261627,8.406580081618273,37.18410391965291,100,21.428571428571427
2006-11-21,44.42,44.50999,44.25,44.45,40.27379520451618,40.903966636207,41.97850489342303,43.252977004434605,40.14426005000003,39.73109950000009,41.88880119999999,43.08299900000002,43.08299900000002,44.77784151308024,41.388156486919804,68135312,74.5049256192869,66.13619693314936,NaN,NaN,NaN,NaN,NaN,NaN,0.10585986260995983,0.7468546434523802,0.6409947808424203,97.93137217714548,96.84167368065046,4929357994,1264429997.2785444,31.022520946714298,8.114043263831842,40.338716722286684,100,14.285714285714286
2006-11-22,44.58,44.75,44.25999,44.73,40.3181355507399,40.979729673113795,42.0864066623084,43.39364586115512,40.16241000000003,39.78839950000009,41.984200999999985,43.19799950000002,43.19799950000002,45.00820086783971,41.387798132160334,69867632,76.59410696655328,67.6838313156919,NaN,NaN,NaN,NaN,76.59410696655328,NaN,0.10576051472198655,0.7731954242449035,0.667434909522917,99.36305732484067,98.05284700008139,4999225626,1328594265.510457,32.20723926520001,7.578750041623048,43.958676976142335,100,7.142857142857143
2006-11-24,44.39999,44.86,44.38,44.64999,40.361238580085775,41.052408095428376,42.186939342217876,43.51329768390225,40.18210990000003,39.853399500000094,42.07740059999998,43.28949850000002,43.28949850000002,45.19643866532286,41.382558334677185,51794512,74.71015250166064,69.2095922676938,NaN,NaN,NaN,NaN,NaN,NaN,0.08896317649774277,0.7786388801450954,0.6896757036473526,92.49964285714296,96.5980241197097,4947431114,1335066421.4057908,31.60273594313045,7.085628705052341,48.048538992685096,100,0
2006-11-27,44.52,44.61,43.64,43.66,40.39406207680134,41.10404357868722,42.244706426836785,43.52726933305442,40.19560985000003,39.90889950000009,42.14840059999999,43.36199800000002,43.36199800000002,45.20856001414782,41.51543598585222,159521248,56.268123602072905,68.93015854334097,NaN,NaN,NaN,NaN,NaN,NaN,0.00430484285510635,0.6950567572162356,0.6907519143611293,49.790794979079394,80.55116505368768,4787909866,1182123369.199604,27.5419392531241,15.58974577206009,48.48330907798731,92.85714285714286,0
2006-11-28,43.52,43.84,43.34,43.77,40.42765349892272,41.15683479495084,42.30452186107848,43.55038653943019,40.212009800000025,39.96969950000009,42.22159839999998,43.426498000000024,43.426498000000024,45.235049714520066,41.61794628547998,118270432,57.52279940787572,68.54198547231492,NaN,NaN,NaN,NaN,NaN,NaN,-0.04826053787386375,0.6304262420187996,0.6786867798926633,54.39330543933071,65.5612477585177,4906180298,1267278080.239604,25.776137218368017,18.43702956565987,47.4802838496305,85.71428571428571,0
2006-11-29,44,44.17999,43.66,44.07001,40.463895852167276,41.21452143267459,42.37375669005579,43.59987448805589,40.22785990000003,40.03679960000009,42.30599839999999,43.50099850000002,43.50099850000002,45.286542610942206,41.71545438905784,139546192,60.82406532038688,68.25932224540547,NaN,NaN,NaN,NaN,NaN,NaN,-0.06571912351246723,0.5965378755020794,0.6622569990145466,63.92739726027412,56.03716589289474,5045726490,1347795097.847177,28.42965547396056,17.201844093986477,46.877572546161765,78.57142857142857,0
2006-11-30,44.05,44.28,43.78999,44.03999,40.49947887851387,41.27047130529489,42.439099172798706,43.641790251098186,40.242259850000025,40.100799500000086,42.37819839999998,43.60299800000003,43.60299800000003,45.26253264806626,41.943463351933794,124969936,60.31889521872438,68.2065538471346,NaN,NaN,NaN,NaN,NaN,NaN,-0.08117019862560382,0.5607942507325419,0.6419644493581457,62.55662100456634,60.29244123472373,4920756554,1350342902.301454,27.919107600438288,16.106768088747764,46.202350707805046,71.42857142857143,0
2006-12-01,44,44.35001,43.25999,43.66,40.53092684987194,41.31778870519004,42.48697763661052,43.64352451289836,40.25285990000003,40.16809960000009,42.447798599999985,43.68399850000002,43.68399850000002,45.18061534078485,42.1873816592152,144574944,54.184351850693425,67.55345320396772,NaN,NaN,NaN,NaN,NaN,NaN,-0.11670229864875281,0.49608657604720463,0.6127888746959574,35.483870967741765,53.98929641086075,4776181610,1311878714.7085648,24.224721692284746,20.409461669410607,44.22122855692167,64.28571428571429,0
2006-12-04,43.78999,44.48,43.78999,44.25999,40.56803195584336,41.37605011696846,42.55650753321403,43.70223551166995,40.268109800000026,40.247599500000085,42.53559839999999,43.800498500000025,43.800498500000025,45.079801844057975,42.521195155942074,89957504,60.93934498662105,67.10770055433146,NaN,NaN,NaN,NaN,NaN,NaN,-0.10015212232107085,0.48759872179461894,0.5877508441156898,62.962117050105434,53.667536340804524,4866139114,1344470237.1864426,23.414093633682064,18.433359936290238,41.76248907290158,57.142857142857146,0
2006-12-05,44.39,44.55,44.19,44.42,40.606359996083725,41.43632635227601,42.629585669166424,43.770594034368045,40.28645980000003,40.332399500000086,42.61259819999999,43.894499000000025,43.894499000000025,45.06079774222055,42.7282002577795,84708496,62.52616270275746,66.51734285379936,NaN,NaN,NaN,NaN,62.52616270275746,NaN,-0.07967560055004752,0.4881563434281304,0.5678319439781779,72.5001718739259,56.9820532972577,4950847610,1368000374.9642224,23.2403279716963,17.62646621867016,38.94650000153007,50,0
2006-12-06,44.28999,44.39999,44.07001,44.25999,40.64271452348588,41.49224048391411,42.69352309390499,43.81720317395204,40.30145980000003,40.41469940000009,42.68239799999999,43.965998500000026,43.965998500000026,45.03365441466471,42.89834258533534,78243936,59.905339436839824,65.64920328085303,NaN,NaN,NaN,NaN,NaN,NaN,-0.07805286659274246,0.47026586073724985,0.5483187273299923,62.49960937744149,65.98729943382428,4872603674,1379851492.9752529,22.22189883609617,18.356419402722878,35.426196674448626,42.857142857142854,78.57142857142857
2006-12-07,44.34,44.48,43.7,43.7,40.67313527449597,41.53595849413363,42.73299277649696,43.80604096690899,40.314209850000026,40.49019950000008,42.741997999999995,43.99949850000003,43.99949850000003,44.98658135068517,43.01241564931489,124961632,51.732755328476706,64.10344830270569,NaN,NaN,51.732755328476706,NaN,NaN,NaN,-0.11368027887633647,0.4062183787345717,0.5198986576109081,27.500453122168086,54.166744791178495,4747642042,1254889860.9752529,20.107132657235518,21.12391503105662,31.383936808746007,35.714285714285715,71.42857142857143
2006-12-08,43.57001,44.25999,43.47,43.89999,40.705243281714914,41.58277099920029,42.77875737349708,43.81498849387004,40.32740985000003,40.56299940000008,42.80339779999999,44.054498000000024,44.054498000000024,44.876966134416975,43.23202986558307,133805504,54.1390541854937,62.729571814345256,NaN,NaN,NaN,NaN,NaN,NaN,-0.1220284648461975,0.36736307655316125,0.48939154139935875,39.99975000156259,43.33327083372405,4881447546,1266744501.1921678,18.216300236781034,21.875313312953807,28.068904416543095,28.571428571428573,64.28571428571429
2006-12-11,43.83501,44.37,43.75,44.06,40.738623945578446,41.63182503882009,42.82900218237955,43.838322923025274,40.33910985000003,40.64279940000008,42.87159799999999,44.10599800000002,44.10599800000002,44.78122511448272,43.43077088551732,72938752,56.027905353949,61.44271303438513,NaN,NaN,NaN,NaN,NaN,NaN,-0.11511423719000657,0.3454987449118505,0.4606129821018571,50.00031249804699,39.16683854059256,4954386298,1266744501.1921687,18.181492456749037,20.264677427688152,24.305577453658234,21.428571428571427,57.142857142857146
2006-12-12,44.03,44.13,43.56,43.8,40.76908539885627,41.674759196467214,42.867080528168586,43.83467312083239,40.35260980000003,40.72379940000008,42.94479799999999,44.122997500000025,44.122997500000025,44.7475313902758,43.49846360972425,111239632,52.26133456526306,59.85388510195486,NaN,NaN,NaN,NaN,NaN,NaN,-0.12553796794233574,0.30369052217393744,0.4292284901162732,33.75041405991188,41.250158853173815,4843146666,1249180348.771114,16.946164270963706,21.15261767951166,20.91316278398242,14.285714285714286,50
2006-12-13,44.105,44.11,43.62,43.88,40.800039772997,41.71842733119063,42.90680286039727,43.8389899664674,40.36370980000003,40.798499400000075,43.016197999999996,44.120498000000026,44.120498000000026,44.74849224208302,43.492503757917035,79035312,53.30160211481717,58.190134755402276,NaN,NaN,NaN,NaN,NaN,NaN,-0.12429823382195204,0.2738556978388331,0.39815393166078517,38.75038281010754,40.833703122688796,4922181978,1254019245.4241767,15.943311324479573,19.90083204669457,17.280198181276923,7.142857142857143,42.857142857142854
2006-12-14,43.97,44.57001,43.94,44.37,40.83556176530549,41.770933720672005,42.96418314038169,43.88956235061336,40.377109800000035,40.875999400000076,43.07759799999999,44.133498000000024,44.133498000000024,44.77078049316162,43.49621550683843,109111120,59.17029987720647,57.08014528222698,NaN,NaN,NaN,NaN,NaN,NaN,-0.08936451180630234,0.2864482919029072,0.37581280370920955,82.22235390848938,51.57438359283626,5031293098,1293851099.6626794,20.120625039970214,18.261917854938034,13.099614878695748,0,35.714285714285715
2006-12-15,44.66,44.75999,44.35001,44.42999,40.871327220377076,41.82358830046068,43.02166576232751,43.94103165055495,40.392009750000035,40.95439930000008,43.13619779999999,44.13999750000003,44.13999750000003,44.786524313134144,43.49347068686591,99944432,59.835797300436035,57.334979117824346,NaN,NaN,NaN,NaN,59.835797300436035,NaN,-0.06238188819145901,0.2978354434698858,0.3602173316613448,77.99999999999964,66.32424557286551,5131237530,1232901524.3452485,21.433058304289904,17.347761677641245,11.872713936192246,100,28.571428571428573
2006-12-18,44.58,44.75,43.8,43.99001,40.90235888982606,41.86648774005552,43.0596400461578,43.945696255264,40.40650980000003,41.03079930000008,43.187797999999994,44.124498000000024,44.124498000000024,44.769800310649764,43.479195689350284,121593056,53.01120626258387,57.01272246458922,NaN,NaN,NaN,NaN,NaN,NaN,-0.07356206916960467,0.26826474519933896,0.34182681436894363,48.66799999999974,69.63011796949625,5009644474,1159948250.599059,19.053022398674404,21.850421106191455,11.175546699702931,92.85714285714286,21.428571428571427
2006-12-19,43.64999,44.06,43.38,43.85001,40.931688751618836,41.90576540856927,43.09063494630848,43.936583278572186,40.42150980000004,41.09819940000008,43.233798199999995,44.09749850000003,44.09749850000003,44.741291673430915,43.45370532656914,136540256,51.017264360202425,56.31223668171889,NaN,NaN,NaN,NaN,NaN,NaN,-0.08876418754126159,0.23087157994236662,0.3196357674836282,39.33466666666637,55.33422222222192,4873104218,1212158834.9595277,17.550697913643788,24.997649197724233,10.668184669108063,85.71428571428571,14.285714285714286
2006-12-20,43.89,44.11,43.67,43.69,40.9591346346873,41.94109678661741,43.11413945821795,43.913099156803405,40.43560980000003,41.16409930000008,43.2751982,44.05949850000003,44.05949850000003,44.7052950578683,43.413701942131766,67318560,48.75985166990344,55.48659071394597,NaN,NaN,NaN,NaN,NaN,NaN,-0.10676493810238102,0.18617959485565194,0.29294453295803297,28.66733333333305,38.889999999999716,4805785658,1150960144.0504355,17.22845533375677,23.695689147145004,9.88050831452924,78.57142857142857,7.142857142857143
2006-12-21,43.75999,43.78999,43.21001,43.38,40.98322284727748,41.96958991955567,43.12456536181725,43.86232780853641,40.44990980000003,41.23309930000008,43.31199839999999,43.99199850000003,43.99199850000003,44.62544730152596,43.3585496984741,102955376,44.638821732013994,54.80476713404029,NaN,NaN,NaN,NaN,NaN,NaN,-0.13490486051784478,0.12431345731072696,0.25921831782857174,10.967238286945966,26.3230794289818,4702830282,1108356450.4058285,16.04237990059417,27.524492969547598,11.152458531129051,71.42857142857143,100
2006-12-22,43.39,43.41,42.92999,42.92999,41.00259366471751,41.98860774293081,43.11693495547147,43.77353373153294,40.461759750000034,41.29349920000008,43.325998199999994,43.90599850000003,43.90599850000003,44.620599949868435,43.19139705013163,92861872,39.429196578460406,53.26832796202882,NaN,NaN,39.429196578460406,NaN,NaN,NaN,-0.1765523138367219,0.03852792553266937,0.21508023936939127,0,13.211523873426339,4609968410,1015494578.4058285,15.11492275382674,29.30581323410784,12.584203260703033,64.28571428571429,100
2006-12-26,42.92999,43.12,42.88,43.11,41.023562881984,42.010813530199506,43.11666299643338,43.71034004281552,40.47390980000003,41.35339920000008,43.33959839999999,43.878498500000035,43.878498500000035,44.66732668290957,43.0896703170905,50857344,42.32863019971035,51.82564706895403,NaN,NaN,NaN,NaN,NaN,NaN,-0.18387399452486683,-0.01476225378669227,0.16911174073817456,12.234107628231902,7.733781971725956,4660825754,1062113810.4058292,14.658609104869383,29.049906565637922,13.954820303166622,57.142857142857146,100
2006-12-27,43.19,43.39999,43.10001,43.33,41.04651250504883,42.03693603455199,43.12502915343599,43.674117181594994,40.48370980000003,41.41719920000008,43.357198399999994,43.85649850000003,43.85649850000003,44.67998477077455,43.033012229225506,54128640,45.746742950955856,50.81431874853375,NaN,NaN,NaN,NaN,NaN,NaN,-0.1663259769251402,-0.038795730418250685,0.12753024650688952,23.9362975334973,12.056801720576402,4714954394,1090984343.1080081,17.73099045289985,27.915500127269304,14.868086809639168,50,92.85714285714286
2006-12-28,43.2,43.38,43.05,43.12,41.067144221416505,42.05838284574898,43.124831931732615,43.621344116681186,40.49070980000003,41.48129910000008,43.37959839999999,43.80899800000003,43.80899800000003,44.68562393169852,42.93237206830154,69024256,43.11960893121628,50.19909400587228,NaN,NaN,NaN,NaN,NaN,NaN,-0.16117251521989984,-0.07393539751798528,0.08723711770191456,12.766025351198408,16.312143504309205,4645930138,1051243104.8049774,16.94697874182389,27.35124863017999,16.36957369196134,42.857142857142854,85.71428571428571
2006-12-29,43.21001,43.61,43.12,43.16,41.0879686570243,42.08019704682326,43.12621107166467,43.57740658175917,40.499659800000025,41.54809910000007,43.4067984,43.76499850000003,43.76499850000003,44.67839732861342,42.851599671386644,75163504,43.78186186017184,49.45929455406358,NaN,NaN,NaN,NaN,NaN,NaN,-0.14773611328670072,-0.09743302390646136,0.05030308938023937,14.89369624306481,17.19867304258684,4721093642,988351193.294773,18.92754154578901,25.545059221213034,16.78052786506596,35.714285714285715,78.57142857142857
2007-01-03,43.46001,44.06,42.52,43.24001,41.109382003720576,42.10316363995547,43.13067377473664,43.54527357397258,40.50860985000003,41.61519920000008,43.4335988,43.74399900000003,43.74399900000003,44.6849831402163,42.80301485978376,167740256,45.15732484487693,48.682824517701285,NaN,NaN,NaN,NaN,NaN,NaN,-0.12692241806230675,-0.10834993319764408,0.018572484864662682,32.14344706895992,19.934389554407712,4888833898,977461147.3240707,15.46988050068433,27.99587463303438,18.45192996931806,28.571428571428573,100
2007-01-04,43.3,44.21001,43.14999,44.06,41.13874138676813,42.141912874807836,43.16711794043324,43.594295138356145,40.521159850000025,41.68789930000007,43.4747988,43.73399950000003,43.73399950000003,44.65691508450451,42.81108391549555,136881936,56.818010029694165,49.00830133658922,NaN,NaN,NaN,NaN,NaN,NaN,-0.05506278988524951,-0.05025600249189921,0.004806787393350304,68.75030692101303,38.595816744345925,5025715834,1075601061.0615485,15.312658622553988,24.6569569795108,19.33318649315324,21.428571428571427,92.85714285714286
2007-01-05,43.92999,43.95,43.48,43.85001,41.16571918391472,42.17573658025719,43.19389802120057,43.61864893470318,40.53485990000003,41.76109940000008,43.5031992,43.70550000000003,43.70550000000003,44.57561300423669,42.835386995763365,138981632,53.67085118549317,49.03467627020893,NaN,NaN,NaN,NaN,NaN,NaN,-0.02058097845168263,-0.020919435671252984,-0.0003384572195703544,59.37571149871183,53.423155162894936,4886734202,1155447487.173546,14.30719841846943,23.037931204312784,20.214443016988415,14.285714285714286,85.71428571428571
2007-01-08,43.88,44.12,43.64,43.88,41.192726953229,42.20948437074714,43.22080398115349,43.6435395123505,40.54820985000003,41.83219940000007,43.5381992,43.68650050000004,43.68650050000004,44.523310474915625,42.84969052508445,106445680,54.06220120606791,48.66981207941331,NaN,NaN,NaN,NaN,NaN,NaN,0.004027419217829103,0.004695816802716024,0.0006683975848869213,60.71455676141412,62.946858393713,4993179882,1155447487.1735477,15.474249865630915,21.76426335842106,21.075054887826155,7.142857142857143,78.57142857142857
2007-01-09,44,44.28999,43.63,44.10001,41.22165514274911,42.24692052182146,43.25528264855923,43.687012892126646,40.56325990000003,41.89619950000007,43.5715996,43.70650100000003,43.70650100000003,44.56254564144022,42.850456358559846,121616368,56.93612212549007,48.46269242406003,NaN,NaN,NaN,NaN,NaN,NaN,0.033274792726128044,0.04226188849254697,0.008987095766418932,70.85246636771285,63.6475782092796,5114796250,1207048619.813495,16.25229875518551,20.117372682487048,21.08168825289194,0,71.42857142857143
2007-01-10,43.96001,44.66,43.82001,44.62,41.25546951943817,42.29391219465668,43.30880097606671,43.775868807162205,40.57985990000003,41.956599500000074,43.6075994,43.74250150000003,43.74250150000003,44.68432779508421,42.800675204915855,121114816,62.85150794519696,49.165571115675256,NaN,NaN,NaN,NaN,NaN,NaN,0.08296477357858634,0.11269306273965185,0.029728289161065517,98.13084112149537,76.56595475020744,5235911066,1316628554.1125224,18.86436213689792,18.226960550135303,20.715933657624312,0,64.28571428571429
2007-01-11,44.71001,45.24001,44.64999,45.08,41.2935245490955,42.34908225020803,43.378259761319,43.900071777908664,40.59870990000003,42.02009950000008,43.664999200000004,43.79350150000003,43.79350150000003,44.89543260406769,42.691570395932374,174062256,67.15032130667134,50.31793232613732,NaN,NaN,NaN,NaN,NaN,NaN,0.13884543861670248,0.20328508743194362,0.06443964881524114,94.11730103933441,87.70020284284753,5409973322,1396281462.691892,24.055199024961837,16.960116035418363,20.70138299596502,100,57.142857142857146
2007-01-12,45.02,45.35001,44.97,45.31,41.33348947895525,42.40771428485738,43.45401428048296,44.034350656203074,40.61955990000003,42.08529960000008,43.7215992,43.86900150000003,43.86900150000003,45.154068133339386,42.58393486666068,104220432,69.07714372350219,51.769167472822936,NaN,NaN,NaN,NaN,69.07714372350219,NaN,0.18068242825097272,0.29029268412895703,0.10961025587798431,98.58622407694688,96.94478874592555,5514193754,1478555843.3547192,24.26975644482311,16.21617502651396,20.99347710885082,100,50
2007-01-16,45.33,45.39999,45.13,45.28,41.37275824035868,42.46459122971169,43.52562156360128,44.15298392704088,40.63635990000003,42.153899600000074,43.775599199999995,43.93900150000003,43.93900150000003,45.363766537513634,42.51423646248643,95896432,68.51264959416463,53.474440891547985,NaN,NaN,NaN,NaN,NaN,NaN,0.19451954568947177,0.35275968798982404,0.15824014230035227,95.83366608911831,96.1790637351332,5418297322,1489214948.9672225,24.082783343491066,15.689601606707356,20.618326559149676,100,42.857142857142854
2007-01-17,45.09,45.28999,44.83,44.91,41.407954675777994,42.513015165757,43.579910914048284,44.22508069589413,40.65065990000003,42.21869970000008,43.8337992,43.96600150000003,43.96600150000003,45.44196054012315,42.49004245987692,127569936,61.804394532442466,55.072669316832425,NaN,NaN,NaN,NaN,NaN,NaN,0.1679401660325523,0.36816534984104266,0.20022518380849036,82.98639925833055,92.46876314146523,5290727386,1406018129.2523577,22.72862612360102,18.474592567760773,19.073896017868773,92.85714285714286,35.714285714285715
2007-01-18,44.78999,44.84,43.95,44.08,41.43454219144189,42.54404456841527,43.59952225075227,44.211263486761354,40.66140995000003,42.27809970000008,43.874599399999994,43.94850200000003,43.94850200000003,45.41027223642331,42.486731763576756,189062560,49.98182306206639,55.619325949857846,NaN,NaN,NaN,NaN,NaN,NaN,0.08768294903053503,0.30982887009665916,0.22214592106612413,54.16685474602327,77.66230669782404,5101664826,1272187328.3534794,20.17851482642021,26.68661268761763,17.71398545779942,85.71428571428571,28.571428571428573
2007-01-19,43.98,44.28011,43.91,44.17,41.461760677099186,42.57624170567438,43.62189392719336,44.20733363087932,40.67235995000003,42.337299700000074,43.9193996,43.95750150000003,43.95750150000003,45.42239601841488,42.492606981585176,127558064,51.07470966908358,55.99989500115269,NaN,NaN,NaN,NaN,NaN,NaN,0.03650112296211172,0.2677723247687638,0.23127120180665206,57.29186559675551,64.81503986703643,5229222890,1323846776.120253,19.280371557745035,25.979839641633482,17.177586205885138,78.57142857142857,21.428571428571427
2007-01-22,44.21001,44.23,43.50999,43.69,41.48393221265044,42.598296325364,43.624564753577936,44.15806376127176,40.67975990000003,42.39099960000008,43.9423998,43.94950100000003,43.94950100000003,45.41839869693648,42.48060330306359,123465248,45.3797254999907,56.16133189892229,NaN,NaN,NaN,NaN,NaN,NaN,-0.03023303727531701,0.1934799052125058,0.2237129424878228,40.62514105951739,50.69462046743204,5105757642,1262116724.2771943,17.635830469559558,28.502586416610832,17.182274431466602,71.42857142857143,14.285714285714286
2007-01-23,43.64,43.9801,43.5,43.58,41.504788608544466,42.617736002089465,43.62281711618272,44.10301006972207,40.684609900000034,42.44069960000007,43.95739979999999,43.94400100000003,43.94400100000003,45.41756046200598,42.47044153799408,133213744,44.16439327303942,56.188655571269976,NaN,NaN,44.16439327303942,NaN,NaN,NaN,-0.07953534149847385,0.12429376561473049,0.20382910711320434,36.80568335306704,44.907563336446636,4972543898,1173298312.582963,16.617976817064612,26.97765142333559,17.816782735269232,64.28571428571429,7.142857142857143
2007-01-24,43.87,44.32001,43.77,44.3,41.532601657215665,42.65104816046393,43.64937330770497,44.12177101546282,40.69245990000003,42.496399600000075,43.9827998,43.99000100000003,43.99000100000003,45.447615873712316,42.53238612628774,117660688,53.03119771326514,56.75107506186913,NaN,NaN,NaN,NaN,NaN,NaN,-0.06217724972720759,0.12610754495419485,0.18828479468140244,51.11155555555532,42.84745998937991,5090204586,1282397736.7263758,19.180926533158964,24.619066235757565,16.64519492217712,57.142857142857146,0
2007-01-25,44.37,44.47,43.58,43.73,41.55446631734287,42.67241354342504,43.65253513877536,44.08445949018065,40.69950985000003,42.544599600000076,44.0013998,44.030001500000026,44.030001500000026,45.41095638704112,42.649046612958934,158405312,46.70751982701778,56.02889719024939,NaN,NaN,NaN,NaN,NaN,NaN,-0.08613072482214193,0.08062138865372503,0.16675211347586696,13.020901150526788,33.64604668638304,4931799274,1177387473.7151394,17.2298834119673,24.286372324653467,16.189368174360713,50,0
2007-01-26,43.81,43.83,43.28999,43.57001,41.57452147836434,42.690187730683945,43.649298858823386,44.03546430063963,40.70605995000003,42.59159970000007,44.0122,44.053002000000035,44.053002000000035,45.38640298696956,42.71960101303051,146284256,45.082535041580925,55.41544603711281,NaN,NaN,NaN,NaN,NaN,NaN,-0.10835961925884113,0.03130258940231556,0.1396622086611567,13.271090047393386,25.80118225115849,4785515018,1182813435.544885,16.156068452800277,26.119796866450308,16.202929333669914,42.857142857142854,100
2007-01-29,43.45,43.91,43.39999,43.61,41.59477499599255,42.70840183502684,43.647757727104825,43.9949438910549,40.71450995000003,42.636899700000065,44.0151998,44.06700200000002,44.06700200000002,45.37538954505534,42.758614454944706,104197008,45.59206297797471,54.81043616367758,NaN,NaN,NaN,NaN,NaN,NaN,-0.11533307467030869,-0.004504134676729166,0.11082893999357953,15.166350710900305,13.819447302940148,4889712026,1164428131.8255067,16.128045849534413,24.562803987499045,16.477052958454923,35.714285714285715,92.85714285714286
2007-01-30,43.67999,43.78999,43.52,43.63,41.6150259910573,42.72665130364017,43.64706134564973,43.96018733000206,40.72301000000003,42.67859960000007,44.0092,44.092502000000025,44.092502000000025,45.34474341444706,42.84026058555299,69951248,45.86259472100855,54.01946992050033,NaN,NaN,NaN,NaN,NaN,NaN,-0.11339200408503838,-0.03091106511271846,0.08248093897231992,16.114218009478652,14.850552922590767,4959663274,1151476308.1004796,15.59796933364276,23.755504350599825,17.198602398974742,28.571428571428573,85.71428571428571
2007-01-31,43.60001,44.19,43.33,44.07001,41.639453692638824,42.75325246594432,43.663647567388956,43.970646631906625,40.73286000000003,42.73259970000007,44.008400200000004,44.13800250000003,44.13800250000003,45.315294545359336,42.96071045464072,157934880,51.56822459717678,53.213521109927456,NaN,NaN,NaN,NaN,NaN,NaN,-0.07890273514140855,-0.01614747995444077,0.06275525518696778,36.967772511848366,22.749447077409098,5117598154,1265340010.7721095,18.730273072463554,21.34858586257868,17.54249075783761,21.428571428571427,78.57142857142857
2007-02-01,44.27,44.39999,43.85001,44.02,41.66314072057277,42.77833657552958,43.67762217258939,43.97534695267742,40.74466000000003,42.788000700000076,44.0028002,44.17700200000003,44.17700200000003,45.28218955333813,43.07181444666193,147389440,50.91147348557426,52.05360340842052,NaN,NaN,NaN,NaN,NaN,NaN,-0.05691296682915388,-0.008385953349474562,0.04852701347967932,34.597630331753564,29.226540284360183,4970208714,1209061996.2988582,19.99903558240675,19.956054642287743,16.31455892623641,14.285714285714286,71.42857142857143
2007-02-02,44.11,44.25,43.94,44.16,41.687985091512346,42.80569624730127,43.6965389501349,43.99293295718433,40.75315995000003,42.84240070000007,44.0000002,44.182002000000026,44.182002000000026,45.28593109557387,43.07807290442618,98188880,52.72653737041029,50.885702954628236,NaN,NaN,NaN,NaN,NaN,NaN,-0.03165467288266207,0.008958672376351728,0.0406133452590138,41.23270142180065,37.599368088467514,5068397594,1250237978.2343402,19.237341868078435,19.19599792249297,14.901364419164178,7.142857142857143,64.28571428571429
2007-02-05,44.14,44.36,43.96001,44.12,41.71218424483063,42.831722064186394,43.71314526581588,44.00503458030963,40.76051000000003,42.89400060000007,43.99460020000001,44.19550150000002,44.19550150000002,45.28941905358629,43.10158394641375,96371504,52.13341442151865,49.715757585153526,NaN,NaN,NaN,NaN,NaN,NaN,-0.017086843981129335,0.01925479028260213,0.036341634263731465,41.50049999999972,39.110277251184634,4972026090,1230960786.2169394,19.652680951071105,18.23115286907119,13.662028398163185,0,57.142857142857146
2007-02-06,44.2,44.23,43.64,44.05,41.73544609314077,42.85584637974706,43.72635525539173,44.009317001232525,40.76826000000003,42.93770070000007,43.98660019999999,44.204001500000025,44.204001500000025,45.29059825687108,43.11740474312897,121128496,51.05112472710104,48.947666884772,NaN,NaN,NaN,NaN,NaN,NaN,-0.011858846665043624,0.02151807593242694,0.03337692259747056,49.032586886535825,43.921929436112045,4850897594,1278180369.4033797,18.19957993730877,20.893538457622103,13.41678659481006,0,50
2007-02-07,44.28999,44.64999,44.12,44.46001,41.762556181766236,42.88761199598969,43.755126029690096,44.052240143972284,40.780560050000034,42.982700700000066,43.9812004,44.222001500000026,44.222001500000026,45.31302933467826,43.13097366532179,117932944,56.71883207800499,49.42888181448189,NaN,NaN,NaN,NaN,NaN,NaN,0.017901210417192046,0.05575343561896062,0.03785222520176858,86.03088235294076,58.85465641315876,4968830538,1311564923.0521638,22.07986958942236,19.328420577361445,12.899487643332028,0,42.857142857142854
2007-02-08,44.39,44.60001,44.23,44.45,41.78929691627602,42.918550372306726,43.78237598931009,44.090122035022546,40.79301000000003,43.027300600000075,43.977200599999996,44.21350150000002,44.21350150000002,45.294597628030935,43.13240537196911,89539008,56.54668638055892,49.81973729387299,NaN,NaN,NaN,NaN,NaN,NaN,0.034631920291183414,0.08114212556574785,0.04651020527456443,85.29485294117649,73.45277406021768,4879291530,1328501857.6483126,21.033464136037527,18.412411331221882,12.316813892044879,92.85714285714286,35.714285714285715
2007-02-09,44.57001,44.72,43.73,43.84,41.80970192208422,42.93679689958778,43.784635754435186,44.06630088882992,40.80286000000003,43.06460060000007,43.980800599999995,44.15150150000003,44.15150150000003,45.166947009144224,43.13605599085584,133482752,47.154395835122564,49.94649946066812,NaN,NaN,NaN,NaN,NaN,NaN,0.003950143032040346,0.05144788406461487,0.04749774103257452,38.461968797421136,69.92923469717945,4745808778,1224681939.4260921,18.506320197160747,22.268301071787423,11.29351166724666,100,28.571428571428573
2007-02-12,43.88,43.89,43.59,43.7,41.82851085818289,42.951909832269216,43.78131670524165,44.03141508989374,40.81206000000003,43.10049950000007,43.97940059999999,44.07100150000003,44.07100150000003,44.95279260226925,43.18921039773081,126940000,45.29489449890907,50.027249548230245,NaN,NaN,45.29489449890907,NaN,NaN,NaN,-0.024855174347177024,0.016428773098603244,0.04128394744578027,28.67182746973804,50.809549736111876,4618868778,1190831272.7594259,17.808076646258076,23.1888515241568,10.533634540019099,92.85714285714286,21.428571428571427
2007-02-13,43.78999,44,43.7,43.86,41.848724680489525,42.969891815788635,43.78440232464394,44.01508984323719,40.82006005000003,43.14059940000006,43.975200399999984,44.00000150000003,44.00000150000003,44.68844931940292,43.31155368059714,93679632,47.82708314964519,49.655527079400244,NaN,NaN,NaN,NaN,NaN,NaN,-0.03177239157585333,0.0015684579759636108,0.03334084955181694,39.86056041566129,35.664785560940146,4712548410,1197076581.5594246,18.544425231109823,22.283424448979307,10.300928576742393,85.71428571428571,14.285714285714286
2007-02-14,44.05,44.71001,44.03999,44.60001,41.876100653817986,43.00217138379282,43.81638693936379,44.070796524833646,40.83381005000003,43.18229960000007,43.98640079999999,43.984502000000035,43.984502000000035,44.60044197114359,43.36856202885648,133439008,57.6020509579842,50.43370787446927,NaN,NaN,NaN,NaN,NaN,NaN,0.012479339182325591,0.04894002352972393,0.03646068434739834,91.60914958636641,53.380512490588586,4845987418,1286701103.7828805,25.462594339567413,19.91118360983838,9.96077954454229,78.57142857142857,7.142857142857143
2007-02-15,44.63,44.86,44.55,44.86,41.90579119457602,43.03896006926227,43.85731294174168,44.14595876056377,40.85091005000003,43.22909970000007,44.010400799999985,44.02350200000003,44.02350200000003,44.74791446817946,43.2990895318206,110463568,60.40861315937783,51.52842774002619,NaN,NaN,NaN,NaN,NaN,NaN,0.05582082845848922,0.10623671992050987,0.05041589146202065,100,77.1565700006759,4956450986,1397164671.7828805,26.38251146760165,19.112072847412083,9.418817219760596,100,0
2007-02-16,44.67999,44.83,44.57001,44.71001,41.93369386925686,43.07205016690064,43.890752042065536,44.19967792622437,40.866710100000034,43.27749980000007,44.01940119999999,44.050502500000036,44.050502500000036,44.832694055861985,43.268310944138086,72352432,58.02236506268608,52.41630646036271,NaN,NaN,NaN,NaN,NaN,NaN,0.07002857075034051,0.1379516048999463,0.06792303414960578,90.19673202614364,93.93529387083669,4884098554,1402733240.4367497,25.35728759474729,18.369378075272575,9.07967481901444,92.85714285714286,14.285714285714286
2007-02-20,44.64999,45.12,44.42999,45.05,41.96470189045828,43.11121749032835,43.93621274629826,44.28066098086967,40.88451005000004,43.322299700000066,44.032001199999996,44.118502500000034,44.118502500000034,44.99436451542493,43.24264048457514,93673936,61.71420544425088,53.54856436916574,NaN,NaN,NaN,NaN,NaN,NaN,0.09634082115810151,0.18834906059723266,0.09200823943913115,96.08938547486032,95.42870583366799,4977772490,1477401146.0313933,26.86701273169403,16.70585674479951,9.264748601323216,100,7.142857142857143
2007-02-21,44.92,45.21001,44.83,45.19,41.99679440896118,43.15238150042086,43.98538087389441,44.36726469697732,40.901310050000035,43.36649970000008,44.0506014,44.199002500000034,44.199002500000034,45.15442788173522,43.24357711826485,95875568,63.15132659911098,54.37592879787532,NaN,NaN,NaN,NaN,NaN,NaN,0.11587813629824978,0.23685590981194338,0.1209777735136936,98.7648224393677,95.01697998012389,5073648058,1563179768.605326,26.70487931975769,15.854315400829098,10.619200452354937,100,0
2007-02-22,45.36,45.55,45.07001,45.42,42.0308561561357,43.19728483704619,44.041640447467174,44.467525202027105,40.917610050000036,43.413499700000074,44.0850014,44.25500250000003,44.25500250000003,45.348812602378196,43.16119239762187,116330064,65.44608744606221,55.41411550933875,NaN,NaN,NaN,NaN,65.44608744606221,NaN,0.13562435495267117,0.29050821720453257,0.1548838622518614,93.36734693877573,96.07385161766791,5189978122,1616496401.8255193,29.566139656032707,14.826317717846289,12.983190780665398,100,50
2007-02-23,45.41499,45.46001,45.06,45.25999,42.062986841149275,43.23813048383735,44.08941886129199,44.54299803992929,40.932910000000035,43.45779960000007,44.112201400000004,44.331502000000036,44.331502000000036,45.480365044967,43.18263895503307,113475808,62.528668959286506,56.114267765687046,NaN,NaN,NaN,NaN,NaN,NaN,0.12926773846730516,0.31646853533599284,0.18720079686868768,85.20357142857162,92.44524693557169,5076502314,1616487891.3526826,27.940224512158316,14.148597061389943,15.316072032941696,92.85714285714286,42.857142857142854
2007-02-26,45.48,45.5,44.75999,45.03999,42.09260876312789,43.27381087029602,44.126696160849164,44.59033060755507,40.947910000000036,43.50169960000007,44.13180120000001,44.40500100000004,44.40500100000004,45.53756222134782,43.27243977865226,102242624,58.65702582420283,56.58024000873592,NaN,NaN,NaN,NaN,NaN,NaN,0.10276054597568388,0.3156514793382925,0.21289093336260864,73.97908163265328,84.18333333333354,4974259690,1591617018.3290212,25.181340049809542,16.754679897802717,16.483340053799203,85.71428571428571,35.714285714285715
2007-02-27,44.36,44.48,43.06,43.19,42.10352807891766,43.27215124910204,44.089962978070766,44.456965787787915,40.95551000000003,43.53219960000008,44.1196012,44.38400100000003,44.38400100000003,45.588065403636385,43.17993659636368,317927936,37.58326566263885,55.61825007556005,NaN,NaN,NaN,NaN,NaN,NaN,-0.03924345226041079,0.16383661803709515,0.20308007029750594,5.220883534136374,54.80117886512042,4656331754,1331901239.624794,19.603687228478332,32.06114082957303,17.71340621378792,78.57142857142857,100
2007-02-28,43.16,43.75999,42.92999,43.33,42.11573177962495,43.273296768921796,44.0601605083425,44.349635712760495,40.96845995000003,43.56239960000007,44.1086012,44.36900100000004,44.36900100000004,45.61693978379552,43.12106221620456,217497056,39.35881606252399,54.37824893159711,NaN,NaN,NaN,NaN,NaN,NaN,-0.11910856996782077,0.05419435783772997,0.17330292780555073,15.267498979011593,31.48915471526708,4873828810,1324045141.1442153,17.82163673108982,30.570564578463745,19.120572174265607,71.42857142857143,100
2007-03-01,42.55,43.53999,42.24001,43.13,42.12582400072321,43.270459209141166,44.0236836256624,44.23347993059283,40.98315995000004,43.580699600000074,44.083801199999996,44.32200050000004,44.32200050000004,45.67760390516164,42.966397094838435,231931936,37.708533727913206,53.032666599265276,NaN,NaN,NaN,NaN,NaN,NaN,-0.17726611292280806,-0.04827971334795933,0.12898639957484873,26.88799664047338,15.792126384540447,4641896874,1409682865.7861333,15.452338564505851,33.562577283257596,21.28512517635704,64.28571428571429,100
2007-03-02,42.78,43.14,42.47,42.48,42.1293481400195,43.25480655153441,43.963147012891326,44.06648184196494,40.99475995000003,43.590499600000065,44.0448014,44.24500050000003,44.24500050000003,45.81799029656173,42.67201070343833,183383248,32.882899752947566,52.013274021967064,NaN,NaN,NaN,NaN,NaN,NaN,-0.24708297745544858,-0.179867322244462,0.06721565521098657,7.250475076963945,16.468656898816302,4458513626,1231773744.5921023,14.390471910477592,31.256196181681123,23.265278262507177,57.142857142857146,92.85714285714286
2007-03-05,42.16,42.8,42.06,42.14999,42.1295535316611,43.232928996058476,43.89204281630735,43.883958809396844,41.00620990000003,43.59789950000007,44.00800099999999,44.144500000000036,44.144500000000036,45.96391316915813,42.32508683084194,172004192,30.732537725821103,50.97310568103221,NaN,NaN,30.732537725821103,NaN,NaN,NaN,-0.2995635971382851,-0.30723884121186984,-0.007675244073584719,2.5785100286533056,12.238993915363539,4286509434,1101603761.3436704,13.30311825279105,33.08092654097777,25.37345142975758,50,100
2007-03-06,42.56,42.99001,42.5,42.85001,42.1367222527391,43.22534644168108,43.8511787842953,43.78548749421619,41.023859900000026,43.610899600000074,43.988001,44.08100050000003,44.08100050000003,45.98603497636209,42.17596602363797,155643568,39.735240879029824,50.39511694741683,NaN,NaN,NaN,NaN,NaN,NaN,-0.272010199308787,-0.34768799320956845,-0.07567779390078147,22.63638968481365,10.8217915968103,4442153002,1168309962.6776834,14.090933819398325,30.283584027814463,27.325802372447463,42.857142857142854,92.85714285714286
2007-03-07,42.86,42.98,42.64999,42.67999,42.14212790196557,43.21454730422205,43.80524981236215,43.68020201857655,41.04200985000003,43.62149950000007,43.96780079999999,44.01250000000003,44.01250000000003,46.01319012097039,42.01180987902967,116592880,38.42884374786169,49.02560214669379,NaN,NaN,NaN,NaN,NaN,NaN,-0.2506413784248699,-0.38897951693186883,-0.13833813850699894,17.764756446991267,14.326552053486074,4325560122,1072915145.7666768,13.604230704026529,29.2375841757202,29.058376109212244,35.714285714285715,85.71428571428571
2007-03-08,43.13,43.24001,42.84,42.97,42.15036543527935,43.20970478334637,43.77249491775971,43.61256373109307,41.06010980000003,43.63579960000007,43.95960079999999,43.93799950000003,43.93799950000003,45.97708455759991,41.898914442400155,121036816,41.93561047397972,47.706101954879635,NaN,NaN,NaN,NaN,NaN,NaN,-0.20433981716930977,-0.39376290996863617,-0.1894230927993264,26.074498567335183,22.1585482330467,4446596938,1030550293.3675851,15.553176610792182,27.501608758463814,29.899147934474286,28.571428571428573,78.57142857142857
2007-03-09,43.33,43.34,42.64999,42.92999,42.158122893634776,43.20416587674545,43.739455509220114,43.547556709084205,41.07990975000003,43.642799500000066,43.95960079999999,43.86199900000003,43.86199900000003,45.93215631193192,41.791841688068146,128609312,41.583731523918395,46.53191384496766,NaN,NaN,NaN,NaN,NaN,NaN,-0.16543347526304947,-0.39621493687813825,-0.23078146161508878,24.928080229226232,22.922445081184225,4317987626,1006318040.7145487,14.417320861472497,27.50421399694177,30.98748382760616,21.428571428571427,71.42857142857143
2007-03-12,42.88,43.28,42.83,43.21001,42.16858943200657,43.204281601958414,43.718692940231094,43.515409403457134,41.103009800000024,43.650599700000065,43.96160099999998,43.83049950000003,43.83049950000003,45.92011754217158,41.74088145782848,81347808,45.05842580788276,45.342215299512795,NaN,NaN,NaN,NaN,NaN,NaN,-0.11240122500269006,-0.37128299286845134,-0.2588817678657613,32.951575931231986,27.984718242597797,4399335434,1062361257.2393473,13.713912905094913,26.162308441447003,31.5516035376831,14.285714285714286,64.28571428571429
2007-03-13,43,43.24001,42.36,42.37,42.17059351726024,43.18776117419686,43.66580302100635,43.406322793604076,41.12060975000002,43.64979970000007,43.94240099999998,43.76399950000003,43.76399950000003,45.9484949328557,41.57950406714436,171185376,37.795621146717096,43.53109348148466,NaN,NaN,37.795621146717096,NaN,NaN,NaN,-0.12451668011807837,-0.41452761801335924,-0.2900109378952809,8.882521489971221,22.25405921680981,4228150058,895066413.7560225,12.43610153404451,28.701005688561082,32.55467856478424,7.142857142857143,57.142857142857146
2007-03-14,42.42999,43,42.10001,42.99001,42.17874691509844,43.183845309361274,43.63930133390806,43.36667395611797,41.138759800000024,43.65969980000007,43.939801199999984,43.72050000000003,43.72050000000003,45.930119922111004,41.510880077889055,192476944,44.86028910751136,42.060679314445316,NaN,NaN,NaN,NaN,NaN,NaN,-0.08337147843701675,-0.3942252859415518,-0.31085380750453506,27.035174418604548,22.956423946602584,4420627002,1083270322.121048,11.278663471593246,28.718418592246174,33.29747362304493,0,50
2007-03-15,42.89999,43.06,42.72,42.89,42.18582406022184,43.17802659036402,43.60991696787245,43.321276436487686,41.15575975000002,43.670599800000076,43.93440119999998,43.634999500000035,43.634999500000035,45.83418510839416,41.43581389160591,111608432,43.99237328602891,40.73665819492691,NaN,NaN,NaN,NaN,NaN,NaN,-0.05676040220599887,-0.38180431026203365,-0.3250439080560348,24.127906976744153,20.015200961773306,4309018570,1083270322.121048,11.511005894811051,27.670665336054785,33.90283036131802,7.142857142857143,42.857142857142854
2007-03-16,42.94,43.03999,42.61,42.83,42.1922337710654,43.17113497471325,43.5793319887402,43.27448820444124,41.176709750000015,43.67989990000007,43.926200999999985,43.53349950000004,43.53349950000004,45.68400826170414,41.38299073829594,108331312,43.4492599988262,39.65038920740001,NaN,NaN,NaN,NaN,NaN,NaN,-0.03797131765558959,-0.37250805512552176,-0.3345367374699322,31.818181818181724,27.660421071176803,4200687258,1085792232.9401817,10.966107989910135,27.571793467419365,35.54534069558884,0,35.714285714285715
2007-03-19,43.06,43.39,42.95,43.27,42.20295781314435,43.173092697986256,43.567201322515096,43.274060756399216,41.198959700000024,43.69259990000007,43.91040099999999,43.46149900000004,43.46149900000004,45.54500629591776,41.37799170408232,95920064,48.47307218349672,40.42823253031843,NaN,NaN,NaN,NaN,NaN,NaN,0.006925515409528793,-0.3258798432080212,-0.33280535861755,71.17688927581933,42.37432602358174,4296607322,1129392262.0310917,14.174646829807392,25.85521236997123,35.90731021485156,0,28.571428571428573
2007-03-20,43.25999,43.59,43.21001,43.58,42.21665972545137,43.181150268323165,43.56770323143607,43.30319782721834,41.218159650000025,43.70410000000007,43.90500079999999,43.387999000000036,43.387999000000036,45.34185034136278,41.43414765863729,81025056,51.72689596401317,41.31166680899623,NaN,NaN,NaN,NaN,NaN,NaN,0.05752053232795451,-0.2609046932076069,-0.3184252255355614,99.34640522875783,67.44715877425296,4377632378,1206152729.1734881,15.848187441823617,24.730104692653388,35.5889774773006,0,21.428571428571427
2007-03-21,43.63,44.44,43.35001,44.42,42.238583509277724,43.20568194617815,43.60112663412485,43.40955993891183,41.24204965000002,43.72700000000007,43.915800799999985,43.34949900000003,43.34949900000003,45.18666250827754,41.51233549172252,173902320,59.238200986550396,42.84950018461317,NaN,NaN,NaN,NaN,59.238200986550396,NaN,0.14272704699728117,-0.14001641678895993,-0.2827434637862411,99.15966386554638,89.89431945670783,4551534698,1373673254.1111493,23.210863146882055,21.799676660069693,33.17374976834699,100,14.285714285714286
2007-03-22,44.44,44.45,44.09,44.25999,42.258697006697844,43.226559333382546,43.62696441317878,43.49055327806309,41.269449600000016,43.74530000000007,43.91900039999999,43.29149850000003,43.29149850000003,44.92554789281555,41.65744910718451,114877056,57.40580837360287,44.60113651465997,NaN,NaN,NaN,NaN,NaN,NaN,0.18101710581955338,-0.05647208151179939,-0.23748918733135277,92.04979079497905,96.85195329642777,4436657642,1367284813.3858151,22.384493005225494,20.918037809928684,30.776471986027513,100,7.142857142857143
2007-03-23,44.25999,44.37,44.07001,44.12,42.277217434491895,43.24425122777101,43.64629914207373,43.550500584914225,41.29629960000002,43.758299900000075,43.90900039999999,43.234499000000035,43.234499000000035,44.65555946181878,41.81343853818129,68602688,55.780144051248385,46.39025125219049,NaN,NaN,NaN,NaN,NaN,NaN,0.1887586659143697,-0.0015408549383906234,-0.19029952085276033,85.95738705271066,92.38894723774536,4368054954,1321545876.6649888,21.600532671609106,20.4188105662131,27.931691984538165,92.85714285714286,0
2007-03-26,44.14,44.32001,43.63,44.3,42.297344624198445,43.26515714405277,43.67193446983554,43.621881481589064,41.32549955000001,43.77919980000007,43.89340039999998,43.19749950000003,43.19749950000003,44.458069176824914,41.93692982317514,114239440,57.44872688431065,47.6555002525677,NaN,NaN,NaN,NaN,NaN,NaN,0.19693798852053337,0.05587296479790638,-0.141065023722627,93.61699411486835,90.54139065418603,4482294394,1429159525.1709504,19.87622770050316,23.87929597687037,25.978680515902596,85.71428571428571,42.857142857142854
2007-03-27,44.23,44.24001,43.95,43.99001,42.31418706574871,43.279510665952714,43.68440802003807,43.656941340485346,41.35344965000001,43.79429990000007,43.86700059999998,43.237500000000026,43.237500000000026,44.54449620510222,41.93050379489783,76552064,53.69127015452223,48.74567356732916,NaN,NaN,NaN,NaN,NaN,NaN,0.1732440399749196,0.07549002624602252,-0.09775401372889708,80.42587415265581,86.6667517734116,4405742330,1373729823.0249534,19.045718728670884,22.88152266451658,24.02566904726703,78.57142857142857,35.714285714285715
2007-03-28,43.785,44.03,43.50999,43.52,42.32618520439798,43.284272830983355,43.67796064670324,43.643899308058174,41.380299700000016,43.803699900000076,43.83180059999999,43.24700000000003,43.24700000000003,44.55929877701397,41.934701222986085,144630256,48.51050967421766,49.21530922448902,NaN,NaN,48.51050967421766,NaN,NaN,NaN,0.12020765771953976,0.05250555842052762,-0.06770209929901214,60.425363512185264,78.15607725990314,4261112074,1234667724.8009968,17.85219689656571,26.750164545370815,23.46837263043636,71.42857142857143,28.571428571428573
2007-03-29,43.84,43.85001,43.10001,43.57001,42.338561570523375,43.28993099274606,43.673727288009,43.63686223110025,41.41114980000001,43.819400000000066,43.80500079999998,43.26900050000003,43.26900050000003,44.58745462668352,41.95054637331655,124430560,49.07358613357153,49.750298839464236,NaN,NaN,NaN,NaN,NaN,NaN,0.0844727452395772,0.03788883225045936,-0.046583912989117834,62.55345767428809,67.80156511304305,4385542634,1266190133.334332,16.26869040774232,29.226147743766855,23.272913251522517,64.28571428571429,21.428571428571427
2007-03-30,43.56,43.87,43.2215,43.53,42.35041667927439,43.294684834473856,43.66809092377335,43.62668487575737,41.442549800000016,43.83430010000007,43.79400079999998,43.321500500000035,43.321500500000035,44.592884027566846,42.05011697243322,120431744,48.615528453407215,50.00437759985884,NaN,NaN,NaN,NaN,NaN,NaN,0.0555179454206756,0.02281351878672666,-0.03270442663394894,60.8508972378606,61.276572808111325,4265110890,1260340326.185528,15.262652438285718,26.99634450841296,23.02638103286451,57.142857142857146,14.285714285714286
2007-04-02,43.67,43.75999,43.3,43.59,42.362750841669666,43.30053265953378,43.66502853460577,43.62319107806619,41.47234980000001,43.85090020000007,43.78240079999998,43.393501000000036,43.393501000000036,44.549187294867814,42.23781470513226,89618064,49.37861496899467,50.83173430145009,NaN,NaN,NaN,NaN,NaN,NaN,0.038586515247823555,0.015528717425830507,-0.023057797821993048,63.404099591913265,62.269484834687326,4354728954,1283721408.0800052,14.42213337694746,25.50964734109385,22.185513942666066,50,7.142857142857143
2007-04-03,43.82001,44.31,43.78999,44.16,42.380633917871954,43.317551814790534,43.6844391803075,43.67431573729798,41.49989985000001,43.867100300000075,43.791800799999976,43.45900050000004,43.45900050000004,44.63240483104993,42.28559616895014,105852944,56.0552437914867,51.63137392173405,NaN,NaN,NaN,NaN,NaN,NaN,0.06253773585877556,0.0551143720014764,-0.0074233638572991575,84.2391304347823,69.49804242151873,4460581898,1328506520.3075368,19.68596992751261,23.342749891373256,19.678077854400605,42.857142857142854,0
2007-04-04,44.2,44.38,44.13,44.34,42.40013009779363,43.337798313507555,43.71014744774642,43.7377142385077,41.529899850000014,43.88220030000008,43.80700079999997,43.54200100000004,43.54200100000004,44.718088558009164,42.36591344199092,85167056,57.941743770504324,52.62775752776802,NaN,NaN,NaN,NaN,NaN,NaN,0.0858264223515164,0.09985966408209634,0.014033241730579946,94.02173913043482,80.55498971904348,4545748954,1386420118.3875375,19.94192138069377,22.624132000428602,17.18224823784133,35.714285714285715,7.142857142857143
2007-04-05,44.28999,44.58,44.23,44.56,42.421621340601654,43.36200032710146,43.74347499881519,43.81602716817363,41.56254985000001,43.897500300000075,43.812200799999964,43.62150100000004,43.62150100000004,44.84613494861683,42.396867051383246,54245328,60.19113206996717,53.82360553284951,NaN,NaN,NaN,NaN,NaN,NaN,0.10983610464096502,0.15132837253178621,0.041492267890821194,98.77300613496956,92.34462523339558,4599994282,1434465980.330396,21.59201512934625,21.62061050244072,14.109172695286759,100,0
2007-04-09,44.71001,44.75,44.38,44.45,42.44180421283447,43.38354487507965,43.77118186160675,43.87640553310948,41.594399850000016,43.91400030000008,43.826600799999966,43.69750150000004,43.69750150000004,44.929681937306015,42.46532106269406,63054144,58.50624769641955,54.540260926629706,NaN,NaN,NaN,NaN,NaN,NaN,0.11172889814818292,0.18115339057604984,0.06942449242786693,81.81807162467672,91.53760563002704,4536940138,1395270161.087153,22.762718871921635,20.581298622047314,12.384399410657224,100,0
2007-04-10,44.44,44.67999,44.41,44.67999,42.4640747181794,43.409217055771144,43.8068213964457,43.95293738709905,41.62439985000002,43.930500200000075,43.848800399999966,43.771000500000035,43.771000500000035,45.0524790819866,42.48952191801347,76420192,60.966480761790784,55.200231269328114,NaN,NaN,NaN,NaN,NaN,NaN,0.12110274564075507,0.22080292447881078,0.09970017883805571,95.75694398147847,92.11600724704158,4613360330,1471690353.087153,21.934148579668772,19.83213272889698,11.180432210289576,92.85714285714286,50
2007-04-11,44.64,44.66,44.07001,44.21001,42.481447208545774,43.42507434179548,43.82263271423214,43.97742049308962,41.65449990000002,43.938000200000076,43.860800599999955,43.86300100000004,43.86300100000004,44.98296366728173,42.74303833271835,116874432,53.929662274807036,54.821049932775004,NaN,NaN,53.929662274807036,NaN,NaN,NaN,0.08972771246780561,0.21185981942281273,0.12213210695500712,67.27313498869677,81.61605019828399,4496485898,1410282693.3375282,20.14961556137607,22.7533774081449,11.389983344881518,85.71428571428571,42.857142857142854
2007-04-12,44.13499,44.62,43.95,44.56,42.502129325873675,43.44754811720547,43.851549078379904,44.03290425565251,41.686549950000014,43.94430030000008,43.879400599999954,43.94150050000004,43.94150050000004,45.02520089867525,42.85780010132483,114810496,57.832858011315814,54.85155347832593,NaN,NaN,NaN,NaN,NaN,NaN,0.08658086360821932,0.23035818646528128,0.14377732285706196,88.48477869562862,83.83828588860128,4611296394,1504530115.427082,18.38069018497397,22.32834989655762,11.840749136982309,78.57142857142857,35.714285714285715
2007-04-13,44.57001,44.72,44.28999,44.64999,42.52350107387493,43.47135884755784,43.882860487070886,44.09167432654275,41.71854990000001,43.94970020000008,43.891000199999965,44.029500000000034,44.029500000000034,45.040782215857625,43.01821778414244,94573440,58.799410980187595,55.06721540182159,NaN,NaN,NaN,NaN,NaN,NaN,0.08450192892833006,0.24940473401747454,0.16490280508914448,93.93875114394649,83.23222160942395,4705869834,1568308520.267901,18.659549458608264,21.051016532911923,12.070028773139711,71.42857142857143,28.571428571428573
2007-04-16,44.83,45.14999,44.83,45.06,42.54873986915976,43.50281708820026,43.92902282091124,44.18389581925297,41.75619990000001,43.957300200000084,43.91180019999996,44.141000000000034,44.141000000000034,45.08841158960159,43.193588410398476,73009632,62.96476120292755,55.46121785315137,NaN,NaN,NaN,NaN,NaN,NaN,0.10343165514444538,0.2941923740197012,0.19076071887525584,95.61020107513244,92.67791030490251,4778879466,1600253514.0999587,23.160871546094892,19.643835272847205,12.003439888469776,100,21.428571428571427
2007-04-17,45.14,45.2,44.96001,45.16,42.57472255702882,43.535632591404216,43.97729643577747,44.27685812218125,41.79294990000001,43.96590020000008,43.93180019999996,44.23550000000004,44.23550000000004,45.19352490578749,43.27747509421258,81867808,63.92277434095392,56.19203958075362,NaN,NaN,NaN,NaN,NaN,NaN,0.11451701985238677,0.3339069936907393,0.21938997383835251,98.09522902489982,95.8813937479929,4860747274,1654830915.6663537,23.08330250562896,18.98775290438963,12.045305884677427,100,14.285714285714286
2007-04-18,44.92999,45.23,44.83,45.00999,42.5989540738743,43.564827787614036,44.01779422260972,44.34668020578304,41.82319980000001,43.97210010000008,43.949599999999954,44.30699950000003,44.30699950000003,45.27208701319736,43.34191198680271,82028560,61.35866176234699,57.10976472990573,NaN,NaN,NaN,NaN,NaN,NaN,0.10388851601814592,0.3492506188610349,0.245362102842889,89.67084352508721,94.45875787503981,4778718714,1646623958.2383554,21.77774354096601,19.75212789889155,10.968730664786566,100,7.142857142857143
2007-04-19,44.81,45.25,44.72,45.14999,42.624337515925305,43.596217138354355,44.06219405701719,44.423185900470365,41.855099750000015,43.979100000000074,43.97159979999996,44.34349900000004,44.34349900000004,45.37579635451837,43.3112016454817,95458496,62.85614164244916,58.094232980539836,NaN,NaN,NaN,NaN,NaN,NaN,0.09847832152422664,0.3684600047481723,0.26998168322394567,95.06975597732327,94.27860950910343,4874177210,1706056778.068696,20.151427567191167,19.826999137801707,8.992327052431943,100,0
2007-04-20,45.52,45.67,45.2,45.39999,42.65195594860266,43.63193541284239,44.11465664301652,44.51621486233033,41.887099700000014,43.985799900000075,43.99039939999995,44.40049900000004,44.40049900000004,45.5294284593311,43.27156954066898,122425312,65.4323188920832,59.29543229758813,NaN,NaN,NaN,NaN,NaN,NaN,0.10341796456974689,0.39925413893612927,0.2958361743663824,88.60717299578064,91.11592416606369,4996602522,1687818011.3745685,24.58463272272299,18.376939874335317,8.041131930919768,100,0
2007-04-23,45.44,45.60001,45.34,45.47,42.67999618792005,43.668332731399964,44.16780736289822,44.607051542108394,41.92369975000001,43.99400000000008,44.010799399999954,44.467999000000034,44.467999000000034,45.68014060234947,43.2558573976506,85394192,66.14054741105696,60.49271318630686,NaN,NaN,NaN,NaN,NaN,NaN,0.10286348925338573,0.42441553593311454,0.3215520466797288,89.36175871404923,91.0128958957177,5081996714,1687814727.1088853,23.65313764821675,17.680650075317132,7.089936809407597,92.85714285714286,0
2007-04-24,45.63,45.83,45.33,45.7,42.71004597709497,43.70856376642175,44.22789334866692,44.7111418714314,41.961649750000014,44.01440000000008,44.04799939999995,44.53799900000004,44.53799900000004,45.85997018884775,43.21602781115234,108180320,68.42900994774723,61.37655362603975,NaN,NaN,NaN,NaN,NaN,NaN,0.10887021483390968,0.45763981522211594,0.34876960038820626,93.08510638297895,90.35134603093627,5190177034,1739741280.7088873,25.278883682043062,16.394258318550563,8.00574568818075,100,0
2007-04-25,45.85001,46.32001,45.7,46.31,42.745866415133825,43.760077355205475,44.309544589895665,44.86341407415222,42.004749750000016,44.03980000000008,44.10019939999996,44.65399850000004,44.65399850000004,46.15790122561699,43.1500957743831,106889872,73.53739032535881,62.49052837995793,NaN,NaN,NaN,NaN,NaN,NaN,0.14267706655336054,0.5271159335799069,0.3844388670265464,99.57763891291593,94.00816800331471,5297066906,1843179699.9299963,30.039101362895238,14.942447186137814,9.952930794125558,100,35.714285714285715
2007-04-26,46.42,46.64999,46.33,46.55,42.78371849060513,43.8153233481717,44.39740558637035,45.02404130518534,42.05069975000002,44.064599900000076,44.15399939999995,44.80549850000004,44.80549850000004,46.42774639293101,43.18325060706907,99400752,75.23522538188823,63.565106473666575,NaN,NaN,NaN,NaN,NaN,NaN,0.16819856222063512,0.5946870698023403,0.4264885075817052,96.29665295056628,96.31979941548705,5396467658,1880459253.189533,33.369647575807946,14.199848474934356,12.826669251439794,100,28.571428571428573
2007-04-27,46.37,46.7,46.28999,46.57001,42.82139303298717,43.86987159870296,44.48260575945386,45.171276418977214,42.09534980000002,44.08990010000008,44.193399399999954,44.95549850000004,44.95549850000004,46.64638644014277,43.26461055985731,96556880,75.37707332014766,64.77016544679002,NaN,NaN,NaN,NaN,75.37707332014766,NaN,0.172766471843656,0.6424465973862752,0.4696801255426192,95.27309090909094,97.04912759085772,5493024538,1915791144.3785286,32.0859810083325,13.338921775834544,15.415072002385914,100,21.428571428571427
2007-04-30,46.5,46.53,45.92,45.96001,42.85262305255944,43.911260477936565,44.540543180651746,45.246393902884144,42.14049990000002,44.11290020000008,44.215399599999955,45.076999000000036,45.076999000000036,46.688039662474395,43.46595833752568,93433808,63.446443741458296,64.94730565962341,NaN,NaN,63.446443741458296,NaN,NaN,NaN,0.12336208618383826,0.6238827332724171,0.5005206470885788,73.09127272727251,88.22033886230992,5399590730,1834614013.9460025,29.07622833251784,17.42700814311076,16.844896075960403,92.85714285714286,14.285714285714286
2007-05-01,45.97,46.14,45.66,46.11,42.88503476347925,43.95479987441307,44.602090506900694,45.328642102609464,42.189499900000015,44.13140030000008,44.24339939999996,45.202999000000034,45.202999000000034,46.72060666476304,43.68539133523703,135060560,64.91685806606793,65.73210535899918,NaN,NaN,NaN,NaN,NaN,NaN,0.09093839016780925,0.6141936347983403,0.5232552446305311,78.54545454545442,82.30327272727261,5534651290,1952792003.946002,27.057797757704783,19.977423184019067,17.48663854191134,85.71428571428571,7.142857142857143
2007-05-02,46.09,46.58,46.05,46.42,42.92020854692721,44.0036157184841,44.67338107525753,45.43258094997999,42.241899900000014,44.15140030000008,44.27079939999996,45.31599900000004,45.31599900000004,46.84266396918782,43.78933403081226,91980944,67.79990257574691,66.44403711360141,NaN,NaN,NaN,NaN,NaN,NaN,0.08086176257399036,0.624332447848019,0.5434706852740286,88.38179094692548,80.00617273988412,5626632234,1989237283.6441164,31.324917073930315,18.454113352687813,18.640825611185296,78.57142857142857,0
2007-05-03,46.53,46.72,46.42999,46.59,42.956723884768735,44.05483124881115,44.74854260171802,45.542811335696186,42.294699900000026,44.174700400000084,44.29879939999997,45.42849900000003,45.42849900000003,46.98226276201458,43.87473523798548,98013808,69.29029430602137,67.19338592258953,NaN,NaN,NaN,NaN,NaN,NaN,0.07620130475381903,0.6387223162163025,0.5625210114624835,93.50000000000023,86.80908183079337,5724646042,1999379673.14131,32.006348622074626,17.634440540565656,20.27865193390689,100,0
2007-05-04,46.77,46.89,46.42,46.63,42.99327389586556,44.10582468942875,44.822325244787905,45.64635311324893,42.34709995000002,44.204000400000076,44.32299939999997,45.531999000000035,45.531999000000035,47.116043082766744,43.947954917233325,93601568,69.6462948899666,67.6706383288066,NaN,NaN,NaN,NaN,NaN,NaN,0.06670993163533812,0.6459084260066561,0.579198494371318,88.0184331797236,89.96674137554976,5818247610,1989422059.5242891,32.29663142812097,16.405059680315322,22.02250623293447,100,21.428571428571427
2007-05-07,46.64999,46.78,46.57001,46.63,43.02946022525994,44.155808358945016,44.89321445087465,45.74003376912998,42.39714995000002,44.23130050000008,44.350399599999974,45.640999000000036,45.640999000000036,47.21219234524665,44.069805654753424,47671504,69.6462948899666,68.07946122516465,NaN,NaN,NaN,NaN,NaN,NaN,0.05198343587994214,0.6441777892212457,0.5921943533413035,88.0184331797236,89.84562211981581,5818247610,1968988171.8389707,31.248444815805694,15.872633753190076,23.657905651084484,92.85714285714286,14.285714285714286
2007-05-08,46.47,46.77,46.3,46.73,43.06628151655089,44.20678245084709,44.9652452567227,45.834316267308076,42.45039995000002,44.25800050000008,44.38419979999997,45.743499500000034,45.743499500000034,47.31801532847918,44.16898367152089,95182560,70.63334436507509,68.74193855393095,NaN,NaN,NaN,NaN,NaN,NaN,0.041010939535012225,0.6434580277600688,0.6024470882250565,92.62672811059892,89.55453149001538,5913430170,2047969445.0304577,28.98128107198834,18.88911300511699,24.815390231300544,85.71428571428571,7.142857142857143
2007-05-09,46.49001,46.97,46.46001,46.83,43.103731451709585,44.25872735281052,45.03837289371397,45.92914328946921,42.50604995000001,44.28830050000008,44.45699979999998,45.874499000000036,45.874499000000036,47.34970585875139,44.39929214124868,116026560,71.62695855948967,69.36842547657669,NaN,NaN,NaN,NaN,71.62695855948967,NaN,0.03287310145623701,0.6435384650453528,0.6106653635891158,92.09039548022594,90.91185225684949,6029456730,2100293899.4989767,29.781218073927846,17.412821522305467,26.629392425381152,100,0
2007-05-10,46.67,46.78,46.07001,46.19,43.13444059149357,44.29697037552714,45.08353474101931,45.953986785710235,42.554949950000015,44.311400500000076,44.51419979999997,45.955999000000034,45.955999000000034,47.306551823146194,44.605446176853874,171249008,58.082206478969695,68.84341744706859,NaN,NaN,NaN,NaN,NaN,NaN,-0.020361424491365687,0.5852135829749088,0.6055750074662745,52.43902439024385,79.05204932702291,5858207722,1986927871.456213,26.462147166974198,21.19133035963281,26.38734315567412,92.85714285714286,0
2007-05-11,46.24001,46.78,46.17999,46.78,43.170714814463786,44.346139278982044,45.1500627903911,46.03265471088069,42.60574995000002,44.33550050000008,44.58719979999997,46.06249950000004,46.06249950000004,47.316806930453815,44.80819206954626,102189248,64.70786697266995,68.74108313004095,NaN,NaN,NaN,NaN,NaN,NaN,-0.020528904610236376,0.579913876703479,0.6004427813137154,88.41463414634161,77.64801800560382,5960396970,2089117119.456213,24.171717897276572,19.357116264560766,26.14529388596709,85.71428571428571,7.142857142857143
2007-05-14,46.77,46.88,46.19,46.46001,43.2034441197925,44.38799810514082,45.20143326919929,46.07335521460634,42.65510000000002,44.355800700000074,44.66679999999997,46.132500000000036,46.132500000000036,47.309057996918824,44.95594200308125,118943632,59.23888239215488,68.08464544749863,NaN,NaN,NaN,NaN,NaN,NaN,-0.045452855269859205,0.5436267122263914,0.5890795674962506,61.06946564885488,67.30770806181346,5841453338,2063263255.7933714,23.234646717180468,17.48305254579593,25.63141892973196,78.57142857142857,0
2007-05-15,46.41,46.7,45.99001,46.10001,43.23226567083934,44.42189933078159,45.236671572367946,46.07589376559621,42.70385000000002,44.37690070000008,44.74580039999997,46.17950050000003,46.17950050000003,47.268772000652326,45.09022899934774,179469632,53.73628162903083,66.67028054061807,NaN,NaN,53.73628162903083,NaN,NaN,NaN,-0.08703687585145425,0.4802834726819327,0.567320348533387,33.58854961832062,61.02421647117237,5661983706,1939404715.5552266,20.983473563521425,18.518302725269056,23.679902954464087,71.42857142857143,28.571428571428573
2007-05-16,46.21001,46.56,45.91,46.55,43.26527795272153,44.464039938092846,45.28817464796136,46.12104674030134,42.75105000000002,44.40390060000008,44.819800199999975,46.256501000000036,46.256501000000036,47.21394504959732,45.29905695040275,144717440,58.878127718155376,65.50191642178001,NaN,NaN,NaN,NaN,NaN,NaN,-0.08499315826624165,0.4610789007005849,0.5460720589668265,67.93893129770984,54.19898218829511,5806701146,2079669311.247532,19.1538001120127,17.97689693360737,21.02783946294421,64.28571428571429,21.428571428571427
2007-05-17,46.5,46.57001,46.28999,46.33,43.29577269946062,44.50098964228903,45.32903054411974,46.14094705074883,42.79719995000002,44.43030060000007,44.89280039999997,46.31550150000004,46.31550150000004,47.12727854702838,45.503724452971696,110221872,55.62321656644931,64.09092665365868,NaN,NaN,NaN,NaN,NaN,NaN,-0.09827503464187959,0.423228265664477,0.5215033003063566,51.14503816793897,50.890839694656485,5696479274,2000945025.839343,18.548075791501585,17.277942897894828,18.333184908777728,57.142857142857146,14.285714285714286
2007-05-18,46.48,46.71001,46.38,46.71001,43.329745209913746,44.544732619669446,45.38318660121308,46.19514352210608,42.848350000000025,44.46360070000008,44.96760059999997,46.38100250000004,46.38100250000004,47.091858026858446,45.67014697314163,104965936,59.761186590317166,63.827694000005756,NaN,NaN,NaN,NaN,NaN,NaN,-0.08195121334903199,0.41906428362006665,0.5010154969690986,80.15343511450371,66.41246819338419,5801445210,2105910961.839343,19.531653384698185,16.348945916495804,17.177465702232976,50,7.142857142857143
2007-05-21,46.74001,47.24001,46.67,47.00999,43.36636456105888,44.59354959749778,45.446982812930216,46.27274794857217,42.89894995000002,44.504400700000076,45.04920059999997,46.458002000000036,46.458002000000036,47.08628524193483,45.82971875806524,112880752,62.716667781535214,63.670537551110556,NaN,NaN,NaN,NaN,NaN,NaN,-0.05284738024433516,0.43495627166367967,0.48780365190801483,82.7053931925327,71.33462215832513,5914325962,2127688643.4544735,25.40126991268739,15.04243637813382,17.93172441017763,100,0
2007-05-22,47.03999,47.28,46.87,47.05,43.40301765000357,44.64219217972554,45.509846232030995,46.34677195347005,42.94859995000002,44.54380070000008,45.12600039999997,46.52550200000004,46.52550200000004,47.10143059982297,45.94957340017711,98131008,63.10589300020005,63.33525115285721,NaN,NaN,NaN,NaN,63.10589300020005,NaN,-0.03372918254227508,0.445642173730171,0.4793713562724461,83.21167883211655,82.02350237971766,6012456970,2115721447.3569117,24.489107315982032,14.16555188134666,17.992529350936003,100,71.42857142857143
2007-05-23,47.19,47.37,46.8,46.83,43.437116976869206,44.68551510685969,45.56161696802978,46.39279367218719,42.99799995000002,44.57880070000008,45.215200399999965,46.551502000000035,46.551502000000035,47.133090631332784,45.969913368667285,119406368,59.43184938073848,62.631076515337,NaN,NaN,NaN,NaN,NaN,NaN,-0.03838835031105059,0.4313859183836328,0.4697742686946834,63.013698630137064,76.31025688492878,5893050602,2008884170.7253332,23.790777400964583,13.028466222319778,18.012408879782473,100,64.28571428571429
2007-05-24,46.855,47.03999,45.97,46.16,43.464210340283444,44.71471282751593,45.58508296928351,46.3706228462646,43.04524990000002,44.60920070000007,45.278600199999964,46.532002000000034,46.532002000000034,47.13811968502154,45.925884314978525,206285184,49.90304810146025,61.220844601872265,NaN,NaN,49.90304810146025,NaN,NaN,NaN,-0.08633692274190558,0.36185311526730146,0.44819003800920704,17.123287671232866,54.4495550444955,5686765418,1875859830.2098505,20.46916234603232,22.039724876191567,15.94556870689968,92.85714285714286,57.142857142857146
2007-05-25,46.25999,46.56,46.17999,46.45,43.49391969013137,44.74907494974334,45.61900128421357,46.378182575191786,43.09509990000002,44.64210070000007,45.349800199999976,46.526001500000035,46.526001500000035,47.132870981918074,45.919132018081996,87143120,53.38671494129412,60.059446034109946,NaN,NaN,NaN,NaN,NaN,NaN,-0.09744317538568786,0.3263860687770972,0.42382924416278506,36.98630136986342,39.04109589041112,5773908538,1912552997.840177,19.379841431847446,20.866822299884152,13.878728534016888,85.71428571428571,50
2007-05-29,46.49001,46.86,46.41,46.81,43.526915514110165,44.78988534677812,45.66570711620519,46.41930804422114,43.14649990000002,44.677800600000076,45.42940019999996,46.56850100000003,46.56850100000003,47.12807895888406,46.008923041116006,99706000,57.35148840184513,59.110742036736376,NaN,NaN,NaN,NaN,NaN,NaN,-0.08018583845080474,0.32359694609927914,0.4037827845500839,61.64383561643871,38.584474885845005,5873614538,1990102108.9512897,22.244003373429983,19.602919342214513,12.823658762605882,78.57142857142857,42.857142857142854
2007-05-30,46.48,47.2,46.35001,47.19,43.563364115959814,44.8374123696142,45.725483307726556,46.49270727810484,43.19849995000002,44.70910060000008,45.50780019999996,46.622501000000035,46.622501000000035,47.20273462541966,46.04226737458041,134470560,61.11155094663177,58.35964149296081,NaN,NaN,NaN,NaN,NaN,NaN,-0.04459629815847477,0.34803741185199044,0.3926337100104652,87.67123287671235,62.10045662100483,6008085098,2121408618.5506952,24.191780591069467,17.452597478063055,12.10759851675167,71.42857142857143,35.714285714285715
2007-05-31,47.32001,47.52,47.21001,47.41,43.601639099880614,44.88835469892877,45.79154278585493,46.5800684897139,43.25289995000002,44.74470050000007,45.584400199999976,46.67200100000003,46.67200100000003,47.337357794562514,46.006644205437546,110695248,63.137814963814996,58.72075638473548,NaN,NaN,NaN,NaN,NaN,NaN,-0.00949133269296043,0.38076954414426467,0.3902608768372251,93.16770186335366,80.8275901188349,6118780346,2153543414.4070745,27.383260547136302,16.687260713779164,13.051132320421717,100,28.571428571428573
2007-06-01,47.58,47.77,47.37,47.44,43.63983174565295,44.93888232865295,45.85618816680179,46.66196672878877,43.30624995000002,44.78030050000007,45.64480019999997,46.71450100000003,46.71450100000003,47.457531500095236,45.97147049990482,125090688,63.41773197596204,58.62860388497063,NaN,NaN,NaN,NaN,NaN,NaN,0.011365926902720591,0.40446828546562585,0.39310235856290526,82.2580645161288,87.69899975206494,6243871034,2072234467.207074,29.28461269339328,15.783749753831339,14.400824521482964,100,21.428571428571427
2007-06-04,47.27,47.64,47.24001,47.58009,43.67903829544745,44.99118347065983,45.92379216026055,46.7494070403327,43.35565040000002,44.815101300000066,45.711202199999974,46.76200550000003,46.76200550000003,47.593563311323635,45.93044768867642,65379888,64.76332493080315,59.023206923445514,NaN,NaN,NaN,NaN,64.76332493080315,NaN,0.029199409833319978,0.4296016208545552,0.40040221102123524,89.78978494623634,88.4051837752396,6309250922,2118029320.1307964,27.671183418122748,16.70463489826864,15.157064152133163,92.85714285714286,14.285714285714286
2007-06-05,47.42999,47.58,47,47.58,43.71785383479623,45.042447164310126,45.988741487309156,46.828511131729584,43.400650400000025,44.84470130000007,45.78040219999998,46.809505500000036,46.809505500000036,47.71106043652425,45.90795056347582,151167632,64.76167683968083,59.81073515277766,NaN,NaN,NaN,NaN,NaN,NaN,0.03519027601147012,0.4443900560355729,0.4091997800241028,89.78494623655891,87.27759856630803,6158083290,2269196952.1307964,25.478782161455733,18.659249306692615,15.814907778885937,85.71428571428571,7.142857142857143
2007-06-06,47.37,47.38,46.9614,47.07001,43.7512086225097,45.082596923432696,46.03114417408135,46.85151102394582,43.44235045000002,44.86460140000006,45.83580239999998,46.82650600000004,46.82650600000004,47.734224860423694,45.91878713957638,183196944,56.056425438841075,59.60918498996949,NaN,NaN,NaN,NaN,NaN,NaN,0.0008235357963772838,0.4102291997695744,0.4094056639731971,61.11166666666678,80.22879928315402,5974886346,2181064604.823777,23.3538278176007,17.623463630556515,16.58738065426484,78.57142857142857,0
2007-06-07,46.91,47.21001,46.32001,46.3399,43.77696674566881,45.10749401405779,46.043252245686,46.80278616452241,43.48010000000002,44.87490040000007,45.88280019999998,46.80200100000003,46.80200100000003,47.734152375963355,45.86984962403671,221448496,46.43352106894784,58.952778168719384,NaN,NaN,46.43352106894784,NaN,NaN,NaN,-0.07108643010301507,0.32054762634442824,0.3916340564474433,20.55000000000002,57.148870967741914,5753437850,1969514110.1393712,20.681347344225323,23.853594178292425,16.84293572013387,71.42857142857143,35.714285714285715
2007-06-08,46.33,46.92999,46.16,46.91,43.80814120591091,45.14318720189823,46.07724235369831,46.812997005996465,43.52255000000002,44.89120040000007,45.95060019999997,46.838001000000034,46.838001000000034,47.72746482709453,45.94853717290554,177603376,53.19063098883561,58.48345276861356,NaN,NaN,NaN,NaN,NaN,NaN,-0.07961973826427837,0.2921093836170954,0.37172912188137375,52.22222222222197,44.627962962962926,5931041226,2137895830.0497077,18.688762704398233,23.557538820853196,17.03254038524883,64.28571428571429,28.571428571428573
2007-06-11,46.89,47.19,46.75999,46.82001,43.83811004963319,45.17639161374183,46.10637049669053,46.81366491018728,43.564500100000025,44.910300500000076,46.01560019999997,46.840001500000035,46.840001500000035,47.72911443080416,45.95088856919591,97135184,52.07398227781006,57.723260946918906,NaN,NaN,NaN,NaN,NaN,NaN,-0.08992638727121482,0.2593211377923552,0.34924752506357004,47.22277777777792,39.99833333333331,5833906042,2067876544.4877915,20.97695802551814,22.267261924447627,15.416168414743764,57.142857142857146,21.428571428571427
2007-06-12,46.57001,47.03999,46.45,46.53999,43.864994427248774,45.20339356198456,46.12337518309482,46.787600633026585,43.60650005000002,44.93490040000007,46.07579999999998,46.844000500000035,46.844000500000035,47.72693906396304,45.961061936037034,154028000,48.65138266530474,56.69079592299782,NaN,NaN,NaN,NaN,NaN,NaN,-0.1127265506214673,0.20833933678673588,0.3210658874082032,31.66611111111127,43.70370370370373,5679878042,1960835712.8126786,19.406417475757774,24.53389305546123,14.342028408524277,50,14.285714285714286
2007-06-13,46.74001,47.09,46.53999,47.05,43.896686024987595,45.23996002610368,46.15971341120875,46.812591048928816,43.650500050000026,44.96370040000007,46.144999999999975,46.89150000000003,46.89150000000003,47.709019714573365,46.07398028542669,147994432,54.51514601239532,56.33960282525902,NaN,NaN,NaN,NaN,NaN,NaN,-0.09148738892724306,0.20670665124914933,0.2981940401763924,59.999999999999766,46.29629629629633,5827872474,2087304073.359429,18.685371302400085,22.81871780728249,12.965511562654067,42.857142857142854,7.142857142857143
2007-06-14,47.10001,47.49001,47.09,47.36,43.931146860559856,45.28194101568579,46.206783473514285,46.864725234745116,43.69570000000002,45.000400400000075,46.208999999999975,46.93200000000003,46.93200000000003,47.75804569105727,46.10595430894279,101547440,57.67869400576199,56.89500610413772,NaN,NaN,NaN,NaN,NaN,NaN,-0.056314276105514594,0.22780119504449914,0.28411547115001373,74.5341614906831,55.40009086726473,5929419914,2122842250.2190073,22.78835084839617,21.52240594309096,12.905675924886014,35.714285714285715,0
2007-06-15,47.75,47.87,47.64999,47.73,43.96894639428563,45.330417431216766,46.266517454945095,46.94713235524558,43.74130000000002,45.04190040000007,46.27679999999997,47.00200000000003,47.00200000000003,47.8491313261321,46.15486867386796,100395248,61.151691353272376,57.44964727642188,NaN,NaN,NaN,NaN,NaN,NaN,-0.01029405390197885,0.27124790377254016,0.281541957674519,91.81286549707599,75.44900899591964,6029815162,2095467535.7627518,26.21296498939745,20.097296521493707,13.585046761296754,100,64.28571428571429
2007-06-18,47.85001,47.87,47.67,47.77,44.00676782319821,45.378725996935245,46.32547755475117,47.02550070236505,43.786500000000025,45.07660040000007,46.340999999999966,47.05499950000004,47.05499950000004,47.95350318039884,46.15649581960123,75748192,61.519338223669926,57.74735083512365,NaN,NaN,NaN,NaN,61.519338223669926,NaN,0.019076103397214494,0.3053870869210371,0.2863109835238226,94.15204678362606,86.83302459046173,6105563354,2095467535.7627544,25.49988201606231,19.550580804086643,14.077515495421983,92.85714285714286,57.142857142857146
2007-06-19,47.63,47.86,47.50999,47.75999,44.04411331749475,45.42587973957019,46.38173294476093,47.09545206404457,43.83074995000002,45.11690030000007,46.407199799999965,47.09249950000004,47.09249950000004,48.04154165590814,46.143457344091935,109648624,61.362835123703114,57.76529970491446,NaN,NaN,NaN,NaN,NaN,NaN,0.03323569073635613,0.3278555969442678,0.2946199062079117,93.56666666666693,93.17719298245635,5995914730,2142455327.8651526,24.25627498995613,20.826637534057582,13.464994346039813,85.71428571428571,50
2007-06-20,47.83,47.92,47.24001,47.31,44.076609702395295,45.46318905165791,46.41813557437815,47.11588520080223,43.87294995000002,45.15430020000007,46.459799999999966,47.10549950000003,47.10549950000003,48.05896951300171,46.152029486998345,161910128,54.634167338178614,57.15789630308329,NaN,NaN,NaN,NaN,NaN,NaN,0.00896507194774021,0.3058262461425869,0.2968611741948467,65.34090909090922,84.35320751373409,5834004602,2013875366.0697162,22.01042764309771,22.574416521816808,11.821764887425854,100,42.857142857142854
2007-06-21,47.30499,47.78999,47.08,47.74001,44.11306144665007,45.50827461499142,46.46997378714763,47.17532565786868,43.91625000000002,45.195600300000066,46.530399999999965,47.15100000000003,47.15100000000003,48.13393672416541,46.168063275834655,143186256,59.234381792564875,56.85908557569778,NaN,NaN,NaN,NaN,NaN,NaN,0.0180185613643844,0.3193843759003272,0.3013658145359428,89.77329545454528,82.89362373737383,5977190858,2136902326.657441,19.935003643509972,22.570882487410135,10.124964895795715,92.85714285714286,35.714285714285715
2007-06-22,47.64,47.71001,47.14,47.28999,44.14467267603664,45.54355610776387,46.50213128569086,47.186246071405,43.95539990000002,45.23220020000007,46.58499979999997,47.20749950000003,47.20749950000003,48.079762805276864,46.3352361947232,153411744,53.15912099184352,56.03021386577209,NaN,NaN,NaN,NaN,NaN,NaN,-0.008718169302160184,0.29046810290824254,0.2991862722104027,64.20397727272746,73.10606060606067,5823779114,2064226806.522147,18.359464145013934,20.787019413655223,8.802701750766397,85.71428571428571,28.571428571428573
2007-06-25,47.31,47.58,46.82001,47.09,44.173979415578565,45.574178759095275,46.525184960761806,47.17707977889024,43.99749990000002,45.262400100000065,46.633799999999965,47.239499500000036,47.239499500000036,48.04246114399879,46.43653785600128,136607440,50.67187254660023,55.02379927340919,NaN,NaN,NaN,NaN,NaN,NaN,-0.04050973198750141,0.24854910722602597,0.2890588392135274,52.84090909090933,68.93939393939402,5687171674,2024680229.758769,16.57279994086702,22.86154520820343,8.838195467670277,78.57142857142857,21.428571428571427
2007-06-26,47.32001,47.32001,46.74001,46.82001,44.20030807811012,45.598848684657746,46.53674672700644,47.143073133281646,44.03920045000002,45.290400200000065,46.669000199999964,47.24000000000004,47.24000000000004,48.041901941482465,46.43809805851761,128146496,47.44448446578728,54.408660632476774,NaN,NaN,47.44448446578728,NaN,NaN,NaN,-0.07817790579857975,0.19133645696530266,0.2695143627638824,37.500568181818466,51.51515151515176,5559025178,1931884491.2760124,15.345452730357911,22.18995520908297,9.14180587328356,71.42857142857143,14.285714285714286
2007-06-27,46.74001,47.56,46.7,47.53999,44.23353874399957,45.63728712654571,46.576089600457166,47.180874739635776,44.08330040000001,45.32420010000006,46.716599999999964,47.25749950000004,47.25749950000004,48.06948508716988,46.445513912830194,141226256,55.57106078440197,55.0613420407235,NaN,NaN,NaN,NaN,NaN,NaN,-0.05419904178885726,0.2017655605278108,0.25596460231666807,78.40852272727287,56.25000000000023,5700251434,2066538799.8747103,16.67372533207463,19.843342001552912,9.253003807976851,64.28571428571429,7.142857142857143
2007-06-28,47.52,47.85001,47.47,47.52,44.266239851024444,45.67456856958441,46.613105694556886,47.213172383479986,44.12610035000002,45.35820010000007,46.76680019999996,47.262999500000035,47.262999500000035,48.08051379086696,46.44548520913311,116577568,55.315313083928665,55.21310504751587,NaN,NaN,NaN,NaN,NaN,NaN,-0.039937646564807416,0.2060425441106588,0.24598019067546623,72.78911564625858,62.89940218511665,5583673866,1980638731.9405007,19.531320344188508,18.892609604925493,8.548541952561196,57.142857142857146,0
2007-06-29,47.78999,47.88,47.21001,47.60001,44.29941169330281,45.712696122661946,46.65180782418211,47.250014061243796,44.165700450000024,45.39370020000007,46.81580059999996,47.271000000000036,47.271000000000036,48.0983590295602,46.44364097043987,124789248,56.18448783664609,55.50671258743272,NaN,NaN,NaN,NaN,NaN,NaN,-0.026041786063608408,0.21342795809595572,0.23946974415956412,78.23197278911535,76.47653705421561,5708463114,2001128687.2718928,17.902699543752696,20.55301069941285,8.827691451029889,50,7.142857142857143
2007-07-02,47.71001,48.048,47.67999,48.00999,44.33633287048387,45.75818709053003,46.70506987029261,47.32239272207772,44.20595035000002,45.429200000000066,46.86800059999996,47.29249500000004,47.29249500000004,48.17157903585402,46.41341096414605,80904816,60.43165498614343,56.34816061034977,NaN,NaN,NaN,NaN,NaN,NaN,0.008013789413672423,0.24948698092665467,0.24147319151298224,97.4794596852806,82.83351604021819,5789367930,2065320957.1119518,19.01280380686764,19.38881921621285,8.064118711857711,100,0
2007-07-03,48.10001,48.32001,48.03999,48.31,44.37587184689697,45.8087180392324,46.768008306751724,47.41645055807032,44.24755030000002,45.46780000000007,46.92480059999996,47.328995000000035,47.328995000000035,48.30776524990268,46.35022475009739,34793232,63.23972514189126,56.9713448338852,NaN,NaN,NaN,NaN,NaN,NaN,0.04588354060156108,0.29882761726493356,0.2529440766633725,99.38210257961363,91.6978450180032,5824161162,2097626650.7052662,21.79651177682231,18.603493963613044,7.917305747319131,100,0
2007-07-05,48.35001,48.77,48.28999,48.66,44.41849998772387,45.8651790681585,46.84220405942813,47.5348838382541,44.29030030000002,45.51600000000007,46.984000599999966,47.40849450000003,47.40849450000003,48.5370381349802,46.27995086501986,73578192,66.24901178871187,57.58351038981023,NaN,NaN,NaN,NaN,NaN,NaN,0.08724441544185552,0.36199959596569187,0.27475518052383635,94.68599033816393,97.18251753435273,5897739354,2137482207.2601693,26.348361380127226,17.426552313019908,9.169029360178216,100,64.28571428571429
2007-07-06,48.71001,48.91,48.5,48.86,44.46269401769677,45.92448245294744,46.921333311999575,47.661085377468,44.33404975000001,45.56760000000008,47.03500059999997,47.53449950000003,47.53449950000003,48.719023243186335,46.34997575681373,65805504,67.86773566900607,58.06322784093407,NaN,NaN,NaN,NaN,NaN,NaN,0.1188537563052679,0.4233223759054212,0.3044686196001533,97.7375565610861,97.26854982628788,5963544858,2187237588.3333406,26.777201561690084,16.468200819670006,9.928494617560272,100,57.142857142857146
2007-07-09,48.89999,48.98,48.72,48.89,44.50674681354058,45.983205572691055,46.99853592721528,47.77812486532819,44.37924970000002,45.61790000000007,47.08180059999997,47.633499500000035,47.633499500000035,48.91933342946864,46.34766557053143,66769120,68.11476687551568,58.534329887494486,NaN,NaN,NaN,NaN,NaN,NaN,0.13157411610929237,0.46893626473676875,0.3373621486274764,96.05263157894753,96.15872615939918,6030313978,2207781932.9487267,26.78248184988112,15.87209709462149,10.812251791870077,100,50
2007-07-10,48.62,48.89999,48.42999,48.48,44.54628167111729,46.03264704649915,47.056632557520565,47.844970116249314,44.419499750000014,45.65669990000008,47.120000399999974,47.716499000000034,47.716499000000034,48.995863221849895,46.437134778150174,104391312,61.19095864020414,58.52205299581599,NaN,NaN,NaN,NaN,NaN,NaN,0.1034087501402502,0.46662308630278915,0.36321433616253895,78.07017543859644,90.62012119287668,5925922666,2125605980.5790243,25.019440613653387,18.889143287280962,11.26611614520496,92.85714285714286,42.857142857142854
2007-07-11,48.37,48.81,48.32001,48.81,44.588706729116126,46.08764413468729,47.12539206506878,47.93687772422557,44.462649800000015,45.696199900000074,47.17700019999997,47.829999500000035,47.829999500000035,49.07400816561784,46.58599083438223,99583568,64.33348679445938,59.21486152840747,NaN,NaN,NaN,NaN,NaN,NaN,0.09808286013600587,0.48581791133254626,0.3877350511965404,92.54385964912302,88.88888888888899,6025506234,2225189548.5790243,23.297585490056314,19.1338842957711,11.876672425007543,85.71428571428571,35.714285714285715
2007-07-12,49.05,49.67,48.92,49.56,44.638172333801535,46.15640365677269,47.22086688604647,48.09146079810885,44.51109980000001,45.74469980000008,47.24600019999998,47.95549950000004,47.95549950000004,49.35601978265597,46.554979217344105,107659248,70.23296778941382,60.00047481389668,NaN,NaN,NaN,NaN,NaN,NaN,0.13393137127200927,0.555149265286552,0.4212178940145427,96.29629629629632,88.97011046133859,6133165482,2301268750.4990244,32.12664144777144,16.93142253214684,13.646153735541438,100,28.571428571428573
2007-07-13,49.62,49.97,49.5699,49.89999,44.69052872849008,46.23053407941085,47.32593053757406,48.263701674479435,44.557749700000016,45.79319970000008,47.315599999999975,48.082499000000034,48.082499000000034,49.689429707948655,46.47556829205141,74212688,72.45706105422445,61.378899104066754,NaN,NaN,NaN,NaN,NaN,NaN,0.167236824142853,0.630263924193109,0.46302710005025594,97.85902140672793,95.56639245071574,6207378170,2349509779.9792557,34.41692717848301,15.98663863802689,15.815027791482182,100,21.428571428571427
2007-07-16,49.89999,50.08,49.75999,49.85001,44.741866850594654,46.30220686991757,47.42491404590449,48.41477865786234,44.603149750000014,45.83979980000008,47.380800199999975,48.188499500000034,48.188499500000034,49.95972782920325,46.417271170796816,77664624,71.6100169465482,62.87448084692018,NaN,NaN,NaN,NaN,NaN,NaN,0.1719342695764613,0.6779449370208326,0.5060106674443713,93.19556213017748,95.78362661106723,6129713546,2315539849.5980783,34.415000633877504,15.270406179247459,17.428188051277367,100,14.285714285714286
2007-07-17,49.97,50.3,49.92,50.23,44.796475140638485,46.37998495170138,47.53491741665333,48.58765688092307,44.650699750000015,45.88789980000008,47.45280019999998,48.31149950000003,48.31149950000003,50.28006504022765,46.34293395977242,124721504,74.09002402653624,64.77773367268796,NaN,NaN,NaN,NaN,74.09002402653624,NaN,0.18550233025841323,0.7378885802673878,0.5523862500089746,98.05555555555556,96.37004636415365,6254435050,2394311325.808604,35.33466686823672,14.300202276295964,19.152731860003307,100,7.142857142857143
2007-07-18,49.94,50.17,49.64,50.17,44.84994304968686,46.455034754637985,47.63825398854927,48.738356225597066,44.69739975000002,45.93699990000008,47.523600199999976,48.43200000000003,48.43200000000003,50.54082457311045,46.32317542688961,144849440,73.0055788479798,66.02305639151496,NaN,NaN,NaN,NaN,NaN,NaN,0.17541712932749443,0.7716576616683426,0.5962405323408482,95.79286664358152,95.68132810977151,6109585610,2539160765.808604,32.42571938594987,17.029907012835295,20.756355803336515,92.85714285714286,0
2007-07-19,50.41,50.66,50.31,50.32001,44.90437157655565,46.53156891791248,47.74342089095911,48.88898991839734,44.74574985000001,45.989800100000075,47.595400399999974,48.58250050000003,48.58250050000003,50.77742168996863,46.387579310031434,116498624,74.02908115469494,67.3597541108554,NaN,NaN,NaN,NaN,NaN,NaN,0.16403774161262452,0.8012877093566289,0.6372499677440043,90.14518882663448,94.66453700859051,6226084234,2429325863.1014047,37.060079932328584,15.861966659617948,23.498718730891802,100,7.142857142857143
2007-07-20,50.28999,50.36,49.74001,50.05,44.955571859375986,46.601240820528076,47.833874973666596,48.99956230712141,44.79529985000001,46.05840010000008,47.65980039999997,48.69800000000003,48.69800000000003,50.945903779113465,46.45009622088659,163696368,68.96079217203659,68.27234727766901,NaN,NaN,NaN,NaN,NaN,NaN,0.12526513865044564,0.7938313910570614,0.6685662524066157,79.53027003265092,88.48944183428897,6062387866,2429323222.7948184,33.892782158287964,22.363492565143623,24.470316969131375,92.85714285714286,0
2007-07-23,50.21001,50.31,49.92,50.07001,45.00646179112349,46.669929319131484,47.921566543326726,49.10150970644318,44.84409990000001,46.12580020000008,47.73740059999997,48.83700100000003,48.83700100000003,51.06315691191409,46.610845088085966,107449872,69.12946884860739,68.89361969641644,NaN,NaN,NaN,NaN,NaN,NaN,0.08957841725287286,0.7805392739727068,0.690960856719834,77.48138365884121,82.38561417270886,6169837738,2404532608.7369733,32.03792072237945,21.139598352576954,25.864250060446505,85.71428571428571,0
2007-07-24,49.71001,50.10001,49.05,49.33,45.04948207180883,46.72260398607938,47.97679922790215,49.12327068678193,44.884249900000015,46.187800200000076,47.78840059999997,48.94900100000003,48.94900100000003,51.03317979466935,46.86482220533071,175521568,56.82974647860118,68.43576407761,NaN,NaN,NaN,NaN,NaN,NaN,0.008989755354235185,0.702198050912628,0.6932082955583928,43.88209332450066,66.96458233866424,5994316170,2322621652.1406746,27.65039999189905,29.59156831861465,25.541939665397695,78.57142857142857,0
2007-07-25,49.57001,49.67,49.06,49.39999,45.09277070791023,46.77562153090949,48.032610630729515,49.14962490708841,44.923749850000014,46.25700010000008,47.84720019999997,49.07800000000003,49.07800000000003,50.92499646998977,47.23100353001029,170786432,57.59816848342967,67.81784669866128,NaN,NaN,NaN,NaN,NaN,NaN,-0.04384616391074059,0.638400590669967,0.6822467545807076,46.15318868884064,55.83888855739417,6165102602,2342214495.6019206,25.4682942080733,27.256270008302973,24.328372699862193,71.42857142857143,0
2007-07-26,49.07001,49.47,48.05,48.98,45.13144960633899,46.81927258970336,48.069763155014634,49.133470154032366,44.96159985000001,46.32530020000007,47.904799999999966,49.15000050000003,49.15000050000003,50.85865070414694,47.44135029585313,318571264,51.65626203148626,66.6598842959813,NaN,NaN,NaN,NaN,NaN,NaN,-0.10768690019847704,0.5476381293326114,0.6553250295310884,35.632183908045974,41.88915530712908,5846531338,2440926718.2498074,21.26182176501067,34.502142388914756,24.3215964742361,64.28571428571429,100
2007-07-27,48.89,49.12,47.99001,47.99001,45.15989299334059,46.842455508719134,48.06663558030818,49.024569186981665,44.99379990000001,46.37670020000008,47.933600199999965,49.17350100000003,49.17350100000003,50.80292166150824,47.54408033849182,246373056,40.93612361694814,64.71855263465504,NaN,NaN,NaN,NaN,NaN,NaN,-0.21120923385702517,0.39131348720980696,0.6025227210668321,0,27.261790865628857,5600158282,2194553662.2498074,18.625507156516637,30.88238763062847,24.262951139661276,57.142857142857146,100
2007-07-30,48.21001,48.73,47.95,48.55,45.19362540136705,46.876268270922715,48.08559104774707,48.97937212155484,45.02844990000001,46.435400300000076,47.97800019999997,49.22100050000003,49.22100050000003,50.7138376633008,47.72816333669926,165934496,47.56490400634508,63.74526301795082,NaN,NaN,NaN,NaN,NaN,NaN,-0.23477892106307552,0.30904906973798774,0.5438279908010633,22.140221402213864,19.257468436753268,5766092778,2283903006.249807,17.05363105209988,28.709004189393678,25.084929030725878,50,100
2007-07-31,48.97,48.99001,47.42999,47.53,45.21687290981116,46.88921345367672,48.0638031635217,48.84133668140676,45.05839995000001,46.481000300000076,47.99439999999997,49.197001000000036,49.197001000000036,50.77967157346358,47.61433042653649,260235008,38.98287248346265,61.93450485287963,NaN,NaN,38.98287248346265,NaN,NaN,NaN,-0.30729643846573856,0.15970744271889004,0.4670038811846286,3.096275243730038,8.412165548647954,5505857770,2057034369.3861785,14.430541693205923,29.420324201796088,26.825699230802734,42.857142857142854,100
2007-08-01,47.39,47.92999,46.98,47.89999,45.2435705923006,46.90922883083164,48.0573791178934,48.75168461651088,45.086749900000015,46.53070030000008,48.012199999999964,49.17650050000003,49.17650050000003,50.81426068211879,47.53874031788127,301155840,43.000321592279256,59.98931583879859,NaN,NaN,NaN,NaN,NaN,NaN,-0.31728571419396673,0.0703967384421702,0.38768245263613693,24.99972826086972,16.745408302271205,5807013610,2339169640.3275604,13.108285346429621,31.06483990456018,27.51687481533509,35.714285714285715,100
2007-08-02,47.94,48.42999,47.78999,48.34,45.27438083516328,46.937560933191406,48.068462289740715,48.712476557795554,45.11629995000002,46.582000200000074,48.03799999999997,49.16050050000003,49.16050050000003,50.82417909820691,47.496821901793155,177369936,47.43302670941962,58.20188481416967,NaN,NaN,NaN,NaN,NaN,NaN,-0.2823681739303613,0.034722235223185294,0.3170904091535466,36.956521739130615,21.684175081243456,5984383546,2466659824.638064,17.16105318027783,29.12843655659541,26.751725050667826,28.571428571428573,92.85714285714286
2007-08-03,48.25,48.31,47.14999,47.42,45.29573027958951,46.9471141820391,48.043032396025396,48.58938355229122,45.14114995000002,46.632500200000074,48.04979999999997,49.08850050000004,49.08850050000004,50.914671019456044,47.26232998054403,166029056,40.3648175355404,55.97008485624054,NaN,NaN,NaN,NaN,NaN,NaN,-0.30728343333485925,-0.06701388251502749,0.24026955081983176,11.956521739130567,24.637590579710295,5818354490,2377922353.0391636,15.2567189598693,31.864098244499584,26.516912677424443,21.428571428571427,85.71428571428571
2007-08-06,47.46001,48.02,47.03,47.97,45.32233992854882,46.9673693467512,48.04016838049499,48.5303946425492,45.17099995000002,46.68230010000008,48.08599999999997,49.04250050000003,49.04250050000003,50.93161747629655,47.15338352370351,190869056,45.58523088679076,53.93402820340158,NaN,NaN,NaN,NaN,NaN,NaN,-0.2738823064352969,-0.10208333222428934,0.17179897421100754,26.902173913043534,25.271739130434906,6009223546,2549511706.4128995,13.877076695800566,30.07868725540831,26.12266241941087,14.285714285714286,78.57142857142857
2007-08-07,47.88,48.62,47.48,48.31,45.35206788945878,46.99395609236009,48.05075001263244,48.50940467659213,45.20354995000002,46.73650010000008,48.12319999999997,49.03400050000003,49.03400050000003,50.934659328966966,47.1333416710331,167364128,48.58177275137232,52.18947062507248,NaN,NaN,NaN,NaN,NaN,NaN,-0.21845801686595773,-0.10127354687143963,0.11718446999451809,36.141304347826235,25.00000000000011,6176587674,2625853238.4830766,17.784788021700397,27.045779592366287,25.374605512679473,7.142857142857143,71.42857142857143
2007-08-08,48.50999,49.06,48.39999,48.84,45.38677368160347,47.030511417263845,48.08170099252921,48.54088994548812,45.238250000000015,46.79660010000008,48.163799999999966,49.03550050000003,49.03550050000003,50.935497073189076,47.13550392681099,164838432,52.93290780257069,50.682601099920745,NaN,NaN,NaN,NaN,52.93290780257069,NaN,-0.1395122023029772,-0.057205782884203416,0.08230641941877379,55.02958579881672,39.35768801989549,6341426106,2680801047.4925165,20.510653360166717,25.242458522342336,23.25222592350073,0,64.28571428571429
2007-08-09,48.19,48.97,47.69,47.71001,45.409890460891,47.04396683474377,48.06712487517512,48.4617585221083,45.26680005000001,46.84100020000008,48.174200199999966,48.94300100000003,48.94300100000003,50.91077319620287,46.975228803797194,242420688,44.32134772507821,48.92264078228085,NaN,NaN,NaN,NaN,NaN,NaN,-0.15558072884403157,-0.11216949163626566,0.04341123720776589,21.92222222222219,37.69770412295504,6099005418,2445959793.8157663,18.271512378490712,28.542167091073466,23.355454630596263,0,57.142857142857146
2007-08-10,47.21001,47.83,46.63,47.28,45.42849851600651,47.04864075880825,48.03625723301139,48.34921009143132,45.291050100000014,46.87800020000008,48.17160019999997,48.81200150000003,48.81200150000003,50.85489964139713,46.769103358602926,246994496,41.55104832694421,46.952753602162055,NaN,NaN,NaN,NaN,NaN,NaN,-0.18533437667128586,-0.18825673363134143,-0.0029223569600555777,18.731934490102322,31.894580837047073,5852010922,2466542668.4824333,16.457569520992926,34.4780609951975,24.41864904111726,0,100
2007-08-13,47.67999,47.88,47.48,47.60001,45.45010559544924,47.059558961604125,48.01914949838349,48.27785770177119,45.318400150000016,46.90980030000007,48.174800399999974,48.69950150000004,48.69950150000004,50.74916004866599,46.64984295133409,116937312,44.339300733017055,46.06057890604891,NaN,NaN,NaN,NaN,NaN,NaN,-0.1738189192609472,-0.22019600603623957,-0.04637708677529238,31.90822368421037,24.187460132178288,5968948234,2419773590.5480328,16.04531107618502,32.72849691587347,26.6196527637811,0,92.85714285714286
2007-08-14,47.69,47.74001,46.73,46.78999,45.4634377785791,47.05422096236444,47.97094716511355,48.13615601588822,45.340200150000015,46.93510030000007,48.15899839999997,48.527501000000036,48.527501000000036,50.611613564173496,46.44338843582658,153528064,39.23697944635862,44.74906540340097,NaN,NaN,NaN,NaN,NaN,NaN,-0.20876015167588807,-0.30732727637015245,-0.09856712469426439,5.633450704225377,18.757869626179346,5815420170,2284483263.9157043,14.69362717078779,36.226901568731705,29.39799844811365,0,85.71428571428571
2007-08-15,46.67999,47.09,45.813,45.89999,45.46778158177732,47.03136490370376,47.889733158638506,47.923187823898864,45.35560005000002,46.95290020000007,48.12539819999997,48.314000500000034,48.314000500000034,50.55060452042271,46.07739647957736,214791008,34.534650794168826,43.52609317216402,NaN,NaN,NaN,NaN,NaN,NaN,-0.27561619025545836,-0.4430873625135874,-0.167471172258129,2.63048079830663,13.390718395580782,5600629162,2098955638.5091577,13.181645469952386,39.88831008053613,31.296570134761907,0,100
2007-08-16,45.53999,45.91,40.55,45.45,45.46760465061535,47.00005074719478,47.79405734849582,47.687646126384685,45.37180000000002,46.964400200000085,48.09299799999998,48.07050000000003,48.07050000000003,50.4371247104585,45.703875289541564,362401280,32.419134531075244,42.917736808887376,NaN,NaN,32.419134531075244,NaN,NaN,NaN,-0.33026251172434196,-0.5802993119135564,-0.2500368001892145,57.5793184488837,21.947749983805235,5238227882,2399153713.733039,8.996900393216233,58.39730120684587,34.763944644786605,0,100
2007-08-17,46.31,46.58949,45.589,46.31,45.47598669389281,46.9863863759632,47.73585902110383,47.556441733395665,45.39095000000002,46.98760010000008,48.09239999999998,47.88350000000004,47.88350000000004,50.185070012002505,45.581929987997576,223226560,39.98566166316702,42.37636235580323,NaN,NaN,NaN,NaN,NaN,NaN,-0.2900381320856522,-0.6125844652962797,-0.32254633321062753,67.68507638072857,42.6316252093063,5461454442,2497662203.078861,12.427754363122654,54.44043488802501,37.43250944483765,50,92.85714285714286
2007-08-20,46.48,46.72,46.08,46.53,45.486474388480936,46.97734902198373,47.68857043204093,47.45868537783417,45.41070000000001,47.017700100000084,48.08479999999998,47.706499500000035,47.706499500000035,49.84709172322513,45.565907276774944,144675632,41.781401847672186,42.57625731038962,NaN,NaN,NaN,NaN,NaN,NaN,-0.23264151266354566,-0.6133482240400596,-0.38070671137651396,70.27027027027029,65.17822169996084,5606130074,2556436678.578862,12.741316502954858,52.29709851197535,39.335049123734166,42.857142857142854,85.71428571428571
2007-08-21,46.48,47.1272,46.39,47.02,45.50173334978958,46.978193595805834,47.6623519837256,47.41690581804044,45.435800000000015,47.052200000000084,48.088799799999975,47.59099950000004,47.59099950000004,49.614827458134975,45.5671715418651,115016816,45.67998199355969,42.767661624766795,NaN,NaN,NaN,NaN,NaN,NaN,-0.14972948536360292,-0.5678685680810176,-0.4181390827174147,76.02820211515866,71.32784958871918,5721146890,2638003134.6352925,14.720040477803881,49.86193614772103,40.31819164878946,35.714285714285715,78.57142857142857
2007-08-22,47.375,47.7,47.27,47.66,45.52320863984143,46.99169471272057,47.66225974906969,47.440057644893734,45.463900050000014,47.093500000000084,48.11119999999998,47.50400000000003,47.50400000000003,49.351178074823935,45.65682192517613,115399680,50.35603830074914,42.97644816700462,NaN,NaN,NaN,NaN,NaN,NaN,-0.04525736684117487,-0.47471079126888327,-0.4294534244277084,83.54876615746176,76.61574618096357,5836546570,2731933106.7283125,17.793313666502623,47.65753720683061,41.7307004686793,28.571428571428573,71.42857142857143
2007-08-23,47.82001,47.85001,47.23,47.53,45.54317671307684,47.00235422335977,47.65707309224343,47.44862358347528,45.49190010000001,47.132900000000085,48.12079999999998,47.43150000000004,47.43150000000004,49.150645671578545,45.71235432842154,118647680,49.42532184087156,43.623627045956844,NaN,NaN,NaN,NaN,NaN,NaN,0.018215147640252893,-0.40668448987739225,-0.42489963751764515,82.02115158636899,80.53270661966313,5717898890,2728103910.3011594,18.059643088050244,45.67476929131214,42.30814246291105,21.428571428571427,64.28571428571429
2007-08-24,47.38,48.24001,47.32001,48.2,45.56961276568304,47.026069981313036,47.678364343528,47.52018324219192,45.52020015000001,47.17330000000008,48.137599999999985,47.441999500000044,47.441999500000044,49.17715155330432,45.70684744669577,88181936,54.130793876886116,44.23402440239223,NaN,NaN,NaN,NaN,NaN,NaN,0.10367518555873784,-0.29530565556922284,-0.3989808411279607,89.89424206815512,85.15471993732861,5806080826,2808615934.867769,19.576454929014446,42.827449079399585,42.33671236882035,14.285714285714286,57.142857142857146
2007-08-27,48.05,48.2,47.84,47.88,45.592601693387685,47.04297948663357,47.68627162417396,47.55445150484031,45.54545015000001,47.20870000000008,48.140599999999985,47.40849950000004,47.40849950000004,49.081550459800155,45.735448540199926,72472256,51.65865414039401,44.45380164446521,NaN,NaN,NaN,NaN,NaN,NaN,0.1350208368960485,-0.23020479500790003,-0.3652256319039485,86.13396004700354,86.01645123384255,5733608570,2752248624.6455464,19.075346462840507,41.731173099088544,43.52250639536911,7.142857142857143,50
2007-08-28,47.60001,47.7,46.71001,46.74001,45.60401869146343,47.03698009085865,47.64916332518675,47.47688564723647,45.5640002,47.23050010000008,48.120000199999986,47.36900000000004,47.36900000000004,49.06584467176793,45.67215532823216,105748624,43.95687326358038,43.81265632025161,NaN,NaN,43.95687326358038,NaN,NaN,NaN,0.07816786230178685,-0.26751580402671493,-0.3456836663285018,73.51555819477434,83.18125343664433,5627859946,2652909072.898802,17.506894777462907,46.24116017112953,46.003413014812416,0,42.857142857142854
2007-08-29,47.05,48.12,47.05,48.08,45.628655321399116,47.057633950445606,47.66605888106178,47.53432510940443,45.590400200000005,47.266800100000076,48.12640039999999,47.37800050000004,47.37800050000004,49.087875328193284,45.6681256718068,113164000,52.85448850906247,44.422166376250495,NaN,NaN,NaN,NaN,NaN,NaN,0.12710239408287183,-0.18680567372491197,-0.3139080678077838,97.91924847952083,85.85625557376623,5741023946,2757612213.0857177,18.729451629974875,41.868328075615516,47.16376536217548,0,35.714285714285715
2007-08-30,47.83,48.74001,47.75,48.33,45.655534372927484,47.08282931776351,47.69209578768681,47.61010367041353,45.61690020000001,47.303300200000066,48.146800399999975,47.37750050000004,47.37750050000004,49.08625528933894,45.668745710661135,138910432,54.31188474008712,45.33365469147498,NaN,NaN,NaN,NaN,NaN,NaN,0.169926948948111,-0.10149938162264505,-0.27142633057075605,94.99377900637484,88.80952856022334,5879934378,2781463875.529208,21.71823830817072,39.017678513478856,46.67120088649204,100,28.571428571428573
2007-08-31,48.86,49.06,48.61,48.87,45.68751910553517,47.11821883622364,47.738288109738306,47.730093797040816,45.64395015000001,47.34990010000007,48.16940019999997,47.45000050000004,47.45000050000004,49.27865236410335,45.62134863589672,94645184,57.376821760743134,46.264906193455424,NaN,NaN,NaN,NaN,NaN,NaN,0.2247967793399436,0.00956964360417345,-0.21522713573577015,97.76733254994119,96.89345334527896,5974579562,2796186459.7069845,22.852635165135606,37.016343944552304,45.91781714291296,100,21.428571428571427
2007-09-04,48.92,50,48.91,49.67999,45.72724518408706,47.1689469780806,47.81443328190543,47.915798197322644,45.67270015000001,47.40110000000007,48.21720019999997,47.53550000000004,47.53550000000004,49.598317907646496,45.47268209235359,98453632,61.54409458423583,47.85827156044665,NaN,NaN,NaN,NaN,61.54409458423583,NaN,0.30105776162114667,0.16109506629066317,-0.1399626953304835,96.61365079365075,96.4582541166556,6073033194,2836830648.080709,27.605139878664897,34.10053087791148,43.649131870010294,100,14.285714285714286
2007-09-05,49.55,49.64999,48.87,49.17999,45.761600853897136,47.20876961217801,47.86798452575228,48.03619741662525,45.69805010000001,47.44640000000007,48.25899999999997,47.578999500000045,47.578999500000045,49.73968187279931,45.41831712720078,113989680,57.788143912942814,49.519235354644785,NaN,NaN,NaN,NaN,NaN,NaN,0.3024419038236956,0.23808968444913603,-0.0643522193745596,91.32264550264547,95.2345429487458,5959043514,2813446388.414815,26.022778349542865,32.42891679058149,40.837432104505766,92.85714285714286,7.142857142857143
2007-09-06,49.23,49.36,48.81,49.14,45.795216765798656,47.24701179807548,47.9178674855267,48.14132147218475,45.72225010000001,47.487200000000065,48.30539979999997,47.59399950000004,47.59399950000004,49.79331038664804,45.39468861335204,99211056,57.48596690499591,51.309723381353415,NaN,NaN,NaN,NaN,NaN,NaN,0.2854895715051816,0.2925097450069174,0.00702017350173581,80.50328723645434,89.47986117758352,5859832458,2833288599.6148148,24.975880547821998,31.56317301387423,36.43387512034064,85.71428571428571,0
2007-09-07,48.53,48.60001,47.95,48.23,45.81944346464643,47.26647691098487,47.93010797629036,48.14976704626239,45.74190010000001,47.51790000000006,48.319199999999974,47.61999900000004,47.61999900000004,49.83640873651141,45.403589263488676,152405808,50.956244011883314,52.09333640626172,NaN,NaN,NaN,NaN,NaN,NaN,0.20176026728588609,0.25922050760909343,0.057460240323207346,54.84693877551015,75.55762383820331,5707426650,2812184236.9464235,22.835323759836164,35.05185627500286,33.45351365766792,78.57142857142857,0
2007-09-10,48.62,48.75,47.81,48.2,45.84313059435144,47.28496251670794,47.94069197722015,48.15455113709454,45.76095010000001,47.54980010000006,48.33279999999997,47.66599900000004,47.66599900000004,49.8904469063586,45.441551093641486,125186320,50.75157739940529,52.73406323138552,NaN,NaN,50.75157739940529,NaN,NaN,NaN,0.13626537094588262,0.22779195400556063,0.09152658305967801,50.13850415512472,61.82957672236307,5582240330,2790875927.1591897,22.367878395670367,32.66997391222052,30.44630617960801,71.42857142857143,0
2007-09-11,48.50999,48.98849,48.42999,48.92999,45.87384561331312,47.31753731835729,47.979487978113475,48.22840245737125,45.78335005000001,47.58760010000006,48.35939959999998,47.73249800000004,47.73249800000004,50.02359899299252,45.441397007007566,103033056,55.441449382118584,53.43131090199687,NaN,NaN,NaN,NaN,NaN,NaN,0.1338230088775197,0.25880534415657763,0.12498233527905794,67.47680084133987,57.48741459065824,5685273386,2872324618.6972375,22.82353242057943,30.78051198520552,27.619848334617597,64.28571428571429,0
2007-09-12,48.84,49.37,48.78,48.94,45.90435461218563,47.3496652922512,48.017155116226675,48.296173651907324,45.80440005000001,47.623000200000064,48.37799979999997,47.83999850000005,47.83999850000005,50.145831598920324,45.534165401079775,93994816,55.50402299922221,53.799024094744944,NaN,NaN,NaN,NaN,NaN,NaN,0.12477633511319303,0.2809527541705492,0.1561764190573562,67.78105708527985,61.79878736058148,5779268202,2829310041.8836775,24.686607402834017,29.409873206363883,24.984328058083754,57.142857142857146,28.571428571428573
2007-09-13,49.28999,49.35001,48.94,49.17999,45.93694799912905,47.38590934586999,48.062756484217786,48.380346637439956,45.82705005000002,47.660100100000065,48.395399599999976,48.003998500000044,48.003998500000044,50.19846224499042,45.80953475500967,80732688,57.0609089617643,54.34442317480871,NaN,NaN,NaN,NaN,NaN,NaN,0.12645684412966324,0.3142474742194352,0.18779063008977198,75.07560813254743,70.11115535305571,5860000890,2843087428.2385464,23.890450551697388,28.46138839991704,22.51309587007061,50,21.428571428571427
2007-09-14,48.8,49.31,48.73,49.22,45.96961518321732,47.422227972684446,48.10813858287591,48.460313624350434,45.85485005000001,47.69530010000006,48.40659959999997,48.19249850000004,48.19249850000004,50.106837129939144,46.27815987006094,99782624,57.328967286172286,54.57286413261487,NaN,NaN,NaN,NaN,NaN,NaN,0.1217223712959083,0.33994359420965736,0.21822122291374907,76.29172125143236,73.04946215641988,5959783514,2911903030.997166,22.77165667328599,28.824111869140665,20.689642212476734,42.857142857142854,14.285714285714286
2007-09-17,48.99001,49.10001,48.59,48.81,45.9978777187077,47.44970860688871,48.135662560018034,48.49361708869801,45.88005005000001,47.72030010000006,48.40559959999997,48.31749850000004,48.31749850000004,50.040778480177295,46.59421851982279,84877184,53.63395199938921,54.71395683682881,NaN,NaN,NaN,NaN,NaN,NaN,0.084219284205891,0.3234953281711128,0.2392760439652218,63.82967729385206,71.73233555927727,5874906330,2900251785.625821,21.589008209633935,28.48124201297913,19.011517215343254,35.714285714285715,7.142857142857143
2007-09-18,49.09,52.77,48.83,50.03999,46.03809774140712,47.5010013077424,48.210342067468304,48.6408906992982,45.90989995000002,47.75520000000006,48.428599399999975,48.49299800000004,48.49299800000004,50.16657465139376,46.819421348606326,151412192,61.624835183034584,55.97595411678982,NaN,NaN,NaN,NaN,NaN,NaN,0.13261181602959282,0.4050408140022128,0.27242899797262,52.2725524475525,64.1313169976123,6026318522,2841838191.695913,40.07990955841719,21.072853971133974,18.011984167567803,100,0
2007-09-19,50.28999,50.59,49.98,50.17,46.0792111967165,47.55385276699503,48.28719139815582,48.78652015650789,45.94055000000001,47.79119990000006,48.462399399999974,48.65049800000004,48.65049800000004,50.3328048471867,46.96819115281338,126863120,62.363193762677,56.65514734919087,NaN,NaN,NaN,NaN,NaN,NaN,0.16180483823118108,0.4746850457615963,0.31288020753041523,48.20717131474104,54.76980035204852,6153181642,2794004556.286078,38.42198806013759,20.201166933568977,17.504620354613156,92.85714285714286,0
2007-09-20,50.06,50.25999,49.92,50.03,46.118522528092456,47.60288538547037,48.35553683352226,48.904946808269045,45.972400000000015,47.83189980000006,48.486799399999974,48.768998000000046,48.768998000000046,50.48899079768571,47.04900520231438,109953008,61.00207003373587,57.13301772730864,NaN,NaN,NaN,NaN,NaN,NaN,0.15983343993146137,0.512672007444742,0.3528385675132806,44.758064516129004,48.4125960928075,6043228634,2755199704.8789186,37.49112312130896,20.13930010554874,17.62074478808658,85.71428571428571,0
2007-09-21,50.28,50.52,50.0143,50.36,46.16072628403183,47.65748171447096,48.43414323220766,49.04352330271961,46.002900050000015,47.874399800000056,48.50279939999998,48.91049800000005,48.91049800000005,50.66478431873202,47.156211681268076,86835632,63.04928161960547,57.53819343151309,NaN,NaN,NaN,NaN,NaN,NaN,0.1680621398268446,0.5629162422968363,0.39485410246999175,51.41129032258058,48.125508717816864,6130064266,2787086944.0768614,38.01132286062328,19.386936929552693,18.24858811782339,78.57142857142857,35.714285714285715
2007-09-24,50.49001,50.96001,50.33,50.59,46.204798659315095,47.71555138349134,48.518686634866185,49.1908067976987,46.033750050000016,47.916099800000055,48.51659959999997,49.02999800000005,49.02999800000005,50.896434015535974,47.163561984464124,107181184,64.45002647732056,57.74575999530486,NaN,NaN,NaN,NaN,NaN,NaN,0.17548788762247824,0.6142139619980895,0.4387260743756113,56.048387096774206,50.73924731182792,6237245450,2768371364.876787,39.5305590923936,18.461616693508628,20.091749205474066,71.42857142857143,28.571428571428573
2007-09-25,50.42,51.07001,50.36,51.07001,46.253208722406484,47.78197630659052,48.6187385315381,49.36977853125121,46.06780015000002,47.96089990000006,48.54099959999997,49.18949850000004,49.18949850000004,51.17687175988831,47.202125240111776,101038064,67.24110779647941,58.42097170127175,NaN,NaN,NaN,NaN,NaN,NaN,0.197576172365448,0.6856962898324213,0.48812011746697326,65.72600806451614,57.72856182795696,6338283514,2869409428.876787,38.21435346096448,17.450739487978954,21.97326678771867,64.28571428571429,21.428571428571427
2007-09-26,51.36,51.50999,51.12,51.32001,46.30362465551687,47.852036379727345,48.72467074598759,49.55551486160824,46.105900200000015,48.00780000000005,48.56279979999997,49.41849850000004,49.41849850000004,51.27529831207489,47.561698687925194,96099936,68.62283197937235,59.216462063727214,NaN,NaN,NaN,NaN,NaN,NaN,0.21256772990401207,0.7538297798469884,0.5412620499429763,70.76633064516129,64.18024193548386,6434383450,2871880985.475881,40.39247890498418,16.835549685413532,24.08129541514975,57.142857142857146,14.285714285714286
2007-09-27,51.62,51.64999,51.36,51.58,46.35612590272566,47.92585744151492,48.83664444222337,49.7483229700265,46.14430025000002,48.05730000000005,48.59099979999997,49.593498500000045,49.593498500000045,51.568671313228776,47.618325686771314,73419680,70.0381750805009,60.579457140057045,NaN,NaN,NaN,NaN,NaN,NaN,0.2224783677058122,0.8193600095752416,0.5968816418694294,76.00806451612894,70.83346774193545,6507803130,2909860523.379945,40.448799101513224,16.36946050102476,25.600976832571032,50,7.142857142857143
2007-09-28,51.53999,51.67999,51.17999,51.41,46.40641320717615,47.99485036346512,48.9375603464499,49.90657792526207,46.18105025000002,48.10410000000005,48.612799599999974,49.74749850000005,49.74749850000005,51.78393987900343,47.71105712099667,75434560,67.88202138077605,61.80306028158352,NaN,NaN,NaN,NaN,NaN,NaN,0.20073682097255485,0.847802668085123,0.6470658471125681,68.66366667357899,71.81268727828973,6432368570,2903828775.9623446,38.700462887068745,17.218046381199557,27.0080598486003,42.857142857142854,0
2007-10-01,51.45,52.16,51.38,52,46.46207078720425,48.07416025725789,49.057656019138136,50.105951456189494,46.222050250000024,48.155800000000056,48.65179959999997,49.90399850000004,49.90399850000004,52.11982258329675,47.68817441670333,100370624,71.19624478255959,62.92840281018645,NaN,NaN,NaN,NaN,NaN,NaN,0.20833993066494538,0.9074907604437499,0.6991508297788045,81.57894736842097,75.41689285270962,6532739194,2963021708.0649095,40.246667647436354,16.052395605003156,29.01738586144666,35.714285714285715,0
2007-10-02,52.03999,52.06,51.72,52.00999,46.51727396345097,48.15209747988644,49.17343382230919,50.28728846036192,46.26270020000002,48.213999900000054,48.69059919999996,50.020498500000045,50.020498500000045,52.414781575602845,47.626215424397245,71035936,71.25034069336671,64.05313978833962,NaN,NaN,NaN,NaN,NaN,NaN,0.19644740289514062,0.9447100833977302,0.7482626805025896,81.81794258373203,77.35351887524398,6603775130,3013160543.1274977,39.007025272851145,15.557963867700433,31.46334061479465,28.571428571428573,21.428571428571427
2007-10-03,51.84,52.07001,51.5,51.64999,46.56834576480966,48.22136267830453,49.270553672414714,50.41706955937507,46.299100150000015,48.26269980000006,48.73699899999997,50.143998500000045,50.143998500000045,52.605977388642216,47.68201961135787,106743440,66.41005639765547,64.72093603376042,NaN,NaN,66.41005639765547,NaN,NaN,NaN,0.1488991724101384,0.9343866460152626,0.7854874736051242,73.20550239234448,78.86746411483249,6497031690,2962593130.094043,36.95210977992564,16.77161282073954,33.52278961621931,21.428571428571427,14.285714285714286
2007-10-04,51.75,51.83,51.34,51.77,46.62010351839365,48.2916327242787,49.36857117545728,50.54592007752983,46.335800200000016,48.31579970000005,48.78439919999997,50.27549850000004,50.27549850000004,52.78932916774983,47.761667832250254,84114320,67.20975835865794,65.42670682465226,NaN,NaN,NaN,NaN,NaN,NaN,0.11178894051673649,0.9252236492510448,0.8134347087343083,76.07655502392345,77.03333333333332,6581146010,3026108024.787922,35.23377190827603,17.510128007324045,35.08512422755139,14.285714285714286,7.142857142857143
2007-10-05,52.17,52.89999,52.06,52.81799,46.68177403064844,48.3812635614217,49.50384250190993,50.762307689193655,46.37994010000001,48.382979500000054,48.86115899999997,50.50489800000005,50.50489800000005,53.067101716828674,47.94269428317142,115667680,73.20827591763017,66.82487281881232,NaN,NaN,NaN,NaN,NaN,NaN,0.1421331496620193,0.9911011458118324,0.8489679961498131,97.98525303501972,82.42243681709587,6696813690,3119192698.4187984,41.38932415846223,15.697296699035764,37.31656793056437,100,0
2007-10-08,52.8,53.16,52.71001,53.14999,46.746134388552434,48.4756937879282,49.64682867830562,50.98970600450855,46.42644000000002,48.448979400000056,48.96435859999997,50.75239750000004,50.75239750000004,53.33244696777067,48.172348032229415,63004256,74.78216029888131,67.76468175565851,NaN,NaN,NaN,NaN,NaN,NaN,0.16714904274037123,1.0579042995752772,0.890755256834906,99.69104938271623,91.25095248055311,6759817946,3179393902.784053,42.086183489922405,15.02996907194738,38.48008527571893,100,0
2007-10-09,53.27,53.45,53.03,53.3801,46.81214399662654,48.57281074262269,49.79323147523481,51.217362575507735,46.47489050000002,48.51948040000005,49.06096059999996,50.97490300000005,50.97490300000005,53.65358751530046,48.29621848469964,94197056,75.84147423169091,68.72741607487379,NaN,NaN,NaN,NaN,NaN,NaN,0.18063052783707134,1.1165434166312451,0.9359128887941738,98.0198300283285,98.56537748202147,6854015002,3242236795.858337,43.191065703094594,14.414039498887934,39.828257932678234,100,7.142857142857143
2007-10-10,53.39,53.57001,53.21001,53.50999,46.87878923049095,48.67057666851135,49.938986711500114,51.435708044506995,46.525540450000015,48.587480200000044,49.18056039999996,51.20340250000005,51.20340250000005,53.92804372815123,48.478761271848875,91766560,76.44301007252412,69.83034036335867,NaN,NaN,NaN,NaN,76.44301007252412,NaN,0.17936824796508166,1.1601231987505258,0.9807549507854442,98.31201082202988,98.67429674435819,6945781562,3303404306.240559,42.831862501201705,13.888662228816836,41.322468454897454,100,0
2007-10-11,53.78999,53.94,52.28,52.66,46.936313715759695,48.74957515032301,50.045693114970696,51.55230727836347,46.574190500000014,48.64398030000004,49.275760599999956,51.37740300000004,51.37740300000004,54.0057219974803,48.74908400251977,239746880,65.0316225769059,69.971936146023,NaN,NaN,NaN,NaN,NaN,NaN,0.1059885637003859,1.1132406554109266,1.0072520917105408,64.54293628808861,86.958259046149,6706034682,3173421058.0477867,36.26748840252937,20.34639464820878,41.01351087459432,100,0
2007-10-12,52.89999,53.53999,52.8,53.53,47.00192253450835,48.84423702853444,50.18233260065812,51.740658966138376,46.62629050000001,48.70878030000004,49.37956059999996,51.59290300000005,51.59290300000005,54.184843774884904,49.000962225115195,131652880,69.97255752869962,70.36640264969292,NaN,NaN,NaN,NaN,NaN,NaN,0.10077794602576096,1.133224524242742,1.032446578216981,88.54748603351965,83.80081104787938,6837687562,3301519262.2516265,33.349583644926064,18.70942323499279,40.427195104032194,92.85714285714286,0
2007-10-15,53.61,53.71001,52.7,53.12,47.062798927199815,48.92890560222683,50.297535243769566,51.8720247788871,46.67524050000001,48.77168030000004,49.49356059999995,51.80840300000004,51.80840300000004,54.14290320529298,49.4739027947071,121523440,65.29053830864417,70.2270762577047,NaN,NaN,NaN,NaN,NaN,NaN,0.05665122481326201,1.1032606092335584,1.0466093844202964,70.92198581560282,74.67080271240368,6716164122,3281063821.1823297,31.85569025745998,17.017140810955908,39.931523030907805,85.71428571428571,0
2007-10-16,52.78999,53.28,52.67999,52.87,47.12058202245156,49.00694707545006,50.39841621460213,51.96707003804071,46.723990500000006,48.838780300000046,49.59156059999996,51.94990350000005,51.94990350000005,54.17919539943305,49.72061160056705,193617376,62.542507672248476,69.7927673786244,NaN,NaN,NaN,NaN,NaN,NaN,0.0005275460854621272,1.047268817027124,1.046741270941662,61.23202452165029,73.56716545692423,6522546746,3210075193.415725,30.11313744619582,16.268704672958936,39.123347901032055,78.57142857142857,0
2007-10-17,53.62,53.66,52.67999,53.55,47.18455633068587,49.09690851950055,50.52200773559812,52.11782527251302,46.77594050000002,48.90978030000005,49.69636059999996,52.118903500000044,52.118903500000044,54.294667467179835,49.943139532820254,183967872,66.65374017372893,69.55102202814071,NaN,NaN,NaN,NaN,NaN,NaN,-0.0008242722481632825,1.0457109306314578,1.046535202879621,85.86961641443327,72.67454225056211,6706514618,3352744576.7880583,30.873421346614467,14.840758822944219,38.60134449562769,71.42857142857143,7.142857142857143
2007-10-18,53.33,53.89,53.12,53.78,47.25018263585318,49.18964300426292,50.64977213812369,52.276127627511784,46.82864045000001,48.97948030000004,49.79516059999996,52.306403500000044,52.306403500000044,54.37339856310003,50.23940843690006,144491120,67.93565541917732,69.55485303088365,NaN,NaN,NaN,NaN,NaN,NaN,0.0035086449220755878,1.0509210090322156,1.04741236411014,93.84615384615397,80.31593159407917,6851005738,3455952519.6452017,30.80405992048013,13.814759678127112,38.57699962696648,64.28571428571429,0
2007-10-19,53.77,53.77,52.39,52.44,47.30182260962578,49.254006509129,50.71997715231492,52.29173452012971,46.870540450000014,49.03198030000004,49.88976039999996,52.410403500000044,52.410403500000044,54.274559308638345,50.54624769136174,245090256,54.733935750339526,68.37897381429649,NaN,NaN,54.733935750339526,NaN,NaN,NaN,-0.08902422360859763,0.936132084599393,1.0251563082079906,42.30769230769218,74.00782085609313,6605915482,3228622427.1234617,27.1544928754947,18.400194788490314,36.88003982406333,57.142857142857146,21.428571428571427
2007-10-22,52.16,53.1185,52.02,53.07001,47.35921750903249,49.3295709346908,50.81213530320453,52.36585599440307,46.91664045000002,49.08858040000005,50.00556059999996,52.53440400000005,52.53440400000005,54.21898547600001,50.849822524000096,206904944,58.788791551707725,67.48886316132085,NaN,NaN,NaN,NaN,NaN,NaN,-0.11149562403200053,0.88578677816799,0.9972824021999905,66.53884615384631,67.5642307692308,6812820426,3417260970.1502094,24.667219455752964,19.799991110732833,34.59226137749304,50,14.285714285714286
2007-10-23,53.61,54.21001,53.34,54.17999,47.42708589202719,49.42561883697415,50.94420803641219,52.538630661602774,46.96814040000001,49.15598030000004,50.13716019999996,52.68990300000005,52.68990300000005,54.37922111465761,51.00058488534249,162288688,64.7756390512896,67.37211906515184,NaN,NaN,NaN,NaN,NaN,NaN,-0.057991180436560485,0.9247934266542899,0.9827846070908504,98.95401061320344,69.26684969158065,6975109114,3568350002.0226703,31.267874236240466,17.961298863050462,33.83986015252804,100,7.142857142857143
2007-10-24,53.74001,53.94,52,53.77,47.490199465240856,49.51164618673704,51.055023407533284,52.65590393192632,47.01649035000001,49.21787940000004,50.276760399999965,52.81240250000004,52.81240250000004,54.440828648803475,51.183976351196605,298323712,61.23697473143832,66.94549166320758,NaN,NaN,NaN,NaN,NaN,NaN,-0.05654010189428027,0.912109479723,0.9686495816172803,80.09013533875438,81.86099736860137,6676785402,3814390176.8680325,26.24817694422469,24.94582652805316,31.621341598950682,92.85714285714286,0
2007-10-25,53.88,53.98,52.75,53.05,47.54552086359667,49.58171259888086,51.13325778370845,52.69343689079048,47.05864035000001,49.27257940000004,50.41976059999996,52.88590250000004,52.88590250000004,54.41485313756335,51.35695186243674,233618128,55.50261394610737,65.68080152238453,NaN,NaN,NaN,NaN,NaN,NaN,-0.10744637969205728,0.8343416070022087,0.941787986694266,47.51109723485408,75.51841439560395,6443167274,3694732111.307056,24.204339662156666,22.72870659045839,28.631254770714083,85.71428571428571,92.85714285714286
2007-10-26,54.08,54.2,53.44,53.92999,47.609047919680286,49.66781710187332,51.242933556896354,52.81120385357234,47.10289030000002,49.34117920000004,50.58936039999996,53.01190200000004,53.01190200000004,54.44597056869992,51.577833431300164,146681056,60.38528779637172,64.65245348649098,NaN,NaN,NaN,NaN,NaN,NaN,-0.08614812694732488,0.8341028280101099,0.9202509549574348,87.32946909742486,71.64356722367778,6589848330,3737188556.963475,23.787577529710422,20.86180832349104,25.715701329575023,78.57142857142857,85.71428571428571
2007-10-29,54.19,54.33,53.84,54.16,47.67423152246954,49.75677121866791,51.35732831937101,52.93966062942259,47.14714030000002,49.41938020000005,50.74636039999996,53.119902000000046,53.119902000000046,54.558211191979574,51.68159280802052,101883568,61.572210092225966,63.633220333672064,NaN,NaN,NaN,NaN,NaN,NaN,-0.061993819016245455,0.8427586811871279,0.9047525002033734,92.70386266094413,75.84814299774102,6691731898,3768377404.3104124,23.887208056606315,20.10408078042968,22.76170360465448,100,78.57142857142857
2007-10-30,53.94,54.56,53.89999,54.25999,47.739761457569344,49.84594386780319,51.47115818919959,53.065406283763295,47.19204025000002,49.49288010000005,50.900960199999965,53.23240200000005,53.23240200000005,54.65777476939387,51.80702923060623,114600944,62.103774956956244,62.608989253988646,NaN,NaN,NaN,NaN,NaN,NaN,-0.045471875956173746,0.8479126552581562,0.8933845312143299,88.28085937499999,89.43806371112298,6806332842,3778793777.7449965,24.435789822795055,19.097878343818543,19.99269171144449,100,71.42857142857143
2007-10-31,54.47,55.07001,54.03999,55.03,47.8123011445587,49.948598444678375,51.61072061315255,53.25251044721441,47.242640250000015,49.57498000000005,51.06116019999997,53.40140250000004,53.40140250000004,54.83768555779351,51.965119442206564,148405680,66.00378646394475,62.67842953163428,NaN,NaN,NaN,NaN,66.00378646394475,NaN,0.008262891824234009,0.9037131459946224,0.8954502541703884,98.69674691613375,93.22715631735927,6954738522,3915670145.1941714,26.381649349327464,17.616076418185667,19.407016242057118,100,64.28571428571429
2007-11-01,54.67999,54.77,53.97,54,47.873870287398915,50.02882421805108,51.70441784400931,53.323699928432085,47.29224025000001,49.64958010000005,51.187960199999964,53.51290250000004,53.51290250000004,54.7589157391374,52.266889260862676,181936816,57.48205633827259,61.786250875175206,NaN,NaN,NaN,NaN,NaN,NaN,-0.032386193962722354,0.8549675117169855,0.8873537056797078,65.14636760140839,84.04132463084737,6772801706,3747378590.3941717,24.29270974147539,16.744030627749556,18.71220807576723,92.85714285714286,57.142857142857146
2007-11-02,54.42,54.55009,53.60001,54.42,47.93900590642977,50.115778193931256,51.8109112618913,53.4281094590576,47.34349025000002,49.723280100000046,51.32576019999996,53.593003000000046,53.593003000000046,54.85588428106837,52.33012171893172,217867184,59.76333158916765,61.3914503952126,NaN,NaN,NaN,NaN,NaN,NaN,-0.03745293117751225,0.8405375417078176,0.8779904728853298,78.82710479770421,80.8900731050821,6990668890,3905582710.30155,22.567852451110056,18.320228479328005,17.285555593262732,85.71428571428571,50
2007-11-05,53.86,54.39999,53.59,54.07001,48.000010922286194,50.194079813853406,51.89950336926811,53.48924284390926,47.39539030000002,49.790380200000044,51.44316039999996,53.63900400000004,53.63900400000004,54.90101025753016,52.376997742469925,150572944,57.01791774917983,60.99683682927912,NaN,NaN,NaN,NaN,NaN,NaN,-0.06900533507159157,0.7917338040458404,0.8607391391174319,67.4268161992958,70.46676286613611,6840095946,3933472509.914286,21.154707130836012,17.248577648290244,15.880021427626007,78.57142857142857,42.857142857142854
2007-11-06,54.33,54.69,53.78,54.67999,48.06647837579578,50.282909718529574,52.00854206066936,53.60264733496552,47.450890250000015,49.85988010000005,51.57916019999996,53.70399850000005,53.70399850000005,55.037822614386826,52.37017438561327,131861248,60.42974122033299,60.55226547546512,NaN,NaN,NaN,NaN,NaN,NaN,-0.054084092725592114,0.7931340232104418,0.8472181159360339,87.29580685404913,77.84990928368303,6971957194,4062432810.458286,21.892339258073477,16.061114215297565,14.472351320085249,71.42857142857143,35.714285714285715
2007-11-07,54.22,54.58,53.31,53.35001,48.119050829767964,50.343644377568594,52.06114864652547,53.578586636397375,47.496140300000015,49.91568020000004,51.711360199999966,53.69599950000004,53.69599950000004,55.03628474729953,52.35571425270055,197763744,50.93598623863561,59.33800339114072,NaN,NaN,NaN,NaN,NaN,NaN,-0.13449671195272972,0.6790972259951218,0.8135939379478515,43.97412386278859,66.2322489720445,6774193450,3877129739.525119,19.694150888227995,17.893147660895746,12.094850340656608,64.28571428571429,28.571428571428573
2007-11-08,53.14,53.33,50.8,51.73,48.154980672257835,50.37109696415139,52.048162425093096,53.40253076626429,47.536140300000014,49.955380300000044,51.784360199999966,53.64949950000005,53.64949950000005,55.18119377697772,52.11780522302237,380564736,42.23253162137515,58.44504595335754,NaN,NaN,NaN,NaN,NaN,NaN,-0.2886498781392629,0.45278159027377285,0.7414314684130358,21.779808478200245,51.016579731679315,6393628714,3776347773.8650393,16.394423537781574,31.38714957143639,12.963458461889875,57.142857142857146,100
2007-11-09,50.73,51.12,50,50,48.1733390735289,50.36374850941572,51.967842329991406,53.07848021709626,47.56829025000002,49.98228030000004,51.81776019999997,53.472999500000036,53.472999500000036,55.682612962154074,51.263386037846,309385728,35.29649173516363,56.76702453789011,NaN,NaN,NaN,NaN,NaN,NaN,-0.487302640253781,0.13230316809580955,0.6196058083495906,0,21.917977446996264,6084242986,3466962045.8650393,14.606401259533408,33.00734612102618,14.942074800222745,50,100
2007-11-12,49.92,50.24001,48.64999,48.73,48.17887798822016,50.331397053783725,51.84086812097213,52.664339244039475,47.593890250000015,49.992180200000035,51.81496019999996,53.253499500000046,53.253499500000046,56.28070246216297,50.22629653783712,283136768,31.2402711736125,54.371641118056026,NaN,NaN,31.2402711736125,NaN,NaN,NaN,-0.67296639430291,-0.221602184529047,0.45136420977386305,1.2462577998198503,7.6753554260066865,5801106218,3212320231.1457257,13.183281442871653,38.06382056145039,16.47923774004835,42.857142857142854,100
2007-11-13,49.39,50.78999,49.35001,50.74001,48.20436188883488,50.339488399253355,51.797697214267345,52.481069792226194,47.62944030000001,50.02668040000004,51.83616059999996,53.147000000000034,53.147000000000034,56.364561300139556,49.92943869986051,255280688,42.50236590895853,53.033454773593185,NaN,NaN,NaN,NaN,NaN,NaN,-0.6298996869151885,-0.33601039887012263,0.29388928804506587,32.55472724384029,11.26699501455338,6056386906,3449879938.5956607,14.800628843725864,33.508670908685026,19.06363766636817,35.714285714285715,92.85714285714286
2007-11-14,51.39,51.44,49.89999,50.09,48.22312445710518,50.334548034911705,51.73072869606078,52.25334885963322,47.65954025000002,50.05668040000004,51.85436079999996,52.97400000000003,52.97400000000003,56.448126180805346,49.49987381919472,263213632,40.20879294684918,51.94103898793189,NaN,NaN,NaN,NaN,NaN,NaN,-0.6140473788160596,-0.4736699354750087,0.14037744334105096,22.429992429930135,18.743659157863423,5793173274,3251618121.475201,17.209179638569754,30.56395788559977,20.835812855798576,28.571428571428573,85.71428571428571
2007-11-15,50,50.53999,49.37,49.82001,48.23901386549219,50.324359162933256,51.65579855111722,52.02160230157291,47.688540300000014,50.086680400000034,51.86796099999996,52.776000500000045,52.776000500000045,56.487110966716195,49.064890033283895,251009008,39.261085951097,50.432167427555115,NaN,NaN,NaN,NaN,NaN,NaN,-0.5904320063564221,-0.5976625646044766,-0.007230558248054575,18.224553817589367,24.4030911637866,5542164266,3193698906.8752832,16.05483642978379,31.552321316343036,22.692961539360404,21.428571428571427,78.57142857142857
2007-11-16,50.14,50.49001,49.34,50.28,48.25932218523854,50.32348076366725,51.60184566675969,51.85573541570883,47.71914030000002,50.114080500000036,51.908960999999955,52.66800050000004,52.66800050000004,56.53440830675949,48.80159269324059,263611376,41.778873322847645,49.01835765831381,NaN,NaN,NaN,NaN,NaN,NaN,-0.5152575201898395,-0.651302458485354,-0.13604493829551448,25.389484767960198,22.0146770051599,5805775642,3361031076.4792356,14.990463098836646,29.63346978914383,24.422570534774913,14.285714285714286,71.42857142857143
2007-11-19,50.17,50.45,49.41,49.7,48.27365728787298,50.311134609931266,51.5272634837495,51.65042728087942,47.747040300000016,50.13588050000004,51.938960999999956,52.49950000000003,52.49950000000003,56.569515076158225,48.42948492384184,197784816,39.55253754276522,47.40755498587159,NaN,NaN,NaN,NaN,NaN,NaN,-0.4769029072819007,-0.7321735723978904,-0.25527066511598967,16.355244999236767,19.98976119492878,5607990826,3273549330.940776,14.081289271259422,27.836195417101194,25.890618706411942,7.142857142857143,64.28571428571429
2007-11-20,49.95,50.78,48.92999,49.89999,48.28983970291902,50.302993132506884,51.46344883732795,51.48371896841471,47.77629025000002,50.158880300000035,51.95836099999996,52.285500000000035,52.285500000000035,56.42899126222753,48.14200873777254,300708096,40.725454181899956,45.60195982286839,NaN,NaN,NaN,NaN,NaN,NaN,-0.4127727920052483,-0.77123665512255,-0.3584638631173017,20.424803227445704,20.723177664880893,5908698922,3288176668.933026,12.61552955753363,27.639475873786427,27.133414919609066,0,57.142857142857146
2007-11-21,49.42999,50.17,48.85001,49.31,48.29999055164619,50.28332990216021,51.378999863315094,51.27669811427998,47.80054020000002,50.17188040000005,51.96576099999996,52.062500000000036,52.062500000000036,56.34030035066576,47.784699649334314,212547680,38.36064538679657,44.236144754905816,NaN,NaN,NaN,NaN,NaN,NaN,-0.3853227831854887,-0.8401173420991626,-0.4547945589136739,10.927299789238765,15.902449338640414,5696151242,3223766182.8863144,11.681221949984087,26.041233416558846,28.538601573107055,0,50
2007-11-23,49.63,49.97,49.37241,49.84,48.31531402874424,50.27455109221645,51.31864692749882,51.13986972244379,47.82749020000002,50.187180400000045,51.97896119999995,51.90200000000003,51.90200000000003,56.25968342587649,47.54431657412357,46464848,41.63909144330021,42.94155617305814,NaN,NaN,NaN,NaN,NaN,NaN,-0.3099487554376724,-0.8422305032107644,-0.532281747773092,19.70211969847735,17.018074238387275,5742616090,3250015062.6137533,11.233252995074974,25.042565283369573,30.515681982462958,14.285714285714286,42.857142857142854
2007-11-26,49.98,50.37,48.89999,48.98,48.321927819503,50.248916417123056,51.226935283283176,50.93416784411581,47.85319020000003,50.19038040000004,51.974161199999955,51.654500500000026,51.654500500000026,56.08501389487198,47.223987105128074,150190880,38.09813234327459,41.5901429297792,NaN,NaN,38.09813234327459,NaN,NaN,NaN,-0.2964882289492199,-0.9028920339596169,-0.606403805010397,5.463732675939189,12.031050721218437,5592425210,3116173421.47444,10.286995707303463,25.64019682871374,32.84160096043502,7.142857142857143,35.714285714285715
2007-11-27,49.39,50.05,49.10001,49.96001,48.33822714468208,50.2431954979721,51.1772519388407,50.841390906580976,47.88449025000003,50.201380500000035,51.99716139999995,51.44450100000004,51.44450100000004,55.77714497846776,47.111857021532316,211323440,43.94777408602511,40.41285956304292,NaN,NaN,NaN,NaN,NaN,NaN,-0.204438612378963,-0.8619520704841008,-0.6575134581051378,22.09136240916955,15.752404927862033,5803748650,3287460658.2184057,9.649803660912504,24.0520043231452,34.79660518042942,0,28.571428571428573
2007-11-28,50.63,51.7,50.60001,51.48,48.36948856612803,50.26768667623008,51.189124411827336,50.90221082023993,47.92259025000002,50.227280500000035,52.025961599999945,51.305501500000034,51.305501500000034,55.4418497413994,47.169153258600666,214679056,51.589021838757446,40.45950496305163,NaN,NaN,NaN,NaN,NaN,NaN,-0.033030050614961004,-0.6988010213738391,-0.6657709707588781,60.47016993553425,29.341755006881,6018427706,3416267311.1601944,17.985323169362097,21.698284109867515,35.12266868418955,0,21.428571428571427
2007-11-29,51.27,51.89,51.2,51.7,48.402627983380484,50.29604931630473,51.20915874861842,50.97819074212184,47.95809020000002,50.25948050000004,52.05656159999995,51.139001500000035,51.139001500000035,54.91461214890556,47.36339085109451,171648256,52.59630198413037,41.199774274677,NaN,NaN,NaN,NaN,NaN,NaN,0.09624659789166135,-0.5454627233943015,-0.6417093212859628,94.1358205684551,58.899117637719634,6190075962,3493384643.5659924,18.36846040786206,20.82785168271524,33.329591250815554,0,14.285714285714286
2007-11-30,52.21001,52.25,50.95,51.31,48.431557058172714,50.31612754766503,51.21311330749613,51.00979162382452,47.99034020000003,50.284480500000036,52.08216159999996,51.00450150000003,51.00450150000003,54.547333754867424,47.46166924513264,171404000,50.5868810205424,42.29194493791834,NaN,NaN,NaN,NaN,NaN,NaN,0.15319074347105255,-0.4502208919471471,-0.6034116354181996,73.88896141955166,76.16498397451367,6018671962,3416912089.7198386,19.07023896733431,19.26020055063575,30.60454151043033,100,7.142857142857143
2007-12-03,51.14,51.53,50.82001,50.88,48.4559196745093,50.32729333880038,51.200050040535494,50.997430516793614,48.021190150000024,50.297680500000034,52.09256159999995,50.82750150000003,50.82750150000003,54.00497195779003,47.65003104221003,108386256,48.39167683674274,43.51704534242764,NaN,NaN,NaN,NaN,NaN,NaN,0.15891131207771025,-0.40477249532106185,-0.5636838073987721,59.705763840481985,75.91018194282958,5910285706,3326841842.3888054,18.261809179406075,19.219864692300575,27.31925044688906,92.85714285714286,0
2007-12-04,50.46001,50.94,50.38,50.67,48.47795032451418,50.33407960931918,51.179263764436065,50.96624665805137,48.049290150000026,50.30538060000003,52.09416159999994,50.65750100000004,50.65750100000004,53.4651524919255,47.84984950807458,113341312,47.31187830903034,43.860581942432766,NaN,NaN,NaN,NaN,NaN,NaN,0.14590374835950481,-0.3813041219493911,-0.5272078703088959,53.529275086103276,62.374666782045644,5796944394,3330889746.388806,17.62708202802568,21.28281377594324,25.224238148285757,85.71428571428571,42.857142857142854
2007-12-05,51.2,52,51.16,51.57001,48.50871708745434,50.35855347844158,51.19458714622289,51.02374792871314,48.08119020000003,50.32258060000003,52.10416159999994,50.50200200000003,50.50200200000003,52.67378424693507,48.330219753064995,137521680,52.2314453591682,44.719342829026985,NaN,NaN,NaN,NaN,NaN,NaN,0.19234533296682638,-0.286776204100363,-0.47912153706718935,80.0002352948098,64.41175807379835,5934466074,3327618695.000236,22.694670132819322,19.545279213879198,23.760050784806094,78.57142857142857,35.714285714285715
2007-12-06,51.63,52.37,51.61,52.32001,48.54664040001698,50.39739420164076,51.238721375782774,51.147201459311894,48.11569025000003,50.343480700000036,52.12416159999994,50.45050200000003,50.45050200000003,52.38565828105416,48.515345718945895,99763568,55.92469061780478,45.909600305220394,NaN,NaN,NaN,NaN,NaN,NaN,0.2636022657464162,-0.14961870488416906,-0.41322097063058527,98.57982551086809,77.36977863059371,6034229642,3414258103.0941324,23.877824595509285,18.56356862445915,22.32923308465604,100,28.571428571428573
2007-12-07,52.28999,52.53999,52.08,52.33,48.584285769171046,50.43566362339045,51.281516615948156,51.25984893937743,48.15104030000002,50.365080700000036,52.13916159999994,50.48050200000004,50.48050200000004,52.51035651500886,48.450647484991215,88992320,55.973518617611866,46.923503540560695,NaN,NaN,NaN,NaN,NaN,NaN,0.29885105955779256,-0.039657146183344594,-0.33850820574113716,94.30918324760556,90.96308135109449,6123221962,3421998668.5916424,24.2722886180164,18.003617789418445,21.04450119823371,100,21.428571428571427
2007-12-10,52.44,52.69,52.32001,52.53999,48.62364601027382,50.47733345263024,51.330868513361956,51.38176713562719,48.18854030000002,50.38728050000003,52.16176139999993,50.60750150000003,50.60750150000003,52.81156946404511,48.40343353595496,75657872,57.050599892315255,48.17336513695712,NaN,NaN,NaN,NaN,57.050599892315255,NaN,0.32176524018745606,0.0636983444931829,-0.25806689569427316,96.09347941010277,96.32749605619215,6198879834,3436306572.32915,24.6866270644889,17.54518809960988,19.908490294157456,100,14.285714285714286
2007-12-11,52.61,52.84,51.21001,51.32001,48.65047550270891,50.49402011693459,51.33044268930855,51.3758855036627,48.229190350000025,50.399980600000035,52.14816159999993,50.73700200000003,50.73700200000003,52.783307296905015,48.69069670309505,167064688,49.477388985135136,48.798503337188215,NaN,NaN,NaN,NaN,NaN,NaN,0.24375641222534009,0.04662861958740194,-0.19712779263793814,61.90491705493002,84.10252657087945,6031815146,3291790630.8613386,22.025758283360872,22.994127508405775,17.39627941424227,100,7.142857142857143
2007-12-12,52.25,52.42999,50.89,51.78,48.681615049945634,50.519485065114104,51.34807238776703,51.41437259855197,48.27144035000002,50.417080500000026,52.14356179999992,50.78900150000003,50.78900150000003,52.88521635829343,48.69278664170664,162975120,52.06135023542936,49.77712511209055,NaN,NaN,NaN,NaN,NaN,NaN,0.21323653986018104,0.06941788218728817,-0.14381865767289287,73.09651498346446,77.03163714949909,6194790266,3317190574.0760355,19.84896489543719,22.775307024092637,15.167557574296563,92.85714285714286,0
2007-12-13,51.33,51.63,50.98,51.5,48.70965868128946,50.53890120243857,51.354030333344795,51.422527589166066,48.313290350000024,50.43878050000003,52.14056199999992,50.859501500000036,50.859501500000036,52.95177750620199,48.76722549379808,153682064,50.37251166070832,50.400940841905424,NaN,NaN,NaN,NaN,NaN,NaN,0.16637128473422913,0.06414544824489354,-0.10222583648933559,65.98993403570034,66.99712202469829,6041108202,3409399812.4760346,18.80902238009178,21.582045299908543,12.93883573435086,85.71428571428571,7.142857142857143
2007-12-14,51.09,51.60001,50.92,50.97,48.73214963968459,50.54743781229128,51.33897032027245,51.3794297235312,48.355740350000026,50.45448060000003,52.124561999999926,50.917001000000035,50.917001000000035,52.9543344494172,48.879667550582866,128407936,47.24815848418984,51.05451413768508,NaN,NaN,NaN,NaN,NaN,NaN,0.09538420470558737,0.01700441939264863,-0.07837978531293874,49.999866309802925,63.02877177632259,5912700266,3299875118.781294,17.948221152289953,20.99814159595597,10.445755106206212,78.57142857142857,0
2007-12-17,50.78,50.9881,49.71001,49.73,48.74207849899121,50.53125092491917,51.27587344496765,51.22234117843299,48.393640400000024,50.46198060000004,52.06280219999992,50.88950100000004,50.88950100000004,52.974769041310964,48.80423295868911,134377504,40.86229324248213,50.83412264886059,NaN,NaN,40.86229324248213,NaN,NaN,NaN,-0.03252864902627366,-0.11904059659578081,-0.08651194756950716,0.6386601874127364,38.87615351097202,5778322762,3169701084.4977612,16.426572356984135,27.24418326959241,9.162657063025268,71.42857142857143,0
2007-12-18,50.24001,50.27,49.17999,49.89,48.75350060347886,50.518552886801956,51.221525466733624,51.09545154239176,48.428840350000016,50.48098050000003,51.99760239999992,50.89900100000004,50.89900100000004,52.964140154660335,48.83386184533975,154251632,41.95248150681168,50.14579833943589,NaN,NaN,NaN,NaN,NaN,NaN,-0.099997203005482,-0.21150845132635965,-0.11151124832087765,19.399127324788804,23.34588460733484,5932574394,3216402106.576751,15.239904982149422,28.788766293251445,10.692400247848045,64.28571428571429,100
2007-12-19,49.89,50.2,49.61,49.88,48.76470955269798,50.505908275182115,51.16891662490093,50.97969425264016,48.46484040000002,50.49428050000003,51.92760039999993,50.898001500000035,50.898001500000035,52.96509214728396,48.83091085271611,137971808,41.900491384393916,49.38181186802614,NaN,NaN,NaN,NaN,NaN,NaN,-0.13666471681032358,-0.28234214433378213,-0.14567742752345855,19.125904027584752,13.054563846595443,5794602586,3204709580.475057,14.624080659428007,27.625450476959113,12.442276447777797,57.142857142857146,92.85714285714286
2007-12-20,50.67,50.96001,50.2,50.89999,48.785956124312925,50.51371187369336,51.158370482747955,50.97210337143633,48.504490350000026,50.52798040000003,51.875400399999926,50.97750100000003,50.97750100000003,52.91224493657487,49.04275706342519,167342320,48.86177647166901,49.25859011453519,NaN,NaN,NaN,NaN,NaN,NaN,-0.08606152159573591,-0.25325432951812843,-0.16719280792239252,46.994407119106306,28.5064794904933,5961944906,3345620969.1809974,18.737154529339538,25.58719896453418,13.51075994802854,50,85.71428571428571
2007-12-21,51.71001,51.89999,51.48,51.85001,48.81644422257847,50.54017322272914,51.18549360107156,51.05571352653764,48.54909045000002,50.567480600000025,51.85920059999992,51.078001500000035,51.078001500000035,52.97439422940179,49.18160877059828,107613120,54.34827955254672,49.68406173709261,NaN,NaN,NaN,NaN,NaN,NaN,0.012319389885529441,-0.1517935705654807,-0.16411296045101015,72.95116680009059,46.35715931559389,6069558026,3427621556.7987957,23.89470783078833,23.83373284720488,13.337309243813749,42.857142857142854,78.57142857142857
2007-12-24,52.00999,52.39999,51.9501,52.24001,48.85050955369709,50.57383335693252,51.22684718534327,51.16850366686739,48.59424045000002,50.60648070000002,51.833400799999914,51.24100200000004,51.24100200000004,52.937987393025125,49.54401660697495,34499888,56.41555366325899,50.33432426239466,NaN,NaN,NaN,NaN,NaN,NaN,0.09972191189529239,-0.03946057058189467,-0.13918248247718706,83.60687539105074,67.85081643674921,6104057914,3437585260.0325637,26.508773615122877,22.90408357857586,13.187285446847728,35.714285714285715,71.42857142857143
2007-12-26,52.14999,52.63,52,52.5,48.88682289147125,50.61197527065663,51.27677474670236,51.29531284145145,48.64489045000003,50.65728070000002,51.82100079999992,51.368001500000034,51.368001500000034,53.042537562355626,49.69346543764444,58492080,57.78787205216383,50.73121188332292,NaN,NaN,NaN,NaN,57.78787205216383,NaN,0.16713738655968063,0.06973925072241371,-0.0973981358372669,90.71040789506031,82.42281669540056,6162549994,3471937751.461135,26.967895400318504,21.85258608724234,13.403131183029478,28.571428571428573,64.28571428571429
2007-12-27,52.33,52.5,51.71001,51.92999,48.917103161207855,50.63807457222779,51.302391031145405,51.35575828512274,48.689590350000024,50.69688060000002,51.80220059999992,51.39050100000004,51.39050100000004,53.08245359867142,49.698548401328665,65778880,53.789087202463335,50.5786687822271,NaN,NaN,NaN,NaN,NaN,NaN,0.16514173569970583,0.10902903378736539,-0.05611270191234044,75.13640673112901,83.1512300057467,6096771114,3442792342.8276076,25.393603083555927,22.71979717135034,12.905695564486658,21.428571428571427,57.142857142857146
2007-12-28,52.03999,52.16,51.42999,51.86,48.94638571681773,50.66227111535199,51.324258049531856,51.40378130558724,48.73444035000002,50.73238060000001,51.76840059999992,51.39850100000003,51.39850100000003,53.097728922368454,49.69927307763161,67559872,53.30137018326575,50.38780103691666,NaN,NaN,NaN,NaN,NaN,NaN,0.15127886823545397,0.13298588338197703,-0.01829298485347694,73.22411687399756,79.6903105000623,6029211242,3454824313.5659814,23.999386149668123,23.57842188289864,11.90975217689198,14.285714285714286,50
2007-12-31,51.56,51.67999,51.21001,51.22,48.969008744511086,50.67331525168166,51.320169498569825,51.38627832410274,48.77639035000002,50.756180600000015,51.71720059999991,51.39400100000004,51.39400100000004,53.09461870193994,49.693383298060134,70137744,48.932216797673746,49.807916530156554,NaN,NaN,NaN,NaN,NaN,NaN,0.0939830720356406,0.09918585519107381,0.0052027831554332105,55.73782585293479,68.03278315268712,5959073498,3387668296.714201,22.7990961032241,24.091817857027543,10.898807752629025,7.142857142857143,42.857142857142854
2008-01-02,51.27,51.47,50.13,50.45,48.983744975908984,50.66889316748994,51.28604520450826,51.29710895990248,48.81229035000002,50.783580500000014,51.67740059999991,51.372501000000035,51.372501000000035,53.1090607427539,49.635941257246174,152344496,44.23421990252683,49.43340445282739,NaN,NaN,NaN,NaN,NaN,NaN,0.003957395125348295,0.01014952706211858,0.006192131936770285,36.8117773571672,55.25790669469986,5806729002,3308085351.0425596,20.52054974467609,29.739033467853414,12.05529076654204,0,35.714285714285715
2008-01-03,50.39999,50.75999,50.14999,50.62,49.0000261204273,50.66792498595549,51.25992578472363,51.23262239229272,48.847490350000015,50.81698050000002,51.62840039999991,51.37000100000004,51.37000100000004,53.11073784402667,49.6292641559734,114105504,45.47880915632671,48.9632229471772,NaN,NaN,NaN,NaN,NaN,NaN,-0.04188385790247857,-0.046162690441327925,-0.004278832538849357,41.739299306378776,44.7629675054936,5920834506,3369818299.288591,19.56210822924831,28.35002953477497,12.875026997087213,64.28571428571429,28.571428571428573
2008-01-04,49.78999,49.83,48.21001,48.39999,48.994055611766335,50.6230153822732,51.14777144022466,50.96284787874103,48.86739030000002,50.82498030000002,51.51280039999992,51.211500000000036,51.211500000000036,53.376186314493765,49.04681368550631,212658560,34.61440660994381,47.83764401497974,NaN,NaN,NaN,NaN,NaN,NaN,-0.210057488718981,-0.2668506934375756,-0.05679320471859461,4.298199769682858,27.61642547774295,5708175946,3207037668.4471674,16.31913197091103,36.99494540360598,15.15472100033317,57.142857142857146,100
2008-01-07,48.41,48.60001,47.42999,48.17,48.9858560534403,50.57444082024799,51.030996089627614,50.69686236647998,48.88694035000001,50.838780400000026,51.400800399999916,51.003999500000035,51.003999500000035,53.477463988554035,48.530535011446034,235083568,33.715801349676994,46.87104707680025,NaN,NaN,NaN,NaN,NaN,NaN,-0.31861355348280557,-0.4550601465721016,-0.13644659308929602,14.230934171280524,20.089477749114057,5473092378,3269323702.942306,15.01749924539578,39.36164144758688,17.793031581790967,50,100
2008-01-08,48.28999,48.75999,46.92,46.92,48.96530027181403,50.50207565549061,50.86978055670104,50.33716118871998,48.90094035000001,50.848980500000025,51.27820039999992,50.733499500000036,50.733499500000036,53.70157977083759,47.76541922916248,261700000,29.26848474552075,46.042917898445864,NaN,NaN,29.26848474552075,NaN,NaN,NaN,-0.4484802650670589,-0.6970469244231197,-0.24856665935606076,0,6.176377980321132,5211392378,3007623702.942306,13.230318182552855,37.97585243655155,19.47549316867948,42.857142857142854,100
2008-01-09,47.09,47.96001,46.46001,47.92,48.95489927408454,50.45094544449079,50.7541028878108,50.10695536122284,48.91904035000002,50.87368050000003,51.158000599999916,50.50250000000004,50.50250000000004,53.589008013940294,47.41599198605979,254110752,36.48631318592521,45.65247730409682,NaN,NaN,NaN,NaN,NaN,NaN,-0.4402843287746442,-0.798922070324366,-0.35863774154972183,23.662761203826967,12.631231791702499,5465503130,3248178493.3589478,11.978780261211458,37.28436812018657,20.946591451879204,35.714285714285715,100
2008-01-10,47.42,48.41,47.28999,47.99001,48.94529838578519,50.40221404955038,50.64570708828881,49.905341517296854,48.93904035000001,50.890480600000025,51.034600799999914,50.336000000000034,50.336000000000034,53.58322949606546,47.08877050393461,249963632,36.97124101745618,45.30038799217271,NaN,NaN,NaN,NaN,NaN,NaN,-0.4043293361628394,-0.8640494117532711,-0.4597200755904317,24.797446997482975,16.153402733769983,5715466762,3310675538.8040414,13.972099526720156,34.64878307314863,21.786129241914818,28.571428571428573,92.85714285714286
2008-01-11,47.72,47.77,46.7,47.05,48.92643969537937,50.33583357332166,50.50469896717944,49.63340422993525,48.95669035000001,50.89568060000002,50.89040099999991,50.09950000000004,50.09950000000004,53.57272651148994,46.626273488510144,211685120,33.29544280929005,44.1885070162885,NaN,NaN,NaN,NaN,NaN,NaN,-0.41639589342243033,-0.9802149423684696,-0.5638190489460393,9.562252126826781,19.34082010937891,5503781642,3237476011.3274035,12.845768139680311,35.54249964697352,24.03263530769516,21.428571428571427,85.71428571428571
2008-01-14,47.69,48.00999,47.31,47.87,48.915927857614406,50.28700518573113,50.40137743905476,49.46546096994142,48.978190300000016,50.904180600000025,50.74720099999991,49.91800000000004,49.91800000000004,53.45825244864199,46.37774755135809,168048432,38.99353600895045,43.091739620317334,NaN,NaN,NaN,NaN,38.99353600895045,NaN,-0.3446601019737425,-0.9946441764132175,-0.6499840744394749,22.852387118941834,19.070695414417198,5671830074,3338308911.6892924,13.583288697451051,33.385636956512805,27.034976492590634,14.285714285714286,78.57142857142857
2008-01-15,47.38,47.52,46.35001,46.55,48.89238628689188,50.213005083043385,50.25034302968007,49.18779802042319,48.993290300000005,50.89308060000002,50.59820099999991,49.697000000000045,49.697000000000045,53.489804687841854,45.90419531215824,241791936,33.963901997421075,41.48805021561463,NaN,NaN,NaN,NaN,NaN,NaN,-0.35994338108133517,-1.099913300791144,-0.7399699197098087,3.1845592110815386,11.86639948561672,5430038138,3179177458.7372494,12.309563106710481,36.17740401256559,30.029992645872557,7.142857142857143,100
2008-01-16,46.19,46.91,45.46001,46.05,48.86410383627604,50.13056933882471,50.08562369518281,48.888960113716216,49.0055903,50.878280600000025,50.43080099999991,49.51300000000005,49.51300000000005,53.62515848431373,45.400841515686366,265725120,32.26615958395938,39.66507075360001,NaN,NaN,NaN,NaN,NaN,NaN,-0.3758164849237903,-1.2097405258645466,-0.8339240409407563,8.380551676919996,11.47249933564779,5164313018,3129695434.9638443,11.227930846035717,38.39191419032782,33.19187825720678,0,100
2008-01-17,46.24001,46.58,45.2,45.41,48.82973464387528,50.03709271825392,49.902265903214854,48.55763057907657,49.0118403,50.85038060000004,50.257600799999906,49.289000000000044,49.289000000000044,53.766459033884594,44.811540966115494,254456000,30.186189150871613,37.97914946420061,NaN,NaN,NaN,NaN,NaN,NaN,-0.399305096296247,-1.333055411311065,-0.9337503150148181,3.0172413793102577,4.860784089103931,4909857018,2952682565.398625,10.300279527422186,36.77664337607097,36.812117009775235,0,100
2008-01-18,45.64,46.14,44.75999,45.35001,48.79511051806557,49.944279199080576,49.723746063873094,48.2521429048788,49.016890350000004,50.82508070000003,50.07100119999991,49.06250050000004,49.06250050000004,53.8453556671711,44.279645332828984,273063168,29.99103182300938,36.314125295610864,NaN,NaN,NaN,NaN,NaN,NaN,-0.3884106681539161,-1.4192636502072133,-1.0308529820532972,8.526300578034624,6.64136454475496,4636793850,2913114416.106256,9.458683705739272,36.37692956056663,40.94376027095599,0,100
2008-01-22,42.83,44.77,42.73,44.17999,48.749188920870886,49.83013485850472,49.506343865289836,47.86431881869987,49.0149903,50.79948050000003,49.88760079999991,48.72650050000004,48.72650050000004,53.875930349423534,43.57707065057655,325732352,26.40538009689618,34.70506553126961,NaN,NaN,NaN,NaN,NaN,NaN,-0.4264909757666939,-1.5639667017616645,-1.1374757259949706,16.590274599542326,9.377938852295737,4311061498,3050429763.200843,8.104744171441473,42.26055955224177,45.590852441197285,0,100
2008-01-23,42.53999,44.14999,41.61,44.02,48.70213231469307,49.71508268308879,49.29119312547455,47.498193216918935,49.0128403,50.75888050000003,49.733400799999906,48.335000000000036,48.335000000000036,53.66252327823355,43.00747672176652,390156544,25.94853002957973,33.3989448260591,NaN,NaN,25.94853002957973,NaN,NaN,NaN,-0.42784165211290626,-1.6722777911361035,-1.2444361390231973,26.338826599810524,17.151800592462493,3920904954,3400651938.046193,7.040193516810302,42.4338584432583,49.39071754886639,0,100
2008-01-24,44.19,44.92999,44.06,44.91,48.664399654845376,49.61993253094842,49.1193816303579,47.25169862483142,49.01399034999999,50.724680500000034,49.631600799999916,47.968499500000036,47.968499500000036,53.178251720029245,42.75874727997083,250249056,32.90303174633539,32.50067501105973,NaN,NaN,NaN,NaN,NaN,NaN,-0.33811705596594055,-1.667082458980623,-1.3289654030146825,40.145985401459825,27.69169553360422,4171154010,3639400910.9890547,10.792764672738683,40.4098863534609,52.212232014971065,0,92.85714285714286
2008-01-25,45.86,45.87,43.94,43.99001,48.617888314996165,49.508448916474194,48.918229801716414,46.94106161294271,49.01289035,50.67588060000003,49.53680099999991,47.54300000000004,47.54300000000004,52.5903849942438,42.495615005756285,199299056,29.78872080091466,32.15598316755764,NaN,NaN,NaN,NaN,NaN,NaN,-0.3107504512031105,-1.7174034670185705,-1.40665301581546,33.286899701957594,33.25723723440931,3971854954,3450430296.2227955,14.51728034721815,36.44001926690871,52.515134230729636,0,85.71428571428571
2008-01-28,44.02,44.44,43.57001,44.33,48.57522275962307,49.40590537357372,48.738299221256945,46.69238907837674,49.01174035,50.62238070000002,49.40860079999991,47.16300050000004,47.16300050000004,51.970706226029506,42.35529477397057,163711184,32.33755430532271,32.05753695010377,NaN,NaN,NaN,NaN,NaN,NaN,-0.24278598681402563,-1.710135499332992,-1.4673495125189664,38.04201124756815,37.158298783661856,4135566138,3572742773.938815,13.856461658306069,36.717144247256186,52.546231818518365,7.142857142857143,78.57142857142857
2008-01-29,44.56,44.67999,44.03999,44.41,48.53377775703975,49.30697655429503,48.568561996893926,46.47501868995991,49.0105404,50.574680800000024,49.295000799999904,46.790500500000036,46.790500500000036,51.22473671812139,42.35626428187868,138520000,32.95431113287174,32.32081026348598,NaN,NaN,NaN,NaN,NaN,NaN,-0.16897697609311857,-1.6785707326353645,-1.509593756542246,41.17647058823527,37.50179384592033,4274086138,3594390852.688814,14.679358804195253,35.43914475141949,52.05309630428379,0,71.42857142857143
2008-01-30,44.24001,45.32001,44.17999,44.37,48.4923471325916,49.20921464232879,48.40391250681965,46.27454071948754,49.007090399999996,50.526980800000025,49.18600059999991,46.44800050000004,46.44800050000004,50.502738125062415,42.39326287493767,220824368,32.79335526431322,32.05702755479941,NaN,NaN,NaN,NaN,NaN,NaN,-0.1026468942137786,-1.6379023743094692,-1.5352554800956906,40.58823529411763,39.935572376640344,4053261770,3447177190.0513163,17.274470607938728,33.22099145855875,50.63966176134856,7.142857142857143,64.28571428571429
2008-01-31,43.87,45.59,43.82001,45.13,48.45889094221755,49.12843811475792,48.27552378106202,46.16553684144111,49.00694039999999,50.49598080000003,49.08300059999991,46.182000500000036,46.182000500000036,49.82920467197852,42.53479632802155,246824000,38.89963463281566,32.19476995589652,NaN,NaN,NaN,NaN,NaN,NaN,0.0068064915505872126,-1.5267473656574566,-1.5335538572080438,55.00008593763431,45.588263939995734,4300085770,3565707764.664732,15.637916941641874,32.000475951345024,50.05545295824369,0,57.142857142857146
2008-02-01,45.52,45.88,44.88,45.5899,48.43034376866315,49.05836805307955,48.17020520141253,46.11071428511339,49.00983994999999,50.46987980000003,49.00079859999991,45.93049550000004,45.93049550000004,48.96035158569393,42.900639414306156,161920256,42.31518326751272,32.83903713148385,NaN,NaN,NaN,NaN,42.31518326751272,NaN,0.11838380712522056,-1.3855740983015181,-1.5039579054267387,62.18603466567915,52.591451965810364,4462006026,3633681888.133531,16.36615745383882,30.25643328258038,48.83313670937449,7.142857142857143,50
2008-02-04,45.58,45.61,44.94,44.95,48.39571348240779,48.97701423024629,48.04392264449439,46.000170067483545,49.00884,50.43007990000003,48.901798799999916,45.75799600000004,45.75799600000004,48.5923561143843,42.92363588561578,100209808,39.04469854639829,32.842691598444404,NaN,NaN,NaN,NaN,NaN,NaN,0.154986806192688,-1.3102243976858787,-1.4652112038785667,56.5143824027073,57.90016766867359,4361796218,3536463417.6857715,15.746921976724298,29.111640624171265,47.949742797837025,0,42.857142857142854
2008-02-05,44.12,44.60001,43.64,43.66991,48.34869056218483,48.871923057370125,47.872392736867155,45.778240537247015,49.000189600000006,50.377379000000026,48.78899699999992,45.532991500000044,45.532991500000044,48.27881690002266,42.787166099977426,188990368,33.471503996420864,32.807520312658674,NaN,NaN,NaN,NaN,NaN,NaN,0.10146988999128959,-1.3383738413894548,-1.4398437313807444,38.8662264150944,52.52221449449362,4172805850,3359249389.3215675,14.584951061957444,34.28618909862227,47.31312502606486,0,35.714285714285715
2008-02-06,43.92,44.17,42.77,42.81,48.29357921330737,48.751884977026165,47.673867531499816,45.49555096227111,48.986889600000005,50.31367910000003,48.64839699999991,45.32749150000004,45.32749150000004,48.23761420418448,42.417368795815605,178284944,30.33868005180345,32.66984320321897,NaN,NaN,30.33868005180345,NaN,NaN,NaN,0.0208566375704069,-1.4137729344177359,-1.4346295719881428,24.144869215291813,39.841826011031166,3994520906,3191152156.4072814,13.44326726364108,36.466759087926825,46.697825105207016,0,28.571428571428573
2008-02-07,42.35001,43.78999,42.14999,43.11,48.24200131068739,48.64016448243159,47.4948923341861,45.268355632531005,48.9739396,50.25257910000003,48.53099699999993,45.08699150000004,45.08699150000004,47.893535068058604,42.280447931941474,286342144,32.7051212415391,32.84976692398093,NaN,NaN,NaN,NaN,NaN,NaN,0.0014610163922692543,-1.432803301497806,-1.4342643178900754,33.11258278145694,32.04122613728105,4280863050,3240043331.5065975,12.235044760969352,36.587078213409654,46.243428916189096,0,21.428571428571427
2008-02-08,43.17999,43.77,42.94,43.60001,48.195812342421846,48.54035944317552,47.34215185049253,45.109465572289956,48.960389649999996,50.20047920000004,48.40379699999992,44.86749150000004,44.86749150000004,47.405342030155005,42.32964096984508,173781248,36.49957298677413,33.3146627213927,NaN,NaN,NaN,NaN,NaN,NaN,0.033574835356483534,-1.392295773694471,-1.4258706090509545,46.604449648711864,34.620633881820204,4454644298,3342641267.8258247,11.663701120987213,34.8785601939705,45.61137883400708,0,14.285714285714286
2008-02-11,43.78,44.22,43.53999,44.07001,48.154759582795755,48.45183767202353,47.21383256223792,45.010469803500435,48.9479897,50.140779400000035,48.25559719999992,44.71849200000004,44.71849200000004,47.06932346726039,42.36766053273969,119562320,39.99448148887654,34.28531282081986,NaN,NaN,NaN,NaN,NaN,NaN,0.09493679874831384,-1.3071996106155623,-1.4021364093638762,57.61147540983612,45.77616928000163,4574206618,3409459797.6556816,13.820796784539132,33.4983746918487,43.73770946098893,57.142857142857146,7.142857142857143
2008-02-12,44.33,44.67999,43.50999,43.82001,48.11162774615102,48.36011831218148,47.08074148136584,44.897092679357534,48.9342397,50.07727950000004,48.09799739999992,44.515992500000046,44.515992500000046,46.39680026357154,42.63518473642855,145412368,38.77210393395567,35.201282385418146,NaN,NaN,NaN,NaN,NaN,NaN,0.1252491388030077,-1.2455749858601166,-1.3708241246631243,44.77253412189246,49.662819726813474,4428794250,3341108527.6511693,15.56241168623809,31.20999611781141,41.01734366272499,50,0
2008-02-13,44.39,44.88,44.16,44.78,48.0784772213137,48.289224880257095,46.99051632523385,44.8859409956092,48.92833965,50.02477950000003,47.96739739999992,44.42749250000004,44.42749250000004,46.06841039359247,42.78657460640761,148685808,45.6424210757936,36.11123876609373,NaN,NaN,NaN,NaN,45.6424210757936,NaN,0.2114444204468222,-1.1065185991045965,-1.3179630195514187,70.50946244111942,57.63115732428266,4577480058,3448492722.317836,15.769029928568168,29.259809294281464,39.02572674778834,42.857142857142854,71.42857142857143
2008-02-14,44.84,44.85001,43.89,43.97,48.03759685095237,48.20369567470745,46.87206470463644,44.79870851983689,48.91763965,49.96087950000004,47.82919739999991,44.323492500000036,44.323492500000036,45.79478488885877,42.8522001111413,170868880,41.41930296442704,36.94199463491604,NaN,NaN,NaN,NaN,NaN,NaN,0.21470899676586286,-1.0495767735940902,-1.264285770359953,48.793702965943694,54.69189984298519,4406611178,3306101692.340231,14.863186569833346,29.194603961528244,38.2762193331496,35.714285714285715,64.28571428571429
2008-02-15,43.77,43.98,43.45,43.82001,47.99563081263444,48.116890017782545,46.75237628484678,44.705499136995286,48.9046397,49.89317960000004,47.69219759999991,44.24399300000004,44.24399300000004,45.64185559251891,42.84613040748117,100053248,40.66890948527133,37.537091433483795,NaN,NaN,NaN,NaN,NaN,NaN,0.20745401019847676,-1.004968257611857,-1.2124222678103338,44.77253412189246,54.69189984298519,4306557930,3345749207.7080817,14.37232399389754,30.972171425449496,37.66232671399441,28.571428571428573,57.142857142857146
2008-02-19,44.39,44.5,43.27,43.74001,47.953286326936585,48.03021912634131,46.63424427367632,44.61354779061478,48.890389750000004,49.81987960000004,47.53559759999991,44.16349300000004,44.16349300000004,45.480399936560936,42.84658606343914,110507568,40.25005314975802,38.05821586326139,NaN,NaN,NaN,NaN,NaN,NaN,0.19797965243356663,-0.9649477022683755,-1.162927354701942,42.62776775397373,45.39800161393662,4196050362,3319696374.7254467,16.499905272485556,28.610661289452207,36.621285809088555,21.428571428571427,50
2008-02-20,43.25,44.09,43.24001,43.94,47.913353129653636,47.94922468819593,46.52858763549294,44.5494003819848,48.87693975,49.74607950000004,47.367997399999915,44.151493500000036,44.151493500000036,45.47194922495636,42.83103777504371,137338752,41.862053841409455,38.705980047339686,NaN,NaN,NaN,NaN,NaN,NaN,0.2050279693053254,-0.9066423930702854,-1.1116703623756108,47.98941557797419,45.129905817946785,4333389114,3408562055.7481394,15.61392580116979,27.263836724133327,36.30628198603666,14.285714285714286,42.857142857142854
2008-02-21,44.36,44.47,43.34,43.52,47.86963817313967,47.86151726862769,46.41060380665008,44.451362250367204,48.86138975,49.66547950000004,47.19179739999991,44.12649350000004,44.12649350000004,45.474604037592684,42.77838296240739,127857008,39.454636208222226,38.74562301701159,NaN,NaN,39.454636208222226,NaN,NaN,NaN,0.1820292805194912,-0.8841337617262468,-1.066163042245738,36.72939214640177,42.448858492783216,4205532106,3321438253.836635,16.89993891016422,25.317523470544256,35.27708284129795,7.142857142857143,35.714285714285715
2008-02-22,43.67,43.69,42.60001,43.67999,47.82795013161589,47.77871474845685,46.303520912271644,44.37789822652271,48.846139699999995,49.588179400000044,47.014597399999914,44.06499300000004,44.06499300000004,45.376240254930856,42.75374574506922,157364624,40.850082983224475,38.64097299670528,NaN,NaN,NaN,NaN,NaN,NaN,0.1780020652509542,-0.8436604606820453,-1.0216625259329994,44.21952537709415,42.979444367156695,4362896730,3475912539.6018987,15.733205244475648,28.256604559180975,35.18250059971622,0,28.571428571428573
2008-02-25,43.62,44.07001,43.34,43.89999,47.78886595120181,47.701908317794334,46.209264798064915,44.33238315733007,48.831489649999995,49.50717930000005,46.866196999999914,44.06049200000004,44.06049200000004,45.37335491573108,42.747629084269,121444256,42.802288614018245,38.909372287249575,NaN,NaN,NaN,NaN,NaN,NaN,0.1895009106164508,-0.7847863876624359,-0.9742872982788867,64.10232929549709,48.350415606330984,4484340986,3540787837.90236,17.45605004729459,26.91633104630059,34.5772995678949,0,21.428571428571427
2008-02-26,43.64999,44.48,43.37,44.07001,47.751862409398804,47.62998953922415,46.125372453042765,44.30739523758435,48.82088969999999,49.42777950000004,46.71199719999991,44.04749250000004,44.04749250000004,45.3545595577876,42.74042544221248,148375808,44.33141580818078,39.68508027380385,NaN,NaN,NaN,NaN,NaN,NaN,0.2065068837775914,-0.7161536935568975,-0.9226605773344889,70.33014531082307,59.55066666113808,4632716794,3579555362.0790825,18.860011656428767,24.976417153672834,32.69445452427121,42.857142857142854,14.285714285714286
2008-02-27,43.77,44.46001,43.67,44.28999,47.71741591776299,47.563850934487036,46.0533966705705,44.305737595909655,48.80843964999999,49.354179500000036,46.5677969999999,44.04149200000004,44.04149200000004,45.34293694295496,42.740047057045125,125682560,46.330630001920554,40.82736241309793,NaN,NaN,NaN,NaN,46.330630001920554,NaN,0.22879079626024945,-0.6366720820091771,-0.8654628782694266,78.38799125277932,70.94015528636648,4758399354,3651141014.8217077,17.872706922815958,23.668924065453893,30.39608296281682,35.714285714285715,7.142857142857143
2008-02-28,44.11,44.53,43.95,44.12,47.68162073450167,47.49565586647739,45.97757719329323,44.28804830106112,48.7967396,49.27767950000003,46.4307969999999,44.02899200000004,44.02899200000004,45.32235317907751,42.735630820922566,129196624,44.986154538678264,41.7045790771793,NaN,NaN,NaN,NaN,NaN,NaN,0.22780622448092958,-0.5807050976682646,-0.8085113221491942,66.66652046719489,71.79488567693241,4629202730,3597680342.8217053,17.64197204838533,22.728216351106898,27.73321973744331,28.571428571428573,0
2008-02-29,43.64999,43.77,42.85001,42.95,47.63453993117329,47.405642879022395,45.85884867590918,44.160615129531486,48.780989549999994,49.17899960000003,46.295196999999895,43.91999200000004,43.91999200000004,45.191078214047735,42.64890578595235,188724560,37.02272370779537,41.741946985823674,NaN,NaN,NaN,NaN,NaN,NaN,0.14795151197089962,-0.6235719321855697,-0.7715234441564693,15.350505923271793,53.468339214415316,4440478170,3449979204.2815056,16.130242579843497,28.202554709345957,26.115506364138856,21.428571428571427,64.28571428571429
2008-03-03,42.92999,42.99001,42.24001,42.67,47.58514152389794,47.3118677725071,45.733795786657836,44.01865178386182,48.76158955,49.07419970000003,46.150796999999905,43.773997000000044,43.773997000000044,44.907654557537924,42.640339442462164,133641936,35.40735495027441,41.41429509020923,NaN,NaN,NaN,NaN,NaN,NaN,0.07930914857724736,-0.6723870084349102,-0.7516961570121575,16.287561695309563,32.768196028592065,4306836234,3469576457.776547,15.296622542520783,30.948383325392907,25.562685648098377,14.285714285714286,100
2008-03-04,42.41,43.03999,42.02,42.91,47.53862270276463,47.22470207404161,45.62305869698498,43.913065899684504,48.74448955,48.96949870000003,46.0113969999999,43.67199700000004,43.67199700000004,44.72853143378102,42.61546256621906,183850944,37.90813729877849,41.352583187696574,NaN,NaN,NaN,NaN,NaN,NaN,0.054297238098657385,-0.6838246093888358,-0.7381218474874932,31.118881118880896,20.918982912487397,4490687178,3606566581.1595583,14.220270272772053,30.28845734272656,25.751719330485646,7.142857142857143,100
2008-03-05,42.99001,43.53999,42.75,43.1199,47.494655312687364,47.14341886465465,45.5248956108287,43.837526290190745,48.726538999999995,48.86559780000004,45.8557951999999,43.64449650000004,43.64449650000004,44.728102170034525,42.56089082996555,183208192,40.092670583124395,40.95617243822021,NaN,NaN,NaN,NaN,NaN,NaN,0.0558985498526583,-0.6682486601716704,-0.7241472100243287,38.8655870473956,28.757343287195337,4673895370,3594926915.902428,16.940659132589587,28.609354477155684,25.441506238629263,0,92.85714285714286
2008-03-06,43.09,43.27,42.10001,42.17,47.441673667785004,47.0449353227803,45.39333107707071,43.678714262553534,48.70233904999999,48.76069780000003,45.662194999999905,43.612496500000034,43.612496500000034,44.82313944989608,42.401853550103986,152752192,34.2244020474092,40.442250944147496,NaN,NaN,NaN,NaN,NaN,NaN,-0.00004656028788629918,-0.7242054103841866,-0.7241588500963003,5.976095617529829,25.32018792793542,4521143178,3460450309.023806,15.56446534036069,30.798329037287665,25.465025558701797,0,85.71428571428571
2008-03-07,41.91,42.64,41.38,42.07001,47.3882242780558,46.94642195005198,45.26300476032284,43.52550433278653,48.677439099999994,48.64609790000003,45.4587949999999,43.56049700000003,43.56049700000003,44.93169827412689,42.18929572587318,242552368,33.66580661269367,39.94202931039195,NaN,NaN,NaN,NaN,NaN,NaN,-0.03488854091840621,-0.767769526244308,-0.7328809853259018,21.905079365079402,22.24892067666826,4278590810,3483554384.5852036,14.22431440936137,33.06674666084145,25.696114276088036,57.142857142857146,100
2008-03-10,42.00999,42.14,41.17,41.25999,47.32724682255276,46.83381933717966,45.10602378932979,43.30974106299734,48.649589049999996,48.52749780000003,45.2339947999999,43.44349600000003,43.44349600000003,45.14160972827025,41.74538227172982,146964128,29.4695767646172,39.171995282881895,NaN,NaN,29.4695767646172,NaN,NaN,NaN,-0.09990995240779388,-0.8577684258356442,-0.7578584734278503,2.678273809523817,10.186482930711,4131626682,3363858920.2526674,13.276569925490994,32.306031811026195,26.76042690234568,50,100
2008-03-11,41.86,42.85001,41.50999,42.83009,47.28249899347263,46.7545375681266,45.016771483865874,43.26406000937855,48.63293949999999,48.42709870000003,45.0519967999999,43.38150000000003,43.38150000000003,45.074120939195474,41.68887906080459,196888192,44.03180411047382,39.326977444957926,NaN,NaN,NaN,NaN,NaN,NaN,-0.02831730365677043,-0.7932551029988133,-0.7649377993420429,49.40744047619039,24.66359788359787,4328514874,3554893449.195937,16.578755036302415,28.90613675906191,26.755576373064322,42.857142857142854,92.85714285714286
2008-03-12,43.02,43.44,42.60001,42.71001,47.2370015905525,46.674447913312214,44.92631024920447,43.21129334181868,48.61423954999999,48.31869880000003,44.8689969999999,43.326000000000036,43.326000000000036,45.03022011600652,41.621779883993554,155566000,43.2955585103102,39.601329037964206,NaN,NaN,NaN,NaN,NaN,NaN,0.01735058828169822,-0.7432495639899201,-0.7606001522716184,45.833630952380815,32.63978174603167,4172948874,3440071410.433571,19.610037022350372,27.27318283360123,26.498901082237246,35.714285714285715,85.71428571428571
2008-03-13,42.21001,43.33,41.81,43.03999,47.19524028119377,46.602478449682266,44.852336906098415,43.19497873783595,48.59538949999999,48.211298700000036,44.705396799999896,43.23899950000004,43.23899950000004,44.809867731207895,41.66813126879219,208991744,45.96917700860424,39.96697861120562,NaN,NaN,NaN,NaN,NaN,NaN,0.07305759081545826,-0.6692781637522955,-0.7423357545677538,55.65446428571433,50.298511904761845,4381940618,3569313554.857993,17.665307387249264,29.72279964983688,26.282848729208784,28.571428571428573,78.57142857142857
2008-03-14,43.36,43.38,41.74001,42.25,47.14603391023662,46.51629075760935,44.75028447840828,43.104980762803955,48.570689499999986,48.109398700000035,44.5413967999999,43.152999500000035,43.152999500000035,44.742588961408416,41.563410038591655,309589760,40.986713616938516,39.837294682842774,NaN,NaN,NaN,NaN,NaN,NaN,0.060496278282806015,-0.6667154067142462,-0.7272116849970522,32.142857142857096,44.54365079365075,4072350858,3452270922.2214527,15.840066779859601,27.092691710437087,26.632111563745386,21.428571428571427,71.42857142857143
2008-03-17,41.25999,42.00999,41.05,41.48,47.089655463368594,46.4165622277557,44.62203802827462,42.95022069015596,48.54103949999999,47.99349860000003,44.358596799999894,43.03599900000003,43.03599900000003,44.75147067035727,41.32052732964279,193130560,36.79995008968792,39.29933284580758,NaN,NaN,NaN,NaN,NaN,NaN,0.006942025047488309,-0.7185341536876919,-0.7254761787351802,12.356321839080438,33.38454775588396,3879220298,3432154957.7901554,14.647488694833271,29.382081257200376,28.025856477466686,14.285714285714286,100
2008-03-18,42.24001,43.34,42.11,43.33,47.0522459562704,46.35544218364172,44.57136987030307,42.986390148236346,48.5204895,47.88499870000003,44.2571969999999,43.01549850000003,43.01549850000003,44.70645177841341,41.32454522158665,216300368,50.0119176366431,39.56228196257347,NaN,NaN,NaN,NaN,NaN,NaN,0.09768805011674586,-0.6033661160892478,-0.7010541662059937,65.5172413793103,36.672140120415946,4095520666,3644938246.635682,20.99536280548067,26.10176260611179,27.80367672189351,7.142857142857143,92.85714285714286
2008-03-19,43.50999,43.60001,42.23,42.25999,47.004561817402035,46.27434412059931,44.48072752244805,42.91720918173765,48.493888999999996,47.76989860000003,44.1389967999999,42.93149800000003,42.93149800000003,44.597126010027296,41.26586998997277,216157184,44.25003407174851,39.50970192922134,NaN,NaN,NaN,NaN,NaN,NaN,0.08755077013083912,-0.5916157035424447,-0.6791664736732839,44.48492647058831,40.786163229659685,3879363482,3438244575.9650173,20.831299311598304,23.97828775527478,27.40539202916063,0,85.71428571428571
2008-03-20,42.35001,43.10001,42.10001,43.09,46.96561095354729,46.21128780137952,44.4261891882344,42.933665450143586,48.471439000000004,47.67029860000003,44.0623967999999,42.90999800000003,42.90999800000003,44.555666655527865,41.264329344472195,128397008,49.144538667620445,40.37554585492313,NaN,NaN,NaN,NaN,NaN,NaN,0.1357684936306951,-0.509455856634915,-0.6452243502656101,79.99968627574033,63.33395137521298,4007760490,3564071075.8648586,19.579215178775407,23.31836770984476,26.08291744917032,0,78.57142857142857
2008-03-24,43.28,44.75999,43.28,44.5799,46.94187253609906,46.178983092441314,44.432217063205606,43.09044969298706,48.45898845,47.576797700000036,43.9955947999999,42.954993500000036,42.954993500000036,44.726790312734046,41.183196687266026,125075632,56.52323786726685,41.883823206136874,NaN,NaN,NaN,NaN,NaN,NaN,0.2598375443657709,-0.3204274198083965,-0.5802649641741674,95.14580901835315,73.21014058822726,4132836122,3658707487.914886,27.365978208727203,21.043606192020114,24.598265039928968,100,71.42857142857143
2008-03-25,44.67999,45.07001,44.28,44.83,46.92085887902345,46.15227055595733,44.44781639406029,43.25612115079782,48.451438950000004,47.483497700000036,43.932394599999895,43.00149400000003,43.00149400000003,44.91333629412904,41.08965170587102,118219632,57.63444834735605,43.292845423892416,NaN,NaN,NaN,NaN,NaN,NaN,0.34523147094908896,-0.1487256254878062,-0.49395709643689517,94.02961684174903,89.72503737861416,4251055754,3705095386.4524727,27.928277363591018,20.047290847907213,23.192970615789722,100,64.28571428571429
2008-03-26,44.69,44.85001,44.28,44.7,46.89876078072471,46.123512723166094,44.457705947234395,43.39363342215041,48.44038895,47.38789780000004,43.8853945999999,43.032993500000025,43.032993500000025,45.032946329838246,41.0330406701618,124824560,56.82149405536927,44.48776138619563,NaN,NaN,NaN,NaN,NaN,NaN,0.37686414186494044,-0.02287691910571965,-0.3997410609706601,90.79579404031333,93.32373996680518,4126231194,3764219582.439212,26.937296585703507,19.335951597714306,22.536524724131258,92.85714285714286,57.142857142857146
2008-03-27,44.44,44.50999,43.71001,43.71001,46.86703191723491,46.075720590034095,44.428384537538925,43.42376452480275,48.42483895,47.274697900000035,43.80219479999991,43.003994500000026,43.003994500000026,44.946186504315165,41.06180249568489,143868560,50.92994700036085,45.68101459712074,NaN,NaN,NaN,NaN,NaN,NaN,0.31740056005946676,-0.0029903608963266493,-0.3203909209557934,66.16923838497904,83.6648830890138,3982362634,3620351022.439212,25.260805339480868,21.71584823453083,20.72854333735376,85.71428571428571,50
2008-03-28,44.03,44.34,43.33,43.49001,46.83342970910322,46.02451840013243,44.39158553606681,43.43007361767868,48.40958905,47.169598000000036,43.74099499999991,42.97249500000002,42.97249500000002,44.86095719598619,41.08403280401386,111838128,49.696781068714444,46.82608420112222,NaN,NaN,NaN,NaN,NaN,NaN,0.2523723339761647,-0.004925503485587512,-0.2572978374617522,60.69661518254922,72.5538825359472,3870524506,3543948971.3922415,23.644049663143623,22.734058497023295,18.02272725366569,78.57142857142857,42.857142857142854
2008-03-31,43.64999,44.02,43.45,43.72,46.80245030901264,45.97888437240704,44.36524884837792,43.457685654090234,48.39293905,47.06259800000004,43.694394999999915,43.01099500000002,43.01099500000002,44.92724446331864,41.09474553668141,113644752,51.03163831641641,48.36623145482216,NaN,NaN,NaN,NaN,NaN,NaN,0.2154072866724302,0.011961270878785513,-0.20344601579364469,66.41774522948941,64.42786626567255,3984169258,3537967668.655398,22.758762805429903,21.88284377295332,15.180935058485748,71.42857142857143,35.714285714285715
2008-04-01,44.45,45.61,44.41,45.59,46.79038612683341,45.97118369176531,44.413278305304274,43.66076321084355,48.38408905,46.977797900000034,43.697994999999906,43.15699500000002,43.15699500000002,45.36917624159565,40.94481375840439,137494368,60.26447820421985,49.52570817580402,NaN,NaN,NaN,NaN,NaN,NaN,0.3021401150739845,0.17422912804883595,-0.12791098702514855,99.56140350877202,75.55858797360355,4121663626,3670878891.055399,29.99610145944211,19.302134283788433,14.79452415899698,100,28.571428571428573
2008-04-02,45.69,46.02,45.17,45.49001,46.77744706089477,45.961655499849165,44.45550307764528,43.83497719076321,48.3728891,46.88589810000004,43.70079499999991,43.28599550000003,43.28599550000003,45.71572219691586,40.85626880308419,132486752,59.6172000487487,50.69153971426392,NaN,NaN,NaN,NaN,NaN,NaN,0.3354488993744403,0.2914001371929018,-0.04404876218153847,89.33621730382285,85.10512201402808,3989176874,3638149987.308386,30.981607025151092,18.259195535171287,15.472520910598062,100,21.428571428571427
2008-04-03,45.28999,45.91,45.14,45.59,46.76563166725403,45.95429598500067,44.499993153031745,44.00212222021433,48.3619891,46.80829800000003,43.72899519999991,43.40950050000002,43.40950050000002,46.036043415276275,40.78295758472377,140033744,60.078959807152955,51.69938134273168,NaN,NaN,NaN,NaN,NaN,NaN,0.3455241268291211,0.3878563963548629,0.04233226952574182,91.34808853118714,93.41523644792733,4129210618,3661792047.983712,29.43027664361707,17.53999783782932,15.463259796197264,92.85714285714286,14.285714285714286
2008-04-04,45.78,46.35001,45.39999,45.86,46.75662040688334,45.952428737772934,44.55332675487364,44.1790629611463,48.35248915000001,46.749598000000034,43.7657951999999,43.59400050000003,43.59400050000003,46.36099958705924,40.82700141294082,139275808,61.36367638658532,53.15487868342074,NaN,NaN,NaN,NaN,61.36367638658532,NaN,0.3505709725382093,0.48054598519850344,0.12997501266029415,90.75454574614014,90.4796171937167,4268486426,3657393957.1645713,30.483619228030516,16.445832562849418,15.727734770012873,100,7.142857142857143
2008-04-07,46.14999,46.41,45.64999,45.75999,46.74670368641684,45.94861806969822,44.600646882133496,44.32962744103713,48.344739100000005,46.70719790000004,43.78279499999991,43.778499500000024,43.778499500000024,46.60585110844697,40.95114789155308,102610752,60.585923629205276,54.853876793386256,NaN,NaN,NaN,NaN,NaN,NaN,0.3277893660447162,0.5397117202161894,0.2119223541714732,84.91852649310103,89.00705359014277,4165875674,3584485926.7603397,29.331461785175467,15.607057217481499,15.518819213881548,100,0
2008-04-08,45.41,45.72,45.17999,45.41,46.733403152223644,45.93795236534776,44.632386220089046,44.43252006570026,48.333089050000005,46.67399790000003,43.8111947999999,43.98600000000003,43.98600000000003,46.64785500051482,41.32414499948525,97565936,57.82385708228841,55.41187246807522,NaN,NaN,NaN,NaN,NaN,NaN,0.27205943642323743,0.55199664970052,0.27993721327728255,76.79809001877034,84.15705408600382,4068309738,3570033788.4283824,28.151456293314308,18.23920429635303,16.27057906508518,92.85714285714286,14.285714285714286
2008-04-09,45.47,45.49001,44.63,44.89999,46.7151602352861,45.917398655142854,44.64288048596791,44.47704101182404,48.32113905000002,46.61559770000004,43.82259459999991,44.089495000000035,44.089495000000035,46.724353087652084,41.454636912347986,127256944,53.96314514993941,56.10566611651742,NaN,NaN,NaN,NaN,NaN,NaN,0.18776741012864862,0.5146464759380933,0.3268790658094447,64.96488390924354,75.56050014037163,3941052794,3522678478.8525405,26.452150650333316,20.99853939098385,16.589878575963702,85.71428571428571,7.142857142857143
2008-04-10,44.92999,45.84,44.92999,45.53999,46.7034669991141,45.909925216427155,44.678061251224065,44.57827424879318,48.313389000000015,46.57009760000003,43.84519439999991,44.23099400000003,44.23099400000003,46.85827027972818,41.60371772027188,112800432,57.773226149111856,56.72200093662394,NaN,NaN,NaN,NaN,NaN,NaN,0.1629549339412778,0.5305727332360419,0.3676177992947641,72.20415335463275,71.32237576088221,4053853226,3561103337.8273654,27.167320780115784,19.605503549109287,17.122068048654643,78.57142857142857,0
2008-04-11,45.02,45.10001,44.12,44.28,46.679352899620426,45.87764946956721,44.66245100607802,44.54986717747954,48.300688950000016,46.51469750000004,43.843394399999916,44.292994500000034,44.292994500000034,46.86281679230441,41.72317220769566,120135376,49.14908581775153,56.195275790229985,NaN,NaN,NaN,NaN,NaN,NaN,0.055099468119384654,0.43649213444399493,0.3813926663246103,30.844155844155953,56.004397702677416,3933717850,3480195439.424534,24.52096486005539,23.252170260877627,16.3789043926189,71.42857142857143,0
2008-04-14,44.21001,44.48,43.95,44.08,46.653488691664,45.84205245036786,44.63960979015339,44.50511792248149,48.283389000000014,46.45269750000004,43.822394399999915,44.38449450000004,44.38449450000004,46.78132691800982,41.98766208199026,89274560,47.92613447696663,55.50182479948789,NaN,NaN,47.92613447696663,NaN,NaN,NaN,-0.0316312704175194,0.341853578302711,0.3734848487202304,24.350649350649363,42.46631951647935,3844443290,3434715946.594344,23.597044941842793,23.584621450656655,15.20742210425539,64.28571428571429,21.428571428571427
2008-04-15,44.24001,44.35001,43.67999,44.14,46.628478853936,45.80834844144968,44.620017249363066,44.470344787007065,48.26648900000002,46.39709750000004,43.793396399999914,44.51749450000004,44.51749450000004,46.51719135003047,42.51779764996961,124232256,48.34141558295719,54.896104908601316,NaN,NaN,NaN,NaN,NaN,NaN,-0.08391018386008608,0.26859711889512283,0.3525073027552089,26.29870129870139,27.164502164502235,3968675546,3481069882.297757,22.44564691184959,24.400175640023853,14.332077468369647,57.142857142857146,14.285714285714286
2008-04-16,44.69,45.48,44.64999,45.37,46.615956676284895,45.79966827429226,44.64942833762334,44.556026235863534,48.255338950000024,46.35179760000003,43.801796399999915,44.619494500000044,44.619494500000044,46.574103407177816,42.66488559282227,134027872,56.07487643768841,55.26359986841043,NaN,NaN,NaN,NaN,NaN,NaN,-0.03699689879784557,0.30626117925790197,0.34325807805574754,66.23376623376625,38.961038961039,4102703418,3579572722.2619987,28.33049486187403,22.079768983101808,14.6787559212943,50,7.142857142857143
2008-04-17,45.42,45.75,44.98,45.27,46.602564072540765,45.7891797936132,44.673764481245954,44.62402373720987,48.24163900000002,46.311397600000035,43.83379819999991,44.76999500000004,44.76999500000004,46.413489314570135,43.12650068542994,125056816,55.34939906362698,55.66735829661847,NaN,NaN,NaN,NaN,NaN,NaN,-0.015164306769941294,0.32430269459332095,0.33946700136326224,61.486486486486626,51.339651339651425,3977646602,3548714546.885377,28.70478560128878,20.852606396516595,15.670363342919044,42.857142857142854,0
2008-04-18,46.50999,46.92999,46.22,46.71001,46.603633186246824,45.80741405512581,44.75361724668729,44.82268909557083,48.23363905000002,46.280097700000034,43.91179839999991,44.95099550000005,44.95099550000005,46.611803688220036,43.29018731178006,133022432,62.810831441503744,56.508729234124694,NaN,NaN,NaN,NaN,NaN,NaN,0.08811809518545466,0.4496146203450806,0.36149652515962594,93.23138461538464,73.65054577854585,4110669034,3599306875.3871303,33.54822910654157,18.469409029245742,17.600776541011882,100,0
2008-04-21,46.61,47.08,46.49001,47.03999,46.60797504509014,45.831821499578766,44.84327892328779,45.03386061027837,48.22553900000002,46.26069760000003,43.99039819999991,45.07400000000004,45.07400000000004,46.95628601444178,43.1917139855583,83303184,64.28371356095104,56.795817473891205,NaN,NaN,NaN,NaN,64.28371356095104,NaN,0.16599706555087784,0.5689928570982232,0.4029957915473454,98.82323875518028,84.51370328568386,4193972218,3671311697.069669,33.207811252216004,17.695335309081944,18.228069393514705,100,71.42857142857143
2008-04-22,46.73,46.77,45.92999,46.34,46.60530862673104,45.84188444018117,44.901973867472584,45.158254837870906,48.21293900000003,46.22449750000003,44.04519799999991,45.14950000000004,45.14950000000004,47.10624312063766,43.19275687936242,104689504,58.95006146335956,56.74816471779199,NaN,NaN,NaN,NaN,NaN,NaN,0.15776249273408377,0.6001989074649501,0.4424364147308663,78.23535813129976,90.09666050062157,4089282714,3668820365.793899,30.608631868513914,20.259223140944034,17.83582245401973,92.85714285714286,64.28571428571429
2008-04-23,46.67999,47.06,46.27361,46.85001,46.60774346626605,45.86184732255382,44.97836744129719,45.3193743771213,48.20273905000003,46.17819760000003,44.10079799999991,45.257000500000046,45.257000500000046,47.33559497997448,43.17840602002561,131086192,61.459153083432085,56.84674995181193,NaN,NaN,NaN,NaN,NaN,NaN,0.17284508984764463,0.6584927770404221,0.48564768719277746,93.23560813056429,90.09806833901479,4220368906,3729898573.3127117,30.9618853782741,19.117584383280583,17.71700354706198,85.71428571428571,57.142857142857146
2008-04-24,46.87,47.78999,46.39,47.27,46.61433308351714,45.889731533988396,45.06823538477573,45.50514824596689,48.19668905000003,46.133897600000026,44.169797799999905,45.435000000000045,45.435000000000045,47.56234980672223,43.30765019327786,166694560,63.44088379074538,56.99512190925193,NaN,NaN,NaN,NaN,NaN,NaN,0.19561296766180192,0.7301638967700299,0.534550929108228,87.34817518248177,86.27304714811528,4387063466,3772764385.6010857,33.02708325347365,17.25354186960916,17.821180847070426,100,50
2008-04-25,47.31,47.35001,46.57001,47.14999,46.619663003084135,45.91468714717674,45.14987282066688,45.661799841589094,48.188389000000036,46.09229750000002,44.217197599999906,45.61799900000004,45.61799900000004,47.67306678091629,43.562931219083794,121945376,62.45269989413236,57.12846307103244,NaN,NaN,NaN,NaN,NaN,NaN,0.1870969207700398,0.7684220800707777,0.5813251593007379,84.42822384428224,88.33733571910943,4265118090,3832167417.735651,31.201694659835834,16.299948169344255,17.88051016208546,92.85714285714286,42.857142857142854
2008-04-28,47.25,47.62,47.13,47.24001,46.62583561001862,45.94093116406433,45.231838984562295,45.81210557096156,48.176789050000025,46.05589760000002,44.28259779999991,45.793999500000034,45.793999500000034,47.770132789073735,43.81786621092633,71243936,62.91927654658932,57.49242160419679,NaN,NaN,NaN,NaN,NaN,NaN,0.17239633339647864,0.7968205760463363,0.6244242426498576,86.61849148418482,86.13163017031628,4336362026,3792913462.9575276,32.0630765772711,15.712438703365175,18.79886538869575,85.71428571428571,35.714285714285715
2008-04-29,47.14999,47.75999,47.06,47.60001,46.635528887530874,45.97378421032048,45.324708436148086,45.98238218325094,48.16528915000003,46.02519770000003,44.35819779999991,45.894500000000036,45.894500000000036,48.01787302427175,43.77112697572832,91270624,64.80292164372997,58.26669135375329,NaN,NaN,NaN,NaN,NaN,NaN,0.1714265917065697,0.8387074822830698,0.6672808905765001,95.37761557177602,88.80811030008105,4427632650,3842464992.6061215,31.429250282119664,14.886943373823817,20.529066442797326,78.57142857142857,28.571428571428573
2008-04-30,47.69,48.06,47.03,47.21001,46.64124511750569,45.998263928928,45.39864183080895,46.099299118179424,48.15208915000003,45.98159770000003,44.427597799999916,45.980500000000035,45.980500000000035,48.1696824684585,43.79131753154157,132152688,61.1772566881307,58.509836392254634,NaN,NaN,NaN,NaN,NaN,NaN,0.13085994980051463,0.8308558278271434,0.6999958780266288,80.59387992264848,87.52999565953645,4295479962,3756504159.687441,31.252325430811272,13.742810037396419,22.15386100493103,100,21.428571428571427
2008-05-01,47.24001,48.72,47.22,48.7,46.66173024071459,46.05176365310764,45.52810685705173,46.34698491644805,48.14443915000003,45.94539760000002,44.522797799999914,46.13600000000004,46.13600000000004,48.61479746655632,43.65720253344376,143596880,68.44180569913797,59.88788781235367,NaN,NaN,NaN,NaN,NaN,NaN,0.18727962186505198,0.9340954053579438,0.7468157834928918,99.60317539052511,91.85822362831657,4439076842,3896271789.554108,32.60021755523428,12.255737712982048,25.203808294077493,100,14.285714285714286
2008-05-02,49.19,49.19,48.34,48.77,46.6827080492647,46.105590115422345,45.655239921481076,46.57774825773871,48.137439150000034,45.909797600000026,44.62779779999992,46.28150000000004,46.28150000000004,49.00768999341675,43.555310006583326,124989936,68.73777164152793,61.374433324108054,NaN,NaN,NaN,NaN,NaN,NaN,0.21048353156506316,1.0099201979492207,0.7994366663841576,92.37750929671644,90.85818820329668,4564066778,3897742259.389403,33.99723588807422,11.501284304875188,28.733588915666733,100,7.142857142857143
2008-05-05,48.73,49.03,48.39999,48.63,46.702084088575496,46.155578429968436,45.77189717946221,46.77320080462074,48.128989100000034,45.87069770000003,44.72679799999992,46.42500050000003,46.42500050000003,49.32300640409775,43.526994595902316,75624624,67.376782870397,62.73410241606804,NaN,NaN,NaN,NaN,NaN,NaN,0.19777061367553528,1.0466499334785766,0.8488793198030413,87.66522540699258,93.21530336474471,4488442154,3877337139.09963,32.40496231183623,10.962617245242921,31.967231884778204,92.85714285714286,0
2008-05-06,48.49001,49.13,48.14,48.92999,46.724252306599624,46.210517272939356,45.8957439567382,46.978609299418764,48.12338905000004,45.84679750000002,44.82739799999991,46.601000000000035,46.601000000000035,49.65443809503417,43.547561904965896,139582496,68.80221417108166,63.64319796845327,NaN,NaN,NaN,NaN,68.80221417108166,NaN,0.1908405309100244,1.0874299834405718,0.8965894525305474,93.82399049881232,91.28890840084046,4628024650,3960519847.1704164,30.025205884084283,12.086145507953207,34.124331887436476,85.71428571428571,0
2008-05-07,48.92999,49.23,47.87199,48.03999,46.73734422394689,46.24674445565343,45.979832036866114,47.079693175664595,48.11323895000004,45.80939740000002,44.90679759999992,46.75800000000004,46.75800000000004,49.76803980707965,43.747960192920424,140008256,60.37396928073176,64.00209584110361,NaN,NaN,60.37396928073176,NaN,NaN,NaN,0.11152095761870084,1.0359906495539235,0.9244696919352227,63.939200184242054,81.80947203001566,4488016394,3855152554.061707,27.086681824609904,12.83477645988964,35.542563610414184,100,0
2008-05-08,48.24001,48.7,48.06,48.39999,46.7538879630121,46.28938298128405,46.07474019228313,47.205435730363206,48.10858890000004,45.77839730000002,44.98899759999991,46.90100000000004,46.90100000000004,49.937619864290475,43.8643801357096,128058688,62.3813735478956,63.971420277274454,NaN,NaN,NaN,NaN,NaN,NaN,0.07050501813588395,1.0126009646050775,0.9420959464691936,74.84825803558188,77.53714957287876,4616075082,3863152220.227707,25.766797322919814,12.209361259838312,36.021989556923806,92.85714285714286,14.285714285714286
2008-05-09,48.03,48.46001,47.89999,48.21001,46.76837673949954,46.32741519947644,46.15847626317399,47.30110947032861,48.10263900000004,45.75079740000002,45.070797799999916,47.09750050000004,47.09750050000004,49.93217572835047,44.262825271649604,97062000,60.63566209496738,63.710845172561335,NaN,NaN,NaN,NaN,NaN,NaN,0.020388043638389197,0.9675810010171801,0.947192957378791,69.09130578392187,69.29292133458193,4519013082,3873554815.2064567,24.668401588104125,12.906881611379683,36.081041074407025,85.71428571428571,7.142857142857143
2008-05-12,48.28,49.19,48.2,49.09,46.79147746845974,46.382119848991756,46.27343797834364,47.471479996963986,48.103189000000036,45.74439740000002,45.193597799999914,47.34800050000003,47.34800050000003,49.94748730477959,44.748513695220474,89636000,65.45762884541006,64.17567141413636,NaN,NaN,NaN,NaN,NaN,NaN,0.03543044860702893,0.991481018137577,0.9560505695305481,95.26449487381593,79.73468623110655,4608649082,3945082532.378175,28.351597650204326,11.938050350805392,37.53769781839513,78.57142857142857,0
2008-05-13,49.13,49.33,48.75999,49.22,46.81564187175865,46.43831549554638,46.3889894301733,47.638005711538845,48.10933895000004,45.737697400000016,45.32459779999992,47.60200050000003,47.60200050000003,49.86957423247783,45.33442676752223,85448000,66.11792916137429,64.5084411339894,NaN,NaN,NaN,NaN,NaN,NaN,0.04258157970740961,1.00927754416481,0.9666959644574005,96.25850340136056,86.87143468636611,4694097082,3997551181.138723,28.18301521075669,11.407123226270667,38.875048158473454,100,0
2008-05-14,49.42,49.92999,49.03999,49.11,46.838471305870506,46.49122013919892,46.49569572702924,47.77819564377324,48.11213895000004,45.72999740000002,45.448597799999916,47.78900050000003,47.78900050000003,49.90098105962312,45.67701994037694,143598128,64.98593868916171,64.61880219816199,NaN,NaN,NaN,NaN,NaN,NaN,0.028998447767816238,1.0029440241671708,0.9739455763993545,75.59539044875271,89.03946290797641,4550498954,3876544749.63598,30.912681134317243,10.613435426678127,40.125910255229996,100,0
2008-05-15,49.11,50.02,48.98,49.97,46.86963079536433,46.56010686911578,46.63194295342026,47.98693891579483,48.12433895000004,45.720697500000014,45.58559979999991,48.024000500000035,48.024000500000035,50.00436434137412,46.04363665862595,157248816,69.3973097036887,65.11484575598743,NaN,NaN,NaN,NaN,NaN,NaN,0.06496857224042074,1.0551562916998805,0.9901877194594597,98.32775919732427,90.0605510158125,4707747770,4018673487.1744404,29.12070440565427,9.758949963575516,41.442208894889646,100,0
2008-05-16,50.09,50.11,49.45,50.0099,46.90087725511195,46.62841960438081,46.7644118572077,48.17960187619532,48.13488850000003,45.702296400000016,45.742397799999914,48.188995000000034,48.188995000000034,50.25209784816443,46.125892151835636,146563184,69.58874611839745,65.591236439688,NaN,NaN,NaN,NaN,69.58874611839745,NaN,0.07762716184862772,1.0872216717702443,1.0095945099216166,96.75000000000007,90.22438321535901,4854310954,4120779172.0277743,28.3131444336517,9.249988201703859,42.62262020977731,100,14.285714285714286
2008-05-19,50.05,50.47,49.34,49.64999,46.928231610782476,46.68825268152178,46.87757178437602,48.3196388403672,48.14143845000004,45.67639620000002,45.893997399999904,48.31949500000003,48.31949500000003,50.40543151439978,46.233558485600284,140179632,65.60226699993066,65.64833253655948,NaN,NaN,NaN,NaN,NaN,NaN,0.04931908066355617,1.0712433607510619,1.0219242800875057,76.1625000000001,90.41341973244147,4714131322,4057509777.414819,28.624154985084548,8.43852676185547,43.9617239609064,100,7.142857142857143
2008-05-20,49.45,49.47,48.89,49.27,46.95153278878464,46.739376390798576,46.971392498714216,48.41014942699889,48.15068845000003,45.644096200000014,46.05419759999992,48.465995000000035,48.465995000000035,50.37970710010922,46.55228289989085,137163632,61.590574167613106,65.67785521366538,NaN,NaN,NaN,NaN,NaN,NaN,-0.004576026576343484,1.0162042468670762,1.0207802734434197,63.07692307692321,78.66314102564111,4576967690,4100077801.1389585,26.914060707067083,11.471847336515406,44.05562535823808,92.85714285714286,0
2008-05-21,49.31,49.60001,48.02,48.17999,46.963756243622605,46.76790339296098,47.0187884791568,48.38822948157043,48.15173840000004,45.606596200000006,46.16119559999991,48.53249400000003,48.53249400000003,50.30412708900649,46.760860910993564,192807632,51.80429518191351,64.48946160529219,NaN,NaN,NaN,NaN,NaN,NaN,-0.1169847034389978,0.8745493941446725,0.9915340975836703,11.85522765501286,50.36488357731205,4384160058,3946317128.3907084,23.73877812150413,16.614662733567933,42.07699378800617,85.71428571428571,0
2008-05-22,48.3,48.69,48.11,48.35001,46.9775498133378,46.79923223666472,47.07099324468006,48.38458953094467,48.151938450000046,45.57149630000001,46.273995599999914,48.58649450000003,48.58649450000003,50.26426130385095,46.90872769614911,153198192,53.057223782512295,63.36942247250538,NaN,NaN,NaN,NaN,NaN,NaN,-0.17949710081442416,0.76716272156564,0.9466598223800642,18.39946728457552,31.11053933883719,4537358250,3919908929.707673,22.680945047311404,15.87429018085409,39.8063534207402,78.57142857142857,21.428571428571427
2008-05-23,48.17999,48.35049,47.82001,48.2,46.989713496787175,46.82697021217631,47.11526801939849,48.367009575616606,48.148738450000046,45.541296300000006,46.37719579999992,48.63899500000003,48.63899500000003,50.194965051802754,47.083024948197306,121708064,51.77822529580781,62.25523978860615,NaN,NaN,51.77822529580781,NaN,NaN,NaN,-0.2274729304418438,0.6623186593277595,0.8897915897696033,14.33929939358262,14.864664777723661,4415650186,3972563130.974451,21.72729266229561,17.505325024792494,37.04336137479745,71.42857142857143,100
2008-05-27,48.32001,49.11,48.28999,49.05,47.010213860003226,46.87099060401441,47.19113986177502,48.43205628270074,48.15543840000005,45.52729630000001,46.51319579999991,48.72949450000003,48.72949450000003,50.15449814212383,47.30449085787623,106987744,57.96196641525137,61.48093637747541,NaN,NaN,NaN,NaN,NaN,NaN,-0.19948578994373822,0.6404343523399305,0.8399201422836687,46.41489213166827,26.384552936608802,4522637930,4063894322.883622,26.177002997137162,16.243590340137075,35.67317409554221,64.28571428571429,92.85714285714286
2008-05-28,49.28,49.36,48.75,49.25,47.03250028925692,46.91809970096462,47.271879475038745,48.50995568434829,48.16528840000005,45.51359630000001,46.66859579999991,48.81199400000003,48.81199400000003,50.154547111807204,47.46944088819285,121369120,59.284962923452774,61.403150209098335,NaN,NaN,NaN,NaN,NaN,NaN,-0.1663804765840795,0.6319445465535694,0.7983250231376489,53.96209042298269,38.2387606494112,4644007050,4141490973.375426,26.909317212043536,15.440204738651738,35.05761507080056,57.142857142857146,85.71428571428571
2008-05-29,49.27,49.97,49.25,49.69,47.05894307244839,46.972988815797,47.36670773091958,48.6223408572675,48.175738350000046,45.526496400000006,46.79579579999991,48.93599350000002,48.93599350000002,50.11151624073189,47.76047075926816,143993008,62.11014603076066,61.38377681501727,NaN,NaN,NaN,NaN,NaN,NaN,-0.11610717278285176,0.6531910571590842,0.769298229941936,70.56592666387411,56.98096973950836,4788000058,4173489419.597647,30.32891350857307,14.52692651932242,35.023938005149674,50,78.57142857142857
2008-05-30,49.89,50.24001,49.75,50.00999,47.088306723468804,47.03312745310795,47.470365859118814,48.75449791848012,48.19183835000004,45.54489630000001,46.950795799999916,49.001493000000025,49.001493000000025,50.260162172566865,47.742823827433185,94163568,64.0631374623052,61.628596484112826,NaN,NaN,NaN,NaN,NaN,NaN,-0.0651028409319716,0.6879196787769715,0.7530225197089431,82.64106657006262,69.05636121897315,4882163626,4179248653.3540206,31.199553349244592,13.852845928923156,35.538380133596746,42.857142857142854,71.42857142857143
2008-06-02,49.92,49.92,48.96001,49.39999,47.11130854711588,47.07999601839294,47.54603739405533,48.81597335481535,48.209338350000046,45.56969620000001,47.07699559999991,49.03299250000002,49.03299250000002,50.29842577835342,47.76755922164662,144359872,57.932855456992286,61.09111267065441,NaN,NaN,NaN,NaN,NaN,NaN,-0.07551545284856687,0.6586282036482345,0.7341436564968014,59.62211178155396,70.94303500516357,4737803754,4167214027.4140015,28.482424911180587,19.198849152965504,34.01917988619182,35.714285714285715,64.28571428571429
2008-06-03,49.59,49.89999,48.67,49.13,47.131395029234135,47.120590156642585,47.608153574680614,48.84588065435674,48.227738350000045,45.581796200000014,47.16799759999991,49.057992500000026,49.057992500000026,50.310279560526624,47.80570543947343,167679872,55.40571522410228,60.325954532277834,NaN,NaN,NaN,NaN,NaN,NaN,-0.10200641008511013,0.6066356438904137,0.7086420539755238,49.43377144819419,63.89898326660359,4570123882,4124954266.3417325,25.662918577906403,19.632369880313554,31.943461195171125,28.571428571428573,57.142857142857146
2008-06-04,48.97,50.10001,48.94,49.75999,47.1575502030726,47.17285550007541,47.69253931685,48.93293868727515,48.24498830000004,45.59949600000001,47.26659739999991,49.099492500000025,49.099492500000025,50.38658886467659,47.81239613532346,174967376,59.811075683170095,59.95632146042129,NaN,NaN,NaN,NaN,NaN,NaN,-0.07951914860133802,0.6092431182238514,0.6887622668251894,73.20706870591971,60.75431731188928,4745091258,4197349410.744558,24.893708170785406,17.8388439661283,29.631051350037133,21.428571428571427,50
2008-06-05,49.87,50.61,49.7,50.55,47.19130592244502,47.239729648588764,47.80459659854216,49.08694452658228,48.265088300000045,45.634496000000006,47.38359739999991,49.224993000000026,49.224993000000026,50.56286475841708,47.887121241582975,126653632,64.54155885194538,59.60948211386822,NaN,NaN,NaN,NaN,64.54155885194538,NaN,-0.017118765106030276,0.6673638104426516,0.6844825755486819,97.84945465754348,73.49676493721911,4871744890,4307301464.898403,27.12551997223111,16.56070495425837,27.801351871931363,100,42.857142857142854
2008-06-06,50.11,50.21001,49.02,49.03,47.20960138590328,47.27518054663651,47.85265163389345,49.08152123833635,48.275138300000044,45.64609600000001,47.489997199999905,49.256493500000026,49.256493500000026,50.54389793528045,47.969089064719604,189135936,51.88685116597245,58.34506104583785,NaN,NaN,NaN,NaN,NaN,NaN,-0.08035316566112294,0.5840411184722782,0.6643942841334012,43.368972648647464,71.4751653373702,4682608954,4121344257.413289,24.010585872515094,19.762708493895406,24.869539204679164,92.85714285714286,35.714285714285715
2008-06-09,49.11,49.19,47.95,48.77,47.2251277402724,47.30478093185163,47.88862607962312,49.051852548970984,48.28068830000004,45.66829600000001,47.59559699999991,49.284493000000026,49.284493000000026,50.50210703323473,48.06687896676532,208897248,50.07811555770383,57.23619308567879,NaN,NaN,NaN,NaN,NaN,NaN,-0.13842476561320627,0.49136332711689334,0.6297880927300996,34.04994283133635,58.42279004584242,4473711706,4188730466.4455485,21.823297236255407,25.823164288770013,21.578925107900492,85.71428571428571,28.571428571428573
2008-06-10,48.28,48.94,48.16,48.53999,47.23821094683685,47.32924051735952,47.91416976277516,49.003103734783274,48.28573825000004,45.693195900000006,47.691996799999906,49.256992500000024,49.256992500000024,50.515106271454115,47.99887872854593,162798496,48.46845248889401,56.298898680056006,NaN,NaN,NaN,NaN,NaN,NaN,-0.18798682315996085,0.3948045637801485,0.5827913869401093,25.805827261029634,34.40824758033781,4310913210,4184551971.7148843,20.554842171818027,24.322221366750345,19.305069930263056,78.57142857142857,21.428571428571427
2008-06-11,48.45,48.52,47.35001,47.38,47.239621783186735,47.33024565562963,47.89322192894084,48.848522426708676,48.28163825000004,45.71289590000001,47.727796799999915,49.164992500000025,49.164992500000025,50.66610566759374,47.66387933240631,170367248,41.26471239754281,55.546071338315244,NaN,NaN,41.26471239754281,NaN,NaN,NaN,-0.2885378304316196,0.2221190989005848,0.5106569293322044,0.9199414722132598,20.258570521526405,4140545962,4022918668.052051,18.76304900999413,28.135558642481406,19.4715219029868,71.42857142857143,100
2008-06-12,47.71001,48.11,47,47.42,47.24141659131423,47.33202296937954,47.87466420623728,48.71247267178404,48.279338250000045,45.7335958,47.76639659999991,49.080492500000034,49.080492500000034,50.763696192937324,47.39728880706274,189917120,41.587114578152544,54.726777823718116,NaN,NaN,NaN,NaN,NaN,NaN,-0.33853847913158386,0.08748383041772456,0.4260223095493084,11.634349030470963,12.786705921237953,4330463082,3976722611.8358355,17.252311478148705,28.40906348290938,19.95576335707161,64.28571428571429,100
2008-06-13,47.7,48.47,47.46001,48.37,47.25264627697279,47.35257696998588,47.89408913932601,48.67985622685223,48.28748820000004,45.7754959,47.8219965999999,49.00049250000003,49.00049250000003,50.65889229254743,47.34209270745263,167855008,48.77830971983795,54.512498139720265,NaN,NaN,NaN,NaN,NaN,NaN,-0.2953883540276748,0.056786867014714915,0.35217522104238974,37.950138504155056,16.834809668946427,4498318090,4111338675.2918296,18.543535095414654,26.255503555515002,20.416707176532586,57.142857142857146,92.85714285714286
2008-06-16,48.12,49.02,48.07001,48.8,47.26804283143077,47.38123881216438,47.92961505543087,48.69129849096154,48.29108820000004,45.823295900000005,47.880796599999904,48.939997500000025,48.939997500000025,50.53370702187688,47.34628797812317,136343808,51.67809597180443,54.063650250902626,NaN,NaN,NaN,NaN,51.67809597180443,NaN,-0.22862706476945727,0.06639139008056816,0.2950184548500254,49.86149584487528,33.148661126500436,4634661898,4184533107.487872,21.25017928061041,24.449632264904885,19.244173836639998,50,85.71428571428571
2008-06-17,48.95,49.06,48.47,48.53999,47.2806990221628,47.40418438024034,47.95355132776692,48.676888158489014,48.29213815000005,45.859595799999994,47.936396599999895,48.88449750000003,48.88449750000003,50.45254481118641,47.316450188813654,122952560,49.84070108889363,53.389060119862684,NaN,NaN,NaN,NaN,NaN,NaN,-0.19408023122801588,0.05241816581500558,0.24649839704302146,42.65900277008319,43.49021237303784,4511709338,4090751563.3332973,20.613771693225186,23.374347247557694,17.758009170506377,42.857142857142854,78.57142857142857
2008-06-18,48.25999,48.45,47.83,48.02,47.288055250797996,47.41637874894845,47.956157158050566,48.614327381490064,48.28788815000004,45.899895699999995,47.9885965999999,48.82199750000003,48.82199750000003,50.422902281715686,47.221092718284375,169338064,46.2956249031333,52.2594514678893,NaN,NaN,NaN,NaN,NaN,NaN,-0.1976847646662648,-0.0006075587898095591,0.19707720587645525,28.254847645429454,40.25844875346264,4342371274,4025201345.0107183,19.50224287416725,26.97457620066672,16.390092472292416,35.714285714285715,71.42857142857143
2008-06-19,47.92,49.00999,47.61,48.77,47.302800969695525,47.443183130157394,47.98807256361721,48.629153345157675,48.283338200000046,45.94429569999999,48.0659967999999,48.85149800000003,48.85149800000003,50.42551230238467,47.27748369761539,221366496,51.638689735811646,51.3719909159969,NaN,NaN,NaN,NaN,NaN,NaN,-0.14351452177555302,0.017684053657013976,0.161198575432567,49.03047091412752,39.98144044321339,4563737770,4170673376.9430614,21.608135783974145,24.2032116970564,14.044470819725516,28.571428571428573,64.28571428571429
2008-06-20,48.34,48.35001,47.21001,47.42,47.30396712920104,47.442724058273086,47.96579520818124,48.51399588371409,48.27453825000004,45.974395699999995,48.10359699999991,48.80499750000003,48.80499750000003,50.48678556633931,47.12320943366075,197434128,43.28988349732279,50.32606434744908,NaN,NaN,NaN,NaN,NaN,NaN,-0.18966185740164496,-0.07587874631948921,0.11378311108215575,11.634349030470963,29.63988919667598,4366303642,4045974674.4495893,19.236506580122715,24.360968530179846,13.493325626688172,21.428571428571427,57.142857142857146
2008-06-23,47.62,47.74001,46.98,47.05,47.30144009308959,47.434947344247874,47.9298816706055,48.374567704312746,48.26408825000004,46.00119569999999,48.1589969999999,48.74749750000002,48.74749750000002,50.57997804562173,46.915016954378316,131548496,41.318174005749356,49.31981140328103,NaN,NaN,NaN,NaN,NaN,NaN,-0.233293599900258,-0.17783388879316675,0.05545971110709124,1.9283746556473893,20.864398200081958,4234755146,3938658477.2877626,18.189082719790118,24.68239149936233,13.624192394644654,14.285714285714286,100
2008-06-24,46.83,47.37,46.41,46.81,47.296550141914565,47.42257214931227,47.88596474234647,48.22556125628296,48.25698825000004,46.017995699999986,48.2135969999999,48.63549750000003,48.63549750000003,50.64554394475701,46.62545105524305,178293680,40.044115372561336,47.907885666808966,NaN,NaN,NaN,NaN,NaN,NaN,-0.26423334972097395,-0.27483197604412624,-0.010598626323152262,9.523809523809653,7.6955110699760025,4056461466,3908942863.954431,16.934752942207005,27.0748140626528,14.090709487043336,7.142857142857143,100
2008-06-25,47.00999,48,46.94,47.57001,47.299271135527356,47.42549171071203,47.87357436029367,48.16312780330363,48.25383830000004,46.03779679999999,48.2821971999999,48.55149800000003,48.55149800000003,50.59198644743299,46.511009552567074,179023376,45.749022881085885,46.56556166889043,NaN,NaN,NaN,NaN,NaN,NaN,-0.2211755483576092,-0.28706806177016375,-0.06589251341255456,30.526498614477507,13.992894264644848,4235484842,3942724237.225678,19.9700111560162,24.79246986631108,13.132855067838287,0,92.85714285714286
2008-06-26,46.7,46.7,45.64,45.64999,47.28286037795992,47.39033326099496,47.78637497361548,47.923781345846145,48.23743830000005,46.044796699999985,48.28779699999991,48.349497500000034,48.349497500000034,50.67863654052958,46.020358459470486,190028256,36.34123350027371,45.45516040705481,NaN,NaN,NaN,NaN,NaN,NaN,-0.3045238263272967,-0.44654729632167545,-0.14202346999437876,0.2814084507042803,13.44390552966381,4045456586,3756277834.579339,17.407070106302935,30.25520100300163,14.365165032804368,0,100
2008-06-27,45.58,45.89999,44.97,45.64999,47.26661291151256,47.355871018202976,47.7025951707286,47.707229789098896,48.22098825000005,46.06459749999999,48.29539679999991,48.13149750000004,48.13149750000004,50.60956403464249,45.653430965357586,181351744,36.341233500273695,44.47395454580981,NaN,NaN,NaN,NaN,NaN,NaN,-0.33950646919033056,-0.566406556482292,-0.22690008729196143,16.625672371638217,15.811193145606667,4045456586,3840127592.5364785,16.320172910735227,32.864479585152274,16.16818249332939,0,100
2008-06-30,45.53,45.83,45.14999,45.17,47.24575109149751,47.3125864435851,47.60327771305297,47.46558885680376,48.200938300000054,46.088197499999985,48.26459659999991,47.919998000000035,47.919998000000035,50.63921929296346,45.20077670703661,132929376,34.296434876250444,43.46166757347812,NaN,NaN,NaN,NaN,NaN,NaN,-0.3721986575590829,-0.692148409240815,-0.3199497516817321,4.8899755501223146,7.265685457488271,3912527210,3715021386.236218,15.555344306265203,31.324318571220143,17.971199953854413,35.714285714285715,92.85714285714286
2008-07-01,44.86,45.86,44.67999,45.81,47.2314650109851,47.28283225658341,47.53295309685481,47.307913727584356,48.18388830000004,46.11519749999999,48.23999679999991,47.75399800000003,47.75399800000003,50.56140566261208,44.94659033738798,245494256,39.208103307272125,43.314766924173064,NaN,NaN,NaN,NaN,NaN,NaN,-0.3294179935609585,-0.7317222436329303,-0.40230425007197174,25.79925616608191,15.771634695947482,4158021466,3939711220.5787754,14.302740578926345,32.00925759667498,19.27466332756823,28.571428571428573,100
2008-07-02,45.96001,46.13,44.64,44.71001,47.20637590639818,47.23188528120552,47.42224944599776,47.060494324957276,48.16338835000005,46.12629749999999,48.2073969999999,47.50149900000003,47.50149900000003,50.44681504621703,44.55618295378303,199725504,34.4424004127122,42.804430198070186,NaN,NaN,NaN,NaN,NaN,NaN,-0.35186632757423647,-0.8421371595397673,-0.49027083196553084,1.5839366515836273,10.757722789262617,3958295962,3758754552.1962776,14.679561327366475,28.850130377161282,19.854672293487038,21.428571428571427,100
2008-07-03,44.98,45.08,44.28,44.63,47.18074032523999,47.180362800389574,47.312749467723336,46.82901867496135,48.13633840000004,46.131897399999986,48.1629967999999,47.20549900000003,47.20549900000003,50.05415697246769,44.356841027532376,123118192,34.11756055032055,41.75723382881894,NaN,NaN,34.11756055032055,NaN,NaN,NaN,-0.3481274398057629,-0.9254301317227345,-0.5773026919169716,7.322175732217601,11.56845618329438,3835177770,3743364778.1962786,13.887076866407241,29.7219902670585,21.218706057059105,14.285714285714286,100
2008-07-07,45.05,45.46001,44.24001,44.89999,47.158046292153024,47.135206903352156,47.21813144938125,46.645301658298365,48.10998835000004,46.142697199999986,48.11559659999991,46.99899850000003,46.99899850000003,49.88718062516496,44.110816374835096,181011248,36.30078350466958,40.65885436688074,NaN,NaN,NaN,NaN,NaN,NaN,-0.3050412722398772,-0.9586042822168181,-0.653563009976941,13.692559528131882,7.532890637311037,4016189018,3758195830.9422474,15.292841673344238,27.301421297826835,22.732415397560374,7.142857142857143,100
2008-07-08,44.95,46.00999,44.77,45.97,47.146224936012196,47.11213349932538,47.16918511803296,46.580987214650904,48.089688350000046,46.15459719999999,48.0919967999999,46.85899850000003,46.85899850000003,49.660368576966114,44.05762842303394,206255312,44.19368375255653,40.25549598571381,NaN,NaN,NaN,NaN,44.19368375255653,NaN,-0.1878009819104316,-0.8883142373649804,-0.7005132554545488,36.268286240193866,19.094340500181115,4222444330,3951147568.031352,17.67135057111409,25.066905954980832,23.520170277502853,0,92.85714285714286
2008-07-09,45.96001,46.03,44.73,44.75,47.12238190182302,47.06535857854666,47.07431511340422,46.40660747992224,48.06163835000004,46.16239719999999,48.042196599999905,46.66949900000003,46.66949900000003,49.50295316693196,43.8360448330681,168576320,38.35772699827153,39.68850327822367,NaN,NaN,NaN,NaN,NaN,NaN,-0.1759433056794224,-0.9204423875538268,-0.7444990818744044,10.691659084524495,20.217501617616747,4053868010,3787758211.7236605,16.176516644276628,23.2067554065317,23.64683281590724,7.142857142857143,85.71428571428571
2008-07-10,44.82001,45.42,44.38,45.28,47.10404974359592,47.03000494332791,47.003949814839345,46.29931152945346,48.03508835000003,46.17699709999999,47.9957963999999,46.564499000000026,46.564499000000026,49.440180080388686,43.68881791961137,238811440,41.94443825178823,38.99605674365058,NaN,NaN,NaN,NaN,NaN,NaN,-0.11867708728249582,-0.8928454409775242,-0.7741683536950283,25.303892944039006,24.087946089585788,4292679450,3962274264.0313525,15.077681741211219,23.916403113827315,24.86127030896269,0,78.57142857142857
2008-07-11,44.81,45.27,43.85001,44.56,47.07873581579895,46.98109395435112,46.90810864562996,46.13366281236266,48.00253830000003,46.18519699999999,47.94279619999989,46.421499000000026,46.421499000000026,49.39554885366861,43.447449146331444,265514624,38.6540015491925,38.66492231878413,NaN,NaN,NaN,NaN,NaN,NaN,-0.1154532548461844,-0.9184849222527589,-0.8030316674065745,17.108233995744673,17.701262008102727,4027164826,3962272394.1968894,13.699701801103114,25.11785131355112,26.122761688536116,0,100
2008-07-14,45.13,45.17999,44.07001,44.23,47.050390185791,46.92661684634417,46.80308477717388,45.95236159213764,47.967088250000025,46.18809699999999,47.8533961999999,46.21449900000003,46.21449900000003,49.19355570911165,43.235442290888415,177389808,37.21307819388659,38.37170118936535,NaN,NaN,NaN,NaN,NaN,NaN,-0.12111911136795239,-0.954430556616515,-0.8333114452485626,9.156407605801439,17.18951151519504,3849775018,3836019715.481956,12.727371373526154,23.33512264820505,27.141970550427704,14.285714285714286,92.85714285714286
2008-07-15,44.00999,44.92999,43.3,44.24001,47.022426203842834,46.87341671077299,46.70257204081412,45.78928048812453,47.93038830000003,46.19529709999999,47.7627963999999,45.98649950000003,45.98649950000003,48.834235805581706,43.13876319441835,283890944,37.289442762338275,38.17493886006371,NaN,NaN,NaN,NaN,NaN,NaN,-0.11008514031616345,-0.9709178706437669,-0.8608327303276034,20.000212765957453,15.421618122501187,4133665962,3879566763.4566803,11.442982682498839,25.747511496922726,28.243561927132784,7.142857142857143,100
2008-07-16,44.3,45.38,43.92,45.34,47.00568564460062,46.84305202343096,46.64913784313514,45.74649187020791,47.900038300000034,46.21189719999998,47.6969963999999,45.826500000000024,45.826500000000024,48.43163575080271,43.221364249197336,186047808,45.17989532734267,38.134286891939205,NaN,NaN,NaN,NaN,NaN,NaN,-0.01935157635531204,-0.8850222007717434,-0.8656706244164314,60.000000000000085,29.718873457252993,4319713770,4055420171.0183244,13.162128507489513,23.463476682869384,29.48303649077629,0,92.85714285714286
2008-07-17,45.56,45.82001,44.9799,45.64,46.992096732714046,46.81922921108579,46.609563810071016,45.736349787330965,47.86823830000003,46.22929729999999,47.631196599999896,45.707500000000024,45.707500000000024,48.11057225861239,43.304427741387656,197555056,47.133596863232185,38.90516998929338,NaN,NaN,NaN,NaN,NaN,NaN,0.06557035832975111,-0.7837076765042426,-0.8492780348339937,82.68551236749113,54.22857504448289,4517268826,4168315157.1928005,15.2054025532064,22.240868808159973,28.899576190165337,0,85.71428571428571
2008-07-18,45.17,45.17,44.59,44.59,46.96819527268704,46.775086058391025,46.530365229283916,45.627173617108966,47.83113835000003,46.234497199999986,47.562196799999896,45.49850000000003,45.49850000000003,47.49199248308352,43.505007516916535,160661008,41.551948429687194,39.277363912822906,NaN,NaN,NaN,NaN,NaN,NaN,0.0560946339676891,-0.7791597423743823,-0.8352543763420714,45.58303886925808,62.756183745583094,4356607818,4007654149.1928005,14.20886849089574,23.216893488806043,28.216141664082187,21.428571428571427,78.57142857142857
2008-07-21,45,45.19,44.49001,44.78,46.94642218539662,46.73557940376942,46.46172345558651,45.54649041547954,47.79678840000003,46.23939729999999,47.48979699999989,45.36650000000003,45.36650000000003,47.17457419098541,43.55842580901465,128107744,42.87033437026512,39.88978530525253,NaN,NaN,NaN,NaN,NaN,NaN,0.06695507094670483,-0.7515605376586905,-0.8185156086053953,52.2968197879859,60.18845700824503,4484715562,3985690677.775439,13.570351381762617,22.815489774047464,27.628390441446708,14.285714285714286,71.42857142857143
2008-07-22,44.02,44.81,43.86,44.78,46.92486574574093,46.696855059140326,46.39577351615174,45.47349132829101,47.76183840000002,46.24599729999999,47.4211967999999,45.25300000000003,45.25300000000003,46.90211045115493,43.603889548845125,152524432,42.87033437026512,40.15137323832346,NaN,NaN,NaN,NaN,NaN,NaN,0.0777145375492696,-0.7213724366688083,-0.799086974218078,52.2968197879859,50.058892815076625,4484715562,4128581987.754386,12.733989945877411,25.49654441111301,27.281964351652185,7.142857142857143,64.28571428571429
2008-07-23,44.84,45.89,44.72,45.37,46.90939444478828,46.67058070153359,46.355547103753636,45.46363501131091,47.72459845000002,46.27019729999998,47.3467967999999,45.181000000000026,45.181000000000026,46.669864426370026,43.692135573630026,169259056,47.16255567254954,41.05995575688326,NaN,NaN,NaN,NaN,NaN,NaN,0.12532198335882772,-0.6424344950195433,-0.767756478378371,75.82417582417573,60.13927180004918,4653974618,4147388549.532163,18.747047666099707,23.569875314919184,25.770758894962544,0,57.142857142857146
2008-07-24,45.59,45.61,44.64999,44.69,46.88731091797447,46.63136128170124,46.290231531057415,45.38995548642416,47.68229850000002,46.290397299999974,47.2561967999999,45.03699950000003,45.03699950000003,46.05705594357958,44.01694305642048,145560944,43.139660374422256,41.704391458604825,NaN,NaN,NaN,NaN,NaN,NaN,0.11219530049590176,-0.6275123527584938,-0.7397076532543956,50.91575091575086,59.67891550930417,4508413674,4013960590.3332367,17.573606591403017,22.551027665068315,24.06317627992028,21.428571428571427,50
2008-07-25,44.98,45.48,44.75999,45.27,46.87121827202447,46.604403632558636,46.250222451408106,45.37853115438376,47.64174800000003,46.31399729999998,47.17939679999991,45.018000000000036,45.018000000000036,46.005308259900964,44.03069174009911,111616688,47.27103351709741,42.48798074520681,NaN,NaN,NaN,NaN,NaN,NaN,0.14184430542879622,-0.5624022714684003,-0.7042465768971965,72.16117216117227,66.30036630036629,4620030362,4060468447.955882,16.650016855889856,21.365847060938968,22.935458418795218,14.285714285714286,42.857142857142854
2008-07-28,45.27,45.52,44.21001,44.42,46.846828040462036,46.561148115082226,46.17844902194112,45.287242473013876,47.59629805000003,46.32699829999998,47.0683967999999,44.95650050000003,44.95650050000003,45.93184011984979,43.98116088015028,124028432,42.40798878476887,42.360431104650544,NaN,NaN,42.40798878476887,NaN,NaN,NaN,0.10516748181460567,-0.5727872246289394,-0.677954706443545,41.025641025641136,54.700854700854755,4496001930,3976203266.722194,15.221452328101087,23.134835397590074,23.17309809974548,7.142857142857143,35.714285714285715
2008-07-29,44.63,45.53999,44.57001,45.34,46.831834726626596,46.53696696428852,46.14556866813951,45.292266999393505,47.55969805000004,46.35869829999998,46.9749987999999,44.96500050000003,44.96500050000003,45.95054417739326,43.9794568226068,142291440,48.574572889557565,43.090205811170975,NaN,NaN,NaN,NaN,NaN,NaN,0.14155914050437124,-0.501005780813081,-0.6425649213174522,78.76447876447891,63.983763983764106,4638293370,4059819548.29501,14.237701140051035,21.44103663431702,23.340141693890406,0,28.571428571428573
2008-07-30,45.46001,45.82001,44.88,45.57001,46.81927925670991,46.51781930162934,46.12299773997718,45.31871871373698,47.51989810000003,46.39369829999997,46.893399199999905,44.953001000000036,44.953001000000036,45.90227591068968,44.00372608931039,165679872,50.01556233096379,43.66671467396923,NaN,NaN,NaN,NaN,NaN,NaN,0.17748480567440872,-0.42070891422444134,-0.5981937198988501,87.64517374517388,69.14509784509796,4803973242,4137372766.323244,15.202946131090467,20.110228591618213,22.71368723305145,64.28571428571429,21.428571428571427
2008-07-31,45.11,46.14999,45.02,45.46001,46.80575418947897,46.496872582785194,46.09699822076239,45.33217502671441,47.48159815000004,46.43569849999998,46.8171993999999,44.99050100000004,44.99050100000004,45.95750697519556,44.02349502480452,180730816,49.30402786457568,44.42743083935375,NaN,NaN,NaN,NaN,NaN,NaN,0.18913194475325523,-0.361778788957281,-0.5509107337105362,75.79009049154543,80.73324766706607,4623242426,4097392516.873672,16.24413795579288,18.61451585165389,21.09833413356694,100,14.285714285714286
2008-08-01,45.52,45.55,44.39999,44.88,46.78659245625032,46.46485530391816,46.04927280034033,45.289110738455896,47.441648150000034,46.456197599999975,46.7511995999999,45.003001000000026,45.003001000000026,45.95742514893386,44.048576851066194,180377376,45.618817459459834,45.02784078689469,NaN,NaN,NaN,NaN,NaN,NaN,0.15452520162436822,-0.3577542316800759,-0.5122794333044441,55.43879101330189,72.95801841667372,4442865050,4067592864.9869585,15.019785084343928,21.27506604138021,20.228313451623517,92.85714285714286,7.142857142857143
2008-08-04,44.87,44.92,44.3,44.42999,46.76314367559111,46.424560941464335,45.98577151405247,45.20728971574581,47.39604810000004,46.473397399999975,46.6727991999999,44.97950100000003,44.97950100000003,45.96553473373755,43.993467266262506,116306816,42.93726886359527,45.43125693698448,NaN,NaN,NaN,NaN,NaN,NaN,0.10068566597858669,-0.3864223508312108,-0.4871080168097975,24.890501705247463,52.039794403364915,4326558234,4000056123.2187,14.390065136512328,21.059245656154935,18.82477229889697,85.71428571428571,0
2008-08-05,44.89999,45.97,44.84,45.92999,46.75485358926682,46.414767457474944,45.98358400369747,45.276118314246204,47.35679805000002,46.50229739999998,46.6273989999999,44.97750050000003,44.97750050000003,45.95561845305555,43.99938254694452,151727008,52.87990571045512,45.981257678635366,NaN,NaN,NaN,NaN,NaN,NaN,0.16182934563019435,-0.2848213347720545,-0.44665068040224887,90.39297114834538,56.90742128896491,4478285242,4141038710.705283,19.81443038082279,18.935611939998463,16.977760364286752,78.57142857142857,28.571428571428573
2008-08-06,45.92999,46.81,45.58,46.63,46.75361126499551,46.419029488019994,46.0089336506113,45.40505942717514,47.327748050000025,46.54609739999998,46.578998999999904,45.07150050000003,45.07150050000003,46.27863361365876,43.86436738634129,133463680,56.67389691969942,46.66270768266874,NaN,NaN,NaN,NaN,NaN,NaN,0.24041468962177437,-0.14613231837503093,-0.3865470079968053,93.89830508474579,69.72725931277954,4611748922,4235439850.2174783,23.683670349326636,17.4242862898672,16.723369992881867,100,21.428571428571427
2008-08-07,46.35001,46.85001,46.08,46.27,46.7487992126075,46.4160784090493,46.01917154666575,45.487434719825124,47.29374800000003,46.59399739999998,46.5193989999999,45.12100050000003,45.12100050000003,46.434756625043825,43.807244374956234,152805744,54.25449065918114,47.5700321276326,NaN,NaN,NaN,NaN,NaN,NaN,0.2576172418003993,-0.06452545574630619,-0.3221426975467055,80.60173711793624,88.29767111700914,4458943178,4158043753.780499,22.739665794509804,16.53457775925718,16.132679540127587,100,14.285714285714286
2008-08-08,46.25,47.44,46.14999,47.32001,46.75448290203429,46.433978044513665,46.07018481934553,45.6619656988894,47.25944810000003,46.63389749999998,46.4719991999999,45.25900100000003,45.25900100000003,46.8571132764392,43.660888723560866,143121440,59.663300374906065,48.76952969939266,NaN,NaN,NaN,NaN,NaN,NaN,0.3248408453967523,0.0839083591992349,-0.2409324861975174,96.64832402234653,90.38278874167618,4602064618,4274540374.46034,24.679423829884886,15.139831535779926,16.029009468933573,100,7.142857142857143
2008-08-11,47.3,48.28,47.14,47.75,46.76438854480012,46.460037885216366,46.13605992446923,45.86082610851898,47.229348100000024,46.68879759999998,46.42679939999991,45.435001000000035,45.435001000000035,47.29492181554747,43.5750801844526,157291120,61.66237079038479,50.111818015115496,NaN,NaN,NaN,NaN,NaN,NaN,0.37958409665523807,0.23354763462153016,-0.14603646203370788,86.97785498244465,88.07597204090915,4759355738,4285578347.793673,28.32110034974715,14.014750237904686,16.058250475487696,100,0
2008-08-12,47.75999,48.16,47.50999,47.8,46.77469313639415,46.48657178847941,46.20131247645083,46.045509336279075,47.20309810000003,46.73589759999998,46.39479959999991,45.613000500000034,45.613000500000034,47.65398396590324,43.57201703409683,140596944,61.8988333232753,51.164409275881624,NaN,NaN,NaN,NaN,NaN,NaN,0.3985199501507296,0.3521134756547042,-0.046406474496025446,88.20635922938376,90.61084607805833,4899952682,4270439534.3745556,27.085169178939623,13.403147353263826,17.65793577537087,92.85714285714286,21.428571428571427
2008-08-13,47.74001,48.12,47.25,47.7,46.78390016986286,46.51060006989566,46.26008453619786,46.20307987568107,47.17194815000003,46.76709859999998,46.36619959999991,45.731000500000036,45.731000500000036,47.95948093206305,43.50252006793702,169664496,61.08730675652645,52.446384017460495,NaN,NaN,NaN,NaN,NaN,NaN,0.38353881455136163,0.4330170436931766,0.04947822914181496,85.74935073550554,86.97785498244467,4730288186,4276290034.236626,25.482270113969204,14.378478012261242,18.76161835073564,85.71428571428571,14.285714285714286
2008-08-14,47.53999,48.46001,47.49001,48.25,46.798488227874174,46.54504363286802,46.33812043673912,46.39802464942573,47.14239815000002,46.80129859999998,46.33599979999991,45.861500500000034,45.861500500000034,48.344526781392815,43.37847421860725,158069120,63.89131522628444,53.633546996688146,NaN,NaN,NaN,NaN,63.89131522628444,NaN,0.38869182209307707,0.5353430067581613,0.14665118466508423,95.0585882352942,89.67143273339451,4888357306,4365913595.698071,26.117198518576686,13.424558361735361,20.168363497755422,100,7.142857142857143
2008-08-15,48.35001,48.57001,47.96001,48.16,46.812035608691346,46.577022966870636,46.4095666941219,46.5658318256709,47.11189820000002,46.83589859999998,46.2881997999999,46.04000050000003,46.04000050000003,48.64216263946954,43.43783836053053,123116000,63.09016456731713,55.110845266870164,NaN,NaN,NaN,NaN,NaN,NaN,0.364465179192039,0.602232658655133,0.23776747946309398,90.39791475898168,90.40195124326048,4765241306,4323525362.386594,25.76958019832659,12.847321249195648,21.084895566711094,100,0
2008-08-18,48.28999,48.31,47.25999,47.60001,46.8198761498984,46.5972801358435,46.4562507453328,46.66432498513081,47.07474825000003,46.87479859999998,46.25959999999991,46.18100100000003,46.18100100000003,48.800338494883995,43.561663505116066,151399008,58.200058982524084,55.798379987796345,NaN,NaN,NaN,NaN,NaN,NaN,0.29226958754063687,0.60310446388889,0.3108348763482532,77.28342556574799,87.57997618667463,4613842298,4270180069.4943724,23.867172909188618,16.820561401464804,20.879847447472702,92.85714285714286,28.571428571428573
2008-08-19,47.36,47.59,46.75,47.00999,46.82176782999891,46.60545260840105,46.477966010221714,46.6972454627374,47.03979820000002,46.909998399999985,46.2243997999999,46.29250050000003,46.29250050000003,48.85298563960313,43.73201536039693,155418560,53.49524057138705,56.04692843354086,NaN,NaN,NaN,NaN,NaN,NaN,0.19121001438288032,0.5498473943268536,0.35863737994397327,63.46565933100861,77.0489998852461,4458423738,4210969298.5762773,22.423980774843123,19.431407261716284,20.39794239130239,85.71428571428571,21.428571428571427
2008-08-20,47.36,47.56,46.74001,47.09,46.824436806814845,46.6150476062545,46.5019673431542,46.73465065676241,47.003148200000034,46.94369839999999,46.19539999999991,46.37850050000003,46.37850050000003,48.9247722463242,43.83222875367586,155466688,54.03784340783808,56.38505811520246,NaN,NaN,NaN,NaN,NaN,NaN,0.11968070961030841,0.5082382669568588,0.3885575573465504,65.33942543460091,68.69617011045251,4613890426,4188215902.526473,21.098584637486425,18.35490027295311,20.408960673094203,78.57142857142857,14.285714285714286
2008-08-21,46.73,47.08,46.38,46.87,46.82489017192116,46.62009616850688,46.51639999636384,46.74754107040409,46.96714815000003,46.95649839999998,46.1851999999999,46.48750050000003,46.48750050000003,48.91938934822637,44.055611651773695,118920944,52.233188010011744,56.8575131545276,NaN,NaN,NaN,NaN,NaN,NaN,0.05099137544990057,0.4522967766589261,0.4013054012090255,60.187212676316825,62.997432480642125,4494969482,4235784280.1264725,19.99648435941,20.04476492652288,19.18652878250536,71.42857142857143,7.142857142857143
2008-08-22,47.12,47.67999,47.08,47.49001,46.83150827966324,46.63732218497209,46.55458078082016,46.818252397032275,46.93119825000004,46.97649839999998,46.1866001999999,46.598501000000034,46.598501000000034,49.00044656394264,44.19655543605743,96525440,56.629158990468966,57.835505306447146,NaN,NaN,NaN,NaN,NaN,NaN,0.04117414437457989,0.4527730816772504,0.4115989373026705,71.04565403309897,65.5240973813389,4591494922,4271182357.6997657,23.257666149484628,18.835946086318188,18.593043426001344,64.28571428571429,0
2008-08-25,47.14999,47.21001,46.37,46.49001,46.82811028683077,46.63440511200235,46.55204859333702,46.78699121636254,46.89689825000003,46.98549849999998,46.149000399999906,46.70200150000004,46.70200150000004,48.88824801312696,44.51575498687311,128076432,48.82452445962215,57.54583521710193,NaN,NaN,NaN,NaN,NaN,NaN,-0.034707655318953645,0.36821436815397846,0.4029220234729321,30.435015267507406,53.889293992307735,4463418490,4179701805.7590985,21.341180311633074,22.507492652231655,18.62103926192996,57.142857142857146,0
2008-08-26,46.50999,46.77,46.12,46.42999,46.824148890941906,46.6303572880023,46.54726198183361,46.752991100518486,46.87039820000004,46.99119839999997,46.1016001999999,46.756501000000036,46.756501000000036,48.85687750629231,44.656124493707765,107233872,48.39342301731606,56.95437279550312,NaN,NaN,NaN,NaN,NaN,NaN,-0.08795316400791064,0.29298056846304377,0.3809337324709544,14.055766844309762,38.51214538163871,4356184618,4174749250.624574,20.295920220595,23.28889870061085,18.023919506542885,50,0
2008-08-27,46.45,47.09,46.28999,46.73,46.82321208605691,46.632330411012155,46.55442817862445,46.750801471897674,46.85404820000004,47.00089849999998,46.0654003999999,46.81450050000003,46.81450050000003,48.84346919915934,44.78553180084072,108489872,50.73497901954669,56.702979106957805,NaN,NaN,NaN,NaN,NaN,NaN,-0.10104272992736912,0.254630320061743,0.35567304998911214,24.89785755976498,23.12954655719405,4464674490,4185599458.3203764,21.497081116510486,21.86917118244297,16.956679141556236,42.857142857142854,0
2008-08-28,46.92,47.28,46.83,47.11,46.826065697140926,46.64178921475449,46.57621530887447,46.785010855526465,46.84594820000004,47.01789849999997,46.0472003999999,46.897000000000034,46.897000000000034,48.83091426907904,44.96308573092103,112808560,53.60635796587795,56.270340363455794,NaN,NaN,NaN,NaN,NaN,NaN,-0.0829420804446992,0.25199544943323815,0.33493752987793735,40.40799833470066,26.45387424625847,4577483050,4213174884.098154,22.06057891795811,20.92474466461712,15.434189327900537,35.714285714285715,85.71428571428571
2008-08-29,46.61,47.1217,45.92,46.12,46.81904016781614,46.631456755056384,46.55832451244802,46.72167648833347,46.822848150000034,47.030098599999974,45.9942003999999,46.95900000000003,46.95900000000003,48.70018821502664,45.21781178497342,133272128,46.07231405768081,55.156764882548366,NaN,NaN,NaN,NaN,NaN,NaN,-0.13348203181004992,0.16808499011537492,0.30156702192542484,7.5471413315419795,24.28433240866921,4444210922,4124263953.7348347,20.025687081720516,25.97967721803348,13.944862839419082,28.571428571428573,100
2008-09-02,46.86,47.08,45.34,45.55,46.806412902464736,46.610041769807744,46.518782374704955,46.61008825134933,46.800148150000034,47.03019869999997,45.9568003999999,47.01500050000003,47.01500050000003,48.47687260799347,45.553128392006585,162403184,42.37922954457074,53.762507469783756,NaN,NaN,NaN,NaN,NaN,NaN,-0.19728754287909522,0.05495759332655581,0.25224513620565103,6.501527859046682,18.152222508429777,4281807738,4001061538.2865577,17.507507917177893,26.90438075190936,13.042430277116145,21.428571428571427,100
2008-09-03,45.44501,45.63811,44.78999,45.12,46.789632674579515,46.58053599218779,46.46392816393221,46.468175084554154,46.77664810000003,47.03859869999997,45.918200399999904,46.97450100000003,46.97450100000003,48.59106063209122,45.35794136790884,161682816,39.78814717503683,52.24113892824879,NaN,NaN,NaN,NaN,NaN,NaN,-0.2566787282981064,-0.06860327416698198,0.18807545413112442,8.730377087951766,7.593015426180149,4120124922,3965202771.0253196,16.423440990895408,29.254008426295485,13.059076260428677,14.285714285714286,100
2008-09-04,44.85001,44.91,43.66,43.66,46.75849205095186,46.52270359630288,46.35397019671918,46.20072983840614,46.743548100000034,47.034398699999976,45.8552003999999,46.82600100000003,46.82600100000003,48.99360410760633,44.65839789239374,219363680,32.51830276473086,50.000209466709244,NaN,NaN,NaN,NaN,NaN,NaN,-0.3753368868300649,-0.2810956544064567,0.0942412324236082,0,5.077301648999491,3900761242,3745839091.0253196,14.732290444923066,34.2113330435865,13.60904809044782,7.142857142857143,100
2008-09-05,43.3,43.78,42.81,43.45,46.72557173203691,46.46185798053451,46.24008901253411,45.938755568081746,46.71229810000004,47.02749869999997,45.7728001999999,46.68500100000003,46.68500100000003,49.29969569730338,44.07030630269668,247977440,31.623289310144102,47.75257551976831,NaN,NaN,NaN,NaN,NaN,NaN,-0.444294630713576,-0.4611270559683618,-0.0168324252547858,11.636363636363647,6.7889135747718115,3652783802,3825089613.087176,13.721365288704717,37.876827423418405,14.562751520783918,0,100
2008-09-08,44.03999,44.22,42.67999,43.31,46.69158594365843,46.39944495121699,46.12518356106219,45.6883978949311,46.67934815000004,47.00689869999997,45.726000399999904,46.48450050000003,46.48450050000003,49.463309930307396,43.505691069692666,311074048,31.0105100921175,45.81046488473927,NaN,NaN,NaN,NaN,NaN,NaN,-0.47300636486864195,-0.6080903813405882,-0.1350840164719463,12.600200000000115,8.078854545454595,3341709754,3768533082.4805455,15.280663370997546,33.89960516351766,16.029880059336087,0,100
2008-09-09,43.35001,43.78999,42.35001,42.45,46.649381108398146,46.32123812049982,45.98105871553034,45.379979047794805,46.64504815000005,46.978698699999974,45.6620005999999,46.21950050000003,46.21950050000003,49.61472459894956,42.824276401050504,214180560,27.486971893005318,43.952731407712,NaN,NaN,27.486971893005318,NaN,NaN,NaN,-0.5198582040362255,-0.7849067715172282,-0.2650485674810027,1.8759920299889563,8.70418522211758,3127529194,3584097260.8719134,13.819446987115985,32.84925717221779,18.431779457887483,21.428571428571427,100
2008-09-10,42.87,43.17999,42.45,42.8,46.611078808812096,46.25151063296517,45.85631131492131,45.134266757528636,46.60984815000004,46.93959859999998,45.6146005999999,45.969500500000024,45.969500500000024,49.591177967982446,42.3478230320176,160658064,30.92677876965132,42.301941076412945,NaN,NaN,NaN,NaN,NaN,NaN,-0.4972196235423838,-0.8865730969089824,-0.38935347336659865,8.44262079782663,7.639604275938574,3288187258,3577496985.0607915,13.133789068776517,31.219426882141814,20.847647937896113,14.285714285714286,92.85714285714286
2008-09-11,42.17,43.69,42.17,43.60001,46.58111792514232,46.199005669936156,45.767828910414586,44.98814706633543,46.58294820000004,46.90519879999998,45.57040079999991,45.764501000000024,45.764501000000024,49.43498051146814,42.09402148853191,203440944,38.14908952062422,41.29593404145669,NaN,NaN,NaN,NaN,38.14908952062422,NaN,-0.4023606950620479,-0.8923043421941586,-0.48994364713211064,25.953041657062847,12.090551494959477,3491628202,3756848915.1784754,15.178155352357836,28.093789993628963,22.971006302652004,7.142857142857143,100
2008-09-12,43.23,43.71001,42.89999,43.42999,46.54976341842449,46.14417367647207,45.676148953143425,44.83975115525586,46.550298100000035,46.87609869999997,45.544800399999914,45.523500500000026,45.523500500000026,49.14213866181301,41.904862338187044,172094256,37.257490987065836,39.91224346978504,NaN,NaN,NaN,NaN,NaN,NaN,-0.3281961004021108,-0.9001887726347491,-0.5719926722326383,24.657338551859002,19.684333668916157,3319533946,3809958865.6918936,14.487662393703596,26.56728705936357,24.3223329920281,0,92.85714285714286
2008-09-15,42.39999,43.28999,42.03,42.08,46.505288160529716,46.06369498980926,45.535123504000545,44.57691771189816,46.50329810000004,46.82839859999997,45.49380039999991,45.219500500000024,45.219500500000024,48.92168787534045,41.517313124659594,616795136,31.051835425265423,38.6427656816167,NaN,NaN,NaN,NaN,NaN,NaN,-0.3454450473430548,-1.0037989814114567,-0.6583539340684019,0.9523809523808983,17.187587053767583,2702738810,3242116113.123505,13.157027329830134,29.8347390379384,26.903257729272955,21.428571428571427,100
2008-09-16,41.47,42.84,41.42999,42.41,46.46453902460405,45.99134459397145,45.412569641098564,44.37054459647929,46.45684810000003,46.779798599999964,45.44400059999991,44.96000000000002,44.96000000000002,48.685872091217334,41.23412790878271,349551360,33.94803110446475,37.61095197355589,NaN,NaN,NaN,NaN,NaN,NaN,-0.31108563670737177,-1.0472109799526166,-0.7361253432452448,16.752279055933226,14.120666186724376,3052290170,3378467446.457025,11.965077178140476,30.986993766498678,29.57606898951878,14.285714285714286,100
2008-09-17,41.84,42.42191,40.19,40.21001,46.402304904956246,45.876862720823496,45.20854769438882,43.974303206338405,46.40134815000004,46.71039879999998,45.32880079999991,44.62000100000002,44.62000100000002,48.754213713456686,40.48578828654336,340088064,26.08225224112745,35.850042917954525,NaN,NaN,26.08225224112745,NaN,NaN,NaN,-0.40692930863429255,-1.2447869790381105,-0.837857670403818,0.28222849083214646,5.995629499715424,2712202106,3044477443.902728,10.364464177843285,34.273861657979324,33.34067394968418,7.142857142857143,100
2008-09-18,41.12,41.97,39.5,41.57001,46.35422236858852,45.79157850852996,45.06585994166769,43.745322900972845,46.35479820000004,46.65369879999997,45.26520099999991,44.34400150000003,44.34400150000003,48.51860589707997,40.169397102920094,423934464,35.9604614549408,34.58962173860187,NaN,NaN,NaN,NaN,NaN,NaN,-0.3512397473800457,-1.2769073546288752,-0.9256676072488295,27.159426374693364,14.731311307152913,3136136570,3331108631.5826,8.939259217452534,33.40224306102726,37.27874897559497,0,100
2008-09-19,43.82001,43.83,42.10001,42.89999,46.319851897259284,45.73431933014323,44.980923865523856,43.6648150056421,46.31594815000004,46.60669859999997,45.21760079999991,44.14550100000003,44.14550100000003,48.196502386835704,40.09449961316436,263401440,43.86145220768893,34.43170303503102,NaN,NaN,NaN,NaN,43.86145220768893,NaN,-0.20460668991302966,-1.1814259696401166,-0.9768192797270869,44.85474934036944,24.09880140196498,3399538010,3311310777.697203,17.693337415223244,29.41644812657517,38.13179997611794,0,92.85714285714286
2008-09-22,42.75,42.84,40.8,40.88,46.26572401768456,45.63819419489287,44.82010332177782,43.39959452891428,46.26249810000003,46.543398499999974,45.1440007999999,43.81500050000003,43.81500050000003,47.7986221160834,39.83137888391666,164698192,36.49645149882544,34.01150460319207,NaN,NaN,NaN,NaN,NaN,NaN,-0.22197967728548185,-1.2542938763339393,-1.0323141990484574,22.482490538618617,31.49888875122714,3234839818,3159530090.952106,15.805972283015532,32.8820897016227,39.12565933563853,0,85.71428571428571
2008-09-23,41.17999,41.75,40.44,40.57001,46.20905024636432,45.53783411182568,44.65343299543359,43.130110288065296,46.20374810000004,46.46209859999997,45.07080099999991,43.51900050000003,43.51900050000003,47.543132044088466,39.4948689559116,185954496,35.51099871434448,33.70599399885691,NaN,NaN,NaN,NaN,NaN,NaN,-0.23160361381804906,-1.3218187163210189,-1.0902151025029698,19.778373382624846,29.038537753870965,3048885322,3010485433.1581535,14.74903656993502,32.52091651699945,39.80473556090963,0,78.57142857142857
2008-09-24,40.85001,41.25999,40.52,40.85001,46.15572646281841,45.44500591159151,44.50427915247541,42.912957879678125,46.14634815000004,46.38289869999998,45.00300099999991,43.240001500000034,43.240001500000034,47.19122953696786,39.28877346303221,159305184,37.16146353748832,34.037648339768154,NaN,NaN,NaN,NaN,NaN,NaN,-0.1976864377921319,-1.3373231497431348,-1.139636711951003,28.601906779660972,23.620923566968145,3208190506,2993269476.774308,14.17251760236374,31.24971991199063,39.64742336781911,0,71.42857142857143
2008-09-25,41.2112,42.02,41.03,41.5,46.10940082637245,45.3668869826491,44.38646428375089,42.77839046256592,46.09114820000004,46.311598699999976,44.92620099999991,42.97850150000003,42.97850150000003,46.653848713274165,39.30315428672589,148587008,40.9401944069758,34.70314156097042,NaN,NaN,NaN,NaN,NaN,NaN,-0.11419406554335554,-1.2823792938801972,-1.1681852283368417,42.372881355932215,30.25105383940601,3356777514,2985765082.4308734,17.341737603109173,29.29963660760815,38.13481006772195,7.142857142857143,64.28571428571429
2008-09-26,40.3,41.4902,40.22,41.08,46.059357037055314,45.281998131507535,44.25679901772144,42.6166389899406,46.039948150000036,46.23309879999998,44.83500099999991,42.67700150000003,42.67700150000003,45.90989088198026,39.4441121180198,182678560,39.295846000817384,35.29495126873469,NaN,NaN,NaN,NaN,NaN,NaN,-0.0720297195849331,-1.258222377818008,-1.1861926582330748,36.48960739030021,35.821465175297796,3174098954,3050454750.426464,16.15405321607408,31.626936939102663,37.7436934621062,0,57.142857142857146
2008-09-29,40.25999,40.38,37.17999,37.82001,45.977373484447796,45.13423599028956,44.004375918987265,42.15981718137483,45.97014820000004,46.13089899999997,44.69960119999992,42.26200200000003,42.26200200000003,45.74193029928061,38.78207370071945,307954432,29.418911023497785,35.43294692091273,NaN,NaN,NaN,NaN,NaN,NaN,-0.23905666130128256,-1.485013484859678,-1.2459568235583955,9.624346429554343,29.49561172526225,2866144522,2865685555.7029986,13.189957257251805,40.12649860664552,38.4398090681163,57.142857142857146,100
2008-09-30,37.74001,39.3,37.60001,38.91,45.907051360224436,45.01098379246204,43.80459647118384,41.85031078314865,45.90719820000004,46.035999099999984,44.582201199999915,41.93000200000003,41.93000200000003,45.35841304305421,38.50159095694585,195512752,35.27661849651436,35.74364975854581,NaN,NaN,NaN,NaN,NaN,NaN,-0.2502944013989057,-1.5588248253070276,-1.308530423908122,26.01514884940022,24.043034223084916,3061657274,2971491929.1007714,12.14394700138092,36.94432536255381,39.1359246741264,50,92.85714285714286
2008-10-01,38.83,38.97,38.03,38.5,45.83334935664011,44.88205342033408,43.59657308015702,41.531233565705925,45.844848200000044,45.938898999999985,44.456601199999916,41.599002000000034,41.599002000000034,45.00979715305943,38.18820684694064,174122944,34.129226548620906,35.456516689117,NaN,NaN,NaN,NaN,NaN,NaN,-0.2584527731346058,-1.6315963903263793,-1.3731436171917735,19.849744586850292,18.496413288601612,2887534330,2971491929.1007714,11.596327149165159,35.27835580644885,40.61266815022881,42.857142857142854,85.71428571428571
2008-10-02,38.25,38.25,36.64,36.75,45.7429677710019,44.721022659535386,43.32808001819008,41.07587798801965,45.77994820000004,45.81549899999998,44.28420119999991,41.25350200000003,41.25350200000003,45.1276553402969,37.37934865970317,192185808,29.690296871541378,34.916002823722394,NaN,NaN,NaN,NaN,NaN,NaN,-0.349179984476955,-1.809618597787967,-1.460438613311012,1.5299026425591025,15.798265359603194,2695348522,2805567535.8585353,10.57969841103928,38.737112807838514,42.58923215339295,35.714285714285715,100
2008-10-03,37.25999,38.17999,36.10001,36.17999,45.64781376333024,44.55189329994062,43.047762762574784,40.60960294154159,45.71139815000004,45.685098899999986,44.11400099999991,40.890001500000025,40.890001500000025,45.21015401584519,36.56984898415486,272144128,28.39484743144574,34.726217967020986,NaN,NaN,NaN,NaN,NaN,NaN,-0.41080361757765926,-1.9739431352830863,-1.563139517705427,1.034671454943655,7.471439561451007,2423204394,2554352539.251568,9.56938346137778,37.51707923253387,44.05788850305165,28.571428571428573,100
2008-10-06,35.25999,35.53,32.91,34.86,45.54047233284934,44.35997462073388,42.726674026787535,40.06202170901382,45.63629815000004,45.54259889999997,43.90580099999991,40.467501500000026,40.467501500000026,45.37164238604343,35.56336061395662,394158080,25.6083400068198,34.130525745760636,NaN,NaN,NaN,NaN,NaN,NaN,-0.49788094595961896,-2.1854907001549506,-1.6876097541953317,17.85714285714288,6.807238984881878,2029046314,2746918318.7935524,8.237540543720803,45.872884927366826,45.86263666234949,21.428571428571427,100
2008-10-07,35.14,35.2,32.27,32.64999,45.412208827049845,44.12809373715499,42.33150994730567,39.35611392720298,45.54504815000004,45.36939879999998,43.6704007999999,39.97750100000003,39.97750100000003,45.853454796634686,34.10154720336538,329540096,21.758385383293344,33.821678113058205,NaN,NaN,NaN,NaN,NaN,NaN,-0.6520116457457934,-2.5026243113775735,-1.85061266563178,3.287110726643595,7.392975012910043,1699506218,2502853950.4925556,7.262226026615201,43.02777695358154,47.11664542395517,14.285714285714286,100
2008-10-08,31.95,34.12,31.84,32.39,45.28263460986527,43.89565623740935,41.94164681211721,38.692674505564604,45.44774810000004,45.193199799999974,43.4114007999999,39.457001000000034,39.457001000000034,46.042127132746955,32.87187486725311,452568320,21.35170444099259,32.77819546920476,NaN,NaN,NaN,NaN,NaN,NaN,-0.714158526489995,-2.743310823744274,-2.029152297254279,4.5871559633027585,8.577136515696411,1246937898,2268629995.404836,6.606708677337251,40.84626579783143,48.14373720003335,7.142857142857143,100
2008-10-09,33.14999,33.67999,30.97,31.52,45.14569297195616,43.65059373765867,41.53295478026948,38.009562647891784,45.34414805000005,45.01189989999998,43.1304005999999,38.85300050000002,38.85300050000002,45.99939203896377,31.706608961036274,352617216,20.004300485536703,31.07411320333674,NaN,NaN,NaN,NaN,NaN,NaN,-0.7526955906640516,-2.9700217855843434,-2.217326194920292,4.6335299073294065,4.169265532425253,894320682,2059142066.8191812,5.922431578261858,39.94074443891341,51.664366956693826,0,100
2008-10-10,30.52,32.48,29.38,31.32001,45.00812398716057,43.40642376265553,41.13244714182754,37.372462395711615,45.23824810000005,44.83239999999998,42.84760059999991,38.24750150000003,38.24750150000003,45.781678194912594,30.71332480508746,472453120,19.696598560327956,29.87412370772978,NaN,NaN,19.696598560327956,NaN,NaN,NaN,-0.7299402841863563,-3.1297515501532374,-2.399811265966881,15.348180379746838,8.189622083459668,421867562,2178020416.065117,5.252279503159666,41.225004669311595,54.6876538013572,0,100
2008-10-13,32.86,35.25,32.39999,35.13,44.90983419624355,43.242534183197,40.8970570578343,37.15889454850099,45.15424815000005,44.7019001,42.65260059999991,37.90000150000003,37.90000150000003,45.335520825518785,30.464482174481272,277347072,38.9596167434008,30.12045356694809,NaN,NaN,NaN,NaN,NaN,NaN,-0.4123897408666499,-2.9152984420501937,-2.502908701183544,45.490506329113934,21.824072205396728,699214634,2432012027.10884,13.981102744579129,35.70855097810089,55.125491987108084,14.285714285714286,92.85714285714286
2008-10-14,36.10001,36.14999,33.19,33.61,44.7973980350869,43.05179093204458,40.61129011438982,36.82090459150089,45.06299815000005,44.5545,42.43620079999991,37.460001500000025,37.460001500000025,44.81699497017281,30.103008029827247,342311680,35.31954510885137,29.98888796490259,NaN,NaN,NaN,NaN,NaN,NaN,-0.2659213687695905,-2.8353104121455317,-2.569389043375941,33.465189873417714,31.434625527426164,356902954,2186843179.077867,15.589201779892184,32.212286351240465,54.92396892616301,7.142857142857143,85.71428571428571
2008-10-15,33.23,33.35001,30.53999,30.60001,44.65613049244922,42.80522101259815,40.218690894217666,36.22843843992938,44.95989820000004,44.378500100000004,42.129601199999904,36.979501500000026,36.979501500000026,44.7962283882931,29.16277461170695,312088320,29.451326739477622,29.16825456008129,NaN,NaN,NaN,NaN,NaN,NaN,-0.3288436935971797,-2.9804436603724156,-2.651599966775236,10.074234942445226,29.67664371499229,44814634,1888086821.815784,14.052403357997068,37.546203841032394,56.34496074822455,0,78.57142857142857
2008-10-16,30.82001,32.27,29.25,32.25999,44.53278581093232,42.59640455690314,39.90658497679736,35.85049096945991,44.86894815000005,44.21059999999999,41.8422009999999,36.5140005,36.5140005,44.29054591709749,28.737455082902514,494913280,35.78758213945517,28.9176642842697,NaN,NaN,NaN,NaN,NaN,NaN,-0.22093348164903626,-2.927766818836531,-2.706833337187495,27.043935309973058,23.527786708612002,539727914,2379719252.8536644,12.72361619484805,38.03495283373311,57.593761247441755,0,100
2008-10-17,31.62,33.64999,31.41,32.3,44.411066549131995,42.392515357756544,39.608287526726876,35.51234897236849,44.77734815000005,44.0411,41.56280099999991,35.984001000000006,35.984001000000006,43.38308529524592,28.584916704754093,326593024,35.93693101006352,29.38323714045297,NaN,NaN,NaN,NaN,NaN,NaN,-0.11448472560933443,-2.849939244199163,-2.7354545185898287,30.348258706467643,22.488809652961976,866320938,2312652201.16604,16.15655824685678,35.36386390537163,56.64797215158955,0,92.85714285714286
2008-10-20,32.78999,33.25999,31.7,33.2,44.299513648145606,42.21048535067226,39.3569821335219,35.29212526071435,44.70134820000005,43.8762,41.28040079999991,35.600001000000006,35.600001000000006,42.735307263935404,28.46469473606461,232783312,39.353925333364124,29.6744733430851,NaN,NaN,NaN,NaN,39.353925333364124,NaN,0.04061128504432299,-2.684690412284425,-2.725301697328748,40.63786008230456,32.676684699581756,1099104250,2527531974.1858153,15.348165590614189,33.59443458505048,55.702183055737336,0,85.71428571428571
2008-10-21,32.66,33.2572,31.48,31.48,44.171956298412816,41.9980004922431,39.04808087338379,34.92906571207489,44.617898200000056,43.69090009999999,40.95500079999991,35.145500500000004,35.145500500000004,42.112637388144094,28.178363611855914,239932368,35.46114504062331,29.769610378228123,NaN,NaN,NaN,NaN,NaN,NaN,0.050773222737884094,-2.661835168906393,-2.712608391644277,24.777777777777786,31.921298855516664,859171882,2287599606.1858153,14.460487276743422,32.36741755095119,54.8248879049202,0,78.57142857142857
2008-10-22,31.39,31.60001,29.71001,30.61,44.03701145962264,41.77249553200066,38.71717574109423,34.51772612044871,44.53634820000005,43.50300019999999,40.611200799999914,34.633500000000005,34.633500000000005,41.34902571286257,27.91797428713744,289993472,33.648102861625134,30.05231080609125,NaN,NaN,NaN,NaN,NaN,NaN,0.02368987757397134,-2.6829960446768126,-2.706685922250784,15.229580324278079,26.88173939478681,569178410,2273787324.5194445,13.562153027951288,36.17451473027734,53.99411686834141,0,71.42857142857143
2008-10-23,30.46001,31.09,28.89999,30.49001,43.902215425198534,41.54907997691154,38.39454179046309,34.1341341089774,44.44919825000005,43.31660029999999,40.26700099999991,34.083000500000004,34.083000500000004,40.238487826616634,27.927513173383375,377966848,33.394507862771476,30.409429408328805,NaN,NaN,NaN,NaN,NaN,NaN,0.02249155639956335,-2.67857147675133,-2.701063033150893,21.93131034482761,20.646222815627823,191211562,2444653447.7451115,12.586429965050302,36.23297191075467,53.21431530506121,0,100
2008-10-24,28.13,30.25,28.09,29.50999,43.75900920206223,41.31068215558656,38.04612799475865,33.69373943193193,44.35679815000005,43.11410029999999,39.89220079999991,33.50450000000001,33.50450000000001,39.06707651813967,27.94192348186034,322129408,31.318380615389984,30.8172894517981,NaN,NaN,NaN,NaN,NaN,NaN,-0.017356083458095473,-2.7227581374735124,-2.705402054015417,17.617763793751582,18.25955148761909,-130917846,2546061574.991333,11.601377995040766,36.038603425177165,51.91022751229715,42.857142857142854,100
2008-10-27,29.14,30.2,28.66,28.69,43.60906881199196,41.06076765745613,37.679221014572036,33.217192819366986,44.26499815000005,42.895500299999995,39.50280079999991,33.0479995,33.0479995,38.6175455705643,27.478453429435703,239493680,29.65701702740249,31.381477426377323,NaN,NaN,29.65701702740249,NaN,NaN,NaN,-0.06908718961253602,-2.791761041031087,-2.722673851418551,7.444177970444147,15.664417369674444,-370411526,2315898817.588736,11.006148684571817,34.18957884583825,50.494299916901475,35.714285714285715,92.85714285714286
2008-10-28,29.67999,31.88,28.85001,31.86,43.492162654658706,40.878574238496604,37.45101626890254,33.08793636037965,44.18494815000005,42.72380029999999,39.18800059999991,32.695499500000004,32.695499500000004,37.587582596405696,27.803416403594312,327367680,42.3820419730331,32.883644392951645,NaN,NaN,NaN,NaN,NaN,NaN,0.1292345119812941,-2.5611307114419333,-2.6903652234232274,46.77425158095728,23.94539778171767,-43043846,2638944797.7811465,15.284439209720615,30.678333754667857,47.73268424723405,28.571428571428573,85.71428571428571
2008-10-29,31.95,33.08,31.25,31.78,43.37562372277156,40.69840445159568,37.228623474043616,32.96337099272444,44.11109815000005,42.553900299999995,38.883400799999905,32.359499500000005,32.359499500000005,36.471685740692195,28.24731325930782,341390848,42.174691427100186,34.46724374592047,NaN,NaN,NaN,NaN,NaN,NaN,0.2661861588335448,-2.3576325248812964,-2.623818683714841,45.78169451823141,33.33337468987761,-384434694,2495299468.2948084,18.28479260677601,28.848008304911655,44.03540736834173,21.428571428571427,78.57142857142857
2008-10-30,32.67,33.06,31.98,32.84,43.27079164592806,40.54279248225715,37.05652059270857,32.951621374369736,44.04504815000005,42.39690039999999,38.5984007999999,32.1639995,32.1639995,35.762342437539246,28.565656562460756,255292064,45.94810812460896,36.34235157194054,NaN,NaN,NaN,NaN,NaN,NaN,0.4296384573316798,-2.086770612050241,-2.516409069381921,58.9330755993494,50.49634056617936,-129142630,2646583654.368882,17.498401677597233,27.607315421829703,40.10777111627038,14.285714285714286,71.42857142857143
2008-10-31,32.36,33.42999,32.09,32.89,43.16750018676459,40.391252037063936,36.89312762828863,32.94575267204881,43.98244815000005,42.252000399999986,38.318800799999906,31.999500000000005,31.999500000000005,35.117129060699746,28.881870939300264,224280320,46.12669078301925,36.85428543191329,NaN,NaN,NaN,NaN,NaN,NaN,0.5356973378921048,-1.84678739701679,-2.382484734908895,59.55342376355304,54.75606462704462,95137690,2690102729.8867598,17.966073973222635,26.330624171702055,38.333250274298564,7.142857142857143,64.28571428571429
2008-11-03,32.81,33.2941,32.50999,32.82001,43.06454008540375,40.24132645217158,36.73339752521849,32.933777179472735,43.91979815000005,42.10600049999999,38.0254007999999,31.897500500000007,31.897500500000007,34.75689740321893,29.038103596781085,128502432,45.89809211786149,37.60989593255687,NaN,NaN,NaN,NaN,NaN,NaN,0.5913449101365091,-1.6433035972382584,-2.2346485073747675,85.07227530984771,67.85292489091673,-33364742,2663214418.2745633,17.457329581767407,25.585021243046963,37.1980906790227,0,57.142857142857146
2008-11-04,33.49001,34.00999,32.98,33.75,42.971858094504206,40.11278533430679,36.61640154383738,33.01151268618962,43.86764820000005,41.95980049999999,37.7706005999999,31.952501000000005,31.952501000000005,34.90836859177658,28.99663340822343,182533008,49.48074935572602,39.04056897657461,NaN,NaN,NaN,NaN,49.48074935572602,NaN,0.67494710606488,-1.3909646247936678,-2.0659117308585477,95.60826960856349,80.07798956065476,149168266,2753597489.3821273,19.34618715961019,24.45332039289817,34.77869086012942,100,50
2008-11-05,33.49001,33.60001,31.92,31.99001,42.86258597416088,39.95193829798389,36.43497442447121,32.91422671607632,43.807498250000044,41.791700599999984,37.481800999999905,31.932501500000008,31.932501500000008,34.881663009671705,28.98333999032831,184147872,43.596860024436296,39.59837453978754,NaN,NaN,NaN,NaN,NaN,NaN,0.5984815729919339,-1.3178097646186302,-1.9162913376105641,65.87865857881518,82.18640116574214,-34979606,2584797374.263003,18.02570020553522,26.737849718971663,32.60700959284805,92.85714285714286,42.857142857142854
2008-11-06,31.5,31.87,30.3999,30.56,42.74017218337321,39.765959321786184,36.204583270570375,32.69001464787858,43.73574825000004,41.611900699999985,37.158400999999905,31.884501500000006,31.884501500000006,34.88967340625254,28.87932959374747,220780432,39.48812359729867,39.852031153161484,NaN,NaN,NaN,NaN,NaN,NaN,0.44539163014650107,-1.3595517999274378,-1.8049434300739389,41.72304345108687,67.73665721282184,-255760038,2412104755.558969,16.943511694042748,30.871878000043555,32.02476013668998,85.71428571428571,35.714285714285715
2008-11-07,30.92,31.48,30.59,31.19,42.62524509697149,39.59613834511715,36.007932946234284,32.54715610998538,43.671748200000046,41.44360069999999,36.8400009999999,31.878001,31.878001,34.8885865736245,28.8674154263755,176977632,42.0780213499357,40.046609440059456,NaN,NaN,NaN,NaN,NaN,NaN,0.3827501075127302,-1.3265057956830262,-1.7092559031957564,52.36495331917791,53.32221844969332,-78782406,2473748649.8511043,16.33255524543409,29.758686514985715,31.4425106805319,78.57142857142857,28.571428571428573
2008-11-10,31.94,31.97,30.39999,30.77,42.50728245919068,39.42136332838216,35.802523811087845,32.37790314712963,43.60394820000005,41.26360069999999,36.533000999999906,31.660001000000005,31.660001000000005,34.306501187061194,29.01350081293882,142737872,40.82359079155429,40.42964127941167,NaN,NaN,NaN,NaN,NaN,NaN,0.3122027625912547,-1.3190024499566881,-1.6312052125479428,45.270346740450556,46.45278117023844,-221520278,2398289890.746844,17.257184664929206,27.909190734950716,30.39565772534232,71.42857142857143,21.428571428571427
2008-11-11,30.47,30.75999,29.72,30.10001,42.38382701183554,39.236782074354785,35.578895818496164,32.16096094264109,43.53239825000005,41.0904008,36.224001199999904,31.484501500000004,31.484501500000004,34.05490576900723,28.91409723099278,162921184,38.834682371141156,40.8001112443771,NaN,NaN,NaN,NaN,NaN,NaN,0.2237330587899744,-1.3515388890604747,-1.575271947850449,33.952928974542196,43.86274301139022,-384441462,2354430772.981789,16.51781154614165,29.488081062084603,29.16197626623633,64.28571428571429,14.285714285714286
2008-11-12,29.64999,29.8,28.64999,28.71001,42.24776913112076,39.028331142189344,35.30952774718259,31.832298948103844,43.45409830000005,40.90700089999999,35.8958013999999,31.390001500000004,31.390001500000004,34.21034769863057,28.569655301369437,184936256,35.0224349075979,40.916391747578984,NaN,NaN,NaN,NaN,NaN,NaN,0.08220840669625273,-1.472511439480133,-1.5547198461763858,10.473159583039843,29.898811766010866,-569377718,2188798477.9649463,15.528372536490725,32.14199151744695,28.191567101205827,57.142857142857146,7.142857142857143
2008-11-13,28.63,30.53,27.28,30.46001,42.130477995487716,38.858661416601436,35.11935058062641,31.701604762570145,43.38074835000005,40.743500999999995,35.631801599999896,31.300002500000005,31.300002500000005,34.11843366646723,28.481571333532777,318269184,42.65491157427277,41.72614395892776,NaN,NaN,NaN,NaN,42.65491157427277,NaN,0.11504899177868677,-1.4109086064530274,-1.5259575982317142,47.25133321149064,30.559140589690895,-251108534,2493359563.387617,13.56678569844553,33.40667773410308,27.544478522274268,50,100
2008-11-14,29.8,30.42,28.87,28.98,41.99962746816943,38.66304435884695,34.87859173432734,31.442404308992035,43.29769885000005,40.55760089999999,35.3424015999999,31.1340025,31.1340025,34.08524182613317,28.182763173866828,259407120,38.53259282079355,42.36011365845569,NaN,NaN,NaN,NaN,NaN,NaN,0.04906285953865486,-1.4646290238083957,-1.5136918833470505,25.26006725121433,27.66152001524827,-510515654,2270771518.484391,12.72018942197612,31.322030006370067,26.89738994334271,42.857142857142854,92.85714285714286
2008-11-17,28.49001,29.23,28.25999,28.37,41.86400928440655,38.45922169827573,34.62335284278509,31.14979437480232,43.21479885000005,40.384800999999996,35.0436015999999,30.892502500000006,30.892502500000006,33.91753099409951,27.867474005900505,202894880,36.947665345988845,41.971943899381095,NaN,NaN,NaN,NaN,NaN,NaN,-0.01999666092176522,-1.538687709499257,-1.5186910485774918,16.196160766955074,29.569187076553348,-713410534,2113897742.903522,12.21922809566925,32.565157680249,27.750158711637535,35.714285714285715,85.71428571428571
2008-11-18,28.56,28.75,27.39,28.34,41.72944202784529,38.258841070587096,34.37694684895038,30.882194910535432,43.13814930000005,40.21170109999999,34.76140159999991,30.735502500000003,30.735502500000003,33.94271695028461,27.528288049715396,252794192,36.86734987983911,41.592848074576736,NaN,NaN,NaN,NaN,NaN,NaN,-0.05030248594992415,-1.581569156014897,-1.5312666700649729,15.750394874286568,19.068874297485326,-966204726,2214271907.37411,11.533399875319219,34.32780799603044,29.699546155892484,28.571428571428573,78.57142857142857
2008-11-19,28.39999,28.78,26.78999,26.86,41.58148738080205,38.03312144542696,34.08216461957978,30.499128728579677,43.05839930000005,40.02860109999999,34.44260159999991,30.548002500000006,30.548002500000006,34.17379252151449,26.922212478485523,244288944,33.05041899005877,40.67158456496601,NaN,NaN,NaN,NaN,NaN,NaN,-0.14715052703399456,-1.7152048288574662,-1.5680543018234716,0.9696675900276992,10.972074410423113,-1210493670,1987171489.0291975,10.596218759210815,33.98841740566533,31.846356716569595,21.428571428571427,100
2008-11-20,26.53999,27.45,25.47,25.56,41.42206959591845,37.786128941557116,33.74796208547861,30.028735516333995,42.97064930000005,39.82610109999999,34.08180139999991,30.301502000000006,30.301502000000006,34.529818976777264,26.073185023222745,342471424,30.10234100566761,39.52698815229804,NaN,NaN,30.10234100566761,NaN,NaN,NaN,-0.268806440353752,-1.9040623522656617,-1.6352559119119097,1.0538654026526943,5.924642622322321,-1552965094,1675833830.8473792,9.747517551685847,36.60573228004282,34.63631761820866,14.285714285714286,100
2008-11-21,25.96001,26.67999,25.05,26.67,41.27528283377001,37.566007576377764,33.47039494487161,29.708855943349807,42.88599925000005,39.645700999999995,33.74660159999991,30.15950250000001,30.15950250000001,34.66619442757542,25.6528105724246,282766336,35.400843635469556,38.777184689270044,NaN,NaN,NaN,NaN,NaN,NaN,-0.24522080932730916,-1.941781923571046,-1.696561114243737,18.0803773218497,6.701303438176698,-1270198758,1955134089.5136046,9.101254125936206,35.88712291959856,37.54035480615513,7.142857142857143,100
2008-11-24,27.22,28.64,26.98,28.3,41.1461755418917,37.38252227783563,33.26763435879821,29.574679186840303,42.80714920000004,39.482400999999996,33.47100159999991,30.1400025,30.1400025,34.675243785761424,25.604761214238575,225212496,42.315903259436425,38.2654099681065,NaN,NaN,NaN,NaN,NaN,NaN,-0.09809289684007627,-1.8191772352938322,-1.721084338453756,38.011651448360894,19.04863139095443,-1044986262,2088090864.2605927,16.281880511423672,33.03628379551214,39.1340563337535,0,92.85714285714286
2008-11-25,28.62,28.64,27.52,28.17,41.01705936734552,37.20009609411611,33.06772712904142,29.440900216665035,42.728899150000046,39.31510109999999,33.18620159999991,29.955502500000005,29.955502500000005,34.49607032903577,25.414934670964243,203052496,41.93039079514656,38.14637645172866,NaN,NaN,NaN,NaN,NaN,NaN,0.006660721200099529,-1.7127584369536315,-1.719419158153731,45.08670520231217,33.726244657507586,-1248038758,2120724301.117736,15.52670176436087,31.504009965913532,40.17044751941389,0,85.71428571428571
2008-11-26,27.88,29.36,27.81,29.35001,40.90096932388934,37.044648844727675,32.92193430045156,29.43224400555408,42.65174920000005,39.1489012,32.96900159999991,29.834003000000003,29.834003000000003,34.30225475030282,25.365751249697183,165061312,46.67893657832682,38.66000595037353,NaN,NaN,NaN,NaN,46.67893657832682,NaN,0.16295019129938226,-1.5157314190295033,-1.6786816103288855,62.13887283236996,48.41240982768101,-1082977446,2283657919.560472,17.526209028871577,29.467059996835165,39.90475050161421,14.285714285714286,78.57142857142857
2008-11-28,29.03999,29.19,28.83,29.12,40.78374574852726,36.887725105228114,32.77283883768875,29.402506481215596,42.57749920000005,38.992601199999996,32.720001399999916,29.648003,29.648003,33.904955685676065,25.391050314323934,41242832,45.89118958286186,38.932375109868254,NaN,NaN,NaN,NaN,NaN,NaN,0.25299280399165003,-1.362440605339323,-1.615433409330973,58.81502890173412,55.34686897880542,-1124220278,2308861872.449361,17.12613661139072,28.79441265424288,39.63905348381452,7.142857142857143,71.42857142857143
2008-12-01,28.5,28.50999,26.89,26.92999,40.64589743262152,36.69054223185726,32.543707510720566,29.167028721099825,42.49304910000004,38.8091011,32.400601399999914,29.350002500000006,29.350002500000006,33.490272901811224,25.209732098188788,149331056,39.12154506933791,38.81080041542423,NaN,NaN,NaN,NaN,NaN,NaN,0.17113374447230933,-1.4015162287405865,-1.5726499732128958,32.92457605004562,51.2928259280499,-1273551334,2166903391.5016017,15.492858884403612,34.34490938562103,40.65640390511193,0,64.28571428571429
2008-12-02,27.28,27.89,26.84039,27.83,40.51837606513275,36.515085950038305,32.35885623579035,29.03969265242365,42.41349905000005,38.6418011,32.13960139999991,29.100502,29.100502,32.966601858009966,25.234402141990035,181779312,42.85249759639072,39.097787217227776,NaN,NaN,NaN,NaN,NaN,NaN,0.18262904339463448,-1.3443636689696028,-1.5269927123642373,50.729927007299224,47.48984398635965,-1091772022,2327900205.7738733,14.778464976475082,32.979170569681266,41.364828204726145,0,57.142857142857146
2008-12-03,27.13,28.71001,27.07001,28.62,40.399984263489635,36.358747614393984,32.212234422622096,28.999721923621397,42.33689905000005,38.48570110000001,31.900601199999915,28.844002,28.844002,32.06986145386735,25.61814254613265,231010688,45.981889332768425,39.88060539045424,NaN,NaN,NaN,NaN,NaN,NaN,0.24459761332060492,-1.2212456957134812,-1.465843309034086,65.14598540145985,49.600162819601564,-860761334,2533553244.960605,17.314579858733385,30.60455750140802,40.856480538579554,7.142857142857143,50
2008-12-04,28.14999,28.78,27.32001,27.81,40.27471078823103,36.18946548341589,32.0395977785977,28.886415073752694,42.25834905000004,38.32140100000001,31.639800999999917,28.635001499999998,28.635001499999998,31.544606823766824,25.725396176233172,188924192,43.360112690081365,39.930976898726286,NaN,NaN,NaN,NaN,NaN,NaN,0.2322876073021527,-1.1754837999063952,-1.4077714072085479,51.39664804469268,55.75752015115058,-1049685526,2471439462.399135,16.50607512243575,28.62831758286771,39.758032073449,0,42.857142857142854
2008-12-05,27.5,29.07001,26.95,28.94,40.16192759630834,36.045911711467056,31.918044924535046,28.891518400061962,42.18464910000005,38.15740100000001,31.388600999999916,28.554001500000005,28.554001500000005,31.331957603341213,25.776045396658798,212310880,47.829158704222145,40.59501731897119,NaN,NaN,NaN,NaN,NaN,NaN,0.29734337711596615,-1.0360921858135903,-1.3334355629295565,90.25522041763345,68.93261795459533,-837374646,2657710335.5040736,14.992194967465736,27.603376220324343,38.855918260987934,0,35.714285714285715
2008-12-08,29.55,30.46001,29.44,30.08,40.061609908782884,35.92777484589345,31.845964731416025,29.004707123865586,42.11554915000005,38.00180100000001,31.168600999999917,28.498501500000003,28.498501500000003,31.10248993662786,25.894513063372145,185853312,51.94834895903247,41.66649471990287,NaN,NaN,NaN,NaN,51.94834895903247,NaN,0.4074406563794395,-0.8241347424552572,-1.2315753988346967,92.97579856599152,78.20922234277255,-651521334,2705082422.6276107,20.048448911971064,25.77785190497277,36.50388815114098,100,28.571428571428573
2008-12-09,29.67999,30.83,29.57001,30.00999,39.96159379028753,35.81059098755893,31.773965722340886,29.1004483501641,42.045249050000045,37.8560009,31.012400599999918,28.460501,28.460501,30.95047249303284,25.97052950696716,178390064,51.67849191893569,42.7244334369812,NaN,NaN,NaN,NaN,NaN,NaN,0.4618489487921298,-0.6542642128445344,-1.1161131616366642,85.81297577854671,89.68133158739056,-829911398,2651277570.1907496,20.567789177684592,24.34082141168687,33.553784760603484,100,21.428571428571427
2008-12-10,30.09,30.46001,29.62,29.91,39.8615779316777,35.69374760166668,31.700869027347125,29.17754850729133,41.97334910000005,37.7073009,30.832400599999925,28.4510005,28.4510005,30.917213896302172,25.984787103697826,162457568,51.26885714771455,44.02575044824233,NaN,NaN,NaN,NaN,NaN,NaN,0.47553438979000384,-0.5216951743991594,-0.9972295641891632,84.083044982699,87.62393977574574,-992368966,2600991749.479472,19.776262566854307,23.404094196604312,30.406258253643824,92.85714285714286,14.285714285714286
2008-12-11,29.8,30.27,28.94,29.09,39.75439805176051,35.56298032242575,31.598482006666845,29.169210554215965,41.89819910000005,37.5504009,30.644200599999923,28.47,28.47,30.949720040666143,25.990279959333854,167448880,47.914596659727906,45.29805442353235,NaN,NaN,NaN,NaN,NaN,NaN,0.41594492783217263,-0.47729840439894744,-0.8932433322311201,69.8961937716263,79.93073817762401,-1159817846,2471313293.5396223,18.558473613916348,25.111274527273235,27.339321982220763,85.71428571428571,7.142857142857143
2008-12-12,28.69,29.86,28.47,29.67999,39.65415518557384,35.446485464555934,31.523247026013244,29.217856215719205,41.83184905000004,37.3935008,30.502800399999924,28.430998999999996,28.430998999999996,30.806649304248968,26.055348695751025,158613808,50.427630350494894,46.37139633174844,NaN,NaN,NaN,NaN,NaN,NaN,0.4025861995139516,-0.3900105828386806,-0.7925967823526322,71.17487674233827,75.0513718322212,-1001204038,2588844984.16109,17.355612207280245,25.675270758012946,24.467509551605097,78.57142857142857,0
2008-12-15,29.73,29.75999,28.74001,29.16,39.54973573099102,35.32200060387166,31.430570672051942,29.212346099936426,41.76429905000005,37.2382008,30.36240059999993,28.439998999999993,28.439998999999993,30.82524499152351,26.054753008476478,107938944,48.21942561638923,46.79307650010221,NaN,NaN,NaN,NaN,NaN,NaN,0.34715038014775257,-0.3586588071679415,-0.7058091873156941,58.14127195390029,66.40411415595496,-1109142982,2569796561.721434,16.509980170182526,24.4242730257044,23.421944063349883,71.42857142857143,35.714285714285715
2008-12-16,29.42,30.66,29.0993,30.56,39.46028562421499,35.227703562210834,31.396430645696963,29.34069409041867,41.702549050000044,37.0911008,30.276400599999928,28.549498999999997,28.549498999999997,31.10671199779243,25.992286002207564,172053680,54.0531302020787,47.65898645774023,NaN,NaN,NaN,NaN,54.0531302020787,NaN,0.38998554295153565,-0.21832725862627456,-0.6083128015778102,93.23242121410365,74.18285663678076,-937089302,2719801971.0736475,19.56883477902736,22.60902573921761,21.510226315022486,64.28571428571429,28.571428571428573
2008-12-17,30.23,30.60001,29.82001,30.19,39.36804397621285,35.12794705602844,31.349119639983357,29.421580367521653,41.63789955000005,36.9488008,30.227200799999927,28.641999,28.641999,31.294278030584465,25.989719969415532,159965376,52.373747815880215,48.06575868899404,NaN,NaN,NaN,NaN,NaN,NaN,0.37832344264262485,-0.13540849827452917,-0.513731940917154,83.95833176676423,78.4440083115894,-1097054678,2711594516.7819557,18.816163933656778,21.739420844071784,20.210106363221588,57.142857142857146,21.428571428571427
2008-12-18,30.19,30.39999,29.36,29.66,39.27144652371322,35.01967087670114,31.282879654101656,29.444286999186257,41.57534955000005,36.7920008,30.17260079999993,28.781999000000003,28.781999000000003,31.337061655998284,26.22693634400172,142773808,49.97839295501985,48.357701787005325,NaN,NaN,NaN,NaN,NaN,NaN,0.32204175830744086,-0.11117974303285294,-0.4332215013402938,70.67382526111578,82.62152608066124,-1239828486,2651191005.4194236,17.831372753600164,22.916634613692345,19.28654033376619,50,14.285714285714286
2008-12-19,29.98,30.37,29.66,29.86,39.17780028964643,34.917499176172406,31.227080451980022,29.48387871354947,41.51429950000005,36.634900699999996,30.13940079999993,28.996999000000006,28.996999000000006,31.11822668605267,26.875771313947343,118332944,50.89114915097298,49.1983877928364,NaN,NaN,NaN,NaN,NaN,NaN,0.2865966583008646,-0.07497567846421305,-0.36157233676507766,75.68684658400197,76.77300120396067,-1121495542,2599524508.7433667,17.170658198575612,22.067493369735743,17.47603641921012,42.857142857142854,7.142857142857143
2008-12-22,29.86,29.92,28.74001,29.21001,39.07861829671462,34.804479588525425,31.14797964994159,29.45779597892571,41.454049600000054,36.472400699999994,30.097200799999932,29.123999500000004,29.123999500000004,30.95735169096058,27.29064730903943,95416320,47.83612594835627,49.554361246548225,NaN,NaN,NaN,NaN,NaN,NaN,0.21117202856714729,-0.09760730105614357,-0.30877932962329085,58.24768041237118,68.20278408582965,-1216911862,2580118443.7455277,16.1027502616453,25.544026848738792,16.373130595768036,35.714285714285715,0
2008-12-23,29.28,29.62,28.89,29.06,38.978930552468704,34.69072751746552,31.06609809504192,29.41991064759945,41.385199150000055,36.314200699999994,29.97580079999993,29.1619995,29.1619995,30.95655471177277,27.36744428822723,68804624,47.13290040010777,49.636576322786745,NaN,NaN,NaN,NaN,NaN,NaN,0.14606913964333262,-0.12619290506912506,-0.2722620447124577,54.381443298969074,62.77199009844742,-1285716486,2543359809.005801,15.46206663065356,24.527701090363134,16.011395580534316,28.571428571428573,14.285714285714286
2008-12-24,29.2,29.21001,28.98,29.14,38.881030745976474,34.580812121080065,30.990564836412826,29.393252490685217,41.317349100000044,36.16130080000001,29.88640079999993,29.210499500000005,29.210499500000005,30.946674491784837,27.474324508215172,27210320,47.575516552793815,49.93767659869478,NaN,NaN,NaN,NaN,NaN,NaN,0.1051942986473296,-0.1407691714032957,-0.2459634700506253,56.44329896907221,56.357474226804165,-1258506166,2554005679.6062098,15.256100573625393,24.200974139676465,15.712237047505743,21.428571428571427,7.142857142857143
2008-12-26,29.19,29.23,28.97,29.13,38.78400556442447,34.47287524739531,30.917601509494677,29.36818082490567,41.24779915000005,35.9933009,29.857000599999928,29.199498999999996,29.199498999999996,30.934786571579604,27.464211428420388,20946304,47.521957758160475,49.915733673976085,NaN,NaN,NaN,NaN,NaN,NaN,0.07566450659585056,-0.1513828368058121,-0.22704734340166266,27.966101694915267,46.263614654318864,-1279452470,2558839442.067748,15.135343139374221,23.81479721845879,15.18914483230209,14.285714285714286,0
2008-12-29,29.23,29.24001,28.46001,28.89,38.68555774786303,34.36232326229837,30.838087724808613,29.322639793962274,41.18099915000004,35.815900899999995,29.789600799999924,29.187998999999998,29.187998999999998,30.928282845836193,27.447715154163802,52742528,46.178322596120886,49.50358893376812,NaN,NaN,46.178322596120886,NaN,NaN,NaN,0.0399430545337319,-0.17711852523449778,-0.21706157976822968,18.14311452790942,34.18417173063231,-1332194998,2564247579.746517,14.393315225179249,25.852743359845963,16.329929344082355,7.142857142857143,100
2008-12-30,28.98,29.59,28.94,29.49001,38.594059760322104,34.26584181155979,30.785221931678862,29.338579813584914,41.121049200000044,35.648101000000004,29.733400999999926,29.315999999999995,29.315999999999995,30.71656133035399,27.915438669646,77131120,49.98559599714297,49.38266779649721,NaN,NaN,NaN,NaN,NaN,NaN,0.055729804955872875,-0.14739932357338859,-0.20312912852926146,46.81839462906655,30.975870283963758,-1255063878,2617648420.704056,16.00405350247932,24.683196844998754,17.25348506729762,0,92.85714285714286
2008-12-31,29.48,30.08,29.45,29.74001,38.50595976270696,34.176221379647714,30.74423322847577,29.37681125991016,41.05309925000004,35.472300999999995,29.66420119999993,29.411500499999995,29.411500499999995,30.64414333314424,28.17885766685575,89221184,51.52427268233946,49.40091176325613,NaN,NaN,NaN,NaN,NaN,NaN,0.08050949126064982,-0.10249226445344917,-0.183001755714099,58.18208264583027,41.047863934268754,-1165842694,2610570206.77339,18.598860566844778,23.646378451807962,17.50681047029942,28.571428571428573,85.71428571428571
2009-01-02,29.77,31.13,29.69,31.03,38.43157210337654,34.11391996618934,30.755439768535545,29.534257806585384,40.99694930000004,35.30510099999999,29.65520119999993,29.53200049999999,29.53200049999999,30.895796992187655,28.168204007812328,107920256,58.60156616051498,50.164266727598054,NaN,NaN,NaN,NaN,NaN,NaN,0.1758130182297099,0.036764517073038405,-0.1390485011566715,96.25466762047806,67.08504829845829,-1057922438,2703501538.328946,23.688867060182876,21.430526441098216,16.792517571496543,100,78.57142857142857
2009-01-05,30.82001,31.33,30.59,31.02,38.357825117273286,34.0526542242846,30.765814679573367,29.675757063101063,40.93659930000005,35.137300999999994,29.663401199999925,29.692500499999994,29.692500499999994,30.960045856230934,28.424955143769054,91816624,58.530228078720135,50.74302370818557,NaN,NaN,NaN,NaN,NaN,NaN,0.2269605156697899,0.14465214343056587,-0.08230837223922402,89.19856863612769,81.21177296747868,-1149739062,2718390720.5992165,23.853447930231717,20.37393996162668,15.973457422974985,100,71.42857142857143
2009-01-06,31.28,31.63,31.11,31.33,38.28789650914121,33.99874027924926,30.787939594099903,29.83330400947239,40.87034980000004,34.973600999999995,29.680200999999926,29.812000499999993,29.812000499999993,31.216486082732253,28.407514917267733,136820000,60.14976003779964,51.59519045257203,NaN,NaN,NaN,NaN,60.14976003779964,NaN,0.26765499640955737,0.25226037327272266,-0.015394623136834679,90.53624774841559,91.99649466834046,-1012919062,2697341489.829985,24.915468167694293,19.519609044887904,15.459820650386916,100,64.28571428571429
2009-01-07,30.81,30.89999,30.19,30.44,38.2098079866622,33.928270174709674,30.7742949041352,29.89108457999883,40.79839980000004,34.79550099999999,29.698801199999924,29.830000499999993,29.830000499999993,31.25681362024493,28.403187379755057,134061872,53.66942027899035,51.56778260092286,NaN,NaN,NaN,NaN,NaN,NaN,0.22247322040628564,0.2626969023710224,0.040223681964736746,62.46044940204864,80.73175526219731,-1146980934,2657690716.577855,22.976401206047235,24.281160217640753,15.142172604214565,92.85714285714286,57.142857142857146
2009-01-08,30.34,30.8,30.08,30.75999,38.135680444506356,33.865531953428295,30.773733927502448,29.973837477141796,40.72869975000005,34.621500899999994,29.740200999999924,29.867500499999988,29.867500499999988,31.34961639631299,28.385384603686987,131926064,55.52471824419637,51.792851917231154,NaN,NaN,NaN,NaN,NaN,NaN,0.2025460473051933,0.29340624109622837,0.09086019379103508,72.55480301199685,75.18383338748703,-1015054870,2774954664.40941,21.821308421893622,23.82853310706769,14.941385245770046,85.71428571428571,50
2009-01-09,30.78999,30.78999,29.92,30.07001,38.055425017197834,33.79037310286536,30.746136910737647,29.982996765033054,40.66049975000004,34.44620089999999,29.70440119999992,29.875500999999993,29.875500999999993,31.36017344741722,28.390828552582764,117168320,50.800811028110154,51.85159606530904,NaN,NaN,NaN,NaN,NaN,NaN,0.13457701604369193,0.25908146384565,0.12450444780195807,50.78880375016956,61.93468538807169,-1132223190,2698192371.3366156,20.481441018880446,23.494659821406604,14.539397089759229,78.57142857142857,42.857142857142854
2009-01-12,30.12,30.14999,29.2,29.52,37.97049541503666,33.705811259244264,30.69805311031656,29.938901835029906,40.59064970000005,34.27130099999999,29.65920119999992,29.89700099999999,29.89700099999999,31.347613665090236,28.44638833490974,102778880,47.34308694851603,51.59816305084782,NaN,NaN,NaN,NaN,NaN,NaN,0.04868515790779432,0.18536089518670096,0.13667573727890664,33.43827583052311,52.26062753089652,-1235002070,2664654728.823326,19.102159380901256,27.016403083334655,14.8737446994179,71.42857142857143,35.714285714285715
2009-01-13,29.52,29.98,29.17999,29.53,37.88651038603132,33.623121927378044,30.652247105990423,29.899958803122296,40.51969970000005,34.095700999999984,29.59300119999992,29.889501499999987,29.889501499999987,31.346062973504033,28.43294002649594,186387376,47.413169641405965,51.567951886065664,NaN,NaN,NaN,NaN,NaN,NaN,-0.008310221165407888,0.12628796082214677,0.13459818198755466,33.75373423890931,39.32693793986734,-1048614694,2641358927.8630385,18.002671450271777,25.605350606442563,14.499762164239744,64.28571428571429,28.571428571428573
2009-01-14,29.17,29.28,28.47,28.63,37.79440580507578,33.5242482258458,30.572943297912367,29.779010345682078,40.434899700000045,33.91330099999998,29.50780119999992,29.86300149999999,29.86300149999999,31.389303122909283,28.336699877090695,137103248,41.99580035991053,51.201016168908716,NaN,NaN,NaN,NaN,NaN,NaN,-0.10226118842757496,0.006771696453085951,0.10903288488066092,5.362477484156058,24.1848291845295,-1185717942,2558419925.986495,16.63632587760038,28.745569377691442,14.786412018898686,57.142857142857146,21.428571428571427
2009-01-15,28.55,29.34,28.07001,29.099,37.70788435427901,33.43661954810628,30.51514159995502,29.71424745561712,40.35294465000005,33.72939089999998,29.433380999999923,29.78995149999999,29.78995149999999,31.315674184728863,28.264228815271117,192790752,45.491005261253434,51.05212250522726,NaN,NaN,NaN,NaN,NaN,NaN,-0.12685068176725642,-0.0495304673284096,0.07732021443884682,28.904294674985056,22.673502132683478,-992927190,2678040698.3299623,15.152487336019663,28.990845171943057,15.406326864953964,50,100
2009-01-16,29.53,29.60001,28.7,29.42,37.62541784329116,33.3570825273517,30.472194870545017,29.68622388841549,40.27209465000004,33.55869079999998,29.346780999999922,29.75145149999999,29.75145149999999,31.273708302479605,28.229194697520377,175490368,47.809067700728,51.07263035826781,NaN,NaN,NaN,NaN,NaN,NaN,-0.11583262101630491,-0.06747056183153433,0.04836205918477059,37.9211739358819,24.062648698341008,-817436822,2783331799.3358626,16.02799278903331,27.143186374586936,15.653704927562467,42.857142857142854,92.85714285714286
2009-01-20,29.28999,29.42999,27.96001,27.96001,37.529244630920104,33.25020980403781,30.373677816798153,29.521822565709254,40.182594700000045,33.373990999999975,29.266180999999918,29.666451999999992,29.666451999999992,31.377751496554623,27.955152503445362,135251008,39.567260175936816,50.600411613968944,NaN,NaN,39.567260175936816,NaN,NaN,NaN,-0.1964686352541482,-0.19722373488291467,-0.0007550996287664716,0,22.275156203622327,-952687830,2648080791.3358626,14.412352924541477,29.48146569673611,16.072091646708426,35.714285714285715,100
2009-01-21,28.42999,29.19,28.10001,29.14999,37.44586896295075,33.16901733267073,30.325690059276656,29.48640994040361,40.099544700000045,33.19819089999997,29.237980799999924,29.63095149999999,29.63095149999999,31.354134386038353,27.90776861396163,149242688,47.509887114421275,50.42357526520311,NaN,NaN,NaN,NaN,NaN,NaN,-0.16076188860125948,-0.20170746038034082,-0.04094557177908135,32.424611511203,23.448595149028307,-803445142,2786367048.6403875,13.212253676330219,27.026579599784345,17.000625391229267,28.571428571428573,92.85714285714286
2009-01-22,28.52,29.23,28.25999,28.75999,37.35944230660298,33.08170986073665,30.26429005695208,29.4172270889366,40.01629465000005,33.014690799999975,29.18938059999992,29.608450499999993,29.608450499999993,31.364471717509343,27.852429282490643,200602624,45.403719454579935,49.98639289179171,NaN,NaN,NaN,NaN,NaN,NaN,-0.15446978363376213,-0.234032801321284,-0.07956301768752189,21.79787955825488,18.074163689819297,-1004047766,2792569121.499182,12.611962465913454,25.241503215242556,18.530350928930467,21.428571428571427,85.71428571428571
2009-01-23,28.31,29.35001,28.14,28.89999,37.27526865181091,32.99890352686068,30.21078809393435,29.36796641379978,39.93629465000004,32.84249069999998,29.15198039999992,29.600449999999995,29.600449999999995,31.36781474734651,27.83308525265348,170164064,46.323618741888794,49.10939664760413,NaN,NaN,NaN,NaN,NaN,NaN,-0.1327686190516808,-0.2455237915021229,-0.11275517245044209,25.61260384905678,26.611698306171558,-833883702,2836160294.2317047,12.392419766148354,23.184387262067844,20.33956685983532,14.285714285714286,78.57142857142857
2009-01-26,28.96001,29.59,28.75,29.11,37.19402219756404,32.921895536229776,30.167619933387904,29.343398183914086,39.85414470000004,32.67809069999997,29.132180199999922,29.59894999999999,29.59894999999999,31.367925565168886,27.829974434831097,140481008,47.74592784266904,48.33908948788619,NaN,NaN,NaN,NaN,NaN,NaN,-0.09777648415011075,-0.23497577763808053,-0.13719929348796978,31.334962765566104,26.24848205762593,-693402694,2816091578.803133,13.321498491286848,21.852927078599997,21.51008971996448,7.142857142857143,71.42857142857143
2009-01-27,29.14,29.57001,29.12,29.32001,37.115673817488776,32.85057107016582,30.134380328157008,29.34117073782703,39.77934475000004,32.52009079999997,29.14438019999992,29.608450499999993,29.608450499999993,31.36927195499852,27.847629045001465,110914816,49.195687537749535,47.556655737882615,NaN,NaN,NaN,NaN,NaN,NaN,-0.056065319688946846,-0.20728094309915335,-0.1512156234102065,46.258818087197874,34.40212823394026,-582487878,2803770448.935263,12.88509049036975,21.137032224368944,22.375189204160154,0,64.28571428571429
2009-01-28,29.83,30.64999,29.81,30.35001,37.04835377950381,32.80105500937046,30.142836393719477,29.43725066755779,39.71069480000004,32.38699089999997,29.14218019999992,29.681450999999992,29.681450999999992,31.43813075983111,27.924771240168873,139797248,55.68903994971562,47.70091428579156,NaN,NaN,NaN,NaN,55.68903994971562,NaN,0.0401282645237194,-0.10105529275555725,-0.14118355727927664,84.15522589868276,53.91633558381559,-442690630,2843717988.1172066,19.20852736504463,19.180601937580988,22.183174215759234,0,57.142857142857146
2009-01-29,29.97,30.4008,29.48,29.58,36.974041801598304,32.73727174185817,30.1207643782795,29.450845842076095,39.63789480000005,32.24829089999997,29.154180199999924,29.68595049999999,29.68595049999999,31.441106141640784,27.930794858359196,130772816,50.49331553071787,47.341528377685954,NaN,NaN,NaN,NaN,NaN,NaN,0.050463853819567694,-0.07810374000481701,-0.1285675938243847,57.24386744782643,62.552637144569026,-573463446,2741349345.8791523,17.96848449155993,20.25597773846711,22.296557606110145,0,50
2009-01-30,29.82001,29.92999,28.94,29.06,36.89529511700528,32.66445447964316,30.079165775209717,29.41362242854504,39.55634480000004,32.105790899999974,29.16798019999992,29.651949999999992,29.651949999999992,31.427823168377834,27.87607683162215,140355184,47.284900665712726,47.09039192322899,NaN,NaN,NaN,NaN,NaN,NaN,0.022283543378099374,-0.1007131646017605,-0.12299670797985987,40.892125592011794,60.76373964617367,-713818630,2635020004.726049,16.718806605409295,22.64079151885082,22.881836229441877,0,42.857142857142854
2009-02-02,28.77,29.61,28.74001,29.41,36.82081456857737,32.60000983648191,30.052923980103454,29.413277435350274,39.477044800000044,31.97539089999998,29.189380199999924,29.570949999999993,29.570949999999993,31.2320897021818,27.909810297818186,126883376,49.60595463028773,47.25202532906983,NaN,NaN,NaN,NaN,NaN,NaN,0.02691005041586554,-0.08935914496002795,-0.11626919537589349,53.90337474628066,50.679789262039634,-586935254,2703565525.8081765,15.68633914684974,22.662209894819494,22.955411674762768,78.57142857142857,35.714285714285715
2009-02-03,29.46001,30.42709,29.03,29.87,36.751652234561675,32.5459502357595,30.04575049068763,29.45677482245977,39.39284475000005,31.846090899999975,29.249580199999922,29.513449999999995,29.513449999999995,31.04449445074728,27.98240554925271,120609312,52.56225601211397,47.61981721269183,NaN,NaN,NaN,NaN,NaN,NaN,0.058815315503785354,-0.042750050996161804,-0.10156536649994716,71.00387363474827,55.26645799101359,-466325942,2727988848.8996882,19.816137443456224,20.475457915887034,21.827000420899527,71.42857142857143,28.571428571428573
2009-02-04,29.92999,30.8667,29.78999,29.91,36.68357609292425,32.493753201388024,30.040426942033214,29.49993912508265,39.30719480000005,31.709190799999977,29.336580199999926,29.44244999999999,29.44244999999999,30.74453014736607,28.14036985263391,175780816,52.821435750373865,48.39307688343921,NaN,NaN,NaN,NaN,NaN,NaN,0.07920838013874876,-0.0025548913265112105,-0.08176327146525997,67.08627339000715,63.99784059034537,-290545126,2591393060.861089,21.37419451916393,18.957248697608158,20.34912365376767,100,21.428571428571427
2009-02-05,29.47,30.77,29.46001,30.57001,36.62274458951207,32.45565927660807,30.061194905090733,29.60185063697954,39.22834485000005,31.58059099999998,29.414580399999927,29.448950499999988,29.448950499999988,30.772015424478226,28.12588557552175,217569568,56.99643750698083,49.21489347241974,NaN,NaN,NaN,NaN,NaN,NaN,0.13070384023512274,0.08161652882864345,-0.04908731140647928,89.79285716743094,75.96100139739546,-72975558,2742531987.5518885,19.481524681413344,19.509110617486318,18.11498487156572,92.85714285714286,14.285714285714286
2009-02-06,30.71001,31.50999,30.58,31.37,36.570478474193536,32.43416107311088,30.112520595087176,29.77024581441006,39.150944800000055,31.47349099999998,29.475980399999926,29.47945099999999,29.47945099999999,30.94270114763772,28.01620085236226,164509632,61.44951740540848,50.18921130846834,NaN,NaN,NaN,NaN,NaN,NaN,0.20762949823334645,0.21044956138520376,0.002820063151857323,96.05659750195782,84.31190935313198,91534074,2857514843.170036,23.275629527748492,18.259676128187508,17.13852552461895,100,7.142857142857143
2009-02-09,31.39,31.67,31.19,31.5,36.520025952062255,32.415662834039374,30.166931552142582,29.93498430827577,39.07209480000005,31.364390999999976,29.542580399999924,29.55095049999999,29.55095049999999,31.244297465729353,27.857603534270623,98853872,62.13568411630818,51.80124158992344,NaN,NaN,NaN,NaN,62.13568411630818,NaN,0.2532313152989598,0.3193592072755571,0.06612789197659727,95.23808189938903,93.69584552292594,190387946,2886347222.5033684,23.617876542650905,17.63845824736576,15.721561422208529,100,0
2009-02-10,31.3,31.67999,30.10001,30.34,36.458533156519344,32.37456059970196,30.173718550097774,29.973557231297125,38.98804485000006,31.26569089999997,29.562380199999925,29.59195049999999,29.59195049999999,31.31967391025555,27.86422708974443,232790560,53.060231632308565,52.19769476977253,NaN,NaN,NaN,NaN,NaN,NaN,0.1939074813918623,0.30851224371642516,0.11460476232456285,62.147068212057086,84.48058253780131,-42402614,2724275793.7511053,21.076106287246297,23.164682227245407,13.606568364515372,100,0
2009-02-11,30.34,30.53,29.73,30.2,36.39625919476293,32.33149999376727,30.17474919519198,29.995123209268826,38.902844800000054,31.15199079999997,29.583980199999928,29.625450499999992,29.625450499999992,31.37293911179221,27.877961888207775,169172560,52.0717153720523,52.67398019244913,NaN,NaN,NaN,NaN,NaN,NaN,0.13658019832459845,0.2853300102303109,0.14874981190571246,58.19225478038071,71.85913496394227,-211575174,2753880991.751105,19.907837908479085,24.444392375580374,11.954009647538525,92.85714285714286,7.142857142857143
2009-02-12,29.83,30.61,29.64,30.57001,36.33828656595932,32.296619003791676,30.19024961890994,30.049874332195603,38.81769480000005,31.028690999999977,29.65678059999993,29.722450999999996,29.722450999999996,31.453443273396907,27.991458726603085,201151376,54.48516246149666,53.25694760099255,NaN,NaN,NaN,NaN,NaN,NaN,0.11574585837568385,0.2934321348753173,0.17768627649963342,62.24532139674417,60.86154812972731,-10423798,2938446710.995971,18.564163466785157,23.420764248669652,10.613524539917886,85.71428571428571,0
2009-02-13,30.46001,30.78,30.28999,30.42999,36.27949754540251,32.25965605322154,30.1996512024821,30.08607582436745,38.73379470000005,30.92419089999997,29.708780399999927,29.789000499999997,29.789000499999997,31.521340814194232,28.05666018580576,145060560,53.38953395996661,53.66006232365667,NaN,NaN,NaN,NaN,NaN,NaN,0.08606402741365429,0.2852663107667013,0.199202283353047,57.48270396397252,59.30676004703246,-155484358,2876276207.9335847,19.135424374680078,22.591242144318546,9.472624639635994,78.57142857142857,35.714285714285715
2009-02-17,29.47,29.67,29.06,29.22,36.20925378873184,32.199464844246855,30.161233508267117,30.00359241252293,38.63639470000005,30.810690799999975,29.72078039999993,29.779000499999995,29.779000499999995,31.522021728838887,28.035979271161104,157782496,44.973325816945255,53.35846505788493,NaN,NaN,NaN,NaN,NaN,NaN,-0.016086411967507958,0.17909426839366205,0.19518068036117,16.32630153946617,45.351442300060945,-313266854,2801264857.3762074,17.29144781382438,29.065947853653373,9.554393509061978,71.42857142857143,28.571428571428573
2009-02-18,29.41,29.66991,28.87,29.24001,36.139908079391226,32.140861778024146,30.12510709617821,29.930870277996938,38.53874475000005,30.694590799999972,29.74938059999993,29.8430005,29.8430005,31.398023287029762,28.287977712970235,161268256,45.12737735774851,52.60406058703013,NaN,NaN,NaN,NaN,NaN,NaN,-0.07977148564502931,0.09546632330488336,0.17523780894991267,17.00691841441099,30.27197463928322,-151998598,2789190554.2023005,16.30355886666602,28.76239164644332,11.523896028109371,64.28571428571429,21.428571428571427
2009-02-19,29.42999,29.61,28.72,28.78999,36.06677456616345,32.07450788142961,30.072749562994748,29.8222150134258,38.43954470000005,30.567490699999976,29.74638039999993,29.825000499999998,29.825000499999998,31.41952656757677,28.230474432423225,155322368,42.26181207945079,52.016096054796776,NaN,NaN,NaN,NaN,NaN,NaN,-0.14582313767301985,-0.007041113141362132,0.13878202453165772,2.364535015321019,11.899251656399386,-307320966,2658297427.8569527,15.25899215459743,27.999418357598337,13.200148567464385,57.142857142857146,100
2009-02-20,28.46001,29.14999,28.39,28.87,35.9951648689877,32.01105227981714,30.02558291346554,29.73152786929001,38.33924475000005,30.445390699999972,29.722180399999935,29.830500999999998,29.830500999999998,31.41099082159297,28.250011178407025,210752368,42.95536902470321,51.70684379472467,NaN,NaN,NaN,NaN,NaN,NaN,-0.17573794163733977,-0.080890402515017,0.09484753912232277,14.589709999118554,11.320387809616847,-96568598,2713762080.186168,14.409969309342577,28.857522533510682,14.510533976733987,50,100
2009-02-23,29.03,29.05,27.73,27.86,35.91421795486842,31.92885322477126,29.94065809332964,29.55328711983382,38.23834480000004,30.345790599999976,29.67918059999993,29.778501499999997,29.778501499999997,31.536493814583434,28.02050918541656,169469872,36.925508736896745,50.801097659482465,NaN,NaN,NaN,NaN,NaN,NaN,-0.250596035287523,-0.218397504987081,0.03219853030044201,3.291147572525475,6.748464195655008,-266038470,2577672637.519501,13.051627881769464,30.850497147665063,16.107066520909612,42.857142857142854,100
2009-02-24,28,28.98,27.96001,28.78,35.84323071153639,31.866499695567867,29.89514208966965,29.47964072746869,38.140244850000045,30.24449059999997,29.656580599999934,29.762001499999997,29.762001499999997,31.550707785597226,27.973295214402768,181335808,44.5597535763384,50.22949034264135,NaN,NaN,NaN,NaN,NaN,NaN,-0.22596027702744342,-0.25025181598386226,-0.02429153895641885,26.5823457780906,14.821067783244876,-84702662,2687895666.7667685,12.01659073773042,28.403950958242525,18.886051280041208,35.714285714285715,92.85714285714286
2009-02-25,28.62,29.17,28.14,28.59,35.77105926167036,31.801618513477415,29.843960046937507,29.39491303913834,38.04214480000005,30.145390599999974,29.64658059999993,29.725500999999998,29.725500999999998,31.57746947600584,27.873532523994154,220223008,43.39168248737729,49.5559365381416,NaN,NaN,NaN,NaN,NaN,NaN,-0.21057774472207885,-0.2875137198590174,-0.07693597513693856,21.772207018245602,17.215233456287226,-304925670,2660100529.834729,12.484832668817928,26.335537634344576,21.006497921980632,28.571428571428573,85.71428571428571
2009-02-26,28.78,28.95,27.7,27.78999,35.69164563717613,31.722180325091724,29.763412201959564,29.24206322588707,37.93564475000005,30.055790499999976,29.608780599999932,29.59749999999999,29.59749999999999,31.606352528217386,27.588647471782593,211282816,38.78188443296193,48.25489703285454,NaN,NaN,NaN,NaN,NaN,NaN,-0.240250796771922,-0.37724947110184104,-0.13699867432991905,2.261060957439597,16.8718712512586,-516208486,2479239058.813673,11.3998673819389,27.105883077387855,23.91492674274809,21.428571428571427,100
2009-02-27,27.49001,27.98,27.39,27.53,35.61043523282612,31.639166853307728,29.675827409725855,29.079009585326396,37.827194750000054,29.969290599999976,29.576180599999933,29.494999999999994,29.494999999999994,31.696888616647993,27.293111383351995,204492560,37.3916255829481,46.53647618839308,NaN,NaN,NaN,NaN,NaN,NaN,-0.2615979108246458,-0.46399606286072625,-0.20239815203608047,3.263410870421623,9.098892948702273,-720701046,2371793815.423843,10.917600969508666,28.181962673016574,26.20624886118593,14.285714285714286,100
2009-03-02,27.12,27.50999,26.47,26.64,35.52117717080795,31.540173450271933,29.55677535444249,28.846722958152455,37.714844750000054,29.887090599999976,29.49778059999993,29.373999999999988,29.373999999999988,31.900283729141584,26.847716270858392,188175936,33.026938403184715,44.45728006602712,NaN,NaN,NaN,NaN,NaN,NaN,-0.3162169690751041,-0.5976693633799606,-0.28145239430485647,3.2629621170098533,2.9291446482903574,-908876982,2245137526.958916,10.091590813575106,32.61634896807155,28.938252389355252,7.142857142857143,100
2009-03-03,26.85001,27.16,26.42,26.62,35.43260824373524,31.442744273038826,29.44160769348396,28.63465410499508,37.59809475000006,29.82679069999998,29.426380599999934,29.234499999999997,29.234499999999997,32.0310894371758,26.43791056282419,158739936,32.93390334028763,43.01968518802562,NaN,NaN,NaN,NaN,NaN,NaN,-0.3325849261188186,-0.6971835519533798,-0.36459862583456115,4.587155963302736,3.704509650244738,-1067616918,2172202961.7697268,9.548462841696058,31.224589419868554,32.39839139354953,0,100
2009-03-04,27.00999,27.71001,26.92,27.33,35.351985276135885,31.361303792384593,29.35879954864145,28.510401333090787,37.48469525000006,29.776190699999983,29.379780599999933,29.107499999999998,29.107499999999998,32.00595622359969,26.209043776400307,164906128,39.45430899899741,42.11844187566455,NaN,NaN,NaN,NaN,NaN,NaN,-0.2767748757095879,-0.7105672204715461,-0.43379234476195816,20.87155963302745,9.573892571113346,-902710790,2178463053.1340375,12.766444239174973,28.768505068546613,34.41969622085848,14.285714285714286,92.85714285714286
2009-03-05,27.03,27.24001,26.42,26.50999,35.26400522363702,31.26523817273341,29.2470815271261,28.319885968034523,37.36899525000006,29.726090599999985,29.312780399999934,28.9374995,28.9374995,32.02068911306982,25.85430988693018,199616432,35.197983334831406,40.74078622375989,NaN,NaN,NaN,NaN,NaN,NaN,-0.2756615415035326,-0.7783692716413739,-0.5027077301378413,2.0639908256879975,9.17423547400606,-1102327222,2022659459.3083997,11.923233400207142,30.497439936324678,36.72100018827892,7.142857142857143,85.71428571428571
2009-03-06,26.63,26.81,25.71001,26.3,35.17481114180978,31.166916624758493,29.13150970253292,28.12751587584076,37.254145250000064,29.675890499999984,29.254580199999932,28.723999,28.723999,31.914922213134197,25.5330757868658,218421568,34.18105574755592,39.36875206573056,NaN,NaN,NaN,NaN,NaN,NaN,-0.26933107248518806,-0.8393715707443263,-0.5700404982591383,14.898774996906559,12.61144181854067,-1320748790,2038542822.9974518,10.979236844589213,33.19309330246366,39.72150297087868,0,100
2009-03-09,26.05,26.81,25.6301,25.74001,35.08093252348332,31.059453127238523,28.998509714198295,27.900134363855926,37.141945350000064,29.58199059999998,29.188180399999933,28.442499499999997,28.442499499999997,31.643373894621288,25.241625105378706,181154000,31.562231851977444,38.410816782518566,NaN,NaN,31.562231851977444,NaN,NaN,NaN,-0.28178478042766053,-0.9222714737937139,-0.6404866933660534,2.720672506875392,6.561146109823316,-1501902790,1891138524.0568645,10.059247096026636,30.97922578925676,41.548439005772806,0,100
2009-03-10,26.25999,27.39,26.16,27.33,35.00380881678199,30.985602570263502,28.933077960700324,27.845835853012506,37.03684530000007,29.519190599999984,29.151980399999935,28.2339995,28.2339995,31.140815121284156,25.327183878715843,175068128,44.55209967858163,38.36972551972093,NaN,NaN,NaN,NaN,NaN,NaN,-0.16751025726157442,-0.8498745149430214,-0.6823642576814469,42.71212844543831,20.110525316406754,-1326834662,2049126834.6910102,12.87090719728604,27.507944779403857,42.16297386102843,0,92.85714285714286
2009-03-11,27.63,27.99001,27.25999,27.75,34.931631614624955,30.921531232238483,28.886682746555213,27.836708628916078,36.93459530000006,29.490690499999985,29.124380399999932,28.104499499999996,28.104499499999996,30.85082423282799,25.358174767172002,173147936,47.39260291895506,38.736210579685526,NaN,NaN,NaN,NaN,NaN,NaN,-0.05407963203441468,-0.7499637977244653,-0.6958841656900506,59.8858724822735,35.106224478195735,-1153686726,2108422448.5098095,16.38430061700148,26.11374045490053,41.694541668881484,0,85.71428571428571
2009-03-12,27.72,28.75999,27.44,28.67,34.86932682243963,30.87694645536247,28.878185383945205,27.916069711876453,36.83269530000006,29.45479059999998,29.119980399999935,28.027999499999993,28.027999499999993,30.617328415403264,25.43867058459672,184511056,53.06457586856533,39.45829678281853,NaN,NaN,NaN,NaN,NaN,NaN,0.08490792383343626,-0.5897492608982553,-0.6746571847316916,85.87530721206815,62.82443604659332,-969175670,2267775510.9955564,20.152406566815152,23.767992485047905,39.89746244382949,21.428571428571427,78.57142857142857
2009-03-13,28.67999,28.84,28.32001,28.74001,34.80833859535068,30.834630881988957,28.872766741437548,27.994540215507268,36.730145350000065,29.419190699999987,29.10498039999993,27.93649949999999,27.93649949999999,30.27747441360852,25.59552458639146,156783504,53.475654162846226,40.64045002752921,NaN,NaN,NaN,NaN,NaN,NaN,0.1781902129603129,-0.45191941853130047,-0.6301096314916134,87.85304669623436,77.87140879685866,-812392166,2364262537.8903823,19.97746475212082,22.895481156198805,37.48775075780629,14.285714285714286,71.42857142857143
2009-03-16,28.89999,28.98,28.19,28.25999,34.74318089788451,30.7836478942268,28.848736280989016,28.019821147363718,36.62299530000007,29.369790599999988,29.07537999999993,27.827999499999994,27.827999499999994,29.879950959499862,25.776048040500125,190329440,50.22741101959393,41.045282702047466,NaN,NaN,NaN,NaN,NaN,NaN,0.2024275534452582,-0.3770751896850406,-0.5795027431302988,74.29277663210819,82.6737101801369,-1002721606,2207657547.271647,19.849646464452597,21.598259723656028,34.893226675782664,7.142857142857143,64.28571428571429
2009-03-17,28.41,29.33,28.3,29.33,34.68931840138814,30.754862787410428,28.867609368009056,28.14460008571003,36.51959535000007,29.34829059999999,29.041379999999933,27.8334995,27.8334995,29.900877504657647,25.76612149534235,169852368,56.5614525430015,41.98598056316348,NaN,NaN,NaN,NaN,NaN,NaN,0.28057621641196173,-0.22878247261534668,-0.5093586890273084,100,87.38194110944751,-832869238,2377509915.271647,20.83134075967637,19.949554650704478,32.49917606585307,100,57.142857142857146
2009-03-18,29.23,30.2,29.08,29.7,34.63967344217035,30.733974415382498,28.900252137891055,28.292733410880505,36.42109540000006,29.339190599999988,29.014979999999927,27.856498999999996,27.856498999999996,29.994967230327426,25.718030769672566,208146880,58.52687539772354,43.396337060646445,NaN,NaN,NaN,NaN,NaN,NaN,0.3431062770261545,-0.08047584274461528,-0.42358211977076976,89.05884155014333,87.78387272741718,-624722358,2399811366.7002187,25.335352474079077,18.368949460502055,30.724254841087394,100,50
2009-03-19,30.12,30.13,29.46001,29.67999,34.590323358168654,30.713103436860074,28.930830093267875,28.42485308603474,36.32384535000006,29.331090399999994,28.981979799999927,27.900998999999995,27.900998999999995,30.149524776618982,25.65247322338101,146766496,58.37305173289807,44.89501035707145,NaN,NaN,NaN,NaN,NaN,NaN,0.36689743549084913,0.03503967459279167,-0.33185776089805746,88.62097638898008,92.55993931304113,-771488854,2349421514.501111,24.104992536611284,17.47689873680697,28.708896696348557,92.85714285714286,42.857142857142854
2009-03-20,29.66,30.03,28.98,29.17999,34.536489195400804,30.682744754942053,28.94060107000247,28.496770887364764,36.220945350000065,29.327790399999994,28.956779599999926,27.9164985,27.9164985,30.19559442561038,25.63740257438962,149437376,54.51729427089318,46.430035776193485,NaN,NaN,NaN,NaN,NaN,NaN,0.33369255481869736,0.08525793262531423,-0.24843462219338314,77.67981793912342,85.11987862608227,-920926230,2256909816.2653775,22.2789705135185,19.616033585562736,25.395670467154282,85.71428571428571,35.714285714285715
2009-03-23,29.86,30.94,29.19839,30.89999,34.50030512380478,30.687046640982803,29.017439851570998,28.72564889809193,36.12269530000006,29.349890299999988,28.95957959999993,28.068497999999998,28.068497999999998,30.691753369983424,25.445242630016573,179642560,63.45900810666501,48.61040040236329,NaN,NaN,NaN,NaN,NaN,NaN,0.4074189765693579,0.2608390985183142,-0.14657987805104367,99.24650181735998,88.51576538182117,-741283670,2428298520.5507226,25.818677637261466,17.256327541340617,23.018162947471893,100,28.571428571428573
2009-03-24,30.64999,30.88,30.31,30.33099,34.45881940117986,30.67999601442869,29.068951622097625,28.87853852684508,36.02920025000006,29.33460019999999,28.96479919999993,28.1460475,28.1460475,30.935301885522666,25.356793114477338,120849440,59.305295439755284,50.02832800527458,NaN,NaN,NaN,NaN,NaN,NaN,0.39729578348113337,0.3500398513003731,-0.04725593218076031,88.53066912747884,88.48566296132076,-862133110,2316349535.7984424,24.744112399657517,16.538124619984526,21.68609379099163,92.85714285714286,21.428571428571427
2009-03-25,30.58,31.05,29.66,30.47,34.41912965589449,30.675837677509307,29.123894695740855,29.030106286193167,35.93770025000006,29.32150019999999,28.983799199999925,28.240047499999996,28.240047499999996,31.204052949920445,25.276042050079546,190601568,59.99423981515517,51.79948918244055,NaN,NaN,NaN,NaN,NaN,NaN,0.37942597746265916,0.42702653964756365,0.04760056218490448,89.2986955478883,92.35862216424238,-671531542,2347887924.748082,22.38076014391396,19.424914702035142,19.063572276000674,100,14.285714285714286
2009-03-26,30.88,31.46001,30.41701,31.41,34.389188067278624,30.690375545281398,29.213545884143173,29.256762830365247,35.852050300000066,29.30720019999999,29.021399199999923,28.421047999999995,28.421047999999995,31.680418031608376,25.161677968391615,182459440,64.38505385826979,53.95691761892012,NaN,NaN,NaN,NaN,64.38505385826979,NaN,0.40789003128496937,0.5574631012911162,0.14957307000614684,99.14218229783992,92.32384899106903,-489072102,2512850151.719511,23.593802584525463,18.033100771296485,16.425669209118272,100,7.142857142857143
2009-03-27,31.07001,31.17999,30.71001,30.82001,34.35367385765396,30.692942564186716,29.27654447692187,29.405643513187606,35.76925035000007,29.28650029999999,29.065199399999923,28.585548499999998,28.585548499999998,31.97781349153201,25.193283508467985,156108000,59.938439846910754,55.98378961855822,NaN,NaN,NaN,NaN,NaN,NaN,0.36533306673011195,0.6062394034187868,0.24090633668867484,87.92455108575265,92.12180964382695,-645180102,2429817091.0786324,22.432127349117454,17.14521478901011,13.738664120233636,92.85714285714286,0
2009-03-30,30.28999,30.32001,29.62,30.06,34.31095073469223,30.680409048064206,29.307268222924936,29.46796317859831,35.682450350000074,29.258900199999992,29.084419399999923,28.756548499999997,28.756548499999997,32.08344907332251,25.42964792667748,162919632,54.697918350532355,56.70849095226898,NaN,NaN,54.697918350532355,NaN,NaN,NaN,0.2688094630055923,0.5769181654456652,0.30810870244007293,66.66658730196521,84.5777735618526,-808099734,2471707784.873977,20.56295231733771,23.28534282774949,11.592906356142363,85.71428571428571,0
2009-03-31,30.31,30.95,30.27,30.32001,34.27123988161071,30.673272433251054,29.346983586731803,29.54911049492228,35.592200400000074,29.2246003,29.102419599999926,28.941549,28.941549,32.18304266166259,25.700055338337407,150243808,56.11167136090478,57.33128155526539,NaN,NaN,NaN,NaN,NaN,NaN,0.20800316446853923,0.568112658025747,0.3601094935572077,71.64186158740897,75.41099999170893,-657855926,2343563073.4565654,23.69684848539483,21.83233008499215,10.250146468730035,78.57142857142857,0
2009-04-01,29.94,30.88,29.78999,30.77,34.23640167383349,30.67518783061242,29.402788151958006,29.665385685882065,35.50205040000007,29.212400199999998,29.15861939999992,29.113548999999995,29.113548999999995,32.35980434032664,25.867293659673354,137949936,58.52406966938203,57.721245398180876,NaN,NaN,NaN,NaN,NaN,NaN,0.184421345996301,0.590636176052584,0.406214830056283,78.89884128794709,72.40243005910708,-519905990,2453670158.546941,21.894851923585055,23.520871854175653,9.917872763128,71.42857142857143,0
2009-04-02,31.34,32.27,31.23,31.75999,34.211760761656045,30.696669061689402,29.495227440116516,29.864871811036153,35.41815040000007,29.224400100000004,29.21081939999992,29.376048999999995,29.376048999999995,32.58659020587161,26.16550779412838,212272320,63.30312135183494,58.4232073402515,NaN,NaN,NaN,NaN,NaN,NaN,0.2194485132715006,0.6805254716456588,0.4610769583741582,87.49975490196067,79.34681925910557,-307633670,2457748236.38694,29.06276283159465,21.138630921941786,10.559193465899307,100,7.142857142857143
2009-04-03,32.05,32.39999,31.83,32.35001,34.19323587845549,30.729408486210403,29.60717969736685,30.10155163855652,35.33980045000007,29.236000199999992,29.28261979999992,29.678549499999995,29.678549499999995,32.81192179521497,26.545177204785023,134577248,65.83014515970387,59.53768835025936,NaN,NaN,NaN,NaN,65.83014515970387,NaN,0.26334915683147453,0.7902634044135013,0.5269142475820268,98.78097263651851,88.39318960880875,-173056422,2568724470.8427,28.673583833787326,20.19863144920081,11.496495063151286,100,0
2009-04-06,31.97,32.33,31.64999,32.27,34.17409920304797,30.759915248859702,29.711604022960305,30.308070530122563,35.25730045000007,29.251000199999993,29.350019999999923,30.005048999999996,30.005048999999996,32.76771414557913,27.24238385442087,160413632,65.17472225039337,60.15292190078734,NaN,NaN,NaN,NaN,NaN,NaN,0.26715020385493116,0.8608520024006907,0.5937017985457596,96.19911169330906,94.15994641059608,-333470054,2700830231.1349325,27.24641523208957,20.473196319868773,12.355890187372713,92.85714285714286,0
2009-04-07,31.89999,31.92,31.21001,31.42,34.14669523087834,30.772986234030796,29.778599943628528,30.413968574872797,35.17730045000007,29.264200099999993,29.39621999999992,30.209549,30.209549,32.74613677545684,27.672961224543155,147531184,58.50994232480535,60.1517123955789,NaN,NaN,NaN,NaN,NaN,NaN,0.19587049114519672,0.8385399124772555,0.6426694213320587,71.34523785157266,88.77510739380007,-481001238,2640568088.46836,25.20097561986378,22.052313977789137,11.693284026647685,85.71428571428571,14.285714285714286
2009-04-08,31.72,32.14999,31.49001,31.95,34.124837566889504,30.796293437317313,29.863752887015643,30.56025728202777,35.10180045000007,29.296599999999994,29.448819799999924,30.419549,30.419549,32.79732847307916,28.041769526920838,126126000,61.175879310991405,60.35191436544272,NaN,NaN,NaN,NaN,NaN,NaN,0.1688901607136415,0.8537821222241107,0.6848919615104692,86.84235918818467,84.7955695776888,-354875238,2690255594.1503487,25.533502403936986,20.889259234178297,11.269311216390337,78.57142857142857,7.142857142857143
2009-04-09,32.53,33.00999,32.42999,32.94,34.11304813836324,30.83874307222192,29.984390028701306,30.786899445644174,35.03245045,29.321399899999992,29.50061959999999,30.633049,30.633049,33.1089037070854,28.157194292914596,131871440,65.61972704910478,61.14494527817207,NaN,NaN,NaN,NaN,NaN,NaN,0.200061368893393,0.9349686726272104,0.7349073037338174,98.16376324902916,85.45045342959548,-223003798,2790300544.200002,29.769617946712756,19.29770584251941,12.339719102810903,100,0
2009-04-13,32.8,33.07001,32.53,32.89,34.100878505145694,30.879362021286834,30.098335517771844,30.987194736535205,34.9590504,29.360499899999994,29.566819599999988,30.8405485,30.8405485,33.34248346973286,28.338613530267143,119310432,65.21373631861528,61.27028300759708,NaN,NaN,NaN,NaN,NaN,NaN,0.19922043795310673,0.9839328511752008,0.7847124132220941,94.78233396424929,93.2628188004877,-342314230,2830067742.317962,29.02111462140317,18.523415300686917,12.497001341371869,100,0
2009-04-14,32.69,32.88,32.27,32.49001,34.08484996280593,30.911256040667293,30.192126673937654,31.130319999722328,34.8932505,29.40169999999999,29.63541979999999,31.0520495,31.0520495,33.35270943018968,28.751389569810325,124068944,61.91360224616241,61.45659063662616,NaN,NaN,NaN,NaN,NaN,NaN,0.1555693935442446,0.9791741551523998,0.8236047616081552,83.18845452621862,92.04485057983236,-466383174,2795495219.2013702,27.649415688920104,19.629999588851714,12.288714240120536,92.85714285714286,28.571428571428573
2009-04-15,32.24001,32.42999,31.85001,32.39999,34.06808518705662,30.94073592105012,30.27870954946951,31.251240952129727,34.8270005,29.442299899999988,29.695219599999987,31.205548999999998,31.205548999999998,33.434693578217896,28.976404421782096,124808128,61.16343358566508,61.54010447737687,NaN,NaN,NaN,NaN,NaN,NaN,0.10680104639806165,0.9571060696057323,0.8503050232076707,80.57918672699498,86.18332507248762,-591191302,2907391716.3175497,26.269146955919126,21.92600848054848,12.427366083258601,85.71428571428571,21.428571428571427
2009-04-16,32.83,33.42999,32.50999,33.24001,34.05984563295655,30.986266100831305,30.39483897890208,31.44064752811737,34.76735055,29.506099999999993,29.76261979999999,31.3825495,31.3825495,33.666896145415386,29.098202854584617,171168000,65.37892919475837,61.61109557284034,NaN,NaN,NaN,NaN,NaN,NaN,0.11649134924663573,0.9959192097659653,0.8794278605193295,95.01363520639165,86.26042548653508,-420023302,3007867332.3175497,31.908466858804772,20.180020574984407,13.081505805246602,100,14.285714285714286
2009-04-17,33.16,33.5,32.92999,33.31,34.05238448237987,31.03228063348811,30.509159018945134,31.618681096868098,34.70485055,29.583599999999986,29.830619799999987,31.564049999999998,31.564049999999998,33.85528136898085,29.272818631019152,129835376,65.71287038793436,62.02355489719917,NaN,NaN,NaN,NaN,65.71287038793436,NaN,0.11290739667366467,1.0205621063614103,0.9076547096877456,95.1030927835052,90.23197157229727,-290187926,3051147309.4999866,31.019241844814342,19.265704246486877,13.796894146574905,100,7.142857142857143
2009-04-20,32.7,32.82001,32.06,32.24001,34.03435090544077,31.056196066488347,30.57703552800611,31.677855278118756,34.64250055,29.639300099999993,29.864019799999987,31.717050999999998,31.717050999999998,33.74454697528516,29.68955502471483,123080496,56.707556748101574,62.16710049702555,NaN,NaN,56.707556748101574,NaN,NaN,NaN,0.028183075488910192,0.9428835540488834,0.9147004785599732,66.03809693235323,85.38494164075001,-413268422,2986370572.884625,28.020974669541832,24.13085436490295,13.886220120116787,92.85714285714286,0
2009-04-21,32.09,32.74001,32.08,32.69,34.02097427951598,31.088548619627193,30.659896879849008,31.774250013536015,34.58280055,29.683200099999986,29.89041979999999,31.8065515,31.8065515,33.839900163552876,29.773202836447126,145490128,59.237534360684236,62.390376425581216,NaN,NaN,NaN,NaN,NaN,NaN,-0.006019730155063963,0.9071758158661432,0.9131955460212071,78.16717475155048,79.76945482246963,-267778294,3109812667.366102,26.561116501390593,22.873666659460167,14.126506177595015,85.71428571428571,7.142857142857143
2009-04-22,32.5,33.53,32.39,32.78999,34.0087256797198,31.122240528149426,30.743429943384342,31.870987155104014,34.52225055,29.729399999999988,29.91621959999999,31.929501500000004,31.929501500000004,33.887054535340525,29.97194846465948,165040496,59.79971017170423,62.48149360431852,NaN,NaN,NaN,NaN,NaN,NaN,-0.029086123186653046,0.8768378920378908,0.9059240152245438,68.10287975379214,70.76938381256527,-102737798,3060587167.848629,30.336769471789125,20.852828996179674,15.194133564004014,100,0
2009-04-23,33.00999,33.14,32.49001,33.11,33.999783135642986,31.161602101849436,30.836236612271232,31.988988378427443,34.45795055,29.766999899999988,29.97161959999999,32.061501500000006,32.061501500000006,33.962817965549796,30.160185034450215,181848816,61.62387666959358,62.361547555586995,NaN,NaN,NaN,NaN,NaN,NaN,-0.029855794551424508,0.8686042720352631,0.8984600665866876,81.89647369169688,76.05550939901316,79111018,3225649681.04397,28.775748369751575,19.77981737803465,15.390019280446191,92.85714285714286,21.428571428571427
2009-04-24,33.35001,33.92999,33.07001,33.69,33.996700716382854,31.21166938696133,30.948148901986087,32.150989485243876,34.402650550000004,29.812699899999984,30.04141959999999,32.1755015,32.1755015,34.1776330976157,30.17336990238431,141169936,64.74628242794348,62.28412878903267,NaN,NaN,NaN,NaN,NaN,NaN,0.00005003652099344613,0.8985226122379295,0.8984725757169361,91.17677335862767,80.39204226803889,220280954,3288028545.296627,33.08506670380842,18.428678485698303,16.183617037366762,100,14.285714285714286
2009-04-27,33.42,34.06,33.35001,33.73,33.99404697791138,31.26153731989279,31.0572411019082,32.30137143903017,34.344900550000006,29.880699999999983,30.104619399999986,32.321001,32.321001,34.330894577320976,30.31110742267903,120749056,64.95803726646886,62.26865129018092,NaN,NaN,NaN,NaN,NaN,NaN,0.013153312651057014,0.9149142165307573,0.9017609038797003,88.4210120035507,87.1647530179584,341030010,3296530418.998284,32.23919456550083,17.373528235864942,17.31001924706788,100,7.142857142857143
2009-04-28,33.52,33.91,33.36,33.48,33.98893208260878,31.305467273954317,31.152251254774544,32.41362177817015,34.28950055000001,29.937199999999983,30.165619599999985,32.492001,32.492001,34.272152348665784,30.711849651334216,108967936,62.433896547655195,62.5489337346702,NaN,NaN,NaN,NaN,NaN,NaN,-0.0034989240913396724,0.8973872487655257,0.9008861728568653,77.43181880085116,85.67653472100984,232062074,3235112127.798283,30.769472208107185,16.5815027768175,18.97430820139726,92.85714285714286,0
2009-04-29,33.75,34.39999,33.64,33.94,33.98844519621466,31.357636238826508,31.261574734979465,32.55899113263014,34.238050550000004,29.99039999999998,30.260019599999985,32.6730005,32.6730005,34.25847417942204,31.087526820577963,141413568,65.11963775003619,62.830630766030545,NaN,NaN,NaN,NaN,NaN,NaN,0.007390113990748626,0.9101238153453011,0.9027337013545524,81.96103498850954,82.60462193097048,373475642,3205342319.3214335,32.476288856171806,15.323145021826337,20.822981487300122,100,0
2009-04-30,34.37,34.89999,34.03999,34.28,33.9913462390384,31.415504828156678,31.379944353215564,32.72289673904632,34.18825050000001,30.055099999999985,30.36081939999999,32.8485005,32.8485005,34.325908055869306,31.371092944130698,144120368,66.99773275309104,62.929059744886715,NaN,NaN,NaN,NaN,NaN,NaN,0.027295704977339796,0.9368533325762272,0.9095576275988874,79.67232572016863,79.68839316984311,517596010,3141664578.120689,34.01703388108746,14.11906726165491,22.251193093573214,100,21.428571428571427
2009-05-01,34.28,34.53999,34.00999,34.37,33.99511393815244,31.474009683044663,31.497201437403188,32.87976371628,34.13340050000001,30.109399999999987,30.472419599999988,32.979001,32.979001,34.50891364068171,31.44908835931828,100112000,67.49663241052812,63.092123751451915,NaN,NaN,NaN,NaN,NaN,NaN,0.035792584285461726,0.9542983579557145,0.9185057736702528,82.62316474206372,81.41884181691397,617708010,3177557563.4791775,32.49870276407989,13.741518409688949,23.57154527411691,92.85714285714286,14.285714285714286
2009-05-04,34.67,35.09,34.52,35.05,34.005610316877295,31.544821372489324,31.636526871230515,33.0864528861581,34.08045050000001,30.159099999999988,30.596019599999988,33.114000499999996,33.114000499999996,34.85939863913636,31.368602360863637,119317312,71.05677531971655,63.74520754242007,NaN,NaN,NaN,NaN,71.05677531971655,NaN,0.07426412679597127,1.0113359321652169,0.9370718053692456,98.76542828835872,87.02030625019704,737025322,3280128586.075666,35.18912665161665,12.899203925214062,25.670851795519564,100,7.142857142857143
2009-05-05,34.99001,35.06,34.63,35.02,34.015703746560106,31.61363679085587,31.769212091966573,33.27060023033352,34.03260050000001,30.209200099999986,30.739219599999988,33.2515005,33.2515005,35.13694185790529,31.366059142094706,113638128,70.68891123398616,64.42559880301442,NaN,NaN,NaN,NaN,NaN,NaN,0.08402666138880821,1.042105132105256,0.9580784707164477,97.6897689768977,93.02612066910672,623387194,3372624736.7733407,33.854450334408256,12.409954443114914,28.338028549643663,92.85714285714286,0
2009-05-06,35.32001,35.34,34.46001,35.03,34.02579624659433,31.681287547472586,31.897086127575726,33.4381621131589,33.98385050000001,30.260400099999984,30.864219599999988,33.4320005,33.4320005,35.27219108580898,31.59180991419102,178840496,70.7432826845571,64.80876690942863,NaN,NaN,NaN,NaN,NaN,NaN,0.07764437060413054,1.0551339339716108,0.9774895633674803,90.5487804878048,95.66799258435374,802227690,3425462542.379132,33.69739459299397,11.452614716088453,30.24890116555279,100,14.285714285714286
2009-05-07,35.25,35.27,33.88,34.21001,34.02762921926504,31.731361259403823,31.98778902453354,33.5116714357152,33.93100055,30.311600199999983,30.97661979999999,33.545001,33.545001,35.28195799432028,31.80804400567972,216484624,60.78609973576315,64.45685471998782,NaN,NaN,NaN,NaN,NaN,NaN,0.008332396260764208,0.9879050586934355,0.9795726624326713,65.54908536585347,84.595878276852,585743066,3311772293.582353,29.788402004842098,14.964567816936283,30.94531679885378,92.85714285714286,7.142857142857143
2009-05-08,34.35001,34.74001,33.88,34.23,34.02964285887434,31.780839254267114,32.0757188667087,33.5800836799328,33.875300550000006,30.35710029999999,31.10541999999999,33.609501,33.609501,35.34760861580401,31.871393384195994,183507312,60.930470210360205,64.75849139586344,NaN,NaN,NaN,NaN,NaN,NaN,-0.043202666321927374,0.925569329530262,0.9687719958521894,65.95092024539862,74.01626203301898,769250378,3277629661.5279336,27.651152865377952,13.890894590557739,32.77849301141798,85.71428571428571,0
2009-05-11,33.78,34.72,33.67999,34.35001,34.03283059162186,31.83171392249945,32.16490675428875,33.653409996129675,33.823600600000006,30.409000399999986,31.241820199999992,33.6825015,33.6825015,35.416236246185605,31.948766753814397,142775872,61.838812532208685,64.94429697954375,NaN,NaN,NaN,NaN,NaN,NaN,-0.07441244152020299,0.8757564439519356,0.9501688854721386,66.44101694915237,65.98034085346818,912026250,3318818731.706259,25.288252241713753,14.347274411478029,34.21740344725829,78.57142857142857,0
2009-05-12,34.42,34.48,33.52,33.92999,34.031807302152984,31.873263943836093,32.23412570510096,33.67975094887923,33.76690055000002,30.442700299999988,31.387619999999988,33.754500500000006,33.754500500000006,35.40160209435843,32.10739890564158,147842128,56.85652385596822,64.73406938556262,NaN,NaN,NaN,NaN,NaN,NaN,-0.12554050434972108,0.7932432550349873,0.9187837593847084,50.52579131856588,60.97257617103897,764184122,3297255341.328591,23.308272688815844,14.52879295684232,34.55142481464662,71.42857142857143,0
2009-05-13,33.63,33.64999,32.96001,33.02,34.0217395678032,31.895971588512605,32.26494430490092,33.61691752517645,33.709900550000015,30.471000299999986,31.51561999999999,33.785501,33.785501,35.35076711032045,32.220234889679546,175548192,47.85970291874654,63.75091411764497,NaN,NaN,47.85970291874654,NaN,NaN,NaN,-0.2174553549835927,0.6469645656552174,0.8644199206388101,2.5205988260457413,39.82913569792135,588635930,3152233066.132211,21.478403217089205,17.92056921469926,33.873080953381006,64.28571428571429,0
2009-05-14,33.10001,33.7,33.08,33.39,34.01545360195441,31.92555630953216,32.309064136081275,33.5953063323025,33.65015055000002,30.508300299999988,31.63681999999999,33.7930005,33.7930005,35.349151247228505,32.23684975277149,140021632,51.2383072480095,62.78605874764968,NaN,NaN,NaN,NaN,NaN,NaN,-0.24793464943886134,0.5545016088402335,0.8024362582790948,18.066882633960752,23.70442425952412,728657562,3152233066.132211,20.688104493490382,16.9178354602724,32.55696057937267,57.142857142857146,92.85714285714286
2009-05-15,33.36,33.82001,33.23,33.37,34.00903117805437,31.954159154887957,32.35066946407809,33.573848586368925,33.589150500000024,30.543400299999984,31.774020199999985,33.796000500000005,33.796000500000005,35.348642485809336,32.243358514190675,121326320,51.04576037708617,61.79232468412234,NaN,NaN,NaN,NaN,NaN,NaN,-0.26263334817668393,0.47414457305823987,0.7367779212349238,17.22654296866791,12.604674809558128,607331242,3088484362.782776,20.670825051467336,16.077252080297473,31.30958605953405,50,85.71428571428571
2009-05-18,33.59,34.28,33.39011,34.24001,34.01132947479015,31.999423528058493,32.42476124980052,33.63729253052426,33.53305050000002,30.593700299999988,31.932820399999986,33.8960005,33.8960005,35.283770198509146,32.50823080149085,114333376,58.37379399590073,61.50231735899702,NaN,NaN,NaN,NaN,NaN,NaN,-0.20927359166335502,0.4751859316557301,0.6844595233190851,53.781738578733425,29.69172139378736,721664618,3192541880.6289806,22.948585791201793,14.851577208163476,30.69938246281055,42.857142857142854,78.57142857142857
2009-05-19,34.14,34.74001,33.95,34.39999,34.015196743697715,32.04695949779991,32.50222120078873,33.70993038476005,33.48065045000002,30.647100199999986,32.10601999999999,33.9815,33.9815,35.26858108529423,32.694418914705764,129086368,59.57219841193337,61.106071691989676,NaN,NaN,NaN,NaN,NaN,NaN,-0.1608887995125945,0.48334852392834193,0.6442373234409364,60.503615561409994,43.837299036270444,850750986,3210510802.400807,25.295862204527136,13.863454664654517,30.221449674860928,35.714285714285715,71.42857142857143
2009-05-20,34.53999,35.03999,34.17999,34.28,34.01783160196938,32.09117812160585,32.57193801644408,33.764222729068614,33.42990050000002,30.698500199999984,32.24501999999998,34.056000499999996,34.056000499999996,35.2257259618505,32.88627503814949,131873680,58.21837903718135,60.478974997996126,NaN,NaN,NaN,NaN,NaN,NaN,-0.13565896262032007,0.4746636201655363,0.6103225827858564,55.46199773948633,56.58245062654325,718877306,3109308486.904994,25.989426472088805,12.860360039075685,29.682703079442188,28.571428571428573,64.28571428571429
2009-05-21,34.02,34.25999,33.31,33.64999,34.0141714865269,32.12204568355425,32.61421456481882,33.75334342153827,33.36850050000002,30.743700099999984,32.36301979999998,34.083,34.083,35.18723153374708,32.978768466252916,139253120,51.58915650414028,59.34272671896843,NaN,NaN,NaN,NaN,NaN,NaN,-0.15850388352174705,0.4121927283836726,0.5706966119054196,28.9908781129334,48.31883047127658,579624186,3069729401.9344153,23.88980498788938,19.06721164047727,27.58712483307175,21.428571428571427,57.142857142857146
2009-05-22,33.78,33.97,33.32001,33.53999,34.00945326278036,32.1501237888304,32.650519483845535,33.73302404805843,33.30305045000002,30.790199999999984,32.46041959999998,34.0754995,34.0754995,35.19227361419677,32.95872538580323,83520320,50.507746443228655,57.87493894207643,NaN,NaN,50.507746443228655,NaN,NaN,NaN,-0.1767364769679326,0.3497760156955039,0.5265124926634365,24.36900995382353,36.27396193541443,496103866,3042741643.954139,22.573768291133952,18.016840980842712,25.07816158565465,14.285714285714286,50
2009-05-26,33.19,34.83,33.17999,34.78999,34.017219797479065,32.2023983672694,32.734420288400614,33.833687472052866,33.24565040000002,30.84319979999999,32.581419199999985,34.128499,34.128499,35.27487327926418,32.98212472073582,144857120,60.61188303856434,57.15515121383201,NaN,NaN,NaN,NaN,NaN,NaN,-0.10392752927127791,0.39660308107433906,0.500530610345617,76.89023903461784,43.41670903379159,640960986,3180573675.1714053,26.441100996402593,15.658672075272188,23.596702094910032,7.142857142857143,42.857142857142854
2009-05-27,34.67999,35.19,34.42999,34.55,34.02252109302653,32.24888552831357,32.80561949277706,33.90190771280974,33.18180035000002,30.891299699999987,32.70721939999998,34.181999000000005,34.181999000000005,35.30188623367857,33.062111766321436,121393120,58.156994652861066,56.25613064013943,NaN,NaN,NaN,NaN,NaN,NaN,-0.0727230817534717,0.40962675815377736,0.48234983990724906,68.83103390057948,56.696760963006945,519567866,3097517914.761937,27.716938109843976,14.704010421029876,22.268638235933533,0,35.714285714285715
2009-05-28,34.77,35.07001,34.21001,34.95,34.03174973886706,32.30237294359449,32.889712846001494,34.00172602587548,33.11780035000002,30.93049969999999,32.81961939999998,34.232499000000004,34.232499000000004,35.394479559285294,33.070518440714714,118931248,60.99276264744342,56.27089227668803,NaN,NaN,NaN,NaN,NaN,NaN,-0.028222900356097314,0.4470712144621274,0.4752941148182247,89.23761989964103,78.31963094494611,638499114,3183256281.1980305,25.800123288770845,15.456094754899654,21.69356431718759,0,28.571428571428573
2009-05-29,34.98,35.5,34.75999,35.38,34.045165164350976,32.36331605362232,32.98737116576614,34.13299021388734,33.055700350000016,30.97409969999999,32.93321939999998,34.287499000000004,34.287499000000004,35.552804994673124,33.02219300532688,111535632,63.83056836063943,56.478042144565116,NaN,NaN,NaN,NaN,NaN,NaN,0.024256872027252574,0.5056152048522904,0.4813583328250378,95.27557195107077,84.44807525043042,750034746,3258618683.5389724,27.74576744550866,14.525239752698885,21.561560815769667,100,21.428571428571427
2009-06-01,35.73,36.5,35.61,36.39,34.06849685425793,32.44305236939218,33.12080759063806,34.34794352685045,32.999150350000015,31.024699699999992,33.06741959999998,34.388499,34.388499,35.95148846514588,32.82550953485413,119192192,69.45211933124634,57.02184977306781,NaN,NaN,NaN,NaN,NaN,NaN,0.11594597975943166,0.6262908075243274,0.5103448277648958,96.89264658939716,93.80194614670297,869226938,3348347637.0670624,33.246717879811726,13.226853451952806,22.666845692459315,100,14.285714285714286
2009-06-02,36.19,36.78999,36.11,36.44,34.09209390048422,32.522199847226,33.25097199884833,34.54718700048374,32.94010035000001,31.08469969999999,33.21261979999998,34.45799900000001,34.45799900000001,36.24064580297459,32.675352197025425,126858560,69.70316059193601,57.9394666827798,NaN,NaN,NaN,NaN,NaN,NaN,0.16587502313453295,0.7176886066830619,0.5518135835485289,90.86183217666921,94.3433502390457,996085498,3344618313.673482,33.7657401684084,12.496491882582122,24.29341856253112,100,7.142857142857143
2009-06-03,36.28,36.37,35.92999,36.33,34.11436162286746,32.59760183044924,33.371718194971926,34.71697871472338,32.880950350000006,31.14039979999999,33.32121999999998,34.523499,34.523499,36.47244157179571,32.57455642820429,93329680,68.37194221908973,59.40462663280431,NaN,NaN,NaN,NaN,NaN,NaN,0.17642341529831973,0.7723428526714287,0.5959194373731089,87.60131428925673,91.78526435177436,902755818,3420979346.5972795,32.32406254163151,13.469924004211228,26.589231137954783,92.85714285714286,0
2009-06-04,36.39999,36.78999,36.34,36.74001,34.14048747736629,32.6796297149948,33.50380806967891,34.9096483609402,32.82665035000001,31.20709979999999,33.44940039999997,34.6089995,34.6089995,36.77704270902026,32.44095629097975,89280560,70.6239827084161,60.78931773711906,NaN,NaN,NaN,NaN,NaN,NaN,0.19451953277681167,0.8390688533441235,0.6445493205673118,98.61551246537383,92.35955297709991,992036378,3490427277.4775195,34.67263785824254,12.93355439738976,29.13485081873471,85.71428571428571,0
2009-06-05,36.96001,37.08,36.42,36.78,34.16675128356165,32.760825166183025,33.63228618459346,35.08777708846971,32.775500400000006,31.279699799999992,33.57560039999998,34.73749900000001,34.73749900000001,37.09231809711878,32.382679902881236,121963056,70.84205586439991,62.20333884335576,NaN,NaN,NaN,NaN,NaN,NaN,0.19234062854991618,0.8849751062547071,0.6926344777047909,92.30771203150768,92.84151292871275,1113999434,3501514828.0229745,35.20985040957886,12.183892720336072,31.712294439034313,100,42.857142857142854
2009-06-08,36.53,36.95,36.12,36.67,34.1916592309889,32.83823456883287,33.75141221657019,35.23846498480592,32.72340040000001,31.351099799999997,33.680800399999974,34.85949900000001,34.85949900000001,37.34566833376545,32.37332966623456,89194128,69.31772391623456,62.985048123379606,NaN,NaN,NaN,NaN,NaN,NaN,0.16755756067558591,0.9020814285492733,0.7345238678736874,89.4872064430605,93.47014364664733,1024805306,3530529785.3241796,32.64707508168059,13.92788916345502,33.05307689736981,92.85714285714286,35.714285714285715
2009-06-09,36.84,37.17,36.67,36.95,34.21910540779498,32.91965566647974,33.87684703160665,35.401468319586314,32.67380040000001,31.434299799999994,33.80340019999998,34.9894985,34.9894985,37.623043934225834,32.35595306577417,109187744,71.02670150016196,63.80322691539594,NaN,NaN,NaN,NaN,71.02670150016196,NaN,0.15441280162720794,0.9275398699076973,0.7731270682804894,94.4862293578212,92.09371594412978,1133993050,3543632314.6041803,33.15898426939545,13.29987352171127,34.02100413322244,100,28.571428571428573
2009-06-10,37.17,37.17999,36.28999,36.82001,34.24498505547861,32.99689040575737,33.99226518722992,35.53656752724476,32.62045040000002,31.511509899999997,33.93860039999998,35.1339995,35.1339995,37.835421758022775,32.43257724197723,133404624,69.1023767157912,64.58065532101092,NaN,NaN,NaN,NaN,NaN,NaN,0.12273523707142286,0.926546114619768,0.8038108775483451,91.00050000000017,91.65797860029396,1000588426,3569120092.4299793,30.520908297427873,15.63872197208886,33.91002270844048,100,21.428571428571427
2009-06-11,36.75999,37.23,36.75,36.82001,34.27060719423007,33.07259574425722,34.10315714067188,35.65880014369764,32.57210040000002,31.58551,34.06860039999998,35.324,35.324,37.93704591619859,32.710954083801404,147909744,69.1023767157912,65.83159962184313,NaN,NaN,NaN,NaN,NaN,NaN,0.0891181790299913,0.9152086013358343,0.826090422305843,89.87681511897517,91.78784815893216,1000588426,3464356853.335982,29.633044326913943,14.947997245994202,35.46099135355713,100,14.285714285714286
2009-06-12,36.67,36.71899,36.2,36.64999,34.294282645033746,33.14343523446995,34.203032939076905,35.753199177631195,32.523200400000015,31.6724098,34.18620019999997,35.4869995,35.4869995,38.00201685743088,32.971982142569125,109452432,66.37454412921944,66.96494231369961,NaN,NaN,NaN,NaN,NaN,NaN,0.04499434821903736,0.8823333575796397,0.8373390093606023,85.67880079308459,88.8520386373533,891135994,3544705765.7768397,27.91779596508092,19.217458916814977,35.97754002512335,92.85714285714286,7.142857142857143
2009-06-15,36.28,36.33,35.58,35.89999,34.31025983264535,33.19802047735173,34.26958027479938,35.76717925595204,32.46905035000002,31.7399098,34.26900019999997,35.613499,35.613499,37.937090760227676,33.28990723977232,112152880,55.89294275537573,66.62787515061471,NaN,NaN,NaN,NaN,NaN,NaN,-0.040517399973536206,0.786692259393682,0.8272096593672182,55.95978794631789,77.17180128612588,778983114,3528253685.9667077,25.20620648594586,22.978921576201497,34.47830724547522,85.71428571428571,0
2009-06-16,36.06,36.19,35.52,35.55,34.32259555570361,33.24459432928536,34.31979281304254,35.74649551728994,32.41125035000002,31.8078099,34.33299999999998,35.6789985,35.6789985,37.916280321356574,33.441716678643424,110550192,51.78338069304418,66.17261701062779,NaN,NaN,NaN,NaN,NaN,NaN,-0.12186757476792265,0.674875190907315,0.7967427656752376,44.37067672409512,62.003088487832535,668432922,3427603511.1607356,23.656755777404275,22.116870860916602,32.52748010728193,78.57142857142857,7.142857142857143
2009-06-17,35.67,36.21001,35.45,35.88901,34.33818176907969,33.29695899603219,34.38133074194283,35.76006832516708,32.36009540000001,31.877700100000002,34.405380199999975,35.7534495,35.7534495,37.91328897551169,33.593610024488314,153421744,55.21803674921048,65.76013658932544,NaN,NaN,NaN,NaN,NaN,NaN,-0.15209671416734283,0.6066218729660591,0.7587185871334019,45.70912668369761,48.67986378470354,821854666,3451425960.8777657,22.00438078210759,21.215381178295413,30.866972930229732,71.42857142857143,0
2009-06-18,35.83,36.06,35.57001,35.82001,34.35292632859134,33.34692040205135,34.437749536376444,35.76577705610355,32.311445450000015,31.9448002,34.49338039999998,35.83045,35.83045,37.88175827185995,33.77914172814005,126266688,54.369129693660945,65.08431954168411,NaN,NaN,NaN,NaN,NaN,NaN,-0.174391103358278,0.5407297079355544,0.7151208112938324,20.787078651685498,36.95562735315941,695587978,3454005461.5754943,20.986613722968055,20.23410766170933,28.763395335849516,64.28571428571429,0
2009-06-19,36.03999,36.36,35.9101,36.16,34.37090716114267,33.40262494854539,34.505288770244036,35.803322098379404,32.26664545000001,32.0132001,34.57758039999998,35.9559505,35.9559505,37.74918880049997,34.16271219950003,122050128,57.81089483654105,64.25280350634803,NaN,NaN,NaN,NaN,NaN,NaN,-0.164045177194046,0.510064339801275,0.674109516995321,39.88764044943798,35.46128192827369,817638106,3467542472.8828945,22.785537404955864,19.181181819902736,26.29987026506463,57.142857142857146,85.71428571428571
2009-06-22,35.8,35.89,35.02,35.08,34.377962811280554,33.435840296098945,34.527826465528584,35.73443427948613,32.22374545000002,32.0605,34.62038039999997,36.032951,36.032951,37.50878029993876,34.55712170006123,137714816,45.95362830172109,62.55640834276125,NaN,NaN,NaN,NaN,NaN,NaN,-0.2240298365612362,0.3940722212937757,0.6181020578550119,2.7149321266966218,21.129883742606697,679923290,3348822803.9173756,20.37499360675162,25.412136172561052,23.80171418522306,50,100
2009-06-23,35.2,35.25999,34.77,35,34.38415223604393,33.46681375558214,34.54634307472354,35.66448815763031,32.181495450000014,32.1147,34.662580399999975,36.0434515,36.0434515,37.4863784644477,34.60052453555231,114903008,45.213857197195374,60.90225941262594,NaN,NaN,45.213857197195374,NaN,NaN,NaN,-0.26062357631391264,0.2923225874626212,0.5529461637765338,9.349593495934856,17.31738869068982,565020282,3341790127.3118925,19.423824899387355,26.60765936366756,21.97562152222405,42.857142857142854,100
2009-06-24,35.3,35.87,35.28,35.59,34.39615072125743,33.508857047550805,34.5872707972834,35.6573940473798,32.14289545000001,32.18,34.72458019999998,36.0954515,36.0954515,37.38629091709645,34.80461208290355,103314560,51.42456329839782,59.53087231191034,NaN,NaN,NaN,NaN,NaN,NaN,-0.23728618789653078,0.25633842890587033,0.4936246168024011,33.33333333333343,15.132619651988302,668334842,3347043410.0237584,23.57800497965528,24.427188555526914,18.840231386689197,35.714285714285715,92.85714285714286
2009-06-25,35.38,36.36,35.28,36.28999,34.41499489318522,33.56392898720326,34.65404409935072,35.71764128096268,32.112095400000015,32.2487999,34.80238019999998,36.162451000000004,36.162451000000004,37.342903407577026,34.98199859242298,112538128,57.57018593233774,58.582881602477336,NaN,NaN,NaN,NaN,NaN,NaN,-0.17004838580151144,0.2810641345505118,0.45111252035202326,61.78821138211398,34.823712737127416,780872970,3444991178.1324997,25.72973743347749,22.01529918839308,15.925613808725021,28.571428571428573,85.71428571428571
2009-06-26,36.13,36.5,36.05,36.37,34.4344476803177,33.6194947498329,34.721336487611474,35.77977068277576,32.07994540000002,32.3137999,34.86497999999998,36.211951000000006,36.211951000000006,37.33882113029588,35.085080869704136,87677312,58.2208338755245,57.79024659956947,NaN,NaN,NaN,NaN,NaN,NaN,-0.11799747214189177,0.30361568017465856,0.42161315231655033,65.040650406504,53.38739837398381,868550282,3482010487.64361,25.958046383860246,21.081283052149814,13.795320744575388,21.428571428571427,78.57142857142857
2009-06-29,36.44,36.75,36.12,36.45,34.45450292727972,33.6755443587471,34.78912721358749,35.843602046320925,32.04419535000002,32.379199899999996,34.92777999999998,36.214951,36.214951,37.34401852081385,35.08588347918615,93817568,58.89949425943337,56.924017510946,NaN,NaN,NaN,NaN,58.89949425943337,NaN,-0.07792569890794787,0.3242060286816155,0.4021317275895634,68.29268292682943,65.04051490514914,962367850,3486477990.881706,26.78315567595304,19.813887443654664,11.810383231664918,14.285714285714286,71.42857142857143
2009-06-30,36.55,36.73,36.11,36.38,34.47366210213266,33.72909793580162,34.8515143816821,35.89468756571893,32.00894540000002,32.4372998,35.01057979999998,36.211951,36.211951,37.338927614910915,35.08497438508908,97843008,58.01152133824957,56.131813555407305,NaN,NaN,NaN,NaN,NaN,NaN,-0.05685788852878265,0.33105936692858506,0.3879172554573677,65.44715447154486,66.2601626016261,864524842,3473853086.623643,25.178850859468323,18.723652708108784,10.557725283853754,7.142857142857143,64.28571428571429
2009-07-01,36.53999,36.84,36.39,36.39999,34.49282954390248,33.781986887567925,34.91223891573378,35.94281160707904,31.980545350000025,32.487599700000004,35.084779599999976,36.2154505,36.2154505,37.344304752938704,35.0865962470613,85975872,58.205301267469196,55.35345102338431,NaN,NaN,NaN,NaN,NaN,NaN,-0.04293326113595464,0.33425067903742445,0.3771839401733791,78.74347826086952,70.82777188641461,950500714,3391694543.3404436,25.12103590615758,17.868461686790518,9.409900681263705,0,57.142857142857146
2009-07-02,36.09,36.10001,35.5,35.60001,34.50384626485867,33.81798734523985,34.93921033080304,35.910163834976274,31.946495400000025,32.5285998,35.140979999999985,36.1584505,36.1584505,37.29072113565994,35.02617986434006,113309744,48.549015685746845,54.0801989917077,NaN,NaN,NaN,NaN,NaN,NaN,-0.08644651064374032,0.2691258018687037,0.35557231251244403,40.09710144927509,61.42924472722982,837190970,3316157861.447541,22.915720980799243,24.981145303258327,8.39947180281258,92.85714285714286,50
2009-07-06,35.38,35.53999,35.03999,35.41,34.51286271993471,33.84951234830441,34.95767267077155,35.86252918402615,31.922495350000023,32.5792998,35.18697999999998,36.0899505,36.0899505,37.22926549875078,34.950635501249224,107632496,46.572679610981616,53.414465909965266,NaN,NaN,NaN,NaN,NaN,NaN,-0.1245557827118497,0.1998775841226319,0.3244333668344816,30.917874396134945,49.91948470209318,729558474,3367825764.8273783,21.64253530512636,28.156956845871566,9.003682652383901,85.71428571428571,42.857142857142854
2009-07-07,35.42,35.49001,34.50999,34.53,34.51303324013436,33.862987351308284,34.94090119348639,35.735621642690326,31.88729530000002,32.6225998,35.20377999999998,35.9829505,35.9829505,37.27586979151728,34.69003120848272,149773008,38.71265021927102,52.48084230469575,NaN,NaN,38.71265021927102,NaN,NaN,NaN,-0.2010298574325231,0.07314604504382771,0.2741759024763508,0.8587945974480445,23.95792348095269,579785466,3224168872.600689,19.59120561575286,30.614053133374263,10.331642100292324,78.57142857142857,100
2009-07-08,34.73,34.87,34.3,34.71001,34.51499320789422,33.879760077024955,34.93184663687908,35.637944343386486,31.846345400000022,32.6639998,35.22338019999998,35.870951,35.870951,37.197036705599835,34.54486529440016,152776368,40.909543360764275,51.45880706266388,NaN,NaN,NaN,NaN,NaN,NaN,-0.22943580030920413,-0.01261884791015433,0.2168169523990498,16.14212598425192,15.972931659278304,732561834,3291181412.122373,18.493296802873907,30.962980468354157,12.002213391568153,71.42857142857143,100
2009-07-09,34.84,35.00999,34.64999,34.77,34.5175305889102,33.89738859035119,34.92549970994264,35.55528297734968,31.815795400000024,32.7073999,35.249180199999984,35.7684505,35.7684505,37.10214983357496,34.43475116642504,97851440,41.66007818405849,50.551017669120846,NaN,NaN,NaN,NaN,NaN,NaN,-0.2333609483287374,-0.07488423301187197,0.15847671531686544,18.503937007874207,11.834952529858057,830413274,3258569701.646818,19.24206664709506,29.82610226647958,13.412535641677788,64.28571428571429,92.85714285714286
2009-07-10,34.66,35.14,34.56261,34.92,34.52153525966731,33.91763832123532,34.92528403504293,35.494779836649705,31.787545350000023,32.7643999,35.26878019999998,35.673449999999995,35.673449999999995,36.963981559536656,34.382918440463335,108481936,43.58942846089637,49.53519864228908,NaN,NaN,NaN,NaN,NaN,NaN,-0.21546014093290738,-0.1108484608492688,0.10461168008363858,24.409448818897758,19.68517060367463,938895210,3284382987.618242,19.43736548690989,28.04735389444093,14.094215628914982,57.142857142857146,85.71428571428571
2009-07-13,34.95,35.60001,34.48,35.59,34.53216674962087,33.950754394082146,34.95135132778634,35.503848423635446,31.761245300000024,32.8278998,35.29498019999998,35.6204505,35.6204505,36.83078211750766,34.410118882492334,127140320,51.33156532132327,49.9193370008321,NaN,NaN,NaN,NaN,NaN,NaN,-0.1511413749956397,-0.08431503866091106,0.06682633633472865,50.78740157480327,31.23359580052508,1066035530,3409250694.68943,21.834060984880207,24.940247672037046,13.782756861639081,50,78.57142857142857
2009-07-14,35.52,35.78999,35.39999,35.72,34.54398598594305,33.98578896053596,34.98149441297119,35.52443428805112,31.73234530000003,32.897199900000004,35.321980199999985,35.611451,35.611451,36.81599747669285,34.406904523307155,115631632,52.68838262082821,50.45323167394873,NaN,NaN,NaN,NaN,NaN,NaN,-0.0952174845972144,-0.05219551941178935,0.043021965185425046,55.90551181102355,43.700787401574864,1181667162,3483379465.542351,22.90613276300948,23.945494337496065,12.826475505508926,42.857142857142854,71.42857142857143
2009-07-15,36.31,36.92999,36.14,36.92,34.567627916431185,34.04389214943624,35.057514239913495,35.65734530823673,31.71154530000003,32.9776999,35.35938019999998,35.679950999999996,35.679950999999996,37.011817384633275,34.348084615366716,160869680,62.95497766494181,51.27683270013045,NaN,NaN,NaN,NaN,NaN,NaN,0.021014957897511496,0.06929066255731442,0.04827570465980292,99.62015064696084,68.77102134426256,1342536842,3640180516.5642643,31.291701075195277,21.129649087763124,14.084789038246587,100,64.28571428571429
2009-07-16,36.74001,37.44,36.72,37.36,34.59541271328261,34.1095576514276,35.14780779913257,35.819502897928466,31.709245250000034,33.072699899999996,35.40618019999998,35.753500499999994,35.753500499999994,37.27271139586,34.23428960413999,119842432,65.87872601004274,51.87029984853795,NaN,NaN,NaN,NaN,NaN,NaN,0.12040521393345063,0.19878222207661622,0.07837700814316559,97.45222929936311,84.32596391911584,1462379274,3733391297.0087094,34.062709088714264,19.648972466537447,15.445906769266106,100,57.142857142857146
2009-07-17,37.36,37.57001,37.17,37.56,34.62491109424497,34.17788324248844,35.242403571715606,35.985264526697186,31.702495250000034,33.1604999,35.45678019999998,35.8405,35.8405,37.552086831007855,34.12891316899214,104906368,67.14793968328866,52.50795026337824,NaN,NaN,NaN,NaN,NaN,NaN,0.1884382451741134,0.31392481461080735,0.12548656943669395,99.69388472818122,98.92208822483506,1567285642,3833047232.5511203,33.99989418297265,18.858305425816287,16.75149673509264,100,50
2009-07-20,37.75,38,37.61,37.92,34.65769804853109,34.25198456441937,35.34740735321695,36.16952504796412,31.699595250000037,33.2537999,35.53097999999998,35.92849999999999,35.92849999999999,37.86318381914984,33.993816180850146,97168752,69.35742894078663,53.254945597760624,NaN,NaN,NaN,NaN,NaN,NaN,0.24303210881954115,0.4292767054611204,0.18624459664157925,97.83783783783788,98.32798395512741,1664454394,3890351881.166506,36.89928988309928,18.000281120289333,18.142084786850276,100,42.857142857142854
2009-07-21,38.07001,38.17999,37.64,38.17999,34.69274572964023,34.32976685027245,35.458489025639814,36.36099790053897,31.706745200000043,33.3576999,35.609979799999984,36.083499499999995,36.083499499999995,38.208764917330015,33.958234082669975,130587632,70.88060617342629,54.17416594313038,NaN,NaN,NaN,NaN,NaN,NaN,0.27940433813708965,0.5355000193129413,0.2560956811758517,99.99999999999999,99.17724085533969,1795042026,4020939513.166506,36.696950428188664,16.9792629223198,19.71572855043696,100,35.714285714285715
2009-07-22,38.2,38.69,38.13,38.5,34.730628856708485,34.41234572452448,35.5777639658108,36.564712386201926,31.71834525000004,33.467399900000004,35.69297959999999,36.25849949999999,36.25849949999999,38.566605605468375,33.95039339453161,113808560,72.68066598095872,55.2081205655225,NaN,NaN,NaN,NaN,NaN,NaN,0.30564242488460297,0.6381487122816054,0.33250628739700244,95.67198177676543,97.83660653820111,1908850586,4057520836.0236487,39.93642548664014,15.9677204799802,21.57316243644981,100,28.571428571428573
2009-07-23,38.45,39.49001,38.39,39.35001,34.77659284818402,34.510121254731914,35.72569518283783,36.82997882561126,31.740795300000045,33.5945,35.80137999999999,36.4465,36.4465,39.09377901062942,33.79922098937058,160566432,76.78560848081531,57.22502005088453,NaN,NaN,NaN,NaN,76.78560848081531,NaN,0.35727992444843737,0.7791061929575491,0.42182626850911176,97.30251001443156,97.658163930399,2069417018,4177216184.1607747,43.60642702747406,14.1806024085258,24.902371394564224,100,21.428571428571427
2009-07-24,38.92999,39.37,38.77991,39.05,34.819114312381195,34.60001984374712,35.856060077628506,37.04140941364829,31.77279535000004,33.718799999999995,35.921979999999984,36.5845005,36.5845005,39.46246036457397,33.70654063542602,109312256,72.63710122938016,59.086764452198715,NaN,NaN,NaN,NaN,NaN,NaN,0.3479244578813815,0.8567318408608386,0.5088073829794572,91.52198165321452,94.83215781480385,1960104762,4167970518.758954,40.958186949147205,13.319407346398467,27.60521831919807,92.85714285714286,14.285714285714286
2009-07-27,39.28999,39.41,38.87,39.35001,34.864197851561485,34.69407905476203,35.993077721643076,37.261276136157974,31.80759540000004,33.8390001,36.041180199999985,36.733501000000004,36.733501000000004,39.8502709389134,33.61673106108661,94718560,74.1416213411235,61.61740524661675,NaN,NaN,NaN,NaN,NaN,NaN,0.3383290952166973,0.9317187520003287,0.5933896567836314,97.30251001443156,95.37566722735922,2054823322,4241644017.9648805,39.06355399435034,12.56725230137321,29.70259116757801,85.71428571428571,7.142857142857143
2009-07-28,39.17999,39.59,38.92999,39.08,34.90614613164545,34.78092897446971,36.114133497264916,37.434487932714354,31.845395400000044,33.964700199999996,36.15538019999998,36.865001,36.865001,40.14070287900477,33.58929912099523,111564256,70.39035540804997,63.72317753570859,NaN,NaN,70.39035540804997,NaN,NaN,NaN,0.29193790991776947,0.9583120441808433,0.6663741342630738,90.01956947162418,92.94802037975676,1943259066,4180793399.7660046,38.247750239481434,11.697758366102844,31.698617294827226,100,0
2009-07-29,39.32001,39.42999,39,39.34,34.950264080584304,34.87120760863863,36.240638065999626,37.615965272455846,31.885495350000042,34.0951002,36.25737999999998,37.013000999999996,37.013000999999996,40.45112339690761,33.57487860309238,126538192,71.86646389944883,65.88077651537932,NaN,NaN,NaN,NaN,NaN,NaN,0.2580743328867292,0.9889670503714854,0.7308927174847561,95.10763209393347,94.14323719332974,2069797258,4254366769.802335,36.477075629493996,11.156212167883702,33.95489246324264,92.85714285714286,14.285714285714286
2009-07-30,39.74001,40.17999,39.50999,39.57001,34.99623170167302,34.96425320054677,36.37120167125454,37.802064770317195,31.907695400000037,34.2334002,36.36078039999998,37.171502,37.171502,40.77048767044999,33.572516329550005,108969808,73.14206744105894,67.99167929967665,NaN,NaN,NaN,NaN,NaN,NaN,0.23133590733716625,1.020062601656214,0.7887266943190477,89.29857771680314,91.47525976078693,2178767066,4164920447.999828,41.163961117464865,10.166093168304384,36.97326318657902,100,7.142857142857143
2009-07-31,39.56,39.8522,39.41,39.45,35.040547804143934,35.053079869842875,36.491938860617104,37.95901098266794,31.93689540000004,34.35460019999999,36.46418039999999,37.3640015,37.3640015,41.017611609479474,33.71039139052053,78208320,71.32492847921392,69.41977666809741,NaN,NaN,NaN,NaN,NaN,NaN,0.18760034113281943,1.023227120735072,0.8356267796022526,84.72824267782438,89.71148416285367,2100558746,4100861077.796302,39.19200426211284,10.762310658138132,40.56401966218443,92.85714285714286,0
2009-08-03,39.85001,40.06,39.64,40.03999,35.09029349763504,35.151830565489554,36.63107812098506,38.15719946050909,31.984095300000035,34.4775001,36.59198039999998,37.595501,37.595501,41.31074759694566,33.88025440305434,111722688,74.65819711024754,70.98904913162737,NaN,NaN,NaN,NaN,NaN,NaN,0.18038694929085597,1.0611104662158226,0.8807235169249666,96.53464488773503,90.18715509412085,2212281434,4201938189.6683025,38.85141253660412,10.04728019717564,44.613113949828275,85.71428571428571,0
2009-08-04,39.86,40.19,39.77,40.03999,35.13954420910136,35.248625801816495,36.76476093976996,38.33651284522251,32.02299530000004,34.5912,36.721980399999985,37.8710005,37.8710005,41.450819405494876,34.291181594505126,100690752,74.65819711024756,71.82499337772063,NaN,NaN,NaN,NaN,74.65819711024756,NaN,0.15838016488531814,1.0786987230316143,0.9203185581462962,95.67694524495693,92.31327760350545,2212281434,4230702181.1563044,38.48055036081989,9.57555703023954,47.52476379675788,100,0
2009-08-05,40.13,40.14,39.46001,39.73,35.18522038612522,35.33736588494884,36.88104482448486,38.46922590758227,32.06014530000003,34.7010999,36.820780599999985,38.122,38.122,41.476981973143715,34.767018026856285,118093008,69.71971156023699,72.0993494884488,NaN,NaN,NaN,NaN,NaN,NaN,0.10811098257997509,1.055457286371265,0.9473463037912899,84.76821192052975,92.32660068440725,2094188426,4206386820.562648,35.56885152335937,12.30045941740629,49.07996212677002,92.85714285714286,0
2009-08-06,39.78999,39.92999,39.24001,39.38,35.22695948676079,35.41741804564292,36.97904306666192,38.55596629733634,32.09104530000004,34.8123,36.91738059999998,38.352500000000006,38.352500000000006,41.371227387512505,35.33377261248751,116937440,64.5295600374485,71.91232237088879,NaN,NaN,NaN,NaN,NaN,NaN,0.03996291887974801,0.9972999523909749,0.9573370335112269,68.60465116279086,83.01660277609251,1977250986,4136900240.6617827,32.85246365935795,13.796126487277604,49.951758959667295,85.71428571428571,0
2009-08-07,39.91,40.07001,39.59,39.88,35.273258397340285,35.505786005135135,37.092806083655574,38.68206474520907,32.13304530000003,34.9178,37.015980599999985,38.600500000000004,38.600500000000004,41.24188960400009,35.959110395999915,107512256,68.17446953827425,71.82782527070933,NaN,NaN,NaN,NaN,NaN,NaN,0.018335083470426783,0.9802558878492604,0.9619208043788336,87.84313725490213,80.40533344607425,2084763242,4159295920.9131103,31.897936075622624,12.747656825585421,50.55670924238611,78.57142857142857,0
2009-08-10,39.73,39.85001,39.34,39.60001,35.316310652093115,35.586859747607704,37.19112780586516,38.769488102808204,32.17799535000004,35.0168001,37.10038079999998,38.80100050000001,38.80100050000001,41.08207902476342,36.51992197523659,87163120,64.19626477043582,71.35037231335286,NaN,NaN,NaN,NaN,NaN,NaN,-0.022819936187464918,0.9333958841445025,0.9562158203319674,71.359708737864,75.93583238518566,1997600122,4161006677.233966,29.977843587575382,14.767113209195967,50.36098010209194,71.42857142857143,0
2009-08-11,39.42,39.5,39.05,39.25999,35.355551242619555,35.659595000130324,37.272259656615546,38.81620256920742,32.221845250000044,35.1126001,37.15778059999998,38.97800000000001,38.97800000000001,40.77288868740012,37.1831113125999,91922688,59.64447483702573,70.41921580307194,NaN,NaN,NaN,NaN,NaN,NaN,-0.07783576560042704,0.8589211133314336,0.9367568789318607,48.33277777777793,69.17854125684802,1905677434,4154874412.581167,28.12109419895503,17.118207035520744,49.035757006402164,64.28571428571429,0
2009-08-12,39.21001,40.22,39.2,39.87,35.40047113075269,35.742969356563385,37.37413182694435,38.916564229282905,32.27364530000004,35.2195002,37.226380599999985,39.12550000000001,39.12550000000001,40.68968042442594,37.56131957557408,147239936,64.50670925245531,69.5421515724748,NaN,NaN,NaN,NaN,NaN,NaN,-0.07784916274112641,0.8394454255054526,0.9172945882465791,75.69596344672888,65.12948332079027,2052917370,4201067333.6792054,32.795970163070436,15.233797288234449,48.01033028983665,100,0
2009-08-13,40.10001,40.16,39.64,40.09,35.447133109551174,35.8290491712849,37.480636461181824,39.02832001697025,32.33064530000004,35.3114003,37.30158059999998,39.26200000000001,39.26200000000001,40.652965635865264,37.87103436413475,110107008,66.0933834320689,69.07474315838114,NaN,NaN,NaN,NaN,NaN,NaN,-0.06809949168387741,0.8321702236417323,0.9002697153256097,90.37037037037072,71.46637053162584,2163024378,4281530147.2176695,30.926836249191332,14.365580644329173,46.98490357327115,92.85714285714286,0
2009-08-14,39.89,39.96001,39.28,39.63,35.48875367562529,35.904315524328766,37.56492522740999,39.08562287249689,32.36949530000005,35.404390400000004,37.359380399999985,39.36550000000001,39.36550000000001,40.52293699619306,38.20806300380696,124480128,60.04880912321726,68.06811371424497,NaN,NaN,NaN,NaN,NaN,NaN,-0.0959824113689618,0.7802917011144075,0.8762741124833693,54.263920434725684,73.44341808394175,2038544250,4285189443.049673,28.228057471038394,16.990362521163593,45.094421126069854,85.71428571428571,0
2009-08-17,38.97,39.00999,38.46001,38.48,35.518517320643944,35.955319177312354,37.60081051260959,39.027944503687664,32.40299530000004,35.484490400000006,37.393380399999984,39.3935,39.3935,40.43054021144728,38.356459788552726,131797184,48.1845584988157,66.48198536358538,NaN,NaN,48.1845584988157,NaN,NaN,NaN,-0.1898064658460985,0.6390160301757462,0.8288224960218447,1.1358019079653823,48.59003090435392,1906747066,4162973064.5631824,24.854291226479237,23.33616294417962,41.522446191142585,78.57142857142857,100
2009-08-18,38.72,39.98,38.61,39.03,35.55345744680669,36.01620394607845,37.656857159173924,39.02814026524122,32.43394530000004,35.560690400000006,37.44058039999999,39.436000500000006,39.436000500000006,40.33050168844885,38.54149931155116,84607808,52.97038419056532,65.13226538437942,NaN,NaN,NaN,NaN,NaN,NaN,-0.21112009832664425,0.5649223731135393,0.7760424714401836,32.38597946579262,29.261900602827893,1991354874,4130241576.796759,30.493536915631232,20.030754733193927,39.20462494911351,71.42857142857143,92.85714285714286
2009-08-19,38.59,39.39999,38.53999,39.3,35.590736477186724,36.08122961051254,37.721294133323966,39.05403166855158,32.46599530000004,35.645490300000006,37.487580399999985,39.476000500000005,39.476000500000005,40.26480479520647,38.68719620479354,88036256,55.15990922406253,63.84782551173682,NaN,NaN,NaN,NaN,NaN,NaN,-0.20325606768596338,0.5219723868327293,0.7252284545186927,47.72697572145292,27.082919031736974,2079391130,4197806332.244572,28.04117929280201,19.074530070091104,36.25046850296302,64.28571428571429,85.71428571428571
2009-08-20,39.28,39.84,39.2,39.75999,35.63222158686646,36.15407635089843,37.80124299084067,39.121265795356194,32.50069520000004,35.742490200000006,37.54637999999998,39.496499500000006,39.496499500000006,40.29241825598982,38.70058074401019,81473504,58.6886307247201,62.945232814987264,NaN,NaN,NaN,NaN,NaN,NaN,-0.16492830890558152,0.5190680683867157,0.6839963772922972,73.86291967568017,51.325291620975236,2160864634,4258908914.1975718,30.506202229000944,17.919562948296058,34.04191346661219,57.142857142857146,78.57142857142857
2009-08-21,40.00999,40.36,39.74001,40.28999,35.678567541225995,36.23597563107866,37.898840912768485,39.232572862465126,32.53339515000003,35.84219,37.61577959999998,39.558499000000005,39.558499000000005,40.39764379570246,38.71935420429755,114660192,62.363734343518786,62.06705690307807,NaN,NaN,NaN,NaN,NaN,NaN,-0.10467190033517804,0.5531565018733247,0.6578284022085027,96.31524376444106,72.63504638719138,2275524826,4347673978.721581,33.676999009689155,16.854855708459233,32.212230966118625,100,71.42857142857143
2009-08-24,40.36,40.57001,40.10001,40.25,35.72405443136305,36.31546126214641,37.991043229914816,39.32947068508749,32.57469510000003,35.93699000000001,37.68777979999999,39.60349850000001,39.60349850000001,40.48837440210622,38.7186225978938,109904880,61.91616097525032,61.15691146486398,NaN,NaN,NaN,NaN,NaN,NaN,-0.06996664117680873,0.5703701007374917,0.6403367419143005,84.83364928909941,85.00393757640687,2165619946,4307916472.982007,34.18616360636682,16.07510724152692,30.48975901057421,100,64.28571428571429
2009-08-25,40.34,40.75999,40.25,40.37,35.770282745478845,36.39574915794549,38.0843356522711,39.42856871507916,32.623745100000036,36.02309010000001,37.77717999999999,39.6679985,39.6679985,40.57852534536439,38.757471654635616,92900320,62.779397967504664,60.66117477966882,NaN,NaN,NaN,NaN,NaN,NaN,-0.04272599833245483,0.5869292439987319,0.6296552423311867,83.04376559796157,88.06421955050068,2258520266,4258734807.8575916,34.34338822622646,15.250653253091304,29.767607605494977,100,57.142857142857146
2009-08-26,40.28999,40.601,40.08,40.3,35.81535455895667,36.47306105580795,38.17122445022125,39.51156217078591,32.669295100000035,36.102590000000006,37.872179999999986,39.7159985,39.7159985,40.65312800659544,38.77886899340456,96407504,61.89800926179595,60.4732068671222,NaN,NaN,NaN,NaN,NaN,NaN,-0.03362000682358046,0.5876302338017112,0.6212502406252917,80.0002608718335,82.62589191963148,2162112762,4243746309.155096,32.50905738620757,16.178886126501386,29.24543979963803,92.85714285714286,50
2009-08-27,40.32001,40.47,39.67,40.39999,35.86097282205163,36.550822024999874,38.25862702080081,39.596174344996776,32.71744505000003,36.18388990000001,37.96239959999998,39.75749750000001,39.75749750000001,40.737614528784505,38.77738047121551,121957744,62.7035019488319,60.08242346787632,NaN,NaN,NaN,NaN,NaN,NaN,-0.02543282309849082,0.5894592117521782,0.614892034850669,84.34768997991293,82.46390548323599,2284070506,4344358399.0114975,29.870793486415657,19.025073038620164,27.765958760226166,85.71428571428571,42.857142857142854
2009-08-28,40.89,41.08,40.16,40.44,35.9065352815337,36.6278354502474,38.344171059200775,39.67653869309232,32.76914500000002,36.27408990000001,38.054799399999986,39.80699750000001,39.80699750000001,40.81945953885006,38.794535461149955,114310192,63.040199701074776,59.99984739149339,NaN,NaN,NaN,NaN,63.040199701074776,NaN,-0.0220205329189751,0.5873663687019501,0.6093869016209252,75.57242584895361,79.97345890023335,2398380698,4299628323.8810625,33.198194214786945,17.287552694164166,27.588874876726717,100,35.714285714285715
2009-08-31,40.16,40.2,39.78999,40.03,35.94756478121993,36.695205045292006,38.410281998055645,39.710201674702574,32.82574495000003,36.3548899,38.13219939999998,39.806498000000005,39.806498000000005,40.81850951381838,38.79448648618163,96415312,57.32877073631722,59.83443995572849,NaN,NaN,NaN,NaN,NaN,NaN,-0.05044832904428842,0.5463264903155647,0.5967748193598531,59.923511158439666,73.28120899576874,2301965386,4316091424.764259,31.041153646091125,19.862899493636352,27.420155928606114,92.85714285714286,28.571428571428573
2009-09-01,39.87,40.59,39.16,39.28,35.98072334061078,36.74638910380108,38.44438858636719,39.669230086635665,32.869844900000025,36.418289900000005,38.21619939999999,39.76849850000001,39.76849850000001,40.7994823903141,38.73751460968592,162958880,48.64637167405674,58.70155870012859,NaN,NaN,NaN,NaN,NaN,NaN,-0.11892566612436495,0.4481177367043969,0.5670434028287619,31.297447700182207,55.59779490252517,2139006506,4180482286.8621626,26.900202688640157,23.090205940304383,25.3527467454099,85.71428571428571,21.428571428571427
2009-09-02,39.09,39.47,39.03999,39.25,36.013253456624604,36.79596555719116,38.475981190823376,39.629303411717984,32.921194900000025,36.4818899,38.30119939999998,39.744498500000006,39.744498500000006,40.80000572123933,38.68899127876068,92757120,48.33106140071893,57.432821412175024,NaN,NaN,48.33106140071893,NaN,NaN,NaN,-0.16269581082516105,0.36367363929731056,0.5263694501224716,30.152405161851863,40.45778800682458,2046249386,4178327351.7936754,25.78622325421684,23.289745375465735,23.10430260374744,78.57142857142857,14.285714285714286
2009-09-03,39.44,39.57021,39.02,39.50999,36.04804685506615,36.8497086154646,38.516530555889126,39.617940229649605,32.97689485000002,36.5520897,38.37959919999999,39.750998,39.750998,40.799021633370394,38.70297436662961,76783056,51.27839520171286,56.806363274924706,NaN,NaN,NaN,NaN,NaN,NaN,-0.1698081616952024,0.3141092480034686,0.48391740969867103,40.07572547986842,33.84185944730083,2123032442,4238302732.0614276,25.377402067313408,22.032500108804143,21.833106323040877,71.42857142857143,7.142857142857143
2009-09-04,39.58,40.38,39.52,40.36,36.0909518614834,36.91921933595045,38.588823475266025,39.68861258873059,33.03699485000002,36.631689800000004,38.460999399999984,39.774998000000004,39.774998000000004,40.85522849396936,38.694767506030644,74866560,59.42708944571669,57.60940119970335,NaN,NaN,NaN,NaN,NaN,NaN,-0.11553055123153627,0.3395042206592507,0.45503477189078695,71.65365490687044,47.29392851619691,2197899002,4309687126.480032,31.07690235465153,20.17765984913928,23.12701018255604,64.28571428571429,0
2009-09-08,40.64999,40.78,40.46001,40.74001,36.13721114644376,36.99487855702074,38.67318373113795,39.78874567551816,33.10639490000002,36.70668980000001,38.54839959999998,39.831998000000006,39.831998000000006,40.9869990355412,38.67699696445881,71024320,62.450687783409776,58.286565742049376,NaN,NaN,NaN,NaN,NaN,NaN,-0.0553512088537102,0.3858457608236492,0.4411969696773594,86.61461962748174,66.11466667140688,2268923322,4362959250.743914,33.767328604209254,19.33156420669401,23.589734790499413,57.142857142857146,7.142857142857143
2009-09-09,40.75999,41.28999,40.59,41.09,36.18649262757367,37.075970070743104,38.76796083972077,39.912674658802146,33.184044900000025,36.7844898,38.64119959999998,39.92349850000001,39.92349850000001,41.16913616886184,38.677860831138176,99290000,65.03512068789198,58.99193798946577,NaN,NaN,NaN,NaN,NaN,NaN,0.003582874516835255,0.4456755628234035,0.4420926883065682,91.18982903008384,83.15270118814534,2368213322,4405514134.2422495,36.503358772452756,17.978468302887904,24.65908038246069,100,0
2009-09-10,41.11,41.53,41,41.48,36.23916434272219,37.16317858419374,38.87431531659447,40.06194373891623,33.25809490000003,36.8768897,38.74319959999998,40.00399850000001,40.00399850000001,41.42162298063154,38.58637401936848,99289056,67.7027329460243,59.63580243384464,NaN,NaN,NaN,NaN,NaN,NaN,0.06119221026564048,0.5185829511386189,0.4573907408729784,98.00796812748987,91.93747226168516,2467502378,4486069406.091305,36.97748760509339,17.00778394648633,25.4447521855112,100,71.42857142857143
2009-09-11,41.5,41.62,41.22,41.52,36.29170997115281,37.24945227559584,38.97806765712018,40.200806239971826,33.32419490000003,36.9651897,38.84559979999998,40.0754985,40.0754985,41.63990989924528,38.51108710075472,93869376,67.97262622323314,60.036437568109946,NaN,NaN,NaN,NaN,NaN,NaN,0.09247559153360135,0.57298523028998,0.4805096387563787,96.15384615384636,95.11721443714003,2561371754,4533004094.091308,36.36888246685078,16.292810120757785,25.78993428054751,100,64.28571428571429
2009-09-14,41.23,41.71001,41.21001,41.67999,36.34532469780801,37.337185695881075,39.08402539605664,40.34168088378403,33.39174485000003,37.0540897,38.967199399999984,40.177998,40.177998,41.87521432330746,38.480781676692544,90560496,69.08540141379788,60.54852617086335,NaN,NaN,NaN,NaN,NaN,NaN,0.11306515891455027,0.6218410873995666,0.5087759284850163,98.88401901851664,97.6819444332843,2651932250,4612690085.731627,35.38517447771422,15.42018693551114,26.023019151754237,100,57.142857142857146
2009-09-15,41.66,41.95,41.57001,41.81,36.39969957643679,37.425756276160655,39.19092636091716,40.481520799614124,33.45404480000003,37.141089699999995,39.09519939999998,40.344498,40.344498,41.99546768842568,38.693528311574326,91594560,69.99764344323553,61.06411513341555,NaN,NaN,NaN,NaN,NaN,NaN,0.12370175985081933,0.6634031282985404,0.5397013684477211,95.22184300341294,96.753236058592,2743526810,4636792141.192034,36.551417732738386,14.772633628696429,26.30415011477746,100,50
2009-09-16,41.98,42.48,41.84,42.42,36.45960306323841,37.52465219148421,39.317556699704724,40.66613786631754,33.520544800000025,37.2283897,39.25299939999998,40.513998,40.513998,42.2822572072715,38.7457387927285,96888432,73.89061217178151,61.92072962698595,NaN,NaN,NaN,NaN,NaN,NaN,0.15789234516617667,0.7370667999054419,0.5791744547392652,98.26589595375737,97.45725265856233,2840415242,4715513992.192035,39.693988257386046,13.681665243702557,27.38943240380136,100,42.857142857142854
2009-09-17,42.32001,42.66,42.21001,42.41,36.518810992957434,37.62139175204888,39.43882898599081,40.8322199742873,33.597944850000026,37.3151897,39.40699919999998,40.669498000000004,40.669498000000004,42.52805284506147,38.81094315493854,102169568,73.7217330617698,62.70774613505294,NaN,NaN,NaN,NaN,NaN,NaN,0.16512696443442232,0.7855831602822931,0.6204561958478708,93.13186813186812,95.5398690296795,2738245674,4704159295.208368,39.70955024636374,12.987910040357672,29.427031042934466,100,35.714285714285715
2009-09-18,42.56,42.62,42.21001,42.44,36.577728296510095,37.71680973715682,39.556521966932344,40.98534188149803,33.67099485000003,37.404789699999995,39.56039919999998,40.8034985,40.8034985,42.76408414773072,38.842912852269286,87453056,73.91434990875912,63.48447114988754,NaN,NaN,NaN,NaN,NaN,NaN,0.1572632045105148,0.8170352014860143,0.6597719969754995,93.95604395604397,95.11793601388983,2825698730,4714822429.112708,37.827504936774055,12.372344388740492,30.797925877836036,92.85714285714286,28.571428571428573
2009-09-21,42.22,42.7,42.16,42.57001,36.63735299007716,37.812912712658665,39.67469796822912,41.13626265468869,33.740744900000024,37.4910898,39.71339939999998,40.917499500000005,40.917499500000005,43.006347400181966,38.828651599818045,71351312,74.77719170743893,64.73078693353908,NaN,NaN,NaN,NaN,NaN,NaN,0.14637227420688048,0.8427373397341,0.6963650655272196,96.46766304347828,94.5185250437968,2897050042,4751822048.346486,36.37789523093212,11.592988719547185,32.91986188218998,100,21.428571428571427
2009-09-22,42.82001,42.83,42.4398,42.64999,36.69718022400674,37.908696421318886,39.791376087122096,41.280427163765964,33.814944850000025,37.5747897,39.854599199999974,41.03749900000001,41.03749900000001,43.232238068798246,38.842759931201776,75638368,75.31806805039308,66.6359081032774,NaN,NaN,NaN,NaN,75.31806805039308,NaN,0.13062848297641794,0.8596506692477419,0.729022186271324,95.27532808398959,95.23301169450396,2972688410,4757672294.23639,36.23483010201795,11.051269722299539,36.179604386361,100,14.285714285714286
2009-09-23,42.83,43.17,42.377,42.45,36.754422211827574,37.99862322485713,39.89563584841142,41.39181505293111,33.88249485000003,37.65558969999999,39.98919919999997,41.141499,41.141499,43.39616891200776,38.88682908799225,143924064,71.20624697909331,68.26984993030415,NaN,NaN,NaN,NaN,NaN,NaN,0.09450356800908133,0.8471516462826756,0.7526480782735943,82.65060240963858,91.46453117903549,2828764346,4640246229.409152,36.850929350009665,10.025916840633196,39.90370963375925,100,7.142857142857143
2009-09-24,42.61,42.69,41.77,42.07001,36.80731363260541,38.079244745156984,39.980905422983525,41.45640504789005,33.94244490000002,37.725789799999994,40.09219939999998,41.229999500000005,41.229999500000005,43.484552555515855,38.975446444484156,111016320,64.0512238912307,69.18219483669827,NaN,NaN,NaN,NaN,NaN,NaN,0.03579531503284572,0.7973922220646514,0.7615969070318057,69.86328767123291,82.5964060549537,2717748026,4601634270.6335,33.02289643314349,15.838183138837625,41.9119435329251,92.85714285714286,0
2009-09-25,41.78,42.09,41.58,41.7,36.85599707904714,38.15094286901526,40.04832089659202,41.479604567138615,34.00089495000002,37.792589799999995,40.17899939999998,41.295,41.295,43.52491169334517,39.065088306654836,109215936,57.94548125127302,69.0763656799523,NaN,NaN,NaN,NaN,NaN,NaN,-0.03343483754230525,0.7198033601039242,0.7532381976462295,45.756257403163985,66.09004916134516,2608532090,4543814069.221737,31.09457730928616,17.088778117937853,42.46928572948948,85.71428571428571,0
2009-09-28,41.92,42.66,41.89,42.41,36.91126078970339,38.235280633985255,40.14093576339233,41.568213655982554,34.06339495000002,37.8663898,40.275999399999975,41.3935,41.3935,43.637633944335214,39.14936605566479,84484128,64.86639379966343,69.2489161096847,NaN,NaN,NaN,NaN,NaN,NaN,-0.03663083408994494,0.7074496550337983,0.7440804891237432,70.5426356589145,62.054060244437146,2693016218,4573438373.845113,34.08786902760463,15.280046382347424,43.24862110440433,78.57142857142857,0
2009-09-29,42.41,42.6201,42.03,42.22,36.964084065427734,38.31418596796574,40.22246769423969,41.63028854588898,34.129044950000015,37.9464897,40.36199939999997,41.503,41.503,43.68313076674724,39.32286923325276,106686368,61.92924199021802,69.02706763127942,NaN,NaN,NaN,NaN,NaN,NaN,-0.05562276986892456,0.6745520267875875,0.7301747966565121,56.22119815668193,57.506697072920154,2586329850,4535453615.470599,31.855881132623274,14.279547391561737,43.541142282395136,71.42857142857143,0
2009-09-30,42.39,42.6024,41.60001,42.25,37.01668024388119,38.392122879491176,40.30197876505382,41.689308684375746,34.191895000000024,38.0266897,40.44339959999998,41.6515,41.6515,43.59778290855135,39.705217091448645,173102624,62.220125756573914,68.63545283203295,NaN,NaN,NaN,NaN,NaN,NaN,-0.06935304409994303,0.6434834915315832,0.7128365356315263,53.060985005025564,59.94160627354068,2759432474,4586844401.368463,28.448314779641144,17.34064896590096,42.631668634638764,64.28571428571429,0
2009-10-01,42.11,42.13,41,41,37.05631526633013,38.44376401059036,40.32935214681641,41.623660238244724,34.25109500000002,38.0931896,40.49339959999998,41.739000000000004,41.739000000000004,43.37876893497744,40.09923106502257,140119056,46.334457603755915,67.08986935921317,NaN,NaN,NaN,NaN,NaN,NaN,-0.16059418721506113,0.5120938016126999,0.672687988827761,0,36.42739438723584,2619313418,4446725345.368463,24.874967741385078,21.19182119662256,40.47970481888113,57.142857142857146,100
2009-10-02,40.72,41.25,40.72,40.88,37.0943618805955,38.49200630741035,40.35094618027459,41.55283545364999,34.30269500000003,38.1626897,40.52399939999999,41.8075005,41.8075005,43.15803815963685,40.456962840363154,145291248,45.142886820465186,65.37968974540368,NaN,NaN,45.142886820465186,NaN,NaN,NaN,-0.22315464306924482,0.39374468499120496,0.6168993280604498,6.530612244898102,19.863865749974565,2474022170,4389157115.028842,23.525660012875278,22.908000055850263,37.76778978629252,50,100
2009-10-05,41.09,41.39999,40.83,41.21001,37.13531360317664,38.54582816270916,40.38463495751872,41.52018541044523,34.35779505000003,38.2445898,40.56719959999999,41.850001000000006,41.850001000000006,43.06205472822813,40.637947271771885,97054128,49.02529356933575,63.88166475441084,NaN,NaN,NaN,NaN,NaN,NaN,-0.23523187584770666,0.3228594832508165,0.5580913590985231,20.000408163265202,8.843673469387769,2571076298,4421514166.808415,23.690509018314366,21.55390105767265,35.07411073840071,42.857142857142854,92.85714285714286
2009-10-06,41.42999,42.14,41.2206,41.94,37.183121428020655,38.61303948621987,40.445629665067,41.560167752307585,34.41919505000003,38.330089799999996,40.618999399999986,41.9100005,41.9100005,43.00994524411034,40.810055755889664,124627936,56.37946234007212,62.63086833786017,NaN,NaN,NaN,NaN,NaN,NaN,-0.18897216372456327,0.32187615444281903,0.5108483181673823,49.795918367346836,25.442312925170047,2695704234,4491920681.881723,28.948387939346276,19.525892171580182,32.981517865579335,35.714285714285715,85.71428571428571
2009-10-07,41.88,42.08,41.77,42.06,37.23164758296572,38.6812961300571,40.50893830565261,41.60777082351639,34.48019505000003,38.416989799999996,40.67859939999998,41.9585005,41.9585005,42.99314500227948,40.923855997720516,93787504,57.465803197524956,61.469730490414115,NaN,NaN,NaN,NaN,NaN,NaN,-0.14707042622745153,0.32701028538306787,0.4740807116105194,54.693877551020485,41.49673469387751,2789491738,4573606572.462371,28.00256491929559,18.887927862769523,30.747981520879673,28.571428571428573,78.57142857142857
2009-10-08,42.31,42.62,42.14,42.24001,37.28148203487651,38.751765711640125,40.57682347013682,41.66798407841959,34.54534505000002,38.496989799999994,40.736599599999984,41.99650100000001,41.99650100000001,43.01373748583329,40.97926451416673,107850368,59.11086818080494,60.412338938417385,NaN,NaN,NaN,NaN,NaN,NaN,-0.10593183986050625,0.3416659117848866,0.44759775164539284,62.041224489795816,55.510340136054374,2897342106,4510698351.561037,32.09192126993054,17.75912506254356,29.179667317400522,21.428571428571427,71.42857142857143
2009-10-09,42.14999,42.55,42.06,42.48,37.333208581793166,38.825592133191805,40.651457843856946,41.745318928093916,34.61244505000002,38.5777899,40.79479939999998,42.044501000000004,42.044501000000004,43.057860602565924,41.031141397434084,62828000,61.261982119462836,59.44696682499051,NaN,NaN,NaN,NaN,NaN,NaN,-0.06335891094627455,0.3683991129625497,0.43175802390882423,71.83673469387739,62.857278911564556,2960170106,4555575494.4181795,30.381005451177685,17.68274918943027,27.3763135616749,14.285714285714286,64.28571428571429
2009-10-12,42.63,42.87,42.28,42.57001,37.38531605859124,38.899739021643455,40.72669518331354,41.82386093494211,34.67959510000002,38.660689999999995,40.85719959999999,42.08900200000001,42.08900200000001,43.1125422366783,41.065461763321714,53221872,62.067997982682044,58.50053324872544,NaN,NaN,NaN,NaN,NaN,NaN,-0.031545672638484235,0.39232593311071895,0.4238716057492032,75.51061224489806,69.79619047619042,3013391978,4554675232.922316,31.923577093714584,16.5393645379931,25.839630048744834,7.142857142857143,57.142857142857146
2009-10-13,42.53999,42.75,42.37,42.58,37.437004456018194,38.972615476660415,40.799373803575754,41.89587417923334,34.74684510000003,38.7499901,40.907999799999985,42.12750200000001,42.12750200000001,43.16401200964778,41.09099199035224,70939184,62.162098637292175,57.85452265288251,NaN,NaN,NaN,NaN,NaN,NaN,-0.013178892963660815,0.40739798954462714,0.42057688250828795,86.51162790697677,77.95299161525074,3084331162,4562142515.448631,30.553274132921942,15.829420908257976,24.01961875105378,0,50
2009-10-14,43.10001,43.293,42.85001,43.16,37.49394968531155,39.05553398207308,40.891947379906114,42.01626711454445,34.81819510000003,38.846190199999995,40.97039999999999,42.164502000000006,42.164502000000006,43.28921369999279,41.03979030000722,91004880,67.24297392142327,58.08250479789626,NaN,NaN,NaN,NaN,67.24297392142327,NaN,0.03220383391658671,0.4608316749040213,0.4286278409874346,94.830936649825,85.6177256005666,3175336042,4598502148.197,34.19303642662854,14.566032364590567,24.382652832686382,100,42.857142857142854
2009-10-15,42.92999,43.12,42.87,43.06,37.54933327053233,39.134830338863715,40.976969051282346,42.1156702464926,34.886045050000035,38.92889029999999,41.03699999999999,42.197002000000005,42.197002000000005,43.3840491296886,41.00995487031141,85772688,65.60721320385669,58.62977136593795,NaN,NaN,NaN,NaN,NaN,NaN,0.04867118513718388,0.4894668224089145,0.4407956372717306,90.94442285270125,90.76232913650101,3089563354,4643103945.957003,33.038043359420705,14.074012112632914,25.181604304084228,92.85714285714286,35.714285714285715
2009-10-16,42.92,42.99001,42.48,42.78,37.60137970565141,39.207011916311956,41.04767614731049,42.178939746826636,34.951245000000036,39.011190299999996,41.10499999999999,42.21400200000001,42.21400200000001,43.42399894879784,41.00400505120218,111859632,61.1236349893408,58.362431450914904,NaN,NaN,61.1236349893408,NaN,NaN,NaN,0.03455358235296119,0.4839876152129321,0.4494340328599709,80.06218422075406,88.61251457442677,2977703722,4662841300.6827545,30.797411035847777,17.67981044053218,24.39317921474301,85.71428571428571,28.571428571428573
2009-10-19,42.81,43.27,42.59,43.21001,37.65718697226185,39.286279205097856,41.13247355329831,42.27713691379553,35.012145050000036,39.093790399999996,41.17160019999999,42.246002000000004,42.246002000000004,43.5239122723197,40.96809172768031,83511936,65.07146739598332,58.58687612275528,NaN,NaN,NaN,NaN,NaN,NaN,0.04723841587724986,0.5084820527065332,0.4612436368292834,96.77458219976671,89.26039642440735,3061215658,4731618292.445577,31.615945236606972,16.285312204139917,23.957993334142195,78.57142857142857,21.428571428571427
2009-10-20,43.45,43.46001,42.94,43.22,37.71253834567218,39.36417466638304,41.214337335521904,42.366933398195954,35.073145050000036,39.1721904,41.243999999999986,42.274502500000004,42.274502500000004,43.61125180711447,40.93775319288554,89847808,65.1599836493169,58.79686597223692,NaN,NaN,NaN,NaN,NaN,NaN,0.04914517623436493,0.5226751071222395,0.4735299308878746,91.24054291772664,89.35910311274915,3151063466,4738527801.574094,31.91626953035483,15.291986364125625,24.74059251197755,100,14.285714285714286
2009-10-21,43.2,43.82001,43.06,43.14,37.76654293924758,39.43894348487051,41.28985351844261,42.44055878884396,35.132195050000036,39.23969039999999,41.321600199999985,42.309002500000005,42.309002500000005,43.69673266832194,40.92127233167807,110397312,63.766366331979654,60.042002309967195,NaN,NaN,NaN,NaN,NaN,NaN,0.03834153024294823,0.5214568436915599,0.48311531344861164,78.06426430882475,88.69312980877271,3040666154,4651371723.136809,33.26973556675801,13.952495290988256,27.091439497943366,100,7.142857142857143
2009-10-22,43.07001,43.49001,42.78999,43.31,37.821701715971486,39.51559806932852,41.369074949091925,42.52336271371596,35.19654505000003,39.30839039999999,41.39040019999999,42.371002000000004,42.371002000000004,43.81993090925,40.92207309075001,85871744,65.45706206911768,61.49301482772809,NaN,NaN,NaN,NaN,NaN,NaN,0.03600462062010695,0.5281210892237453,0.4921164686036384,82.94286641181802,84.08255787945647,3126537898,4693079664.281349,30.610131761952108,15.920574565582543,29.251396628831888,92.85714285714286,0
2009-10-23,43.69,43.73,43.02,43.13,37.87452060436978,39.58717038478736,41.438130833441264,42.58113769336206,35.25839510000003,39.3763904,41.45120019999999,42.442502000000005,42.442502000000005,43.89305804512867,40.99194595487134,117029872,62.15028469111933,62.43051419356977,NaN,NaN,NaN,NaN,NaN,NaN,0.01667875783957301,0.5129649159031047,0.49628615806353166,73.45513020262293,78.1540869744219,3009508026,4612312569.520786,30.866408006739675,14.642068982250253,31.46060212530275,85.71428571428571,0
2009-10-26,43.17,43.75999,42.78999,42.99001,37.9254209963661,39.65455334746484,41.49898883997298,42.62007791304186,35.322995100000036,39.43889039999999,41.51840039999999,42.4715025,42.4715025,43.941363190702305,41.001641809297695,107068496,59.627365934637254,62.66250730746729,NaN,NaN,NaN,NaN,NaN,NaN,-0.009767027521591864,0.4840773736615418,0.49384440118313366,59.512392622474756,71.97012974563857,2902439530,4549400445.829899,27.604834918284322,15.600504229912163,32.056761704347984,78.57142857142857,0
2009-10-27,42.95,43.11,42.17999,42.34,37.969347155606236,39.70773050890118,41.531969669777965,42.59340382608549,35.38709510000003,39.4944904,41.59560039999999,42.4775025,42.4775025,43.94418390032937,41.01082109967063,121438192,49.566100547712324,62.098242832480665,NaN,NaN,NaN,NaN,NaN,NaN,-0.07181513452115496,0.40407548303168994,0.4758906175528449,15.909000517042571,49.62550778071343,2781001338,4469749600.4217005,24.889306309991614,20.518113300279026,31.355938181432407,71.42857142857143,0
2009-10-28,42.19,42.32001,41.3,41.39,38.00338350231662,39.74104277605165,41.526402231747454,42.47879393788688,35.44639510000003,39.54169039999999,41.642800399999985,42.434502499999994,42.434502499999994,43.973963181561736,40.89504181843825,143553504,39.16473380169314,60.6735189482584,NaN,NaN,NaN,NaN,NaN,NaN,-0.1719064024438942,0.26100761449797716,0.43291401694187137,3.571414399149336,26.330935846222232,2637447834,4351528819.35579,22.25304162060433,27.30716704406942,30.03070287922456,64.28571428571429,100
2009-10-29,41.67999,42.19,41.53999,42.09,38.04404635303984,39.78755678048627,41.54850410501226,42.441765943802416,35.513695100000035,39.593090399999994,41.69860039999999,42.4890025,42.4890025,43.892653133196625,41.08535186680337,85207504,47.84890207385333,59.71544180214344,NaN,NaN,NaN,NaN,NaN,NaN,-0.184904482193894,0.20178341419950385,0.38668789639339785,31.349081948087676,16.943165621426534,2722655338,4410519033.160256,20.45797643074602,25.104405469711484,28.872012936568275,57.142857142857146,92.85714285714286
2009-10-30,42.06,42.14999,40.92,40.96001,38.07306091669118,39.810773675922185,41.525425904815705,42.30064633010695,35.57300015000003,39.6344904,41.72260079999999,42.493003,42.493003,43.878628089294104,41.1073779107059,162796432,38.335511569175864,58.02026420117871,NaN,NaN,38.335511569175864,NaN,NaN,NaN,-0.25899710994629066,0.06294150896053452,0.3219386189068252,1.3796504149984032,12.100048920745145,2559858906,4258313720.1845074,18.04749371815337,28.08560449251433,28.158780090616084,50,100
2009-11-02,41.00999,41.57001,40.64,41.13,38.10347822100271,39.83689696946828,41.50991900658764,42.189156203430095,35.63155015000003,39.6775903,41.73940099999999,42.4890025,42.4890025,43.88980016564413,41.088204834355864,142520624,40.25977127203932,56.455812246517795,NaN,NaN,NaN,NaN,NaN,NaN,-0.28394656539648333,-0.032994587838778955,0.2509519775577044,15.40875657623723,16.045829646441103,2702379530,4265974504.47044,16.46755185006825,28.26258243785706,27.774854012961704,42.857142857142854,100
2009-11-03,40.97,41.32001,40.84,41.25999,38.13488629840567,39.865077029478805,41.500117869074394,42.1006641840558,35.69805005000003,39.7236903,41.75960079999999,42.45500199999999,42.45500199999999,43.9380473668392,40.97195663316079,95107008,41.756514030907645,54.63535082576668,NaN,NaN,NaN,NaN,NaN,NaN,-0.27869167572107445,-0.09741261709363869,0.18127905862743576,19.496479570818984,12.094962187351536,2797486538,4337297330.390233,15.70342418946177,26.951141538956954,26.783159960707774,35.714285714285715,92.85714285714286
2009-11-04,41.50999,41.87,41.28,41.33,38.16667847454094,39.89408540513269,41.49344658009108,42.02726759509811,35.75895010000003,39.7779904,41.77880079999999,42.418502,42.418502,43.97285560973713,40.86414839026286,107970624,42.59076526867162,52.99131883039632,NaN,NaN,NaN,NaN,NaN,NaN,-0.25797334644970854,-0.1411876244346999,0.11678572201500863,21.698044974701247,18.867760373919154,2905457162,4247626812.152944,20.14949632457643,25.34180880750874,24.723218811168802,28.571428571428573,85.71428571428571
2009-11-05,41.81,42.39999,41.78,42.35001,38.20830366384899,39.94271757532808,41.52703730244045,42.05800496699353,35.826900200000026,39.8459905,41.81980099999999,42.42400199999999,42.42400199999999,43.976567778350415,40.87143622164956,135204816,53.12533320503703,52.4200115600889,NaN,NaN,NaN,NaN,NaN,NaN,-0.16743416780603781,-0.09250698774253863,0.07492718006349917,53.77373027128831,31.65608493893618,3040661978,4361032771.062731,23.127825193924302,22.773081899160022,22.845614388857552,21.428571428571427,78.57142857142857
2009-11-06,42.16,42.64999,42.08,42.60001,38.25200223435795,39.99533722730178,41.56911466312906,42.10962449394653,35.895400300000034,39.9131005,41.86380139999999,42.430002499999986,42.430002499999986,43.984314270564376,40.8756907294356,96312192,55.29080286880649,51.721392665290566,NaN,NaN,NaN,NaN,NaN,NaN,-0.08663746976320272,-0.033369657140504216,0.053267812622698495,61.6353407693685,45.70237200511935,3136974170,4440454549.70053,24.267179416606055,21.52159316775595,20.987867455983885,14.285714285714286,71.42857142857143
2009-11-09,42.92,43.52,42.88,43.50999,38.304320520583246,40.06493431190967,41.645227421437724,42.24299263738019,35.96740025000003,39.9900003,41.92520119999999,42.47700149999999,42.47700149999999,44.10070209928802,40.853300900711965,101620752,62.14576294693484,51.50609118654898,NaN,NaN,NaN,NaN,NaN,NaN,0.026133179845551108,0.08593428742963738,0.05980110758408627,90.25097405354067,68.55334836473249,3238594922,4538896477.55203,30.3968996880079,19.645048941470623,20.007217185415243,7.142857142857143,64.28571428571429
2009-11-10,43.45,43.77139,43.39999,43.62,38.35721285371177,40.135331652267894,41.72266948334212,42.37413619572494,36.038900200000036,40.064600299999995,41.99700119999999,42.52900149999999,42.52900149999999,44.22745815594625,40.83054484405373,72846432,62.886601850504505,51.44325086644361,NaN,NaN,NaN,NaN,NaN,NaN,0.10192107973301712,0.18720245725035767,0.08528137751734055,95.16540577826461,82.35057353372459,3311441354,4552355611.003402,31.758859134986288,18.927548407771884,18.89350307669624,0,57.142857142857146
2009-11-11,43.94,44.14,43.61,43.89999,38.412364865117624,40.209879342322,41.80805460164243,42.51945560565589,36.10665010000003,40.152800199999994,42.089400999999995,42.56600099999999,42.56600099999999,44.34801369135628,40.78398830864371,84676128,64.77608055420568,51.394609329664185,NaN,NaN,NaN,NaN,NaN,NaN,0.16117140936292432,0.28674563922099594,0.12557422985807162,93.14257142857149,92.85298375345893,3396117482,4560340729.640081,33.767257853824475,17.921624477252234,18.828230781597824,100,50
2009-11-12,43.92,44.16,43.55,43.64999,38.464480538101526,40.27800034544433,41.88028736236234,42.62712554797438,36.17700005000003,40.239300099999994,42.177400799999994,42.5955005,42.5955005,44.428063671673904,40.762937328326096,92426064,61.75298810051394,51.3662310017638,NaN,NaN,NaN,NaN,NaN,NaN,0.17276024426536402,0.34152453518977666,0.16876429092441264,85.51107954545469,91.27301891743026,3303691418,4498215262.818313,31.680367489192342,17.42191925862342,18.355874435238185,100,42.857142857142854
2009-11-13,43.78,44.14,43.63,44.00999,38.519659736727384,40.35190113068306,41.96380511285793,42.75882692435777,36.25175000000004,40.323499999999996,42.2674008,42.657,42.657,44.590004687060414,40.72399531293958,87959504,64.33426789259258,51.702438284474894,NaN,NaN,NaN,NaN,NaN,NaN,0.19240329114028493,0.4092684048497688,0.21686511370948386,95.73835227272743,91.46400108225122,3391650922,4541329217.347568,30.010426838931554,16.503572235487983,18.44543789335308,92.85714285714286,35.714285714285715
2009-11-16,44.19,44.64999,44.12,44.46001,38.57876769954602,40.43324982116459,42.061695500588996,42.92084436013322,36.32700005000003,40.405200199999996,42.349400999999986,42.7195,42.7195,44.79552676288102,40.643473237118975,87776064,67.30480825104826,52.969488834713175,NaN,NaN,NaN,NaN,NaN,NaN,0.22137118114493226,0.49357909014064916,0.2722079089957169,95.26233232501814,92.17058804773342,3479426986,4566176936.893067,33.313833983871646,15.406089437339867,20.383288387286193,100,28.571428571428573
2009-11-17,44.34,44.60001,44.25,44.60001,38.63868055825701,40.515759923715784,42.16123724566394,43.08076489726339,36.400650100000036,40.487500299999994,42.42660099999999,42.7885005,42.7885005,45.01291196513357,40.56408903486643,81884000,68.19236592678166,55.04289112936235,NaN,NaN,NaN,NaN,68.19236592678166,NaN,0.23437585567247715,0.5651777285863133,0.33080187291383617,98.75361285190225,96.58476581654928,3561310986,4648060936.893067,32.058252866868145,14.825441920342694,22.28032851929105,92.85714285714286,21.428571428571427
2009-11-18,44.47,44.49001,44.05,44.353,38.69553945817485,40.59174487572141,42.24718872622614,43.201930145143066,36.47286510000003,40.5665303,42.49186099999999,42.84915049999999,42.84915049999999,45.17253467693204,40.52576632306795,100240816,64.84751170269149,56.257077531422226,NaN,NaN,NaN,NaN,NaN,NaN,0.21146110541140095,0.5951282546780874,0.38366714926668644,92.59374711657632,95.53656409783224,3461070170,4685875925.297514,30.136124549014813,16.11677563154867,23.71691815266883,85.71428571428571,14.285714285714286
2009-11-19,44.06,44.08,43.35001,43.66,38.74493707550644,40.65250240293485,42.302593089903546,43.24555584560563,36.53831505000003,40.6393303,42.535461,42.8666505,42.8666505,45.208852020709806,40.52444897929019,114557936,56.47759705320792,57.55294078028165,NaN,NaN,NaN,NaN,NaN,NaN,0.1382899821217724,0.556529626918902,0.41823964479712955,75.31190850849988,88.8864228256595,3346512234,4668611964.778383,26.961467904093883,21.770956413327323,22.923491117655686,78.57142857142857,7.142857142857143
2009-11-20,43.41,43.55,43.28,43.44,38.79165411953125,40.70770037515396,42.34719728245635,43.26407433650033,36.59866505000003,40.7097304,42.573860999999994,42.882150499999995,42.882150499999995,45.23519582502425,40.52910517497574,70912064,54.090748656410526,58.540867736308165,NaN,NaN,NaN,NaN,NaN,NaN,0.06732545318128846,0.5023964612737402,0.4350710080924517,68.24164892821227,78.7157681844295,3275600170,4681743828.482086,25.85038110913333,21.633014742016954,21.67438072236404,71.42857142857143,0
2009-11-23,43.87,44.39999,43.86,44.14,38.84487149147621,40.775666704358834,42.41750327137963,43.347495828262204,36.66186505000003,40.7951303,42.623061199999995,42.93964999999999,42.93964999999999,45.35578490314567,40.52351509685432,91621440,59.89804761748236,59.836691563920645,NaN,NaN,NaN,NaN,NaN,NaN,0.060022855086309446,0.5100995769503385,0.45007672186402903,84.86672067276159,76.14009270315792,3367221610,4685138974.715164,32.170540617840544,19.45209975647465,21.550667498553853,64.28571428571429,0
2009-11-24,44.14,44.14999,43.73,43.99001,38.89606689952122,40.83931706664876,42.47917020191376,43.40868765414199,36.73011510000003,40.8809304,42.666661399999995,43.022150499999995,43.022150499999995,45.46330140513019,40.5809995948698,60669936,58.19925506697837,60.95158369237113,NaN,NaN,NaN,NaN,NaN,NaN,0.038623955871355586,0.49835666670322354,0.45973271083186795,77.00410105958542,76.70415688685311,3306551674,4699588875.184413,30.71178137070027,19.973608450203805,22.248672959286402,57.142857142857146,0
2009-11-25,44.14,44.22,44.00999,44.17999,38.94864324877972,40.905469005923045,42.545869017524986,43.48214502041419,36.80001505000003,40.977430299999995,42.701861199999996,43.161649999999995,43.161649999999995,45.53161048706261,40.79168951293738,37630048,59.75614364633452,61.42521300960667,NaN,NaN,NaN,NaN,NaN,NaN,0.03111959322182889,0.49863220235915406,0.4675126091373252,81.71199109724142,81.19427094319616,3344181722,4722880765.758765,30.704714735070947,19.453402258742848,23.79573313034306,50,0
2009-11-27,43,43.83,42.89999,43.50999,38.994029783617734,40.95704367907308,42.5836776835044,43.48479692323188,36.86471495000003,41.06543009999999,42.723861,43.232649499999994,43.232649499999994,45.554530289545156,40.91076871045483,61229936,52.350751897334966,61.21520936878728,NaN,NaN,52.350751897334966,NaN,NaN,NaN,-0.022235394377652873,0.43971836616525906,0.46195376054291193,35.59285645681611,64.769649537881,3282951786,4741973107.927817,26.558859724935875,28.53579827993245,23.62373730449934,42.857142857142854,0
2009-11-30,43.41,43.62,43.11,43.56,39.03946232308422,41.00858736859639,42.62196483317089,43.49195912101932,36.93036500000002,41.15333009999999,42.746261,43.362649,43.362649,45.43918085177429,41.286117148225706,84819376,52.820736218604175,60.54913603104937,NaN,NaN,NaN,NaN,NaN,NaN,-0.05553167371974749,0.39253916839322756,0.44807084211297504,37.71485714285713,51.67323489897157,3367771162,4806834983.692525,25.10439341866325,26.97306714047069,22.345350343632642,35.714285714285715,0
2009-12-01,43.88,44.3,43.88,44.00999,39.0889203099192,41.06802108406973,42.676397192654385,43.54129539520795,37.00431495000002,41.244229999999995,42.775060599999996,43.5066485,43.5066485,45.32761167097541,41.68568532902459,81817808,56.93664612878199,60.12413919378348,NaN,NaN,NaN,NaN,NaN,NaN,-0.04885774025416273,0.3869986667952716,0.43585640704943435,63.428571428571395,45.57876167608156,3449588970,4775662398.844525,30.369126026207976,24.846831103095372,21.25150564843395,28.571428571428573,85.71428571428571
2009-12-02,44.16,44.49001,43.98,44.07001,39.13848339141254,41.127466409137654,42.73104867529539,43.59164916709291,37.078464950000026,41.32903009999999,42.803461,43.6471495,43.6471495,45.160729725444575,42.13356927455542,81653504,57.469602858638474,59.60224792981439,NaN,NaN,NaN,NaN,NaN,NaN,-0.042256728058867266,0.38303549697585026,0.42529222503471753,66.85828571428577,56.000571428571455,3531242474,4722830415.579572,30.749796560761556,23.473454022491044,20.020323023616324,21.428571428571427,78.57142857142857
2009-12-03,44.24001,44.5,43.88,43.89,39.18576216363729,41.18217004460028,42.776497746852435,43.62006353213168,37.15396500000002,41.410730099999995,42.832260999999995,43.7751495,43.7751495,44.853735616569594,42.6965633834304,72460368,55.26065505983785,59.13850985548038,NaN,NaN,NaN,NaN,NaN,NaN,-0.05126929968525984,0.36120560042814276,0.4124749001134026,56.57199999999989,62.286285714285704,3458782106,4652707478.805378,28.67480229397635,22.977852920743075,18.733972140954666,14.285714285714286,71.42857142857143
2009-12-04,44.45,44.73,43.66,44.12,39.23485905753145,41.24034489520225,42.82918410972097,43.66767652907152,37.23021500000002,41.4827301,42.8732608,43.863648999999995,43.863648999999995,44.72944298209594,42.99785501790405,125062496,57.50800285415322,58.65091949559186,NaN,NaN,NaN,NaN,NaN,NaN,-0.04331297582190291,0.358333680336024,0.4016466561579269,66.66684881503373,63.365711509773156,3583844602,4635175353.197902,27.87472635652267,20.41721628272821,17.76285060790786,100,64.28571428571429
2009-12-07,44.08,44.28999,43.82001,43.91,39.281377872879396,41.293209352723,42.87156904659466,43.69075495487423,37.31046500000002,41.5482301,42.9174608,43.9291485,43.9291485,44.57219706737855,43.28609993262144,67471808,54.80125789648972,57.757808755980534,NaN,NaN,NaN,NaN,NaN,NaN,-0.05311901369837907,0.33524788903495306,0.38836690273333213,55.19150168578298,59.47678350027223,3516372794,4593542040.461187,26.47893865921035,19.394852908239752,16.24042514100366,92.85714285714286,57.142857142857146
2009-12-08,43.67999,44,43.36,43.642,39.32476714777612,41.33972005860967,42.90178202515958,43.68611162583859,37.38477500000002,41.6090501,42.9421008,43.935749,43.935749,44.56399200727621,43.30750599272379,86621376,51.47169154138158,56.5634748713091,NaN,NaN,51.47169154138158,NaN,NaN,NaN,-0.0771244626143876,0.2919613244653476,0.3690857870797352,40.54677296845388,54.13504115642355,3429751418,4583255752.061189,24.667517335269594,22.985120973546596,13.867141555387061,85.71428571428571,50
2009-12-09,43.61,44.12,43.32001,44.08,39.3720828975495,41.39398302774612,42.94798665162391,43.72362480433016,37.46222500000002,41.670650099999996,42.97930079999999,43.958749,43.958749,44.57258567224558,43.344912327754415,78820432,56.15976121886834,55.94292126532173,NaN,NaN,NaN,NaN,NaN,NaN,-0.06354036907613536,0.289660325734566,0.3532006948107014,64.48106840946221,53.40644768789971,3508571850,4654194042.334417,23.85233147369802,21.04692852868653,12.148428078447866,78.57142857142857,42.857142857142854
2009-12-10,44.25,44.53999,44.24001,44.3,39.421116898568904,41.4515279182858,43.00100678293278,43.77851768010824,37.54477505000002,41.7318502,43.020300799999994,43.9787495,43.9787495,44.60945965940466,43.348039340595335,76722320,58.33688868654868,56.07572781056035,NaN,NaN,NaN,NaN,NaN,NaN,-0.04087540854615579,0.30210643412800664,0.34298184267416243,76.50286064010574,60.510234006007295,3585294170,4608157581.23701,27.199577874829288,20.002490467041888,12.476739174448385,71.42857142857143,35.714285714285715
2009-12-11,44.52,44.59,43.95,44.13,39.4679714567921,41.50456696940885,43.04528102673933,43.8119921867646,37.62777505000002,41.7881502,43.08290079999999,44.00274999999999,44.00274999999999,44.61793289163346,43.387567108366525,66643632,56.02174217243875,56.21365591884808,NaN,NaN,NaN,NaN,NaN,NaN,-0.03850259675901313,0.294853596725396,0.33335619348440915,67.21329391642689,69.3990743219983,3518650538,4579000992.23701,25.317122967650395,21.754278424969957,12.382971378107337,64.28571428571429,28.571428571428573
2009-12-14,44.42999,44.60001,44.19,44.55,39.518538904983224,41.56487257397501,43.10428961392603,43.88227864516797,37.71732505000002,41.8401501,43.15630079999999,44.02975049999999,44.02975049999999,44.68961405493966,43.36988694506032,47965472,60.221888586444855,56.23678741663112,NaN,NaN,NaN,NaN,NaN,NaN,-0.01123272053568769,0.31931529281479953,0.3305480133504872,90.163988174928,77.96004757715356,3566616010,4615265514.237156,24.11380031013943,20.625327463530787,11.18011661364629,57.142857142857146,21.428571428571427
2009-12-15,44.41,44.67,44.17,44.3,39.56611563229682,41.61903351310421,43.15118021730148,43.92206163134245,37.805725050000014,41.8926501,43.218100599999985,44.02174999999999,44.02174999999999,44.664203259092055,43.379296740907925,61171040,56.74772498577491,56.133106696545156,NaN,NaN,NaN,NaN,NaN,NaN,-0.01251961174860411,0.3148984986647321,0.3274181104133362,76.50286064010574,77.96004757715356,3505444970,4585903415.037155,23.5461298427786,19.467891677757326,10.344063026582726,50,14.285714285714286
2009-12-16,44.47,44.7,44.28999,44.36,39.613815974264014,41.67331007720116,43.198584914662206,43.96377004740508,37.89087505000002,41.942750000000004,43.26650059999999,44.0097495,44.0097495,44.61652444105721,43.40297455894279,61629616,57.383162770676385,55.96360806256957,NaN,NaN,NaN,NaN,NaN,NaN,-0.011825860079059114,0.3126357853145123,0.3244616453935714,79.7815312484632,82.14946002116567,3567074586,4545320551.14642,22.779832717574628,18.548674641076907,9.473075868222535,42.857142857142854,7.142857142857143
2009-12-17,44.17,44.21001,43.75999,43.82001,39.655668651137006,41.71581898656351,43.222954525851925,43.95007861431888,37.977425150000016,41.9901501,43.30170079999999,43.98309999999999,43.98309999999999,44.57383774224847,43.392362257751515,90440880,50.23074534520756,55.81217902313191,NaN,NaN,50.23074534520756,NaN,NaN,NaN,-0.04819005401781917,0.2642240778712974,0.3124141318891166,43.827777777778095,66.70405655544903,3476633706,4479004206.134199,21.20212260847812,23.381793485383078,9.565980107777245,35.714285714285715,0
2009-12-18,44.14,44.48,44,44.46001,39.70347304266798,41.77015940267117,43.27146650523028,43.998643508193275,38.068225200000015,42.041350200000004,43.34610079999999,44.02310049999999,44.02310049999999,44.62905497662078,43.4171460233792,96442560,57.06184594434803,56.115115432113605,NaN,NaN,NaN,NaN,NaN,NaN,-0.030461139187744124,0.27433770790443646,0.3047988470921806,80.85163724565413,68.15364875729848,3573076266,4567413904.574199,22.696278437819895,21.608936808692334,9.48497644389572,28.571428571428573,0
2009-12-21,44.67,45.13,44.67,44.96001,39.755776892989694,41.83332476103411,43.33768389718203,44.090202221698675,38.164325200000015,42.0952502,43.39570099999999,44.09910099999999,44.09910099999999,44.77113906987003,43.42706293012995,82381376,61.50699266677476,56.44156875625595,NaN,NaN,NaN,NaN,NaN,NaN,0.011377863413325917,0.319021176358838,0.30764331294551206,90.60823540461517,71.76255014268247,3655457642,4588908280.112284,28.385235489491023,19.95484428452772,10.016297023413255,100,42.857142857142854
2009-12-22,45.08,45.28999,45.03,45.23,39.81024677465149,41.90058565685522,43.411892371802345,44.1987543910607,38.253825200000016,42.15305020000001,43.44890079999998,44.153600999999995,44.153600999999995,44.987391220231736,43.319810779768254,51569040,63.69273338528271,56.886078079587676,NaN,NaN,NaN,NaN,NaN,NaN,0.05143069898028596,0.3719316866708695,0.32050098769058355,96.95479141920191,89.47155468982373,3707026682,4616679276.267518,29.16944499169743,19.17627954278506,10.53422458203375,100,35.714285714285715
2009-12-23,45.34,45.57001,45.21001,45.56,39.86745824953058,41.973049307214524,43.49613188663363,44.3283968300073,38.34287520000001,42.2082503,43.50850079999999,44.232100499999994,44.232100499999994,45.26205033942722,43.20215066057277,73932192,66.2177071348012,57.66872465637078,NaN,NaN,NaN,NaN,NaN,NaN,0.09197684086884905,0.43547203877664487,0.3434951979077958,99.55511111111106,95.70604597830938,3780958874,4686500016.923517,31.30023674368725,18.33576544943649,11.612063420573724,100,28.571428571428573
2009-12-24,45.61,45.98,45.60001,45.98,39.928279560480526,42.0523948654875,43.59353847931466,44.4856923700066,38.42942520000001,42.2676504,43.56490079999999,44.322100999999996,44.322100999999996,45.602289948285865,43.04191205171413,31770352,69.15760004926246,58.50083874173572,NaN,NaN,NaN,NaN,NaN,NaN,0.13624063776398143,0.5137959951127726,0.3775553573487912,100,98.83663417677099,3812729226,4718270368.923517,34.76163953124535,17.37872554676979,12.89035864257029,100,21.428571428571427
2009-12-28,46.08,46.3,45.94,46.22,39.99088374395833,42.13492169983428,43.69653697032193,44.65086452524407,38.51682515000002,42.3325504,43.628100799999984,44.457601499999996,44.457601499999996,45.925232744177784,42.98997025582221,49381392,70.72536349759673,59.6382748561005,NaN,NaN,NaN,NaN,70.72536349759673,NaN,0.16871650795929327,0.5884509922979078,0.4197344843386145,97.31542723297736,98.95684611469615,3862110618,4745704475.590184,37.24963099991383,16.57990200761302,14.530068397037114,100,14.285714285714286
2009-12-29,46.22,46.25,45.99001,46.03,40.05097445297367,42.2120519632039,43.78804532442695,44.78221076093511,38.60567520000002,42.39905039999999,43.69310079999998,44.581101499999995,44.581101499999995,46.13875428123459,43.0234487187654,32410160,67.78764641701518,60.80370020436004,NaN,NaN,NaN,NaN,NaN,NaN,0.1642753607987097,0.6250786853370016,0.4608033245382919,90.93956691129848,96.08499804809196,3829700458,4723264562.8950815,35.96393309313624,16.007634719762173,17.020636270216333,92.85714285714286,7.142857142857143
2009-12-30,46,46.25999,45.96001,46.17,40.11186027931224,42.290427171853324,43.88145531170433,44.91438116465557,38.68987520000002,42.4619504,43.752300599999984,44.68910199999999,44.68910199999999,46.36818263369902,43.01002136630096,57612656,68.81550327469832,61.70768177977647,NaN,NaN,NaN,NaN,NaN,NaN,0.15761356691681216,0.6578202831843072,0.500206716267495,94.88190991374067,94.37896801933884,3887313114,4746311161.735004,34.48493793981007,15.760601767388248,19.23616854727771,85.71428571428571,0
2009-12-31,46.25,46.27499,45.75,45.75,40.1679611720554,42.35893356448989,43.954731573990436,44.993963910878854,38.770125200000024,42.52345029999999,43.80290059999999,44.77310149999999,44.77310149999999,46.487608438699866,43.05859456130011,50079168,62.384310902564984,61.99678336663478,NaN,NaN,62.384310902564984,NaN,NaN,NaN,0.1138120119956032,0.642471731261999,0.5286597192663958,78.34654194274833,88.05600625592916,3837233946,4696231993.735004,32.004363958727765,17.504384391205484,20.23904808170747,78.57142857142857,35.714285714285715
2010-01-04,46.32001,46.485,46.27,46.42,40.23017051362699,42.4393507216287,44.05140876716728,45.12977687174754,38.85382525000002,42.59505039999999,43.868500599999976,44.89960149999999,44.89960149999999,46.705704023350044,43.09349897664993,62822800,67.58810216065027,62.82295193722132,NaN,NaN,NaN,NaN,NaN,NaN,0.11832997722341732,0.6765721907956674,0.5582422135722501,97.61468765252246,90.28104650300382,3900056746,4721068914.665237,31.668611108678984,15.791716821228095,22.087902294259493,100,28.571428571428573
2010-01-05,46.38,46.5,46.16,46.42,40.29176085677498,42.518175459814266,44.144294697866606,45.25265526491444,38.940025300000016,42.66055039999999,43.93070059999998,45.01460149999999,45.01460149999999,46.898712150903776,43.130490849096205,62935584,67.58810216065027,63.34911004966456,NaN,NaN,NaN,NaN,NaN,NaN,0.10986930966153019,0.6955788506491629,0.5857095409876327,97.08030262663281,91.01384407396786,3900056746,4754387753.253473,30.196763354971058,16.561425375299752,23.61390415052228,100,21.428571428571427
2010-01-06,46.39,46.55,46.07001,46.14,40.349952291035926,42.589894757639726,44.222557650891446,45.33716428730354,39.01622535000002,42.721050399999996,43.990900599999975,45.12610149999999,45.12610149999999,46.999445944262874,43.252757055737106,96033008,63.34103988365746,63.820061113799035,NaN,NaN,NaN,NaN,NaN,NaN,0.07559804842919982,0.6802071015241324,0.6046090530949326,85.30471216949053,93.3332341495486,3804023738,4686360954.674169,28.203885114712346,16.705751747753283,24.765449619725143,100,14.285714285714286
2010-01-07,46.2,46.27,45.92,46.17,40.40786321351318,42.660787930755774,44.29892793909178,45.41648197422701,39.09542040000002,42.78645039999999,44.05450039999998,45.252501499999994,45.252501499999994,47.04775772963619,43.4572452703638,77094064,63.60492138483881,64.26447244338206,NaN,NaN,NaN,NaN,NaN,NaN,0.046556935802095856,0.6628052228475525,0.6162482870454566,86.37997713269858,89.58833064294065,3881117802,4719401267.817025,26.814232409444855,17.99441540845631,25.440122756055196,92.85714285714286,7.142857142857143
2010-01-08,46.03999,46.55,45.92999,46.55,40.46897900243345,42.737802031136845,44.387205274813674,45.52443607191967,39.17582040000002,42.86715039999999,44.138700399999976,45.376001499999994,45.376001499999994,47.171463682294664,43.58053931770532,88886624,66.85909141249294,65.45221144818815,NaN,NaN,NaN,NaN,NaN,NaN,0.04454643176999418,0.6719313267579494,0.6273848949879552,100,90.5615631007297,3970004426,4808287891.817025,28.39055770693649,16.448326737385692,26.99331784254043,85.71428571428571,0
2010-01-11,46.60001,46.64,46.12,46.36,40.527596126787344,42.80952872358958,44.46456977384059,45.6040135888797,39.25057040000002,42.94045039999999,44.23810039999998,45.479001499999995,45.479001499999995,47.25194910555646,43.70605389444353,104673312,63.78801006226109,65.93265174232481,NaN,NaN,NaN,NaN,NaN,NaN,0.02310598477400827,0.6562673759554656,0.6331613911814573,85.78680203045678,90.72225972105178,3865331114,4800236098.586256,27.592418367817544,15.263790414073,28.872833463514805,100,0
2010-01-12,46.08,46.14,45.53,45.78,40.57985885189394,42.86834993698385,44.516155272905664,45.62077419946259,39.325370350000014,43.005250399999994,44.31190039999998,45.56150149999999,45.56150149999999,47.225916478919295,43.89708652108069,90673808,55.41942655932761,65.49782559179287,NaN,NaN,NaN,NaN,NaN,NaN,-0.03433038249305942,0.5902484130651331,0.6245787955581925,46.583850931677034,77.45688432071127,3774657306,4783885084.028879,24.552998937833987,21.41265539161406,28.11513206307893,92.85714285714286,0
2010-01-13,45.92999,46.49001,45.61,46.35001,40.63727329117857,42.93729370060793,44.58807114455642,45.6902252280852,39.40682040000002,43.07115059999999,44.41970039999998,45.65150199999999,45.65150199999999,47.28171638346697,44.021287616533,100660944,60.85481310908546,65.29511700063593,NaN,NaN,NaN,NaN,NaN,NaN,-0.03784818849496163,0.5772685599394904,0.6151167484344521,79.72083720865164,70.69716339026182,3875318250,4852517909.80295,26.253472223913928,19.020364911170706,27.7798560555172,85.71428571428571,0
2010-01-14,46.25999,46.52,46.22,46.39,40.69451435295789,43.00566412237807,44.65873502124048,45.75687044445804,39.48717035000002,43.13215069999999,44.52490039999998,45.75600199999999,45.75600199999999,47.29147660547627,44.22052739452371,75812688,61.21211433338239,64.93757465767743,NaN,NaN,NaN,NaN,NaN,NaN,-0.04112485016761369,0.563710685724935,0.6048355358925487,77.47747747747746,67.9273885392687,3951130938,4862626268.20295,25.612942643669,18.270949147430613,27.109242431911834,78.57142857142857,0
2010-01-15,46.46001,46.55,45.64999,45.85001,40.74581281710756,43.06198780312306,44.70545168707419,45.76574087831918,39.56257040000002,43.188150799999995,44.61670079999998,45.83050249999999,45.83050249999999,47.22602539485845,44.43497960514152,126866064,54.03936918027047,63.85770102417801,NaN,NaN,NaN,NaN,NaN,NaN,-0.08099783603586352,0.5035882408477192,0.5845860768835828,28.829729729729415,62.009348138619494,3824264874,4792150133.473246,22.720689808300083,23.359508808673326,24.826930382684186,71.42857142857143,78.57142857142857
2010-01-19,45.96001,46.64,45.95,46.59,40.80396393335525,43.13184943078399,44.779355542483046,45.84424174705069,39.63672045000002,43.250350799999985,44.72190079999998,45.96900199999999,45.96900199999999,47.054224086056415,44.88377991394356,84388128,60.81557135992419,63.149858728629965,NaN,NaN,NaN,NaN,NaN,NaN,-0.05984853732926532,0.5097754052220012,0.5696239425512665,95.49549549549575,67.26756756756754,3908653002,4864308097.994986,21.628123206787393,21.1065513111861,22.171358713237233,64.28571428571429,71.42857142857143
2010-01-20,46.27,46.604,45.42999,45.92,40.854869764864155,43.1870603331447,44.82408669767979,45.85145681876015,39.70457040000002,43.30655079999999,44.79330059999998,46.04200149999999,46.04200149999999,46.87953367015808,45.2044693298419,145679936,53.171681750067854,62.105861252419444,NaN,NaN,NaN,NaN,NaN,NaN,-0.09140619491859003,0.4553661989030289,0.5467723938216189,40.49635953421902,54.94052825314805,3762973066,4840236368.806445,18.736090769497128,24.207022752386084,20.33860583607294,57.142857142857146,100
2010-01-21,46.06,46.35001,45.3,45.49001,40.900990563223715,43.232663296844805,44.850201336986466,45.817033312211564,39.77067045000002,43.35745099999999,44.85110059999998,46.06850149999999,46.06850149999999,46.793380067796924,45.343622932203054,204939568,48.92185912561833,60.684886670342294,NaN,NaN,NaN,NaN,NaN,NaN,-0.138820036352717,0.3732473483807226,0.5120673847334396,14.179850746268688,50.057235258661144,3558033498,4709468603.581048,16.59834770886856,22.85757434420171,18.809904227904212,50,100
2010-01-22,45.34,45.48,44.03999,44.16,40.9334185178185,43.25102639987758,44.823134617888954,45.65922061581046,39.83437045000002,43.394650999999996,44.86410079999998,46.01500149999999,46.01500149999999,47.064696017491656,44.965306982508324,171098624,38.63556554338605,58.988547716115235,NaN,NaN,NaN,NaN,NaN,NaN,-0.2508074895657201,0.19855802277628953,0.4493655123420096,4.615751477878686,19.763987252788795,3386934874,4566888595.238215,14.190450480879788,32.147538225893655,19.48595415218154,42.857142857142854,100
2010-01-25,44.39,44.60001,44.12,44.31,40.96701634351185,43.27199617413743,44.80301169169723,45.5307234143047,39.89617045000002,43.43745099999999,44.87790079999998,45.95250149999999,45.95250149999999,47.22774043057465,44.67726256942533,154218624,40.16363193435412,57.029656985665504,NaN,NaN,NaN,NaN,NaN,NaN,-0.302375442666423,0.0713962090089808,0.3737716516754038,10.38496005784591,9.726854093997762,3541153498,4534757171.754874,13.492649915797566,30.56671664660296,19.86448488265886,35.714285714285715,92.85714285714286
2010-01-26,44.28,44.89,44.05,44.35001,41.00067797193462,43.29334298257035,44.785246919473806,45.418274517704255,39.95322050000002,43.488151099999996,44.886901199999976,45.87100199999999,45.87100199999999,47.324656093677426,44.417347906322554,140816432,40.5886009266232,55.10112118323501,NaN,NaN,NaN,NaN,NaN,NaN,-0.3197004763486283,-0.025853943760381526,0.2938465325882468,11.923800293075592,8.974837276266735,3681969930,4494527258.24135,15.27625053961125,27.9742822717792,19.878617654943127,28.571428571428573,85.71428571428571
2010-01-27,44.28999,44.85001,44.00999,44.7,41.03748714634323,43.321197576974896,44.78190390302385,45.34986742078004,40.01227050000002,43.54265109999999,44.907901399999986,45.79500199999999,45.79500199999999,47.324673677212274,44.265330322787705,161632624,44.31429755087464,53.7420681594648,NaN,NaN,NaN,NaN,NaN,NaN,-0.29414364315646757,-0.07383302135733771,0.22031062179912986,26.236021916266527,16.18159408906268,3843602554,4598431471.188663,13.997719461450005,26.031634833679924,20.19718243691028,21.428571428571427,100
2010-01-28,44.39999,44.42999,43.32001,43.55,41.06248727424031,43.3257283180249,44.733593946042525,45.178451475943845,40.06757045000002,43.58305119999999,44.89870159999999,45.67100199999999,45.67100199999999,47.480795751803086,43.86120824819689,221439808,36.266603145530375,51.78933114237134,NaN,NaN,NaN,NaN,NaN,NaN,-0.3381044626818329,-0.20231995655316126,0.13578450612867163,6.927430504308564,15.029084237883566,3622162746,4468757175.075217,12.192397640941273,29.12275624351352,21.71827360824991,14.285714285714286,100
2010-01-29,43.89999,44.02,42.63,42.78999,41.07967635608867,43.315119638460054,44.657374183452625,44.95097895442538,40.11952045000002,43.607351099999995,44.86530119999998,45.50200149999999,45.50200149999999,47.68634464522511,43.31765835477487,212126000,32.11562763975515,49.307655158604355,NaN,NaN,32.11562763975515,NaN,NaN,NaN,-0.3976742421742693,-0.36130829658916497,0.036365945585104295,3.9897755610972716,12.384409327224125,3410036746,4305462885.492483,10.69601429780417,31.64097865203158,23.349585629587388,7.142857142857143,100
2010-02-01,42.91,43.2807,42.88,43.25999,41.101371019212166,43.31402796245094,44.60257480370939,44.78993238733725,40.16962035000002,43.6325509,44.838500799999984,45.37750099999998,45.37750099999998,47.76546581132362,42.98953618867634,136827056,36.923717903132825,47.38877714723805,NaN,NaN,NaN,NaN,NaN,NaN,-0.38450192439137315,-0.44426145990411214,-0.05975953551273901,15.71047381546134,8.875893293622397,3546863802,4428146251.301517,10.219183040503255,30.230415126889604,24.82848501987197,0,92.85714285714286
2010-02-02,43.31,43.78,43.03,43.64999,41.12673041205583,43.32068067606578,44.565218536897255,44.68136644568609,40.221320300000016,43.658150799999994,44.82444059999998,45.23900049999999,45.23900049999999,47.68954011488875,42.78846088511123,110727632,40.6783505805416,46.335843148753334,NaN,NaN,NaN,NaN,NaN,NaN,-0.33065583939228466,-0.4730793347530948,-0.14242349536081017,25.436159600997517,15.04546965918538,3657591434,4500485351.471331,14.071634179337536,28.16382026958347,26.723759214599845,28.571428571428573,85.71428571428571
2010-02-03,43.45,43.97,43.42,43.89,41.15422563183637,43.331954326044674,44.53873937858756,44.6059982127636,40.27957025000001,43.68225079999999,44.82904059999999,45.11250049999999,45.11250049999999,47.567321045404576,42.6576799545954,93581632,42.92978993514507,45.055484350614734,NaN,NaN,NaN,NaN,NaN,NaN,-0.26295730568922904,-0.47112012747234644,-0.20816282178311743,31.421446384039868,24.189359933499578,3751173066,4566843235.980422,15.120356616469078,26.721195996053503,27.56299430785111,21.428571428571427,78.57142857142857
2010-02-04,43.58,43.66,42.62,42.62,41.168810451420086,43.31785622057844,44.46349469707432,44.41685552583373,40.32922025000001,43.693250799999994,44.81264059999999,44.936500499999994,44.936500499999994,47.56967360751465,42.303327392485336,151652368,35.29612445219064,43.20434221624389,NaN,NaN,NaN,NaN,NaN,NaN,-0.2858911721591442,-0.5655267869820477,-0.2796356148229035,0,18.9525353283458,3599520698,4415190867.980422,13.411991637306262,30.819246599305405,29.17903844894212,14.285714285714286,100
2010-02-05,42.75,43.02,42.12,42.98,41.18683223797312,43.311165998388766,44.40531843444395,44.28001214242099,40.38017030000001,43.70625089999999,44.78944059999999,44.77700049999999,44.77700049999999,47.47757715177999,42.076423848219996,213618496,38.62755853706571,42.10349859887212,NaN,NaN,NaN,NaN,NaN,NaN,-0.25975504420535817,-0.6043294200796012,-0.34457437587424306,19.026548672566346,16.815998352202076,3813139194,4609821053.224864,12.347321993621529,32.78286229149469,32.31439513978092,7.142857142857143,100
2010-02-08,42.92,43.17999,42.64,42.67,41.201590126152496,43.29846964198503,44.337266731132424,44.126677652666615,40.42797030000001,43.714850899999995,44.76304039999998,44.58300049999999,44.58300049999999,47.303617163210674,41.862383836789306,94354368,36.867262550486224,40.39290511248369,NaN,NaN,NaN,NaN,NaN,NaN,-0.24639869387484797,-0.652572743217803,-0.40617404934295503,12.265834076717306,10.430794249761222,3718784826,4525950698.039917,13.190453111585018,31.183403683468747,35.123541576993595,0,92.85714285714286
2010-02-09,43.17,43.50999,42.75999,43.11,41.220579279126106,43.29473756986651,44.28913862402919,44.02985120955551,40.47507030000001,43.72175089999999,44.74164059999998,44.42050049999999,44.42050049999999,47.084807291294766,41.75619370870521,118955936,40.978515818887246,39.521964688827936,NaN,NaN,NaN,NaN,NaN,NaN,-0.1933277821998925,-0.6478337770928206,-0.45450599489292814,23.404199990070992,18.232194246451545,3837740762,4518023474.464876,15.162187615978354,28.827255927603208,36.43243261644408,0,85.71428571428571
2010-02-10,43.10001,43.31,42.75,43.02,41.23848396291589,43.28929722194837,44.239368481910404,43.933674903883556,40.52152030000002,43.72785089999999,44.73184079999998,44.28250049999999,44.28250049999999,46.93673998243929,41.62826101756069,94102816,40.39900072739034,38.913189088954496,NaN,NaN,NaN,NaN,NaN,NaN,-0.15152934646022664,-0.6439176779682114,-0.4923883315079848,26.78571428571446,20.818582784167585,3743637946,4514662659.607734,14.382003695062995,27.435717337940645,37.52899692673519,0,78.57142857142857
2010-02-11,43.00999,43.78999,42.75999,43.67,41.26267815233962,43.296835890820674,44.21704030614921,43.9085630082756,40.57247030000002,43.74015089999999,44.73404079999998,44.14849999999999,44.14849999999999,46.63712913269938,41.659870867300604,93050816,46.30505529700512,39.46100978564158,NaN,NaN,NaN,NaN,NaN,NaN,-0.07141698606586488,-0.5816595640903159,-0.510242578024451,55.9566787003611,35.38219765871552,3836688762,4586033538.885715,17.362095695030572,24.89805182871969,36.03470327151519,0,71.42857142857143
2010-02-12,43.27,43.88,43.16,43.75999,41.287527026445694,43.30600725931927,44.19911676473159,43.89441319796364,40.62157025000002,43.75205069999999,44.729040799999986,44.01699949999999,44.01699949999999,46.28623483115017,41.74776416884981,93944000,47.086815206096176,39.955522876480295,NaN,NaN,NaN,NaN,NaN,NaN,-0.007065578430395347,-0.5190745510624453,-0.5120089726320499,59.20541516245497,47.31593604951018,3930632762,4648660262.663492,17.04567581796225,23.27725081909502,34.37054345624045,7.142857142857143,64.28571428571429
2010-02-16,44.08,44.35001,43.85001,44.32001,41.31770098638156,43.32608652151097,44.20385767591859,43.934946226729004,40.67177030000002,43.76875089999999,44.73404079999998,43.94049949999999,43.94049949999999,46.05530387916607,41.825695120833906,83861376,51.79078006258065,40.75567852904869,NaN,NaN,NaN,NaN,NaN,NaN,0.07404608263896406,-0.4194513693333448,-0.4934974519723089,80.58615169907824,65.2494151872981,4014494138,4722458273.543494,20.44738792975518,22.012644157595037,32.536770125262464,0,57.142857142857146
2010-02-17,44.5,44.57001,44.25999,44.57001,41.35006227009916,43.350718669599864,44.21821659058845,43.99542849085005,40.72277035000001,43.789950999999995,44.747640999999994,43.839499999999994,43.839499999999994,45.602134414777915,42.07686558522207,82691632,53.76672998019831,41.43085227400037,NaN,NaN,NaN,NaN,NaN,NaN,0.1414572204196296,-0.31667592644777187,-0.4581331468674015,100,79.93052228717774,4097185770,4805149905.543494,21.95402453548912,21.35611547931788,30.488041721975073,0,50
2010-02-18,44.53999,44.92999,44.45,44.85001,41.384887620645436,43.38040760683551,44.242992802722235,44.07681720600719,40.771770400000015,43.81775099999999,44.76224119999999,43.786000499999986,43.786000499999986,45.34611630857956,42.22588469142041,65752560,55.944675151567765,42.83642884586019,NaN,NaN,NaN,NaN,55.944675151567765,NaN,0.1983394526874388,-0.21020883100810295,-0.40854828369554175,97.15372652571719,92.57995940826514,4162938330,4848989968.413137,24.46685173047569,20.3444107837535,28.218112862296284,100,42.857142857142854
2010-02-19,44.75999,45.05,44.62,44.83,41.41916734581314,43.40911240670015,44.26601269281156,44.14854890067318,40.82082040000002,43.84905099999999,44.780641199999984,43.75299999999999,43.75299999999999,45.19065869390435,42.31534130609563,80416432,55.742581278432894,44.52406839148002,NaN,NaN,NaN,NaN,NaN,NaN,0.22604251729511332,-0.1259951370766501,-0.35203765437176343,92.49146757679186,96.54839803416968,4082521898,4847119818.831742,24.617308411796937,19.45523243670285,25.521017409725808,100,35.714285714285715
2010-02-22,45.00999,45.03,44.56,44.74001,41.45221055630257,43.43546681448827,44.28460082250522,44.20487852918049,40.86937045000001,43.87235109999999,44.80260139999998,43.782000499999995,43.782000499999995,45.27371305682096,42.29028794317903,72054880,54.78410621567955,45.799810413804785,NaN,NaN,NaN,NaN,NaN,NaN,0.22902324774938754,-0.06575859468502898,-0.2947818424344165,89.42013651877137,93.02177687376013,4010467018,4830258976.911741,23.41279639739949,19.12792971301937,22.706758143003366,92.85714285714286,28.571428571428573
2010-02-23,44.69,44.74001,43.95,44.16,41.47915373484682,43.44981400628058,44.27971451574031,44.20060438354425,40.91912040000002,43.89175109999999,44.804201399999975,43.77450049999999,43.77450049999999,45.25699885823852,42.29200214176146,95814320,48.94281810685419,46.39012952282712,NaN,NaN,48.94281810685419,NaN,NaN,NaN,0.18455832135947406,-0.06408394073507395,-0.248642262094548,69.62457337883957,83.84539249146759,3914652698,4785383270.853335,21.507832984073517,23.85407355358605,20.69293650576243,85.71428571428571,21.428571428571427
2010-02-24,44.4099,44.78999,44.32001,44.61,41.51030643400257,43.472787986354234,44.29266688767206,44.23959444225432,40.971020400000015,43.91535109999999,44.810401399999975,43.78749999999999,43.78749999999999,45.29431620649689,42.28068379350309,86591008,53.119293354320014,47.117951195625324,NaN,NaN,NaN,NaN,NaN,NaN,0.17799848751305866,-0.026144152703224677,-0.20414264021628334,84.9829351535837,81.3425483503982,4001243706,4805650113.86793,20.62127725382374,22.29614049305836,18.99128528810283,78.57142857142857,14.285714285714286
2010-02-25,44.11,44.7,43.83,44.60001,41.54104975306722,43.49510921434722,44.30471955874375,44.2739197334682,41.02227040000002,43.95135119999999,44.819801599999984,43.78250049999998,43.78250049999998,45.2777925618333,42.287208438166665,97961312,53.01561346602017,48.38362898232744,NaN,NaN,NaN,NaN,NaN,NaN,0.16577952692114814,0.0030817684351518437,-0.1626977584859963,84.64197952218431,79.74982935153587,3903282394,4881093836.013033,18.795643262749888,25.308590671407533,17.23500348929835,71.42857142857143,7.142857142857143
2010-02-26,44.60001,44.86,44.39999,44.75999,41.57307900925561,43.52015635861757,44.322573301538114,44.32021213980456,41.076420400000025,43.99015109999999,44.82400139999998,43.84299999999999,43.84299999999999,45.39269140160282,42.29330859839716,66222368,54.54565262440983,49.52063570285202,NaN,NaN,NaN,NaN,NaN,NaN,0.16112331666925497,0.03870638735057241,-0.12241692931868256,87.96639004149395,85.86376823908732,3969504762,4918521616.835885,19.562857799603588,24.093973853930077,14.741976749329707,64.28571428571429,0
2010-03-01,44.95,45.49001,44.95,45.41,41.61125732757147,43.55757900498158,44.36521748579152,44.424001459823174,41.13837040000002,44.03215099999999,44.846201399999984,43.97400049999999,43.97400049999999,45.58714361335984,42.360857386640134,77290000,60.21470645491834,51.18831026745431,NaN,NaN,NaN,NaN,NaN,NaN,0.19235671522107564,0.118028964707662,-0.07432775051341364,97.07993766446103,89.89610240937975,4046794762,4972908437.635499,24.62177969025616,22.26757190988182,12.20427916800293,100,0
2010-03-02,45.53999,45.85001,45.45,45.55,41.65044879694887,43.59703288607105,44.41167954517224,44.53123941603049,41.19917040000002,44.06825099999999,44.870001399999985,44.088500999999994,44.088500999999994,45.80447941832422,42.37252258167577,76368432,61.333281564411294,52.64222210642032,NaN,NaN,NaN,NaN,NaN,NaN,0.21146165232357406,0.18999931489105393,-0.021462337432520122,90.32228928293777,91.78953899629757,4123163194,4934723267.053962,27.304003740340004,21.223300653751892,10.880425694288187,100,7.142857142857143
2010-03-03,45.67,45.82001,45.42999,45.60001,41.68974791339714,43.63669579921815,44.458280739479214,44.63302709069425,41.260320450000016,44.103651099999986,44.90560139999999,44.18600199999999,44.18600199999999,46.009468386897346,42.36253561310263,65744944,61.74701575145899,54.16708032242523,NaN,NaN,NaN,NaN,NaN,NaN,0.2157382769377615,0.24821050873968176,0.03247223180192026,91.90943747936906,93.10388814225594,4188908138,4926298231.668288,26.134082223670003,20.53375685064524,9.507900665210396,92.85714285714286,0
2010-03-04,45.64,45.81,45.39999,45.75,41.7301484316718,43.67854340715443,44.50893639675454,44.739405463009085,41.31787040000002,44.13875099999999,44.93140119999998,44.279001999999984,44.279001999999984,46.218622626861276,42.33938137313869,54470832,63.02487743641548,55.3613533323831,NaN,NaN,NaN,NaN,NaN,NaN,0.21638539368334328,0.30295397390609935,0.08656858022275607,96.28216995475863,92.83796557235515,4243378970,4964826769.968134,24.924994745096757,19.922281674909016,9.030950593236406,85.71428571428571,0
2010-03-05,46.10001,46.53999,45.99001,46.44,41.777012626381534,43.733225715923645,44.58466438119554,44.90136684748441,41.37807045000002,44.17835099999999,44.96100099999998,44.47000199999999,44.47000199999999,46.46993427888954,42.470069721110434,68136256,68.27523011062728,56.87481153984963,NaN,NaN,NaN,NaN,NaN,NaN,0.2486926728387379,0.39743442127117845,0.14874174843244056,96.31031848825991,94.83397530746254,4311515226,5008187782.368584,30.83553831746521,18.177297056489042,9.77182251511407,100,0
2010-03-08,46.46001,46.64,46.44,46.53,41.824306033084206,43.78860738491525,44.6609520525212,45.05647476677161,41.43932045000001,44.217950899999984,44.98700099999999,44.64750199999999,44.64750199999999,46.715931665263945,42.57907233473603,58712352,68.8956393197609,58.09658720107679,NaN,NaN,NaN,NaN,NaN,NaN,0.26029290827739415,0.4741078837791832,0.21381497550178907,96.08540925266907,96.22596589856254,4370227578,5002316547.168585,31.282639899130903,17.75333636322822,11.479261348495541,100,50
2010-03-09,46.39999,47.05,46.39999,46.78999,41.873715823799785,43.84804070402584,44.74444373673606,45.221571455650505,41.50502045000002,44.26005079999999,45.011600799999975,44.85350149999999,44.85350149999999,46.91374571808932,42.79325728191067,98002752,70.67945745606133,59.30463916363844,NaN,NaN,NaN,NaN,NaN,NaN,0.2685613708488871,0.549516689062898,0.2809553182140109,91.92515527950329,94.77362767347743,4468230330,5021915288.314845,33.68217148854135,16.41344165902564,13.842905061175285,100,42.857142857142854
2010-03-10,46.8,47.28,46.8,47.17,41.926415168836606,43.91382207622335,44.83956359019739,45.40713607892189,41.57317050000002,44.30015079999998,45.03540079999998,45.056501499999996,45.056501499999996,47.18841233354087,42.924590666459125,102578880,73.1071269562448,60.53052857825822,NaN,NaN,NaN,NaN,NaN,NaN,0.2813553865862796,0.6326495514468604,0.3512941648605808,96.81159420289858,94.94071957835699,4570809210,5077478848.314846,34.447476531333535,15.465823597271836,15.902168211332253,100,35.714285714285715
2010-03-11,47.07001,47.35001,46.98,47.35001,41.98038128655963,43.98186540144665,44.93801246901318,45.592171690453135,41.63597060000001,44.34305089999999,45.05800099999998,45.27300199999999,45.27300199999999,47.41312407880371,43.13287992119627,67510320,74.19699552435384,61.84870102439543,NaN,NaN,NaN,NaN,NaN,NaN,0.28291044932555753,0.7049322265175277,0.4220217771919702,100,96.24558316080062,4638319530,5144989168.314846,33.75121700007404,14.772279023705307,17.85932548329975,100,28.571428571428573
2010-03-12,47.5,47.53,47.10001,47.36,42.03390983097197,44.04875915587345,45.032992372189135,45.760536291362364,41.700020600000016,44.38885089999999,45.084600999999985,45.45750199999999,45.45750199999999,47.648654792523274,43.26634920747671,64068256,74.25934174246102,63.23978927630839,NaN,NaN,NaN,NaN,NaN,NaN,0.2658445457587065,0.7543274593903533,0.4884829136316468,95.40540540540536,97.40566653610131,4702387786,5158397625.156726,34.18206601266584,13.98728846276462,20.13447884366588,100,21.428571428571427
2010-03-15,47.25999,47.38,46.91,47.24001,42.085711822703594,44.11195224189576,45.11954208308368,45.90143854932785,41.76147065000001,44.429150899999996,45.10600119999997,45.631502999999995,45.631502999999995,47.80847399754732,43.45453200245267,60150416,72.00878700343392,64.88735848320695,NaN,NaN,NaN,NaN,NaN,NaN,0.22910107068666097,0.7748592519899731,0.5457581813033121,92.16243243243235,95.8559459459459,4642237370,5182716310.365916,32.1697821774911,15.543821978450497,22.25398269148956,92.85714285714286,14.285714285714286
2010-03-16,47.39,47.61,47.23,47.53999,42.13998324735331,44.1798341776998,45.21446160923726,46.05749106843948,41.82227060000001,44.472350799999994,45.14180099999998,45.792502,45.792502,48.033033579822614,43.55197042017738,74950624,74.12046135965922,66.38744191215974,NaN,NaN,NaN,NaN,NaN,NaN,0.20822956528308578,0.8060451379071694,0.5978155726240836,98.14788359788369,95.23857381190713,4717187994,5230049601.80676,33.552409686292435,14.785925539012787,24.748315920841087,100,7.142857142857143
2010-03-17,47.60001,47.89999,47.53,47.67,42.1950082896682,44.2489463722008,45.31075723240443,46.21106334763572,41.87867060000001,44.51765079999999,45.16680099999998,45.9475015,45.9475015,48.25617748206612,43.63882551793388,75643440,75.00070349872867,67.95780548592464,NaN,NaN,NaN,NaN,NaN,NaN,0.1870787361594597,0.8316639928234082,0.6445852566639485,93.42885714285713,94.57972439105772,4792831434,5211651393.299503,35.73268985871357,14.06674686868624,26.801118152138994,100,0
2010-03-18,47.72,47.88,47.60001,47.83,42.251077858925235,44.31985832522653,45.40955106642778,46.36524779071804,41.935620600000014,44.562850799999985,45.19500099999998,46.096500999999996,46.096500999999996,48.48586158144269,43.7071404185573,77829376,76.07903484900861,69.49590421625312,NaN,NaN,NaN,NaN,76.07903484900861,NaN,0.16834909520830155,0.8550216256743255,0.686672530466024,97.62744958457472,96.40139677510517,4870660810,5261683570.828128,34.37027760443977,13.53041141822218,29.167365467404103,92.85714285714286,0
2010-03-19,47.95,47.95,47.32001,47.49001,42.30320653694588,44.38263360591511,45.49113769127375,46.472368001125844,41.99142065000001,44.60645089999999,45.22200119999998,46.2295015,46.2295015,48.61819485959375,43.840808140406246,86337056,69.24404722921838,70.14085712870312,NaN,NaN,NaN,NaN,NaN,NaN,0.11982695145166156,0.8364562197806009,0.7166292683289394,81.96124721079507,91.00585131274231,4784323754,5221941856.087511,31.463414977399772,16.14502218798462,31.10700986160725,100,0
2010-03-22,47.31,48.11,47.25,47.92,42.35909502911557,44.45268046520392,45.58638719357674,46.610237715304336,42.047320600000006,44.655750799999986,45.257001199999976,46.388501,46.388501,48.78278015084105,43.99422184915895,71902752,72.59713969670915,70.94541842386725,NaN,NaN,NaN,NaN,NaN,NaN,0.1040402699934797,0.846679605820789,0.7426393358273093,92.98895576031093,90.85921751856023,4856226506,5262073624.645651,30.041430985040265,14.359627927805457,32.73472815914744,100,14.285714285714286
2010-03-23,48,48.3,47.77,48.2525,42.41773587459701,44.527924416388,45.69094063696589,46.76664364718011,42.10468310000001,44.71487579999999,45.291051199999984,46.593126,46.593126,48.888064387550614,44.29818761244938,59182592,74.87795111506014,71.88334237841019,NaN,NaN,NaN,NaN,NaN,NaN,0.10314039317488288,0.8715648272959129,0.76842443412103,98.36207461353584,91.10409252821394,4915409098,5310648016.192821,30.43852856621848,13.37778545187906,34.658768862972316,100,7.142857142857143
2010-03-24,48.14,48.17,47.91,48.02,42.473479796242806,44.59707442794467,45.782276298261344,46.88601091887724,42.1614331,44.78117579999999,45.32425119999998,46.763626,46.763626,48.94791017076421,44.579341829235794,63030096,70.46161550796754,72.41453795494962,NaN,NaN,NaN,NaN,NaN,NaN,0.07532639225267435,0.8625824244368729,0.7872560321841986,87.87873540578123,93.07658859320934,4852379002,5300951078.346669,29.055909647085286,12.770122068229147,36.64319507478583,92.85714285714286,0
2010-03-25,48.42,48.60001,47.89999,47.95,42.52797253458865,44.663468993727946,45.867285070878545,46.987343212317505,42.2164331,44.83977579999999,45.36765119999998,46.93112549999999,46.93112549999999,48.932155940332336,44.93009505966765,76350064,69.13942616144925,72.47626624429405,NaN,NaN,NaN,NaN,NaN,NaN,0.04229988192981082,0.8401308845964621,0.7978310026666513,70.45435950582285,85.56505650837995,4776028938,5235510036.090734,31.998315754744006,11.609412318157531,38.13811452833342,100,0
2010-03-26,48.14,48.33,47.74001,48,42.58242056907035,44.72953891464422,45.95092095045194,47.083786715906314,42.27233305000001,44.91017569999999,45.40065099999999,47.093126,47.093126,48.877748885265206,45.30850311473479,78067808,69.57854063197412,72.52504490945213,NaN,NaN,NaN,NaN,NaN,NaN,0.015299285613363578,0.8169551096833558,0.8016558240699923,72.7270661175808,77.02005367639494,4854096746,5226246273.58954,29.559678646568592,12.791169588027044,38.995521912892094,92.85714285714286,7.142857142857143
2010-03-29,48.23,48.39999,48.10001,48.23,42.638615389278606,44.798854975740376,46.040296599453825,47.19294988582,42.32938300000001,44.981175699999994,45.43745099999999,47.23412599999999,47.23412599999999,48.9066297263389,45.56162227366108,57993216,71.58169508357729,72.5894904542747,NaN,NaN,NaN,NaN,NaN,NaN,0.004943340650604533,0.8078349998832479,0.8028916592326434,79.4440030888717,74.2084762374251,4912089962,5218513329.259916,28.92390543082443,12.116948272171857,39.45839561143372,85.71428571428571,0
2010-03-30,48.36,48.55,48.06,48.39,42.69584309684797,44.86996675839898,46.132441830847796,47.30695465859905,42.388083050000006,45.052475799999996,45.48825079999999,47.37612599999999,47.37612599999999,48.93065666184505,45.821595338154935,49455024,72.91766690437117,72.5759575934266,NaN,NaN,NaN,NaN,NaN,NaN,0.0010843131026767594,0.8042470506109893,0.8031627375083126,87.57344631096876,79.91483850580708,4961544986,5235671194.729304,29.0338090370277,11.32913956171767,39.875139810488534,78.57142857142857,0
2010-03-31,48.23,48.45,48.07001,48.16,42.750212817277344,44.93511593149999,46.21195391591259,47.3881970720658,42.449383100000006,45.12077579999999,45.519650799999994,47.504125499999994,47.504125499999994,48.86169839715804,46.14655260284195,59947392,67.97097178853119,72.13124161229639,NaN,NaN,NaN,NaN,NaN,NaN,-0.023391636132819804,0.7739231923422878,0.7973148284751076,73.96405938426396,80.32716959470146,4901597594,5204117527.859332,27.538507777959914,10.745665425437915,40.214481581278974,71.42857142857143,14.285714285714286
2010-04-01,48.34,48.7,47.78999,48.16,42.80404154546364,44.99897502196534,46.28834787999445,47.461702112821435,42.51243310000001,45.17887569999999,45.564450799999996,47.62462549999999,47.62462549999999,48.74514599918782,46.50410500081217,83728560,67.97097178853119,71.68207232987284,NaN,NaN,67.97097178853119,NaN,NaN,NaN,-0.04477542581397986,0.7413455462076328,0.7861209720216127,69.83240223463663,77.12330264328979,4901597594,5188477020.706223,24.309563672246483,13.093685824597543,39.36175576096861,100,7.142857142857143
2010-04-05,48.25999,48.72,48.14,48.61,42.86181227635455,45.07048046707494,46.379393061171136,47.57106381636225,42.57603805000001,45.23897559999998,45.6268506,47.733125499999986,47.733125499999986,48.792371578634416,46.673879421365555,56220256,72.24363800615835,71.69884740149601,NaN,NaN,NaN,NaN,NaN,NaN,-0.034280135230919995,0.7432708029829627,0.7775509382138827,92.61744966442957,78.8046370944434,4957817850,5223372352.016567,22.755706425602433,12.11839998467424,39.05151962871448,100,0
2010-04-06,48.49001,48.89999,48.39,48.75,42.92040120892813,45.143342240004145,46.472358039164426,47.68334345289917,42.64068800000001,45.29137569999999,45.718650600000004,47.84412549999998,47.84412549999998,48.83912440005148,46.849126599948484,54097056,73.43112425169977,71.64960903664176,NaN,NaN,NaN,NaN,NaN,NaN,-0.024059179634802308,0.7474769636703797,0.771536143305182,90.9096418766173,84.4531645918945,5011914906,5245649107.895231,23.581719873689163,11.319975511670778,38.78787966189707,100,0
2010-04-07,48.69,48.87,48.37,48.63,42.9772131371975,45.212384967924855,46.556971449393274,47.77350121928973,42.70303800000001,45.34147569999999,45.8050506,47.93612599999999,47.93612599999999,48.86210972479164,47.01014227520834,77211440,70.64138789632241,71.3382293507556,NaN,NaN,NaN,NaN,NaN,NaN,-0.03108372813095872,0.7326814831414836,0.7637652112724423,83.63687052648807,89.05465402251166,4934703466,5248737565.495233,22.047984349910944,10.843890368790197,38.1133802193519,92.85714285714286,21.428571428571427
2010-04-08,48.50999,48.82001,48.24001,48.74001,43.034554399513944,45.28223892895605,46.642580804319024,47.86554967459547,42.771338050000004,45.389875899999986,45.8928506,48.014626499999984,48.014626499999984,48.933676352888796,47.09557664711117,68323872,71.70274821328547,71.02563744820395,NaN,NaN,NaN,NaN,NaN,NaN,-0.03379963909282524,0.7215156624064107,0.755315301499236,90.30418366171891,88.28356535494142,5003027338,5298213472.805576,20.391219497150402,11.713164920392959,36.936547662234545,85.71428571428571,14.285714285714286
2010-04-09,48.77,49.05,48.63499,49.03,43.09421057464316,45.35645201947177,46.73620508650259,47.976449705586376,42.84148805000001,45.443675999999996,45.97945059999999,48.09862599999998,48.09862599999998,49.06520896000924,47.13204303999073,54227216,74.336521492283,71.38938560985143,NaN,NaN,NaN,NaN,NaN,NaN,-0.02210966763156974,0.7276782169597737,0.7497878845913435,98.88888888888911,90.94331435903204,5057254554,5347214095.133136,22.30838914294292,11.072050856445166,37.04266553749944,100,7.142857142857143
2010-04-12,49.05,49.2,48.94,49.07001,43.153671265442725,45.42998782106638,46.827726847816216,48.08059830505434,42.908888100000006,45.494276199999995,46.089850799999994,48.184126499999984,48.184126499999984,49.17641928849347,47.1918337115065,44280592,74.68659155121715,71.53863217088771,NaN,NaN,NaN,NaN,NaN,NaN,-0.017905922972870636,0.7274054808752553,0.7453114038481259,91.09651435968746,93.42986230343183,5101535146,5347217501.332521,23.568525877854384,10.677739016857673,37.20858731799624,100,0
2010-04-13,49.02,49.35001,48.86,49.32001,43.21502786976668,45.50701796322348,46.9254634420195,48.19863751409678,42.9740382,45.542876199999995,46.220451199999985,48.28812649999998,48.28812649999998,49.2986491618417,47.277603838158264,59375920,76.81476530627879,71.67697604168904,NaN,NaN,NaN,NaN,NaN,NaN,-0.005172885037545649,0.7388452975511939,0.7440181825887395,98.13664596273328,96.04068307043661,5160911066,5399323048.891144,24.04343277394851,9.957961206358714,37.386386854277774,100,21.428571428571427
2010-04-14,49.57001,49.92,49.5,49.91,43.281644507878454,45.59420572632797,47.042504091352065,48.36162441751613,43.04173820000001,45.59597609999999,46.3534514,48.406626999999986,48.406626999999986,49.580994771001485,47.23225922899849,69004752,80.89660804080063,72.42233265117713,NaN,NaN,NaN,NaN,NaN,NaN,0.033947819367523224,0.7864529567981435,0.7525051374306203,99.54128229945985,96.25814754062685,5229915818,5465041860.319714,29.835742793988462,9.145074274657066,38.396539613491214,100,14.285714285714286
2010-04-15,49.88,50.19,49.87,50.13,43.34978734859608,45.68402343471752,47.163582362279435,48.530041139657456,43.11013820000001,45.6537461,46.48305159999999,48.529626999999984,48.529626999999984,49.87279589986626,47.186458100133706,72254128,82.15800260984975,73.35223096892003,NaN,NaN,NaN,NaN,82.15800260984975,NaN,0.06386775854979065,0.8323398356178586,0.768472077068068,97.5510104122876,98.40964622482689,5302169946,5510200690.3197155,32.27838505424097,8.7354950826991,39.15703941715715,100,7.142857142857143
2010-04-16,49.95,50.12,49.2,49.53,43.41128200184388,45.76018138650529,47.25638305395475,48.62527531683293,43.17588820000001,45.712446099999994,46.595851599999996,48.614626999999984,48.614626999999984,49.9848300264039,47.24442397359607,127387936,68.81285710640216,73.29753928852202,NaN,NaN,NaN,NaN,NaN,NaN,0.033976331815216865,0.8109424918370891,0.7769661600218722,72.50011458285599,89.8641357648678,5174782010,5474199751.8849325,28.3100451561269,16.51859017440008,38.207691538196215,92.85714285714286,0
2010-04-19,49.36,49.66,48.89999,49.5,43.471866260532,45.83423720063389,47.34436803223103,48.70858242951551,43.24138825000001,45.773046099999995,46.733451599999995,48.71512649999998,48.71512649999998,50.03455066457085,47.395702335429114,98251680,68.2162124829539,73.05714767419178,NaN,NaN,68.2162124829539,NaN,NaN,NaN,0.0044618870885008155,0.7825435188824983,0.7780816317939975,71.25011979116756,80.43374826210372,5076530330,5531082847.787355,25.546023656155985,18.759864405312857,36.3766083480182,85.71428571428571,21.428571428571427
2010-04-20,49.755,49.88,49.42999,49.75,43.53433525296452,45.911777058047086,47.438706540770994,48.80776505527594,43.31213820000001,45.829146099999996,46.8688516,48.806626499999986,48.806626499999986,50.1464542979099,47.466798702090074,69543632,70.51083893696006,72.88523139080527,NaN,NaN,NaN,NaN,NaN,NaN,-0.0054103003304381,0.7713187563809498,0.7767290567113879,81.66674305523732,75.13899247642028,5146073962,5560446607.51785,26.91404455557552,17.660381510036306,34.726348353965,78.57142857142857,14.285714285714286
2010-04-21,50.09,50.19,49.72501,50.03,43.598968733034525,45.99332602719467,47.54032589211331,48.92416838334489,43.3852382,45.889546,47.0160516,48.89550149999999,48.89550149999999,50.31023142972235,47.480771570277625,74748624,72.87300657634546,73.235376732792,NaN,NaN,NaN,NaN,NaN,NaN,-0.0005267239417257041,0.7760706517842308,0.7765973757259566,93.3333611109955,82.08340798580012,5220822586,5583754211.969044,29.34797418676841,16.579130177209205,33.57911602641185,71.42857142857143,7.142857142857143
2010-04-22,49.5697,50.36,49.25999,50.31,43.66574516355159,46.07880471972547,47.648940563010825,49.05615234683585,43.46413820000001,45.9508461,47.160051599999996,49.01000149999999,49.01000149999999,50.49185182984213,47.52815117015784,110477120,75.02727089206658,73.73939809733024,NaN,NaN,NaN,NaN,NaN,NaN,0.01335067470135931,0.7932857191026557,0.7799350444012964,97.74774774774788,90.91595063799356,5331299706,5684188048.726165,25.387996744080027,20.04620910981586,32.277031809495675,100,0
2010-04-23,50.28999,50.57001,50.09,50.52,43.73394670421277,46.166749180721006,47.76153112916727,49.19556640904196,43.543188150000006,46.0209462,47.310051599999994,49.13850149999999,49.13850149999999,50.67509834304276,47.60190465695722,77205120,76.53252439772317,74.04574712529916,NaN,NaN,NaN,NaN,76.53252439772317,NaN,0.027640085370560064,0.8144851511144964,0.7868450657439363,97.85364806866951,96.31158564247096,5408504826,5745305886.997868,26.482961757368358,18.85088763098664,31.300835190736425,100,0
2010-04-26,50.53,50.64999,50.3,50.41,43.80037509521563,46.250773949419596,47.865392653513645,49.311226751037964,43.62138815,46.089446200000005,47.44485159999999,49.25900149999999,49.25900149999999,50.797557125270416,47.72044587472956,67360944,74.01585327926935,74.08751348441128,NaN,NaN,NaN,NaN,NaN,NaN,0.02095401290909238,0.8130375818803017,0.7920835689712094,90.04182607324519,95.2144072965542,5341143882,5720287317.579998,26.320563291747522,18.007743544764562,30.130879197263653,100,14.285714285714286
2010-04-27,50.22,50.42999,49.21001,49.34,43.855495741034375,46.311946742500396,47.92322039259154,49.31396706046292,43.69348815,46.1427463,47.5564518,49.31450149999999,49.31450149999999,50.77887021929485,47.85013278070513,112608000,55.05191175528855,72.97397947433743,NaN,NaN,NaN,NaN,NaN,NaN,-0.05984130674833765,0.7172819355357873,0.777123242284125,45.64311737026877,77.84619717072782,5228535882,5631676291.16973,22.536650475267226,28.263360235348973,28.502996255942076,92.85714285714286,7.142857142857143
2010-04-28,49.60001,49.63,48.98,49.37,43.910366430178314,46.37250225254989,47.979956847784024,49.31930353089503,43.76238815000001,46.195746199999995,47.65745159999999,49.36350149999999,49.36350149999999,50.765088870822964,47.96191412917702,130082064,55.39696840060704,71.80928091628897,NaN,NaN,NaN,NaN,NaN,NaN,-0.1125156220069572,0.6364787147754285,0.7489943367823857,36.476923076922844,57.387288840145594,5358617946,5657692703.969729,20.819305626951277,28.80613356923713,27.72181591783068,85.71428571428571,0
2010-04-29,49.61,50.33,49.61,50.23,43.97324835624619,46.4488883465588,48.06819383414543,49.406036527952644,43.834938150000006,46.259146199999996,47.77065139999999,49.467001499999995,49.467001499999995,50.801946785789085,48.132056214210905,84180128,63.94246148242097,71.06684805844168,NaN,NaN,NaN,NaN,NaN,NaN,-0.09157785502596671,0.6345220179999274,0.7260998730258941,76.53674042871721,52.88559362530293,5442798074,5718489463.08084,26.451043912411954,25.692183034308947,25.421379832191427,78.57142857142857,0
2010-04-30,50.21001,50.28999,49.2,49.2375,44.025628969616875,46.50410837930021,48.11404897790444,49.38998543005239,43.89652565,46.3103212,47.85840119999999,49.52087649999999,49.52087649999999,50.720606660099854,48.32114633990013,110896944,51.64494723272623,69.42101632140661,NaN,NaN,NaN,NaN,NaN,NaN,-0.1436125511096913,0.54658418413878,0.6901967352484712,21.089503293314323,44.701055599651454,5331901130,5615223112.75601,23.36295073106579,27.084144878336424,23.25959340778915,71.42857142857143,7.142857142857143
2010-05-03,49.42999,50.17,49.42999,49.92999,44.08437883061571,46.571947619314074,48.18526235131995,49.44141443671407,43.9593756,46.370521100000005,47.96040099999999,49.58687599999999,49.58687599999999,50.72242181262785,48.45133018737213,74169632,57.75040471597971,68.0592762792424,NaN,NaN,NaN,NaN,NaN,NaN,-0.1307977811689348,0.5266995087873028,0.6574972899562376,58.85714285714251,52.16112885972468,5406070762,5641281358.757658,21.094035536465075,24.453842372689643,20.82746982291181,64.28571428571429,0
2010-05-04,49.31,49.32001,48.08,48.42999,44.127618742748886,46.6087405377435,48.19485951401328,49.34508829988416,44.01372555000001,46.418401,48.034200599999984,49.570875499999985,49.570875499999985,50.760852383851926,48.380898616148045,141136432,44.61088187032783,65.46743869563718,NaN,NaN,NaN,NaN,NaN,NaN,-0.2176298688253081,0.3854599539246024,0.6030898227499105,13.618340927396513,31.18832902595111,5264934330,5579815800.1146145,17.46933475657011,32.79111859846762,19.213588840384634,57.142857142857146,100
2010-05-05,47.98,48.5,47.64,48.17999,44.167940844811085,46.639854388481254,48.19427639581668,49.23412655703805,44.065025500000004,46.4594009,48.11460039999999,49.548374999999986,49.548374999999986,50.82269169832162,48.27405830167835,128560192,42.86056806585081,62.660479085351554,NaN,NaN,NaN,NaN,NaN,NaN,-0.282098692559824,0.2504664570501305,0.5325651496099545,17.939926710719824,30.138470165086275,5136374138,5612700301.31945,16.08556873440615,34.246359795426116,17.690717339611073,50,100
2010-05-06,47.85001,48.3201,41.55,46.57001,44.191842030434856,46.638471331283604,48.130579674412104,48.98040117065348,44.106975600000005,46.482101,48.15380059999998,49.43987499999999,49.43987499999999,51.234376286604075,47.6453737133959,274356736,33.69257179874512,60.15188727766177,NaN,NaN,NaN,NaN,NaN,NaN,-0.41531887990240357,0.013416549731950056,0.4287354296343536,55.16500567583045,28.90775777131559,4862017402,5745213052.708813,9.62324105325741,56.62687649744797,20.87967151350256,42.857142857142854,100
2010-05-07,46.22,46.8,44.28329,45.41,44.2039630052564,46.614145166307694,48.02389027541555,48.640362963924574,44.1415256,46.494901,48.17000039999998,49.25887499999999,49.25887499999999,51.76956611354249,46.74818388645749,288200448,28.89648098330443,57.343335027686805,NaN,NaN,28.89648098330443,NaN,NaN,NaN,-0.5549848377371427,-0.2649956175370747,0.28998922020006795,42.41762903036154,38.50752047230393,4573816954,5715062460.883008,8.289943981419217,48.78124027119612,24.85339649036115,35.714285714285715,92.85714285714286
2010-05-10,47.42,47.8,47.31,47.77,44.23944596042798,46.63703338083626,48.013933794026705,48.55747125307462,44.18362555000001,46.527101,48.23020059999998,49.193874499999986,49.193874499999986,51.78672724612774,46.60102175387223,136041568,45.800307036156624,55.57829703477228,NaN,NaN,NaN,NaN,NaN,NaN,-0.46546562182237894,-0.2918428070779058,0.1736228147444732,68.35172346343239,55.31145272320813,4709858522,5834445877.699338,12.45394727432577,42.72702785900255,27.28921207011708,28.571428571428573,85.71428571428571
2010-05-11,47.31,48.39,47.2,47.72,44.27407833893118,46.65847826438405,48.002406978574676,48.477712086115126,44.226975550000006,46.561301,48.27640059999998,49.11387399999999,49.11387399999999,51.78381111884335,46.443936881156624,113196944,45.55321675993011,53.6268834764569,NaN,NaN,NaN,NaN,NaN,NaN,-0.3897300037722435,-0.31353968997083115,0.07619031380141232,67.80227231018934,59.52387493466109,4596661578,5820177355.346396,14.770460284268413,40.0610249658152,28.597908514816844,21.428571428571427,78.57142857142857
2010-05-12,47.98,48.66,47.89999,48.62,44.31732134053386,46.697320278950706,48.02662631274822,48.491263316008926,44.27332550000001,46.60390099999999,48.33780059999997,49.049373999999986,49.049373999999986,51.701532027451826,46.397215972548146,85462320,50.70811267861799,51.889800746924855,NaN,NaN,NaN,NaN,50.70811267861799,NaN,-0.2650888099367083,-0.25517069861947306,0.009918111317235245,77.69239306856376,71.28212961406183,4682123898,5896643760.029492,15.47374044603693,38.04180062312258,30.770326093319458,14.285714285714286,71.42857142857143
2010-05-13,48.42999,48.78999,47.7301,47.85001,44.35247247147382,46.72014581798138,48.01970018283652,48.43019157162712,44.31717555000001,46.644201,48.382800599999975,48.93537449999998,48.93537449999998,51.58793985246601,46.28280914753395,102844256,46.63965103641652,49.75459550683153,NaN,NaN,NaN,NaN,NaN,NaN,-0.22229911537705357,-0.26795578290408173,-0.045656667527028155,69.23095519885182,71.57520685920163,4579279642,5817069946.692334,14.581305534587822,36.772232200593585,32.65438352180904,7.142857142857143,64.28571428571429
2010-05-14,47.49001,47.52,46.38,46.92999,44.378119412056165,46.72430114831838,47.97696645017627,48.28731523147216,44.355125500000014,46.6689008,48.406400399999974,48.805373999999986,48.805373999999986,51.58063974054065,46.030108259459325,147386000,42.27514815808912,47.487402283890084,NaN,NaN,NaN,NaN,NaN,NaN,-0.24212336078403945,-0.3483108685070775,-0.10618750772303803,60.58554119993378,69.16962982244978,4431893642,5811895922.376543,13.424835475664201,41.13998877039071,34.94297136177734,0,57.142857142857146
2010-05-17,47.03999,47.27,46.07001,47.08,44.405003796015805,46.73134468993584,47.9417912952674,48.17233282847481,44.39267545000001,46.6901007,48.41920039999997,48.68437399999998,48.68437399999998,51.53786623980419,45.830881760195766,120969504,43.20834158041097,46.641432985684546,NaN,NaN,NaN,NaN,NaN,NaN,-0.23131492809571133,-0.3953311678426772,-0.16401623974696586,62.98405466970388,64.26685035616315,4552863146,5894558097.548801,12.549816671784598,40.14227433501076,37.87814387102044,0,50
2010-05-18,47.47,47.58,46.22,46.42999,44.42515291247336,46.72537727033315,47.882504969962795,48.00639541623911,44.427575400000016,46.7021006,48.41720019999998,48.51837349999998,48.51837349999998,51.488479725059,45.54826727494096,153072064,40.17741547364554,45.554322062330144,NaN,NaN,NaN,NaN,NaN,NaN,-0.2524013160285205,-0.4795178847826165,-0.22711656875409597,55.58075170842823,59.71678252602195,4399791082,5788756037.54786,13.304722712330449,37.1841764179454,40.10687404497529,7.142857142857143,42.857142857142854
2010-05-19,46.25999,46.63,45.55,46.06,44.44142004767263,46.712201482801795,47.811034186827,47.82102442421634,44.45767545,46.707100600000004,48.402600399999976,48.319873499999986,48.319873499999986,51.38836484040382,45.251382159596155,159000256,38.521034167172786,43.73850582552671,NaN,NaN,NaN,NaN,NaN,NaN,-0.2739278804452759,-0.5695264193106908,-0.29559853886541493,51.60188970467932,56.72223202760381,4240790826,5779922689.992306,12.515963594246719,38.65755702478849,43.65179403520453,0,35.714285714285715
2010-05-20,45.17,45.28,44.25,44.35001,44.44051049495947,46.66542541383542,47.675307748127906,47.49045162191002,44.47922555000001,46.6908007,48.34620059999998,48.02187399999998,48.02187399999998,51.40126253088254,44.642485469117425,189289744,31.962493134706094,42.33261624709669,NaN,NaN,31.962493134706094,NaN,NaN,NaN,-0.3794932133430603,-0.7699650555442403,-0.39047184220118003,32.48271461716936,46.55511867675897,4051501082,5627391911.618402,11.306214543449078,41.86323193373083,47.22997832970026,0,28.571428571428573
2010-05-21,43.64,45.64,43.49001,44.84,44.44448551491012,46.62927837593769,47.56411920898564,47.238027657918586,44.50477555000001,46.67700070000001,48.296000399999976,47.737873999999984,47.737873999999984,51.183796310595234,44.29195168940473,190631120,35.358726582424126,40.73321066612844,NaN,NaN,NaN,NaN,NaN,NaN,-0.39093598319194,-0.8791418211911051,-0.48820583799916506,42.34228784776344,42.1422973898707,4242132202,5676157352.24315,10.062095386853203,41.146364466609356,51.03890721125894,0,21.428571428571427
2010-05-24,44.81,45.325,44.64,44.66,44.44662993764733,46.59028276453298,47.45023218118228,46.99250121430729,44.53117555000001,46.66330070000001,48.24200039999998,47.45037399999998,47.45037399999998,50.91597146229372,43.984776537706246,113386000,34.67399092143532,40.02343274120755,NaN,NaN,NaN,NaN,NaN,NaN,-0.3846508794723511,-0.9690194373396039,-0.5843685578672528,42.95586043627128,39.26028763373469,4128746202,5569392432.535119,9.696014685710002,39.64937110942944,53.19724026753554,0,14.285714285714286
2010-05-25,43.67,44.75999,43.23,44.7,44.449151032795115,46.55285142266104,47.342379938782976,46.77416776532564,44.55527555000001,46.6486007,48.191200199999976,47.21837399999998,47.21837399999998,50.7671546236308,43.669593376369164,155642944,34.975344643083886,39.4602024967242,NaN,NaN,NaN,NaN,NaN,NaN,-0.35266718036757927,-1.025202533326727,-0.6725353529591477,43.50834738722019,42.93549855708497,4284389146,5712830041.584486,8.915771411131725,43.87472436131652,55.35009809081769,42.857142857142854,7.142857142857143
2010-05-26,44.92999,45.57001,44.12,44.2,44.446671918040934,46.50626030538063,47.21914935294835,46.529008930532726,44.57827550000002,46.63310070000001,48.12440039999998,46.959873999999985,46.959873999999985,50.59618701549476,43.32356098450521,140203120,32.93039743447426,39.40576147070485,NaN,NaN,NaN,NaN,NaN,NaN,-0.33991047651776707,-1.0974234486063565,-0.7575129720885895,17.446074543299627,34.63676078893037,4144186026,5588097503.994264,12.47892718216912,40.54476704162131,54.063097645262765,35.714285714285715,0
2010-05-27,45.22,45.89,45.09,45.87,44.46083438651814,46.4936610914127,47.16624153518567,46.466246175243896,44.61132555000001,46.6276007,48.088400399999976,46.74187399999998,46.74187399999998,50.07826375580739,43.40548424419257,110736064,44.58458134085932,40.52634006767306,NaN,NaN,NaN,NaN,NaN,NaN,-0.2006145530831034,-1.0082811634424687,-0.8076666103593653,47.48209978794922,36.14550723948968,4254922090,5693296764.794263,13.040400144770583,37.0182903762039,52.41672604984673,28.571428571428573,85.71428571428571
2010-05-28,45.94,45.99001,45.2,45.60001,44.4721694672493,46.475965030196605,47.10482069066858,46.383747491887334,44.639975600000014,46.6194008,48.043800599999976,46.55999949999999,46.55999949999999,49.72454119196373,43.39545780803625,128535248,43.2753610567204,40.34598678342762,NaN,NaN,NaN,NaN,NaN,NaN,-0.11265680924974841,-0.9484876219215508,-0.8358308126718024,42.626155802438454,35.85144337789577,4126386842,5694925399.662783,13.02441464339091,35.46539713473201,51.80375057475428,21.428571428571427,78.57142857142857
2010-06-01,45.45,46.25,45.13,45.17999,44.47921245762493,46.45030215831152,47.029337134171776,46.2691039212314,44.665425550000016,46.60980070000001,47.99760019999997,46.322499499999985,46.322499499999985,49.132876195423414,43.512122804576556,104242624,41.24618916955449,40.038341955543636,NaN,NaN,NaN,NaN,NaN,NaN,-0.07080552852586308,-0.9243377233291312,-0.8535321948032681,35.07182566875116,41.72669375304628,4022144218,5599988291.33021,13.637703943981528,33.33068370737663,51.50403579197079,14.285714285714286,71.42857142857143
2010-06-02,45.45,46.28,45.13,46.25,44.49683223416598,46.446335778939016,46.99877489361602,46.26728450016174,44.698525550000014,46.610600700000006,47.964200199999965,46.21349999999999,46.21349999999999,48.85233337862723,43.57466662137275,97249312,47.942887850325974,39.84082589637992,NaN,NaN,NaN,NaN,NaN,NaN,0.03520481480034332,-0.809526176302839,-0.8447309911031823,54.3166444543965,44.00487530852871,4119393530,5692163726.182384,12.949445887086858,31.250704166473568,51.44934873851049,7.142857142857143,64.28571428571429
2010-06-03,46.36,46.77,46.08,46.69,44.518654799000146,46.451160813019435,46.98666607425853,46.30754311919396,44.73957555000002,46.61200070000001,47.932950199999965,46.13900049999999,46.13900049999999,48.63163660744527,43.6463643925547,98928368,50.444204604729755,40.112579722688004,NaN,NaN,NaN,NaN,50.444204604729755,NaN,0.13558557295125295,-0.6752490249141161,-0.810834597865369,79.54022988505747,56.30956666940171,4218321898,5768152182.762093,15.200041330020067,30.039429980349507,50.7057624067342,0,57.142857142857146
2010-06-04,45.71001,46.28999,44.9375,45.0925,44.52436470149766,46.4242566385042,46.91238505173859,46.19182472688977,44.76988805000002,46.59932570000001,47.874400199999975,46.06512499999998,46.06512499999998,48.58966124010862,43.54058875989134,112849872,42.46603588886289,40.126214560600424,NaN,NaN,NaN,NaN,NaN,NaN,0.09683817398847872,-0.6897868803797707,-0.7866250543682494,42.81609195402307,58.890988764492356,4105472026,5681168276.735963,13.743042621210938,33.40903247211762,50.05679838421097,14.285714285714286,50
2010-06-07,45.34,45.46001,44.22,44.27,44.52183370944296,46.38159809120708,46.80876210853315,46.008793800519314,44.794738050000014,46.584225700000005,47.80080019999997,46.00812499999999,46.00812499999999,48.63851360771908,43.37773639228091,88436560,39.042250716133026,39.82863664172343,NaN,NaN,NaN,NaN,NaN,NaN,0.0221571198596493,-0.7589286545436877,-0.781085774403337,23.90804597701163,48.75478927203073,4017035466,5599863639.865616,12.807566187671851,35.073553488724535,49.638025666192156,7.142857142857143,42.857142857142854
2010-06-08,44.37,44.48,43.59,44.19,44.5185318814883,46.33820010920298,46.70606555525734,45.835575343327,44.816888100000014,46.562625600000004,47.72460019999997,45.82912499999999,45.82912499999999,48.44275374709086,43.21549625290912,133990000,38.71529710042721,39.72419961506497,NaN,NaN,NaN,NaN,NaN,NaN,-0.0237974340881294,-0.8108325670134988,-0.7870351329253694,27.118644067796588,31.280927332943765,3883045466,5646534314.022919,12.167393678535497,36.85862779801889,49.85710313233483,0,35.714285714285715
2010-06-09,44.48,44.91,43.69,43.82001,44.51158141500583,46.288334958525695,46.59288690603156,45.64361673920062,44.83453820000002,46.536925700000005,47.63640039999998,45.63412549999999,45.63412549999999,48.23627518269291,43.03197581730707,102077312,37.16515356773172,39.62735100081919,NaN,NaN,37.16515356773172,NaN,NaN,NaN,-0.06779000575743788,-0.8717726401221668,-0.8039826343647289,16.66694915254253,22.56454639911692,3780968154,5566212856.667378,13.75328768187283,34.32580042046981,49.26458030611605,71.42857142857143,28.571428571428573
2010-06-10,44.39,45.12,44.24001,45.07001,44.5171379183391,46.26420971182222,46.533166243049926,45.588987525943416,44.85863825000001,46.5291257,47.57000059999998,45.456625999999986,45.456625999999986,47.67602110557614,43.23723089442383,76892320,45.15488173756834,40.569664472452196,NaN,NaN,NaN,NaN,NaN,NaN,-0.004708197299732042,-0.809867880989394,-0.805159683689662,51.9776836158193,31.921092278719474,3857860474,5634369061.309705,13.928757664478217,31.816869307171242,47.9526107529829,64.28571428571429,21.428571428571427
2010-06-11,44.63,45.53999,44.61,45.5,44.52691764054468,46.24907684624158,46.49264991979307,45.58051252347261,44.88428825000001,46.518225699999995,47.51680059999997,45.33912549999998,45.33912549999998,47.26920529916445,43.40904570083551,74347744,47.62212703428243,41.445621647584936,NaN,NaN,NaN,NaN,NaN,NaN,0.06985851403593057,-0.7178365411447487,-0.7876950551806793,64.12429378531071,44.25630885122418,3932208218,5702322830.573288,15.593696693881466,30.120748527144315,45.88663802077222,57.142857142857146,14.285714285714286
2010-06-14,45.91,46.24001,45.41,45.49001,44.536500649096475,46.23404581958333,46.453330707252164,45.57189323552284,44.91023830000001,46.513925799999996,47.463400799999974,45.26712649999998,45.26712649999998,47.05677894171357,43.4774740582864,68084944,47.56858604260535,42.36666415623994,NaN,NaN,NaN,NaN,NaN,NaN,0.11947711236118319,-0.6383486647292003,-0.7578257770903835,63.84209039548015,59.98135593220339,3864123274,5647364177.508193,18.94435058165289,28.652654333962634,43.00774132597229,50,7.142857142857143
2010-06-15,45.71001,46.77,45.4532,46.71001,44.55812760781193,46.243470852858906,46.46339656186973,45.68028530833019,44.941788400000014,46.52612579999999,47.42540099999997,45.248626999999985,45.248626999999985,46.96925695139673,43.52799704860324,76332560,54.32254674411085,43.74860716345615,NaN,NaN,NaN,NaN,NaN,NaN,0.22908040367399984,-0.4714752724978837,-0.7005556761718835,98.11352201257841,75.35996873112309,3940455834,5716741709.75242,20.5820407564513,26.45005306674421,39.16878093557632,42.857142857142854,0
2010-06-16,46.58,47.14,46.5,46.89999,44.58142972116704,46.25647123201021,46.48051787316896,45.796447659917796,44.97408835000001,46.553525699999994,47.38840079999997,45.272126999999976,45.272126999999976,47.067853781458254,43.4764002185417,78399632,55.28841906733025,45.34560870866015,NaN,NaN,NaN,NaN,NaN,NaN,0.30427976214969243,-0.320205973484768,-0.6244857356344604,93.23915492957751,85.06492244587868,4018855466,5736339167.763921,22.022106556071567,25.426970956196236,35.900572141254536,100,57.142857142857146
2010-06-17,47.16,47.17999,46.64,47.05,44.605992609513635,46.272184672960506,46.502850505593706,45.915833597068485,45.00918835000002,46.58092569999999,47.356800799999974,45.321626999999985,45.321626999999985,47.251096196863315,43.392157803136655,77111808,56.078179164227066,46.16657998175784,NaN,NaN,NaN,NaN,56.078179164227066,NaN,0.35072902025547315,-0.18607446031511898,-0.5368034805705921,96.37909854902104,95.91059183039232,4095967274,5776325236.687568,21.525841558287446,24.563659626360305,32.94997018724367,100,50
2010-06-18,47.06,47.34,46.86,47,44.6298135785732,46.28659685765436,46.522346564197875,46.01908754020482,45.04778835000001,46.607425599999985,47.322000599999974,45.45412649999999,45.45412649999999,47.46091651844503,43.44733648155494,75921376,55.72486692883195,47.055830401194385,NaN,NaN,NaN,NaN,NaN,NaN,0.36315977224520707,-0.08285376526408328,-0.44601353750929035,90.93333333333324,93.51719560397726,4020045898,5744691330.020901,21.89759611094389,23.79041823433744,29.940194505579324,100,42.857142857142854
2010-06-21,47.60001,47.67999,46.33,46.60001,44.649417523065004,46.292803058492886,46.52539218913129,46.07441348875675,45.084538400000014,46.62642569999999,47.27340079999997,45.54212699999998,45.54212699999998,47.58746544476784,43.49678855523212,95488064,52.85592182626947,47.88509701953118,NaN,NaN,NaN,NaN,NaN,NaN,0.33045348434907507,-0.03294668207294649,-0.36340016642202155,73.59455646590821,86.9689961160875,3924557834,5687400189.199058,19.991513596689504,25.136933237841834,27.759734729636712,100,35.714285714285715
2010-06-22,46.78999,47.14,46.14999,46.24001,44.66524431388028,46.291757651394015,46.51420073073398,46.09018458506563,45.1181885,46.65332579999999,47.21680079999998,45.621127499999986,45.621127499999986,47.646028377858954,43.59622662214102,94493376,50.343708844983325,48.05658423343527,NaN,NaN,NaN,NaN,NaN,NaN,0.27296958999973253,-0.022188178922355917,-0.29515776892208845,64.79257895496075,76.44015625140072,3830064458,5610091071.353055,18.705603257581508,24.6896138494477,25.787173398500848,92.85714285714286,28.571428571428573
2010-06-23,46.28999,46.47,45.69,46.05,44.679022977423756,46.286970371168394,46.49599678050912,46.08635748172605,45.14663850000001,46.685925899999994,47.15140059999998,45.68862749999998,45.68862749999998,47.67585917123488,43.70139582876508,92397504,49.01939953696514,47.95481244288066,NaN,NaN,NaN,NaN,NaN,NaN,0.21319518443762614,-0.028663788375055788,-0.24185897281268193,60.14684632480759,66.17799391522551,3737666954,5602983571.045362,17.737551906163414,26.463849745649988,24.854335391252086,85.71428571428571,21.428571428571427
2010-06-24,45.84,45.99001,45.2,45.35001,44.68569946521058,46.268416700452185,46.451056122449934,46.01622915013309,45.169688500000014,46.70682609999999,47.06020079999998,45.74612799999998,45.74612799999998,47.6211198614934,43.87113613850656,114714320,44.387057281196874,48.092028256618796,NaN,NaN,NaN,NaN,NaN,NaN,0.12208695678999909,-0.08925027682518305,-0.21133723361518214,43.032134552896146,55.99051994422149,3622952634,5531834003.752795,16.721951992141694,28.249308338017006,23.70613090131639,78.57142857142857,14.285714285714286
2010-06-25,45.50999,45.66,44.95,45.27,44.691513400880126,46.24864607272046,46.404740196079345,45.94515970726327,45.19058850000001,46.72302619999999,46.963000799999975,45.71612799999998,45.71612799999998,47.60140389510507,43.830852104894895,89040256,43.876665833490286,48.43734362214432,NaN,NaN,NaN,NaN,NaN,NaN,0.05540275468217676,-0.1420837902624612,-0.19748654494463797,41.0758950510882,48.084958642930644,3533912378,5523055386.964064,15.90286782375148,28.590322988684736,22.421334694515956,71.42857142857143,7.142857142857143
2010-06-28,45.28999,45.55,44.81,45.11,44.69567744664251,46.2260986257359,46.3539660707429,45.865620687523915,45.20873850000001,46.735226199999985,46.87460079999997,45.69162749999998,45.69162749999998,47.59495239479745,43.78830260520251,71378688,42.81639329871324,48.730279064879035,NaN,NaN,NaN,NaN,NaN,NaN,0.002291705662093746,-0.1946219128670208,-0.19691361852911454,35.58906162672092,39.89903041023509,3462533690,5509551310.855955,15.074103392827748,28.086305991313885,20.97740189176572,64.28571428571429,0
2010-06-29,44.42,44.46001,43.07001,43.37,44.682486626277914,46.169542217305484,46.23694779345887,45.62794252680735,45.21798850000001,46.7427262,46.752000799999976,45.60112799999998,45.60112799999998,47.74950442898637,43.45275157101359,136384128,33.3718980840853,48.45933224461857,NaN,NaN,NaN,NaN,NaN,NaN,-0.1403649170994711,-0.3723697649034534,-0.2320048478039823,6.507403502835032,27.724120060214727,3326149562,5432036067.113106,13.054375926886138,35.75137500791363,21.242820746519442,57.142857142857146,100
2010-06-30,43.23,43.67,42.64,42.71001,44.66285999318062,46.101036628843985,46.09863650744087,45.35004419092094,45.22313860000001,46.74002629999999,46.61120099999998,45.42412849999998,45.42412849999998,47.88943003776996,42.95882696223,101313184,30.613514551994655,47.42066315993474,NaN,NaN,NaN,NaN,NaN,NaN,-0.26242503966340336,-0.5600361473832365,-0.2976111077198331,1.3890900577182972,14.495185062424754,3224836378,5344495574.3982315,12.167892700402806,36.158624613121425,21.99564663772847,50,100
2010-07-01,42.82001,42.96001,41.77,42.59,44.64223452061166,46.031511151045095,45.961042918913776,45.08718283940466,45.227038600000014,46.73922629999999,46.46240099999998,45.21912849999998,45.21912849999998,47.90158677779864,42.53667022220132,158694880,30.12589792404897,46.17093250920378,NaN,NaN,NaN,NaN,NaN,NaN,-0.330118699747605,-0.7102594824043393,-0.38014078265673434,13.87481197091706,7.257101843823468,3066141498,5404504405.459484,11.219907104787914,39.037354159866354,23.679381662182045,42.857142857142854,100
2010-07-02,42.67,42.8215,42.09,42.47,44.62062024677473,45.96098617775707,45.8241392750348,44.83792733088993,45.22728860000001,46.7328263,46.30560099999998,45.08800349999998,45.08800349999998,48.02656469489333,42.149442305106625,78565248,29.617892945638943,44.88874014513475,NaN,NaN,29.617892945638943,NaN,NaN,NaN,-0.3594348554133238,-0.8294343519233891,-0.4699994965100653,11.844351682490098,9.036084570375154,2987576250,5407565389.147795,10.669626764026338,37.12276713620421,26.176040649224877,35.714285714285715,92.85714285714286
2010-07-06,43.09,43.37,42.25,42.60001,44.600514672179955,45.89443219403911,45.69770283287657,44.624792346995655,45.22823865000001,46.728626399999996,46.14720119999997,45.00450399999998,45.00450399999998,48.12082388347403,41.888184116525935,88591808,30.975921130206117,43.22112402985584,NaN,NaN,NaN,NaN,NaN,NaN,-0.3463856546099615,-0.9029815647725172,-0.5565959101625557,14.04418619997657,13.254449951127912,3076168058,5374345043.144366,13.53545016752093,34.34529114126832,28.38926963020158,28.571428571428573,85.71428571428571
2010-07-07,42.74001,44.00999,42.7,43.96001,44.594141491362244,45.85612680405814,45.62955801590102,44.56147974251988,45.235838700000016,46.731526499999994,46.01820139999998,44.99300449999998,44.99300449999998,48.12292955535521,41.86307944464474,72448368,43.30051149866124,42.36484491780805,NaN,NaN,NaN,NaN,NaN,NaN,-0.2281821585014605,-0.8418236082893813,-0.6136414497879208,37.056069468814606,20.981535783760428,3148616426,5441265171.336978,16.469058289444753,31.18230161311324,30.08220040149851,21.428571428571427,78.57142857142857
2010-07-08,44.30969,44.38,43.67999,44.2,44.59021968547804,45.82333221387877,45.57349691723823,44.52705310037513,45.24398865000001,46.73592659999999,45.91540139999998,45.012003999999976,45.012003999999976,48.11773659250347,41.90627140749648,78264560,45.16130386162158,41.58506811047908,NaN,NaN,NaN,NaN,NaN,NaN,-0.12122275821765194,-0.7651698975599857,-0.6439471393423337,41.11682084064444,30.73902550314521,3226880986,5479279961.190838,18.17671064614779,29.718977946038144,31.332745574675194,14.285714285714286,71.42857142857143
2010-07-09,44.17999,44.63,44.08,44.62,44.59051600701557,45.7995038532079,45.5361048812681,44.53590518605369,45.25383870000002,46.73892649999999,45.82040139999998,44.98950349999998,44.98950349999998,48.0997463095137,41.879260690486255,47861056,48.35565307076079,41.058695692045426,NaN,NaN,NaN,NaN,NaN,NaN,-0.01515381901668622,-0.6628894131131915,-0.6477355940965053,48.223431850138454,42.1321073865325,3274742042,5525400615.154473,19.218485734874427,28.583972506491023,32.43625498232818,7.142857142857143,64.28571428571429
2010-07-12,44.58,45.03,44.46001,44.75,44.592102912418405,45.77872159868893,45.50527723886543,44.55629516833429,45.26533870000002,46.740726399999986,45.71080139999998,44.952003499999975,44.952003499999975,48.05479843104713,41.84920856895282,60934832,49.33931324783049,40.80750936501407,NaN,NaN,NaN,NaN,NaN,NaN,0.06632410347684403,-0.5648304647504503,-0.6311545682272943,55.49348230912473,48.27791166663587,3335676874,5526468596.9992075,21.30172698063349,27.415420062458974,32.51822961783797,0,57.142857142857146
2010-07-13,45.13,45.5,44.8,45.33,44.59944517199633,45.76983602247727,45.49840362165502,44.62998134277864,45.28163865000001,46.74552629999998,45.63265139999998,44.94400299999998,44.94400299999998,48.042029214240706,41.845976785759255,93310496,53.586809888388,41.03915943954297,NaN,NaN,NaN,NaN,NaN,NaN,0.1566844284424571,-0.435299032674223,-0.5919834611166801,75.7446808510638,59.820531670109,3428987370,5574456852.084922,23.56678719417912,25.914207255370464,31.872124026952804,0,50
2010-07-14,45.42,45.81,45.24001,45.56,44.609002931478955,45.765680853715345,45.50081916590384,44.7185545482283,45.30093865000001,46.75282629999999,45.54525159999997,44.886502499999985,44.886502499999985,47.892608870392124,41.880396129607846,87694688,55.191199407835995,41.48000228746232,NaN,NaN,NaN,NaN,NaN,NaN,0.22518193580617396,-0.31050604135896265,-0.5356879771651366,89.81021371987278,73.68279229335377,3516682058,5585225025.584668,24.888790312427982,24.802639565200813,30.47435561270453,0,42.857142857142854
2010-07-15,45.46001,45.74001,44.99001,45.60001,44.61886369832991,45.76240024275069,45.504709002535066,44.80250268649227,45.31688870000002,46.76142629999998,45.48865199999997,44.821503499999984,44.821503499999984,47.70434380742055,41.93866319257942,95992432,55.47950547051494,42.27232001527075,NaN,NaN,NaN,NaN,NaN,NaN,0.26374754699738573,-0.20600354341840443,-0.46975109041579016,94.80222772277214,86.78570743123623,3612674490,5645380282.971334,23.46267630285346,25.291443630862815,28.911375797246905,0,35.714285714285715
2010-07-16,45.44,45.6281,44.3,44.34,44.61608893516245,45.73423390131008,45.45903413969055,44.758454811588244,45.327488700000025,46.763226299999985,45.41185219999998,44.686003499999984,44.686003499999984,47.38608813424569,41.98591886575428,98831872,45.54171264953205,42.39125193070231,NaN,NaN,45.54171264953205,NaN,NaN,NaN,0.19796537915307166,-0.22229436647445056,-0.4202597456275222,63.61386138613863,82.74210094292785,3513842618,5552501689.911174,21.151438832240284,27.917957840157566,27.85953252439177,85.71428571428571,28.571428571428573
2010-07-19,44.48,44.81,44.10001,44.72,44.61712287610611,45.71415006168017,45.4300524087223,44.75479244857984,45.33983870000003,46.76432629999999,45.374851999999976,44.57200349999999,44.57200349999999,47.05550671604127,42.0885002839587,81800752,48.53575051875632,42.799777446419675,NaN,NaN,NaN,NaN,NaN,NaN,0.17443885859421193,-0.20221117238475728,-0.3766500309789692,73.01980198019793,77.14529702970292,3595643370,5613563931.002569,20.016280261354765,27.931377267040325,26.885198077848504,78.57142857142857,21.428571428571427
2010-07-20,43.99001,45.25999,43.86,45.25999,44.62351956390605,45.70515679313205,45.423383294654755,44.80290650109605,45.36113865000002,46.77092609999999,45.371851799999966,44.50500249999998,44.50500249999998,46.83350732071939,42.17649767928057,89061184,52.52969595407449,44.16819157999033,NaN,NaN,NaN,NaN,NaN,NaN,0.18844326479948342,-0.14109594997961494,-0.32953921477909837,86.38589108910891,74.3398514851485,3684704554,5702625115.002569,21.25685537583558,25.073822580467713,24.15189574193348,71.42857142857143,14.285714285714286
2010-07-21,45.75,45.75999,44.56,44.64,44.62368354834479,45.68406457940666,45.392662381138884,44.78739159622975,45.37993865000002,46.76972619999999,45.30925179999996,44.425001999999985,44.425001999999985,46.61541954925876,42.23458445074121,83576816,47.93040162853467,45.405112085457475,NaN,NaN,NaN,NaN,NaN,NaN,0.1507804806973257,-0.14106361390744127,-0.29184409460476696,71.039603960396,76.81509900990095,3601127738,5630191967.333138,23.018001583564075,22.910259396166836,20.62272361521022,64.28571428571429,7.142857142857143
2010-07-22,45.25999,45.98,45.24001,45.77,44.63508968219211,45.68576627090356,45.40745993481971,44.880973348969775,45.40273860000002,46.773326199999985,45.27025179999997,44.41100199999998,44.41100199999998,46.56293723696739,42.25906676303257,82890256,55.56655651815331,47.22230198503636,NaN,NaN,NaN,NaN,NaN,NaN,0.19404466233672585,-0.04928826668385966,-0.2433329290205855,94.6015424164526,84.00901248865252,3684017994,5666035766.597238,22.397583918823788,20.7564198985638,16.94079037497837,100,0
2010-07-23,45.46001,46.10001,45.38,46.06,44.6492678943096,45.69317683979656,45.433049741297374,44.99326160144884,45.42333860000002,46.778426199999984,45.21905179999997,44.44650149999999,44.44650149999999,46.68106545793151,42.21193754206847,81056064,57.29736652591645,49.19940724077047,NaN,NaN,NaN,NaN,NaN,NaN,0.23171521375136597,0.04631108816862195,-0.18540412558274402,98.96078192004708,88.20064276563191,3765074058,5738083474.822624,22.101964730350222,19.685520566816372,13.400261293554223,100,0
2010-07-26,46.12,46.46001,45.91,46.44,44.66708612421697,45.707965417226326,45.47253798673669,45.13104621083467,45.44523860000002,46.78682609999998,45.19085159999998,44.505001499999985,44.505001499999985,46.87960975823676,42.13039324176321,64850816,59.52234130576921,51.238437253310686,NaN,NaN,NaN,NaN,NaN,NaN,0.2691204974552375,0.15099649623630285,-0.11812400121893465,99.46782056430703,97.67671496693556,3829924874,5798215595.423778,23.867040598060868,18.88401370015628,11.128411088204768,100,0
2010-07-27,46.69,46.72,46.21001,46.42,44.68452805332924,45.72206511193472,45.50969335980584,45.2538037145647,45.466138550000025,46.79352609999998,45.18065179999998,44.570501499999985,44.570501499999985,47.076861927809325,42.064141072190644,67655568,59.347074033302384,52.38462029149934,NaN,NaN,NaN,NaN,NaN,NaN,0.2782582241377927,0.22969877895330626,-0.048559445184486474,90.1316114091731,96.18673796450908,3762269306,5786274816.828748,24.92628522724327,18.146240681420007,10.047277993810992,100,0
2010-07-28,46.38,46.58,45.88,46.05,44.69811483886825,45.728558872094425,45.53088185549973,45.329631932225205,45.48398855000002,46.78962609999998,45.16005179999998,44.704501499999985,44.704501499999985,47.22631850091176,42.18268449908821,51988112,56.05842072155703,53.162985781494726,NaN,NaN,NaN,NaN,NaN,NaN,0.246228989866045,0.25922679214806976,0.012997802282024774,76.5734265734265,88.72428618230224,3710281194,5759538073.5144615,23.56539158424564,19.729439091644956,8.958800129604752,92.85714285714286,0
2010-07-29,46.3,46.41,45.25,45.71001,44.708183447436724,45.72819156769651,45.53790648861739,45.365858414870424,45.499688550000016,46.78142619999998,45.14565219999998,44.854501499999984,44.854501499999984,47.236973154834125,42.47202984516584,85693936,53.14419163135568,53.50502425010865,NaN,NaN,53.14419163135568,NaN,NaN,NaN,0.19143008980729337,0.2522854145411415,0.06085532473384812,64.68566433566426,77.13023410608797,3624587258,5741809771.1340475,21.47317113286667,22.799656615902634,7.77337874789844,85.71428571428571,50
2010-07-30,45.36,46.09,45.07001,45.81,44.719146796218446,45.72981153665302,45.548576822397095,45.40815761345419,45.515838550000026,46.77162629999998,45.14065219999998,45.015501499999985,45.015501499999985,47.190240393312635,42.840762606687335,98958064,53.90316931399349,53.831013969120285,NaN,NaN,NaN,NaN,NaN,NaN,0.15287444107644516,0.25194837607940457,0.09907393500295941,68.1818181818183,69.81363636363636,3723545322,5786437384.992379,19.807868621022045,22.399996102737393,7.315662436985622,78.57142857142857,42.857142857142854
2010-08-02,46.38,46.78999,46.2101,46.67,44.73855827088294,45.74842912998662,45.592554201910936,45.52833307883951,45.53338855000002,46.76662629999998,45.18705199999997,45.225501499999986,45.225501499999986,47.17605186697012,43.27495113302985,68706688,59.917013957865656,54.28317140265441,NaN,NaN,NaN,NaN,NaN,NaN,0.1746745293140434,0.31741709664551365,0.14274256733147025,95.90476418008248,76.25741556585503,3792252010,5826710695.996328,23.64235632419859,20.736070777238684,7.444575713042005,100,35.714285714285715
2010-08-03,46.63,46.7,46.25,46.47,44.75578654679455,45.762717662066095,45.62696384105168,45.61801564275956,45.55043855000002,46.75782619999998,45.219651999999975,45.41900099999998,45.41900099999998,47.027103200754965,43.810898799244995,60863376,58.021249222028274,54.48531781795385,NaN,NaN,NaN,NaN,NaN,NaN,0.1651167853181254,0.349138548979127,0.1840217636610016,89.07880231673133,84.38846155954404,3731388634,5825358176.529661,22.804662913501822,20.00135256152279,7.899968475104556,92.85714285714286,28.571428571428573
2010-08-04,46.69,46.99001,46.5,46.938,44.77750011349311,45.785990579648946,45.67837702375554,45.74372843868722,45.57122855000002,46.75360619999998,45.26521199999998,45.567900499999986,45.567900499999986,47.159456056195026,43.976344943804946,43817792,61.12115288856862,54.88829263352911,NaN,NaN,NaN,NaN,NaN,NaN,0.1786594571908601,0.4073460851495767,0.2286866279587166,98.33834396695232,94.44063682125538,3775206426,5859874267.087161,24.19684888397448,19.15666125311911,8.462453364294358,100,21.428571428571427
2010-08-05,46.72,46.92,46.52,46.83,44.79792299793596,45.806664033517286,45.723538709098456,45.847182873097964,45.58932850000002,46.749506099999984,45.30781199999998,45.69940049999998,45.69940049999998,47.251247387568185,44.14755361243178,39150160,60.01967716902317,55.9224329563499,NaN,NaN,NaN,NaN,NaN,NaN,0.16880491756186244,0.43969277491104464,0.2708878573491822,94.88787575758545,94.10167401375638,3736056266,5881406855.08716,23.34344829072645,18.481023439432935,8.307888817726273,92.85714285714286,14.285714285714286
2010-08-06,46.32001,46.85001,46.05,46.75999,44.81744605268287,45.82554177542784,45.76418385776126,45.93411688518387,45.60702845000002,46.74170609999998,45.35901179999998,45.80639999999998,45.80639999999998,47.34079959595812,44.27200040404185,71339440,59.27396984063678,56.689448622198505,NaN,NaN,NaN,NaN,NaN,NaN,0.14684174278968226,0.454440035836285,0.30759829304660274,92.65114168964328,95.29245380472703,3664716826,5936691554.799415,21.76151871215178,21.20990576271788,7.220452191309783,85.71428571428571,7.142857142857143
2010-08-09,47.00999,47.19,46.78999,47.08,44.83995902728304,45.85038253235006,45.81578449079023,46.043248610404454,45.626728450000016,46.735806099999984,45.383211799999984,45.922899999999984,45.922899999999984,47.472515539441005,44.37328446055896,26937008,61.62119300282627,57.33884126853792,NaN,NaN,NaN,NaN,61.62119300282627,NaN,0.14299593921429604,0.4863432170644728,0.34334727785017677,95.81749049429659,94.4521693138418,3691653834,5948813578.774015,23.924560610912586,20.409301140845017,7.1983472858490645,100,0
2010-08-10,46.72,46.95,46.28,46.6725,44.85819326581753,45.86666208616491,45.849381177425904,46.10317731417546,45.64354095000002,46.724231099999976,45.40466159999998,45.99002499999999,45.99002499999999,47.54738148057042,44.432668519429555,86694432,57.10757530848604,57.99435367424873,NaN,NaN,NaN,NaN,NaN,NaN,0.10395345101700959,0.47328909162143873,0.36933564060442914,75.58950749767689,88.01937989387227,3604959402,5963693966.356104,22.2424372469558,23.456475159737682,7.371348237906374,92.85714285714286,0
2010-08-11,45.91,45.92,45.21001,45.39999,44.86358427809795,45.857421054755704,45.831757993997435,46.0362070937778,45.65489090000003,46.70333089999998,45.40906159999998,45.98202449999998,45.98202449999998,47.54974486272319,44.41430413727677,92219632,45.82068048589214,57.29821967194436,NaN,NaN,NaN,NaN,NaN,NaN,-0.010542813803644191,0.3561571233498739,0.3666999371535181,15.56516776022528,62.32405525073293,3512739770,5920826820.130158,19.53797445047239,29.50020625920547,8.550792218566455,85.71428571428571,42.857142857142854
2010-08-12,44.56,45.24001,44.45,45.03999,44.8653395589129,45.84123430119619,45.80070826874263,45.94132927532277,45.665140800000025,46.67453079999998,45.38486139999997,45.954023499999984,45.954023499999984,47.56737705576147,44.3406699442385,66000432,43.21827952163068,56.292570600209665,NaN,NaN,NaN,NaN,NaN,NaN,-0.1080716750157465,0.23161034338383502,0.3396820183995815,21.532481751824868,37.56238566990902,3446739338,5953406393.131817,18.006405752576356,33.458999709870504,10.282399910826951,78.57142857142857,100
2010-08-13,44.87,45.06,44.71001,44.72,44.863893394147595,45.81903164176656,45.758327552321354,45.82501220148251,45.67704080000002,46.63920579999997,45.34546139999997,45.97302349999998,45.97302349999998,47.517372593918594,44.42867440608137,46387264,40.98980770242779,54.96881819997099,NaN,NaN,40.98980770242779,NaN,NaN,NaN,-0.1870534103583419,0.10586525545165415,0.29291866580999604,9.854014598540019,15.650554703530071,3400352074,5909667254.891753,17.463275571135853,32.44977039265158,11.594492059932282,71.42857142857143,92.85714285714286
2010-08-16,44.48,45.11,44.3,44.8,44.86325763898195,45.79885279737514,45.7207460796813,45.727391991817505,45.69409080000002,46.60700579999997,45.33961139999997,45.97702349999999,45.97702349999999,47.50873279744713,44.445314202552844,55472848,41.79781856411869,53.71529995217215,NaN,NaN,NaN,NaN,NaN,NaN,-0.2243170535360351,0.012522348889952184,0.23683940242598728,17.301038062283734,16.22917813754956,3455824922,5922679404.422617,16.2422175668241,33.72015607929117,12.968863928465794,64.28571428571429,100
2010-08-17,45.11,45.78,45.03,45.37199,44.86831965252442,45.79040006871425,45.70706937067419,45.69354418307298,45.71050075000003,46.58122569999997,45.36165119999997,45.98262349999998,45.98262349999998,47.50459381215736,44.4606531878426,56927056,47.34893644464097,53.09319393239243,NaN,NaN,NaN,NaN,NaN,NaN,-0.2015702666465542,-0.015123430882205469,0.18644683576434873,37.09307958477506,21.41604408186629,3512751978,5917668305.43979,20.594503495270754,30.90462808775978,13.766001539493791,57.142857142857146,92.85714285714286
2010-08-18,45.28999,45.82001,45.11,45.55,44.87510254155403,45.785639671313966,45.7009097875105,45.6798733084946,45.73345070000002,46.55672569999997,45.38885119999996,46.02812349999998,46.02812349999998,47.43703005371061,44.61921694628935,61836480,48.9798231573342,52.7957390413909,NaN,NaN,NaN,NaN,48.9798231573342,NaN,-0.16708599272194977,-0.022410655138088487,0.14467533758386128,43.252595155709336,32.5489042675894,3574588458,5932473143.731081,19.679553806033454,29.01442971385344,14.921310805663975,50,85.71428571428571
2010-08-19,45.28999,45.46001,44.56,44.86,44.87495226750872,45.76731017287211,45.66793293309832,45.601790136257016,45.75210070000002,46.52302569999997,45.40965099999997,45.982623499999974,45.982623499999974,47.47805441819396,44.487192581805985,82969504,43.37175805723321,52.04349538019374,NaN,NaN,NaN,NaN,NaN,NaN,-0.18206615953326277,-0.08290736183271719,0.09915879770054559,19.377162629757862,33.24094579008078,3491618954,5904816027.815658,18.024184492413102,31.246968403517215,16.399555674719192,42.857142857142854,78.57142857142857
2010-08-20,44.78999,45.03,44.53999,44.92,44.87540050365291,45.75053175360731,45.63860222983956,45.536857742327776,45.770400750000015,46.48832569999997,45.40665079999996,45.92562349999998,45.92562349999998,47.49021736010826,44.3610296398917,66806624,43.97249447947531,50.90460113173729,NaN,NaN,NaN,NaN,NaN,NaN,-0.1789861809455707,-0.1245739284814178,0.054412252464152905,21.453287197231987,28.02768166089975,3558425578,5941628453.166651,17.25071841567849,30.081315020847395,17.86803914432551,35.714285714285715,71.42857142857143
2010-08-23,45.25,45.34,44.46001,44.48,44.871466170283234,45.725372708981425,45.59316684827723,45.43620462401084,45.78615075000002,46.451525699999976,45.386250799999964,45.82762349999997,45.82762349999997,47.493332589574436,44.16191441042551,69612128,40.57329051256851,49.65831836677587,NaN,NaN,NaN,NaN,NaN,NaN,-0.19624879686920102,-0.19089874362234838,0.005350053246852643,6.228373702422134,15.686274509804015,3488813450,5875178966.648304,18.628351200199294,27.77608554031337,18.808338404266323,28.571428571428573,64.28571428571429
2010-08-24,44.00999,44.12,43.465,43.64999,44.85931217853912,45.68427602167486,45.5169638346193,45.26608894553362,45.79265065000002,46.40642559999998,45.34945039999996,45.68912299999998,45.68912299999998,47.580178992190866,43.798067007809095,79095744,35.066441709530494,47.79726756827315,NaN,NaN,35.066441709530494,NaN,NaN,NaN,-0.24979905843955696,-0.30689876980259356,-0.057099711363036605,4.966174496644279,10.882611798766156,3409717706,5840760846.106503,17.009244875009934,33.88233903514919,20.346137715323948,21.428571428571427,100
2010-08-25,43.35001,44.25999,43.27,44.07001,44.85145842551883,45.65231035787932,45.460220546987166,45.15217666500661,45.80000065000002,46.36102569999997,45.296650399999955,45.590123499999976,45.590123499999976,47.598891306673856,43.581355693326095,87347872,39.53855477638595,46.334330254513354,NaN,NaN,NaN,NaN,NaN,NaN,-0.24294318320830283,-0.36077869037341515,-0.11783550716511232,20.408418367346975,10.534322188804461,3497065578,5894584442.664206,15.586283917731524,32.69563475950564,22.046892239979694,14.285714285714286,100
2010-08-26,44.24001,44.32001,43.5,43.53999,44.83840898844899,45.610482231980725,45.384917388281785,44.99863507786312,45.80015065000002,46.308925599999974,45.22945039999995,45.48162249999998,45.48162249999998,47.678391298056106,43.28485370194385,91223008,36.15467442765265,44.682952010728776,NaN,NaN,NaN,NaN,NaN,NaN,-0.25866092467600105,-0.4411616630101136,-0.18250073833411257,6.887500000000008,10.754030954663753,3405842570,5812258906.86557,15.012213849284125,30.425173780307475,24.378152406121945,7.142857142857143,92.85714285714286
2010-08-27,43.86,44.16,42.97,44.07001,44.83076322736989,45.57997783134744,45.33335239266289,44.910194594257106,45.80240070000003,46.263325699999974,45.169850599999954,45.39462299999998,45.39462299999998,47.66893193100319,43.12031406899677,109595936,41.54256363311264,43.24876419860636,NaN,NaN,NaN,NaN,NaN,NaN,-0.21946460486456698,-0.4568314944148213,-0.2373668895502543,27.638442211055363,18.311453526134116,3515438506,5905279148.27626,13.542491382066316,31.806826497612374,26.688560365523703,0,100
2010-08-30,43.87,44.25,43.60001,43.61,44.81861632958512,45.54096836934056,45.2657699458918,44.786366537661195,45.80095075000003,46.212025599999976,45.10205059999995,45.241622999999976,45.241622999999976,47.56336882278989,42.91987717721006,49373120,38.505382516854624,41.92003614206126,NaN,NaN,NaN,NaN,NaN,NaN,-0.21058514864068145,-0.5005983253511062,-0.2900131767104247,21.694915254237287,18.740285821764218,3466065386,5857423705.375293,13.559038180471827,30.07486333588209,29.2024389611708,0,92.85714285714286
2010-08-31,43.39,43.85001,43.17999,43.46001,44.805097858643975,45.49976127291798,45.19495583036663,44.66004686740775,45.800000850000025,46.15632569999997,45.03925059999996,45.09112349999997,45.09112349999997,47.46450720963692,42.71773979036303,72066816,37.54161980341394,41.32867466474139,NaN,NaN,NaN,NaN,NaN,NaN,-0.2009084726585793,-0.5411487675336488,-0.3402402948750695,17.19327300605953,22.175543490450725,3393998570,5845594344.425351,12.786137892411444,31.93387839316793,30.80970179857291,0,85.71428571428571
2010-09-01,44.10001,44.91,44.07001,44.75999,44.804649024229604,45.48511233682059,45.17789834682284,44.669565260987966,45.803750850000036,46.11322549999997,45.00965019999995,44.982222999999976,44.982222999999976,47.201513939755785,42.76293206024417,83523120,49.36978758841195,41.76806809808291,NaN,NaN,NaN,NaN,NaN,NaN,-0.09824777306718341,-0.46305001120904876,-0.36480223814186535,62.80644629317091,33.898211517822574,3477521690,5899285434.922144,19.859490766214236,28.189011725190216,29.903305058119237,28.571428571428573,78.57142857142857
2010-09-02,44.84,45.28,44.73,45.25999,44.80917978020742,45.48065446876474,45.181117627339596,44.72579618851292,45.80775075000003,46.07262529999997,44.993849999999945,44.90372249999997,44.90372249999997,46.961191307587406,42.84625369241254,41816720,53.052416979735234,42.62968304646201,NaN,NaN,NaN,NaN,NaN,NaN,0.006482939458734127,-0.35669856381844767,-0.3631815032771818,80.3502443851074,53.44998789477928,3519338410,5938059418.314144,22.026922252199263,26.90038947381564,28.47012088010595,21.428571428571427,71.42857142857143
2010-09-03,45.73,46.02,45.55,46.00999,44.82112814060337,45.49113636047237,45.213622426267456,44.8481003610355,45.81480065000003,46.03362519999997,45.007049599999945,44.86622249999998,44.86622249999998,46.81126045443476,42.9211845455652,64041072,57.98860110394602,43.78616751359254,NaN,NaN,NaN,NaN,NaN,NaN,0.12296057900331842,-0.2094807795230338,-0.3324413585263522,99.67180327868849,80.94283131898892,3583379482,5999372613.162144,26.825707868299663,25.186972575187383,26.196438283410725,100,64.28571428571429
2010-09-07,45.82001,46.03,45.625,45.7,44.82987313422921,45.49527227412638,45.23269605660991,44.9292336599845,45.82153565000003,45.989325199999975,45.01564959999994,44.79722249999997,44.79722249999997,46.50690184543173,43.08754315456821,51195136,55.396046070323585,44.360961058284154,NaN,NaN,NaN,NaN,NaN,NaN,0.17276867699030113,-0.11648051228847578,-0.2892491892787769,89.21568627450986,89.74591131276857,3532184346,5967138638.643626,25.966794295827505,24.298775642719157,25.003467919692532,100,57.142857142857146
2010-09-08,45.84,46.45,45.82001,46.25,44.84400374980902,45.510217377609024,45.27259032889972,45.05502093046216,45.83448565000003,45.95652519999998,45.03844959999995,44.77609749999998,44.77609749999998,46.40090448982777,43.15129051017219,66883936,58.90646198634104,45.0700066889275,NaN,NaN,NaN,NaN,NaN,NaN,0.2326673530763624,0.001585002066676111,-0.2310823510096863,94.25287356321832,94.38012103880556,3599068282,5991555909.458464,27.94016780000331,22.702190832240795,24.37293815545932,100,50
2010-09-09,46.67,46.7,46.32001,46.42999,44.859784707522365,45.52843069686429,45.31797855129581,45.185970365656246,45.849435600000035,45.925825099999976,45.099649399999954,44.827597499999975,44.827597499999975,46.587885108373946,43.067309891626,61476384,60.01550204853077,46.258845545448764,NaN,NaN,NaN,NaN,NaN,NaN,0.2716071506990405,0.10842658736411437,-0.16318056333492614,92.76112600536177,92.07656194769665,3660544666,5965665581.472146,29.064867984771187,21.777591893066976,23.47981572400917,100,42.857142857142854
2010-09-10,46.49001,46.67,46.25,46.60001,44.87710038207438,45.549650089005596,45.36825429438225,45.320640807022315,45.861735650000035,45.894325199999976,45.17744939999995,44.905598499999975,44.905598499999975,46.82745774026985,42.9837392597301,66995680,61.08391504315177,47.481089871425645,NaN,NaN,NaN,NaN,NaN,NaN,0.2941137310602871,0.20446160049043272,-0.08965213056985437,97.31930294906152,94.77776750588053,3727540346,6010332558.409287,27.921854534255242,21.57669179536762,22.459190606446832,92.85714285714286,35.714285714285715
2010-09-13,46.95,47.37,46.94,47.25,44.900711323546275,45.58332038427281,45.44204824362216,45.504389301591615,45.87803560000003,45.86652519999997,45.270649399999954,45.032098499999975,45.032098499999975,47.205089125246616,42.859107874753334,64523296,64.94083342524829,49.22162865090278,NaN,NaN,NaN,NaN,NaN,NaN,0.3351006764898854,0.32922371504250236,-0.0058769614473830195,97.27272727272732,95.78438540905022,3792063642,6038842851.990684,32.46011233509436,20.022110898160005,22.74393320053662,100,28.571428571428573
2010-09-14,47.17,47.7,47.08,47.45,44.9260773800284,45.62028433705949,45.520791449754626,45.68968555858289,45.89438565000003,45.837925199999965,45.370249399999956,45.164598499999975,45.164598499999975,47.575021460272836,42.754175539727115,91405808,66.05560871805372,51.43514058008301,NaN,NaN,NaN,NaN,NaN,NaN,0.3560410805460991,0.4391743892352409,0.08313330868914177,94.71458773784356,96.43553931987746,3883469450,6056534298.700361,33.681199582939946,18.844748650815504,22.393287952197735,100,21.428571428571427
2010-09-15,47.35001,47.8,47.19,47.75,44.954176112565435,45.66245692444445,45.6082113929015,45.88590598157499,45.91558570000003,45.81022519999997,45.47324919999996,45.283498999999985,45.283498999999985,47.94467307701802,42.62232492298195,67108128,67.71395977827382,53.44766950878928,NaN,NaN,NaN,NaN,NaN,NaN,0.3688892469920007,0.5442448674291427,0.17535562043714198,98.96480331262946,96.98403944106677,3950577578,6112641094.241345,32.66725904923952,17.739489330668906,21.977450311605725,100,14.285714285714286
2010-09-16,47.67999,47.98,47.53999,47.94,44.98388580298767,45.70755678732674,45.699654083375954,46.081533983329756,45.93748570000003,45.78552519999997,45.55284899999995,45.40299899999998,45.40299899999998,48.30505369007676,42.5009443099232,66885744,68.75508930901886,55.776270571744014,NaN,NaN,NaN,NaN,NaN,NaN,0.36813111732832005,0.6355195170975421,0.267388399769222,99.20159680638724,97.62699595228673,4017463322,6167366070.2588,33.02636012023923,16.966482987676574,21.84909575983645,100,7.142857142857143
2010-09-17,48.14,48.14,47.75,47.995,45.01384713828133,45.75285269252819,45.78966764873376,46.26376884206025,45.95741075000004,45.77207519999996,45.62874899999995,45.559748999999975,45.559748999999975,48.659485025567086,42.460012974432864,76372560,69.06605966940366,57.74223457433623,NaN,NaN,NaN,NaN,NaN,NaN,0.34943013737358414,0.7041760714862022,0.35474593411261807,97.07661879713946,98.41433963871872,4093835882,6186948777.951106,33.3457941982889,16.288962981190306,21.426947041898554,100,0
2010-09-20,48.17999,48.92999,48.11011,48.8299,45.05181781352231,45.813784322379114,45.908892446822634,46.50816228567356,45.981210200000035,45.76667419999997,45.71294699999995,45.755243999999976,45.755243999999976,49.14823854819162,42.36224945180833,84536560,73.39480992534436,60.23433653208549,NaN,NaN,NaN,NaN,NaN,NaN,0.369438236784188,0.8165437300928531,0.44710549330866506,98.25930434782619,98.17917331711762,4178372442,6250845087.450058,38.12608603855146,14.766537599209073,21.87788940786506,100,7.142857142857143
2010-09-21,48.84,49.17,48.61,48.82001,45.08931226313901,45.87331354371814,46.023053919496256,46.72833825846656,46.00586025000003,45.75257429999997,45.79434719999995,45.972244499999974,45.972244499999974,49.56074889753128,42.383740102468664,82352624,73.26402292993109,62.78593675540815,NaN,NaN,NaN,NaN,NaN,NaN,0.35790503090076164,0.8944867819346172,0.5365817510338555,93.13743752438734,96.1577868897843,4096019818,6230259872.615202,38.39518239366807,13.926953053973124,22.159864353997847,100,0
2010-09-22,48.61,49.021,48.42,48.69,45.12514000181424,45.929089513149464,46.12764004030032,46.915163186231645,46.02871025000003,45.74709929999997,45.86154719999995,46.224244999999975,46.224244999999975,49.83284758300926,42.61564241699069,88315872,71.46127452322247,64.36390010789461,NaN,NaN,NaN,NaN,NaN,NaN,0.3187254198858469,0.9349885258911641,0.6162631060053172,89.18918918918912,93.5286436871342,4007703946,6221296032.0295105,36.02766589032523,15.017566974246835,23.861586887936657,92.85714285714286,0
2010-09-23,48.39,49.16,48.32001,48.67,45.160412240602156,45.98336496833462,46.22734043087678,47.08229050182863,46.05251025000003,45.73449939999996,45.92374719999995,46.45424449999997,46.45424449999997,50.07068077609561,42.83780822390434,85039936,71.17114878738661,65.65809523701257,NaN,NaN,NaN,NaN,NaN,NaN,0.27056557917815327,0.9544700799780088,0.6839045007998555,86.18784530386742,89.50482400581461,3922664010,6207121528.238561,34.37326385318126,13.742141671025148,26.21285727029645,85.71428571428571,0
2010-09-24,49.22,49.69,49.14999,49.66,45.2051842581086,46.05616962242701,46.36195453162671,47.32778664451162,46.082600250000034,45.74679949999997,46.004946999999945,46.760244999999976,46.760244999999976,50.37422672685736,43.146263273142594,79495872,76.30032646194431,66.96607561972674,NaN,NaN,NaN,NaN,76.30032646194431,NaN,0.2831408896763601,1.0378306128953056,0.7546897232189456,99.26199261992618,91.54634237099424,4002159882,6277784689.140617,36.1313187892436,12.368472196069165,29.487509085416225,100,0
2010-09-27,49.64999,49.75,49.35001,49.39,45.24682421573936,46.12218606554726,46.480701412739386,47.52418791646289,46.10915025000003,45.75889959999997,46.105946999999944,47.026244499999976,47.026244499999976,50.591842680813286,43.460646319186665,43883408,72.51120288716689,68.18858682092983,NaN,NaN,NaN,NaN,NaN,NaN,0.25206900598764115,1.069775980703497,0.8177069747158558,90.83967134776424,92.09650309051928,3958276474,6242675987.937888,35.27541832423924,11.867492153990074,32.79713113199141,100,0
2010-09-28,49.50999,49.53999,48.59,49.37,45.28785084045837,46.18649921276415,46.59400723969078,47.699979543466426,46.13450025000003,45.78689949999996,46.19894699999995,47.31424449999998,47.31424449999998,50.652838074998094,43.975650925001865,104922880,72.22508083947758,69.13991673901101,NaN,NaN,NaN,NaN,NaN,NaN,0.21064864575749742,1.0810177819127276,0.8703691361552301,89.14285714285708,93.08150703684917,3853353594,6310049335.056067,31.963958370219792,18.263570681998967,34.00667228177307,92.85714285714286,0
2010-09-29,49.3,49.53,49.11,49.28999,45.32767312065281,46.24795447587773,46.699732053820554,47.85140911075534,46.16030020000004,45.82569939999997,46.27954699999994,47.605743499999974,47.605743499999974,50.541047527008594,44.670439472991355,81679184,71.01778884938321,69.92579436764332,NaN,NaN,NaN,NaN,NaN,NaN,0.16060357576243633,1.0711236058582756,0.9105200300958393,86.85685714285724,88.9464618778262,3771674410,6298376990.713973,30.596439989362878,17.482197852062406,34.93121506776176,85.71428571428571,7.142857142857143
2010-09-30,49.53999,49.84,48.75,49.07001,45.364910303531886,46.30383676348411,46.79268413014132,47.96746633830245,46.18290025000003,45.83869949999997,46.36814719999994,47.82124449999998,47.82124449999998,50.51185775482085,45.1306312451791,122458560,67.66863344737749,70.3961313965166,NaN,NaN,NaN,NaN,NaN,NaN,0.09847754359933514,1.0336169595950082,0.9351394159956731,73.44862068965523,83.14944499178985,3649215850,6247822951.421496,27.32865976132453,19.142479439222885,35.27383900929131,100,0
2010-10-01,49.46001,49.53,48.78101,49.00999,45.40117975324799,46.357423956286404,46.879637301508325,48.06675430608317,46.206450200000035,45.85159939999996,46.43294699999993,48.008744499999985,48.008744499999985,50.4723582962386,45.545130703761366,77682368,66.74377262914695,70.52491276822364,NaN,NaN,NaN,NaN,NaN,NaN,0.04201997092327325,0.9876643796497646,0.9456444087264914,69.92717391304348,76.74421724851864,3571533482,6217638436.863172,25.326958825646052,17.740379250653614,34.83927944883423,92.85714285714286,0
2010-10-04,48.86,49.05,48.2,48.48,45.431814780578854,46.39945516507281,46.9423966230178,48.106111038837156,46.227050200000036,45.85019939999996,46.481346999999936,48.13224499999998,48.13224499999998,50.42436102717173,45.84012897282824,71359504,59.066818876010245,70.02571349379197,NaN,NaN,59.066818876010245,NaN,NaN,NaN,-0.03801328138911009,0.8981278069901037,0.9361410883792138,48.67924528301873,64.01834662857247,3500173978,6193292253.145524,23.246029930093524,21.898935809539246,33.034849731452475,85.71428571428571,0
2010-10-05,49.03,49.75999,49,49.66,45.47388627529946,46.46402040932879,47.04896930446808,48.254100463709804,46.256250150000035,45.868299299999954,46.545746999999935,48.33024499999998,48.33024499999998,50.423238980407575,46.23725101959238,99301248,67.91540289208406,70.04010228763556,NaN,NaN,NaN,NaN,NaN,NaN,-0.01941363071668256,0.9118740499833606,0.9312876807000432,92.17394706979505,70.26012208861908,3599475226,6266463863.156813,27.034647289733854,19.32411953169988,32.10754055478243,78.57142857142857,0
2010-10-06,49.59,49.71001,48.91,49.23,45.511260541216885,46.51879228241139,47.134499919979135,48.347043276689824,46.280100100000034,45.89129939999995,46.60194699999994,48.47924499999998,48.47924499999998,50.37351207779545,46.5849779222045,81831120,62.60442555521416,69.60076916236379,NaN,NaN,NaN,NaN,NaN,NaN,-0.04267000286801448,0.8779501771150251,0.9206201799830396,70.81339712918634,70.55552982733337,3517644106,6250096820.855842,25.052026650921494,18.731983275777402,30.843986264622142,71.42857142857143,0
2010-10-07,49.52,49.53999,49,49.41,45.55005396866746,46.57604392038344,47.223735217234854,48.448277250338414,46.302350050000044,45.91459939999995,46.66914699999993,48.628245499999984,48.628245499999984,50.31134232698752,46.94514867301245,75693248,63.877836713842804,69.23018180839516,NaN,NaN,NaN,NaN,NaN,NaN,-0.05191575328530573,0.8557254883764074,0.9076412416617131,75.14292816306207,79.37675745401448,3593337354,6289347300.2582,23.78413744132851,17.783953010578852,29.420407753310943,64.28571428571429,0
2010-10-08,49.45,49.87,49.08,49.75,45.59184447644191,46.63889453582139,47.322804424402115,48.57225084554428,46.324950050000034,45.94779949999995,46.74994679999993,48.78574499999998,48.78574499999998,50.25629229335055,47.31519770664941,83223808,66.21789283336909,68.71754487325407,NaN,NaN,NaN,NaN,NaN,NaN,-0.04156608720174859,0.8556836326595274,0.897249719861276,92.81437125748516,79.59023218324451,3676561162,6347287926.080985,25.112632558271187,16.470621161471506,27.750288977419157,100,0
2010-10-11,49.78,50.02,49.62,49.77,45.63341816324348,46.70089662422097,47.41877287834713,48.686322193587685,46.346000050000036,45.984899499999955,46.82914679999993,48.91174499999998,48.91174499999998,50.26120947970246,47.562280520297506,46879920,66.35596190333061,68.22411194278261,NaN,NaN,NaN,NaN,NaN,NaN,-0.03980385518083629,0.8474949008852306,0.8872987560660669,86.26373626373626,84.7403452280945,3723441082,6335567946.080986,25.59214225642127,15.833050457394712,26.09270077044246,100,64.28571428571429
2010-10-12,49.69,50.21001,49.25999,50.11,45.67796126609678,46.768403621761145,47.52431119684332,48.82191055610314,46.36665005000003,46.042499399999954,46.897946799999936,49.044744999999985,49.044744999999985,50.31365071043588,47.77583928956409,88571632,68.69810737722388,68.02674286092557,NaN,NaN,NaN,NaN,NaN,NaN,-0.023004066119540978,0.8585436734166407,0.8815477395361817,95.02440286366746,91.36750346162962,3812012714,6405491446.638869,23.286557432527115,17.82060102541454,24.102492275010142,100,57.142857142857146
2010-10-13,50.39999,50.75,50.28,50.52,45.726140755986364,46.84269265895399,47.641789189123976,48.9836333602838,46.38815005000004,46.09929939999996,46.97894679999993,49.183244999999985,49.183244999999985,50.46128852115929,47.90520147884068,71122752,71.29334957402722,68.03547148854275,NaN,NaN,NaN,NaN,NaN,NaN,0.006859967053025606,0.8901226983524637,0.8832627312994381,90.98039215686286,90.75617709475551,3883135466,6407004696.681423,27.03420099577035,16.727317808916116,22.72206201384214,100,50
2010-10-14,50.53999,50.64,50.17,50.42,45.772845823090975,46.91353042808362,47.75073863268774,49.12043018311391,46.41010005000004,46.15689939999995,47.04858679999994,49.30724499999999,49.30724499999999,50.55971144744534,48.05477855255464,68463744,69.77384921984529,67.56929454267853,NaN,NaN,NaN,NaN,NaN,NaN,0.010784249571629045,0.8967430432639745,0.8859587936923454,87.05882352941181,91.02120618331405,3814671722,6411374722.894189,25.783221803763773,17.036286063348204,20.681468010656022,92.85714285714286,42.857142857142854
2010-10-15,51.03999,51.5,50.63,51.49001,45.82973302883136,47.00415378594335,47.897376725523515,49.346104451388776,46.43670010000003,46.22479949999995,47.14178699999993,49.48199549999998,49.48199549999998,50.91552836464522,48.048462635354745,104653936,75.73361717355672,67.79946699170638,NaN,NaN,NaN,NaN,75.73361717355672,NaN,0.07288700689972016,0.9770675523169956,0.9041805454172754,99.69727272727266,92.57882947118243,3919325658,6513625227.122602,31.31569748409057,15.285884464909754,19.59178601971566,100,35.714285714285715
2010-10-18,51.52,51.72,51.3,51.3,45.88416354595742,47.08922004760784,48.03081293236573,49.5321897417327,46.46445010000004,46.29579949999995,47.232587199999934,49.605500499999984,49.605500499999984,51.208617744027535,48.00238325597243,72505184,72.98170959965094,67.85351190314734,NaN,NaN,NaN,NaN,NaN,NaN,0.08762171897917637,1.013707694141246,0.9260859751620696,88.06818181818176,91.60809269162206,3846820474,6441120043.122602,32.18474364677688,14.655265974768659,20.316607730736926,100,28.571428571428573
2010-10-19,50.81,51.3,50.42,50.82001,45.93327644599765,47.16309707636808,48.14019320952786,49.65483929013911,46.48645015000004,46.345299599999954,47.30738739999993,49.705500499999985,49.705500499999985,51.349152682822414,48.06184831717756,105739680,66.41632187012982,67.52483569034352,NaN,NaN,66.41632187012982,NaN,NaN,NaN,0.05318908623770913,0.992572332959206,0.9393832467214969,74.43210227272738,87.39918560606058,3741080794,6431509748.115331,29.443869600691457,21.923279945209163,19.414050858683375,92.85714285714286,21.428571428571427
2010-10-20,50.96001,51.57001,50.87,51.19,45.985582153002646,47.24283772832119,48.259793475820885,49.80104507203062,46.51030015000004,46.401199499999954,47.39773739999993,49.830500499999985,49.830500499999985,51.52566774782459,48.13533325217538,80861056,68.74998946078539,67.60207540558693,NaN,NaN,NaN,NaN,NaN,NaN,0.043866839002937086,0.9942167954751682,0.9503499564722311,84.94318181818177,82.48115530303029,3821941850,6424577744.32887,29.91926359843048,20.333916111624603,19.518228658353486,85.71428571428571,14.285714285714286
2010-10-21,51.50999,51.7101,50.78999,51.28999,46.03836233058471,47.322979357463346,48.37862471206321,49.94284935088484,46.53605010000004,46.46229949999995,47.51553739999994,49.96149999999999,49.96149999999999,51.682435257387006,48.24056474261297,85885312,69.36945440440726,67.78962410381982,NaN,NaN,NaN,NaN,NaN,NaN,0.033441231908875046,0.9921514963583249,0.9587102644494498,87.78380681818193,82.38636363636368,3907827162,6432034871.819801,28.634880918450666,18.55654511385604,19.785418912379978,78.57142857142857,7.142857142857143
2010-10-22,51.3,51.69,51.21001,51.64,46.0941000188376,47.4084649147413,48.506521782178375,50.10448274603867,46.56340010000004,46.516199499999956,47.64753759999994,50.06049999999998,50.06049999999998,51.92267780035086,48.198322199649105,47409152,71.49922032937648,68.67765277906027,NaN,NaN,NaN,NaN,NaN,NaN,0.03875006075772447,1.0071478403966054,0.968397779638881,97.15302491103209,89.96000451579859,3955236314,6469566911.379959,27.29455562899253,17.68796085915267,21.09773004794453,71.42857142857143,0
2010-10-25,51.85001,52.23,51.85001,51.89,46.15177066541633,47.49720818375633,48.6392072024851,50.274532008320705,46.590100100000036,46.568199499999956,47.79093759999994,50.18549999999998,50.18549999999998,52.18167287831475,48.18932712168522,51413632,72.94615960329585,69.03699254414683,NaN,NaN,NaN,NaN,NaN,NaN,0.047171907863022944,1.0273626644676597,0.9801907566046367,89.75903614457843,91.56528929126415,4006649946,6428974780.701995,31.0421666416208,16.655939980909512,22.06406608856946,100,7.142857142857143
2010-10-26,51.62,52.14999,51.42,52.03,46.21026050954154,47.58696643754333,48.772179469054315,50.44171943609969,46.61845010000004,46.63757449999996,47.935537599999954,50.318499999999986,50.318499999999986,52.43069747185637,48.2063025281436,60498256,73.74986667185016,69.8330954810494,NaN,NaN,NaN,NaN,NaN,NaN,0.04997599002071407,1.0426607441305293,0.9926847541098153,93.80804953560384,93.57337019707147,4067148202,6469584584.154864,28.802944475435282,19.703662560807327,22.37294166884849,92.85714285714286,0
2010-10-27,51.77,52.23,51.66,52.19,46.26976040496899,47.67811561699792,48.90621164673846,50.608222346947336,46.65050010000004,46.71677449999996,48.07189779999995,50.46350049999999,50.46350049999999,52.66945006109502,48.257550938904956,57483184,74.67580311202347,70.60437879520516,NaN,NaN,NaN,NaN,NaN,NaN,0.05027441920920084,1.0555277781213164,1.0052533589121155,98.73015873015876,94.09908147011367,4124631386,6518999952.856619,27.958485984263753,18.576829985796728,22.781920274570805,85.71428571428571,0
2010-10-28,52.42,52.45,51.84,52.3,46.32976278899915,47.76963808002767,49.03930138608205,50.769344028190446,46.68025005000004,46.79787449999995,48.20689779999994,50.624999999999986,50.624999999999986,52.87179060886322,48.37820939113675,61220000,75.32033774784917,71.25455343195374,NaN,NaN,NaN,NaN,NaN,NaN,0.04568124074623814,1.0623549098449132,1.016673669098675,95.29782038300803,95.94534288292353,4185851386,6550111756.135306,28.45978446149356,17.428139256253196,23.014633025762922,100,0
2010-10-29,52.28999,52.49001,52.1698,52.17999,46.38797400502901,47.85697178141326,49.162465645451384,50.90369126360088,46.70920000000004,46.88147429999995,48.35329759999994,50.78349999999999,50.78349999999999,52.999245102685286,48.56775489731469,46668688,73.13340314639537,71.73865637788694,NaN,NaN,NaN,NaN,NaN,NaN,0.02348006173569739,1.0460237462682969,1.0225436845325995,90.40191701599365,94.80996537638681,4139182698,6506413330.967321,27.920566348232523,16.839498403451387,23.1002219684215,100,7.142857142857143
2010-11-01,52.38,52.75,51.98,52.22,46.4460041144317,47.943368379801115,49.2823689534729,51.02905400040079,46.74104995000003,46.95297419999995,48.499297599999935,50.970499999999994,50.970499999999994,53.00055772333489,48.940442276665095,60555552,73.4105870995654,72.0752620723399,NaN,NaN,NaN,NaN,NaN,NaN,0.0015649383489182433,1.0244998574687472,1.022934919119829,79.45736434108521,88.38570058002897,4199738250,6483606694.499789,28.390635514994884,15.485078556431114,24.251439686042364,100,0
2010-11-02,52.66,52.92999,52.575,52.78,46.509028949113976,48.03914326336941,49.41953095529749,51.195810762267385,46.77199995000004,47.02577419999995,48.66529759999994,51.12649999999999,51.12649999999999,53.20860623169788,49.04439376830211,48137408,76.98903298937127,72.48209660200733,NaN,NaN,NaN,NaN,NaN,NaN,0.014158916263748322,1.0406335644495144,1.026474648185766,94.56556002014516,88.14161379240801,4247875658,6491066168.890843,28.165827074720234,14.339794351608532,24.892521844378884,100,7.142857142857143
2010-11-03,52.84,53.03999,52.36,53.02,46.57381473071483,48.13777408983734,49.56072581979563,51.369543070622875,46.807499950000036,47.10107409999995,48.852697799999945,51.315999999999995,51.315999999999995,53.3627660736088,49.26923392639119,126225808,78.33476040693306,73.09359025822789,NaN,NaN,NaN,NaN,NaN,NaN,0.027268409733308907,1.0605601603524022,1.0332917506190933,99.2370199886259,91.08664811661875,4374101466,6609870532.746312,26.16950613316295,15.564436799595665,25.248499109689654,100,0
2010-11-04,53.63,53.8614,53.5,53.67,46.64442353936443,48.247323117761354,49.72187382686246,51.58863420675403,46.84839990000004,47.170673999999956,49.04469759999994,51.528999999999996,51.528999999999996,53.624106527142,49.433893472857996,84201008,81.49175767595734,73.50488600839935,NaN,NaN,NaN,NaN,NaN,NaN,0.06611688899891921,1.1159378618677422,1.049820972868823,94.43830999012026,96.0802966662971,4458302474,6604884640.186268,32.33585593771737,14.221267308208773,25.570694447161056,100,14.285714285714286
2010-11-05,53.7,53.81,53.50999,53.67,46.714329772803595,48.354702858003705,49.8767023042404,51.786859520396504,46.89594990000004,47.23837409999996,49.24729779999994,51.72499999999999,51.72499999999999,53.85093870092141,49.59906129907856,77937056,81.49175767595734,74.11274658527839,NaN,NaN,NaN,NaN,NaN,NaN,0.07742938919172326,1.1466077093584772,1.069178320166754,94.43830999012026,96.03787998962214,4458302474,6610082868.547189,31.29870564845326,13.765129962383742,25.67670535287702,92.85714285714286,7.142857142857143
2010-11-08,53.57001,53.83,53.44991,53.7375,46.78421206362147,48.46129290041947,50.02810613544666,51.972634804168266,46.94308740000004,47.305249099999955,49.44064759999995,51.923374999999986,51.923374999999986,54.022858519243734,49.82389148075624,39623424,81.81097027599787,75.21236432855468,NaN,NaN,NaN,NaN,81.81097027599787,NaN,0.07502106627649319,1.1629546530123704,1.0879335867358773,95.96602212013354,94.94754736679135,4497925898,6630420509.074853,29.986451937211683,13.850729868216177,27.260094423593575,85.71428571428571,0
2010-11-09,53.97,54.0401,53.21001,53.45,46.850538311744636,48.56007917961909,50.16229805170366,52.113336251390336,46.988587350000046,47.36974909999995,49.63744759999995,52.09037499999998,52.09037499999998,54.116387351289795,50.064362648710166,66969744,75.81334578224792,75.71688978008773,NaN,NaN,NaN,NaN,NaN,NaN,0.041312786679931435,1.1395745700857915,1.0982617834058601,81.84369144428959,90.74934118484778,4430956154,6602174442.89909,27.294936122803843,15.20156131612439,27.93032538019063,100,7.142857142857143
2010-11-10,53.53,53.77,53.10001,53.715,46.91884141312031,48.66215681962663,50.30161969673489,52.26587565601983,47.03366235000004,47.44089899999995,49.84254739999995,52.25012499999999,52.25012499999999,54.25943123538968,50.2408187646103,83553632,77.45404535619063,76.29436056235795,NaN,NaN,NaN,NaN,NaN,NaN,0.024918443394887024,1.1294098376494688,1.1044913942545818,88.51273281061738,88.77414879168016,4514509786,6672010109.675729,25.319534556877144,15.289609224899664,28.169068327661197,92.85714285714286,0
2010-11-11,52.89999,53.48,52.66,53.38499,46.98318120005444,48.75567826874293,50.422536179215875,52.37245797449413,47.082837300000044,47.512348799999955,50.01504739999995,52.39837449999999,52.39837449999999,54.27909566516349,50.51765333483649,85163504,70.9952916101549,76.25836565384213,NaN,NaN,NaN,NaN,NaN,NaN,-0.017793383792554796,1.0822496645138884,1.1000430483064432,74.99675584901338,81.78439336797344,4429346282,6737438529.492705,22.551806193297,18.17735833700467,27.41078597918201,85.71428571428571,0
2010-11-12,53.10001,53.3672,52.11,52.50999,47.038174322441954,48.830021075302476,50.50439711336427,52.38555626263755,47.131437300000044,47.576948699999946,50.16004739999995,52.44937349999998,52.44937349999998,54.2835422218172,50.61520477818276,99164256,57.34185456641417,75.14377243692202,NaN,NaN,NaN,NaN,NaN,NaN,-0.10950090935960799,0.9631669116069332,1.0726678209665412,41.60108392809435,68.37019086257503,4330182026,6701374354.239509,19.743010643159806,21.286120274466935,25.525072284718927,78.57142857142857,7.142857142857143
2010-11-15,52.78,52.88,52.28999,52.315,47.09068005057686,48.89903055895985,50.5754011481343,52.378836618576834,47.176712350000045,47.64659859999994,50.28614759999994,52.50012349999999,52.50012349999999,54.25889352734568,50.741353472654296,56723376,54.812102966338,73.79107502938542,NaN,NaN,NaN,NaN,NaN,NaN,-0.1834643051420224,0.8433374395390132,1.0268017446810356,27.519852107054305,48.039230628054014,4273458650,6649459885.321625,18.589194410641802,20.04212200369055,24.45379794575786,71.42857142857143,0
2010-11-16,51.92999,52.2462,50.85001,51.45,47.134056368481566,48.94954480531708,50.60969914232511,52.290375988236185,47.21571240000004,47.70839859999995,50.40114759999994,52.53162299999998,52.53162299999998,54.188517303678914,50.87472869632105,101096624,45.27070784298933,71.69071108159729,NaN,NaN,45.27070784298933,NaN,NaN,NaN,-0.2847690613827508,0.6708404179525971,0.9556094793353479,18.807933318495856,29.3096231178815,4172362026,6635252529.163051,16.076824883038032,30.617871958695265,25.2381114566266,64.28571428571429,100
2010-11-17,51.49001,51.87,51.35001,51.60001,47.17849371804891,49.00202926461773,50.64853486223393,52.224626846499405,47.25426245000004,47.77329869999995,50.50814779999994,52.55212349999998,52.55212349999998,54.15125068477627,50.952996315223686,77836128,46.99396281406762,69.66739858632717,NaN,NaN,NaN,NaN,NaN,NaN,-0.3324756767029531,0.5400148834566565,0.8724905601596096,23.510308486594386,23.27936463738151,4250198154,6632260271.237475,15.287070177876416,29.1138057878354,25.745273714000728,57.142857142857146,92.85714285714286
2010-11-18,52.14999,52.78999,52.13,52.42999,47.23074741239668,49.069909675219364,50.71839584802868,52.24418524207089,47.30331240000004,47.863898599999956,50.628147799999944,52.60912349999999,52.60912349999999,54.101972747943485,51.11627425205649,71488256,55.36756605597302,68.39841022272557,NaN,NaN,NaN,NaN,NaN,NaN,-0.2999352798699627,0.49757146032215616,0.7975067401921189,49.52775627019917,30.61533269176313,4321686410,6625760157.231868,21.985178619281555,25.969757619837193,24.570445999665903,50,85.71428571428571
2010-11-19,52.34,52.59,52.14,52.47,47.28287927894,49.137238196502146,50.787086206929516,52.26569140949271,47.350762400000036,47.961498499999955,50.74554759999994,52.65062349999998,52.65062349999998,54.07811811473305,51.22312888526691,54512704,55.73062408813526,67.13555572190913,NaN,NaN,NaN,NaN,NaN,NaN,-0.2685338585473114,0.4618394170079796,0.730373275555291,50.78195286026409,41.27333920568588,4376199114,6651199419.098534,21.059018918431345,24.875741357115242,23.062953918466054,42.857142857142854,78.57142857142857
2010-11-22,52.25,52.91,52.17,52.91,47.33887052989582,49.21194635102685,50.870337728226396,52.32705413239817,47.40196240000004,48.06469849999995,50.858747599999944,52.70162349999998,52.70162349999998,54.08909691851673,51.314150081483234,69918816,59.6206591211338,65.8949575884636,NaN,NaN,NaN,NaN,59.6206591211338,NaN,-0.21335396907017257,0.46368081421757523,0.6770347832877478,64.5746671723994,54.961458767620876,4446117930,6721118235.098534,22.599143061281094,23.148760540728052,20.82537287651209,35.714285714285715,71.42857142857143
2010-11-23,52.39,52.45,51.77,52.07001,47.385946544523726,49.2685416708085,50.9173836996685,52.302573738836436,47.446762450000044,48.160698599999954,50.95114779999994,52.70362399999999,52.70362399999999,54.08732843976002,51.31991956023996,76900944,50.49784047112456,63.90660616447728,NaN,NaN,NaN,NaN,NaN,NaN,-0.2273625120635041,0.3928316432083676,0.6201941552718717,38.24343513819372,51.20001839028573,4369216986,6712073327.008652,20.265055745777886,24.381841464224724,19.668917786949798,28.571428571428573,64.28571428571429
2010-11-24,52.58,53.25,52.56,53.12,47.44300180278717,49.34480817237665,51.00376080948542,52.38042385894725,47.49726245000004,48.26589849999995,51.05854779999994,52.75012399999999,52.75012399999999,54.124133042404445,51.37611495759554,53455536,58.952800056836594,62.29668062025436,NaN,NaN,NaN,NaN,NaN,NaN,-0.16287035973710162,0.41660620560049466,0.5794765653375963,71.15755354864585,57.99188528641298,4422672522,6745386197.269521,25.172389455024756,21.864600282560033,17.392061169821833,21.428571428571427,57.142857142857146
2010-11-26,52.8,53.13,52.67,52.968,47.4979769092271,49.416554545200874,51.080789797348736,52.436383491428465,47.54375245000005,48.35597839999995,51.159107799999944,52.783523999999986,52.783523999999986,54.14455679747942,51.422491202520554,23640288,57.423748813303334,60.57753713006479,NaN,NaN,NaN,NaN,NaN,NaN,-0.12889325682573616,0.41835999430542614,0.5472532511311623,66.39279769536292,58.597928794067485,4399032234,6752375499.808651,24.126659131376336,20.95628462302455,15.115204552693871,14.285714285714286,50
2010-11-29,52.7,52.89999,52.10001,52.73,47.55003684047857,49.482167326484024,51.14546470725663,52.46434696843528,47.58860250000004,48.441278399999945,51.25380779999995,52.811024499999995,52.811024499999995,54.14410644485295,51.47794255514704,89265936,55.017521367370854,58.66371935087715,NaN,NaN,NaN,NaN,NaN,NaN,-0.1210180768756649,0.3959806550365812,0.5169987319122461,58.93219313561675,65.49418145987516,4309766298,6803704696.238561,22.24847933117452,24.436927265865286,12.820872218549031,7.142857142857143,42.857142857142854
2010-11-30,52.17999,52.7355,51.88,52.08501,47.59516095151859,49.533708765563546,51.182309620697545,52.42821963810811,47.627427500000046,48.515928499999944,51.31890999999994,52.804275,52.804275,54.15055976468165,51.45799023531834,118861504,49.02237008295425,56.750078229499024,NaN,NaN,49.02237008295425,NaN,NaN,NaN,-0.15561323282606782,0.32248219087966135,0.47809542370572916,42.2946653926896,55.87321874122309,4190904794,6741810572.565947,20.550427966883998,24.534634646593283,11.419425307271084,0,35.714285714285715
2010-12-01,52.87,53.46001,52.84,53.19,47.65083099180198,49.60611057218605,51.26104257674862,52.50077014876448,47.670527450000044,48.60032849999994,51.40630979999994,52.82477499999999,52.82477499999999,54.181403382283584,51.46814661771639,81758064,57.55553664234423,55.32875617851,NaN,NaN,NaN,NaN,NaN,NaN,-0.10298012792847921,0.34937026379513014,0.45235039172360936,88.97334210396241,63.40006687742292,4272662858,6752358511.372353,24.300965477575808,21.671703470599738,10.063746593350658,0,28.571428571428573
2010-12-02,53.27,53.81,53.21001,53.73,47.71132023566465,49.68777174897444,51.35786443648397,52.617839658405956,47.71492740000005,48.68432849999995,51.50710979999994,52.86027499999999,52.86027499999999,54.27153807526823,51.44901192473174,56883984,60.991946510716005,54.61423152855008,NaN,NaN,NaN,NaN,NaN,NaN,-0.03425478269248022,0.4095319133580091,0.4437866960504893,97.2972881665139,76.18843188772198,4329546842,6794073180.150432,26.024960990462148,20.509555987948076,10.143171962657235,100,21.428571428571427
2010-12-03,53.5,53.94,53.5,53.87,47.77260063132968,49.770588149984846,51.456379556621854,52.737093024272056,47.760127400000044,48.767428499999944,51.61110979999994,52.87027499999999,52.87027499999999,54.306952231536194,51.43359776846379,38014160,61.8542284179537,54.93654394651718,NaN,NaN,NaN,NaN,NaN,NaN,0.015505178920345641,0.46316816970092134,0.4476629907805757,97.73462050038997,94.66841692362209,4367561002,6819991925.604977,26.16356423106611,19.702086558200786,10.880802407553935,100,14.285714285714286
2010-12-06,53.86,53.95,53.67999,53.845,47.833022515595054,49.851269572757424,51.55005094655825,52.842607974341384,47.805652350000045,48.849878399999945,51.69480979999994,52.87902499999999,52.87902499999999,54.33705139469038,51.420998605309606,39311536,61.592398801722695,55.4208507919018,NaN,NaN,NaN,NaN,NaN,NaN,0.040204252117464534,0.4979183059274064,0.45771405380994185,96.61289229965246,97.21493365551878,4328249466,6828728954.883003,25.59400851239789,19.20246780398015,11.631298434220115,100,7.142857142857143
2010-12-07,54.49001,54.52,53.82001,53.88,47.89319144578814,49.93104641290084,51.64142149767361,52.9414072148803,47.85425235000005,48.94527839999994,51.78460979999994,52.88615,52.88615,54.3621690480181,51.4101309519819,59067232,61.8359646447043,56.60408342059572,NaN,NaN,NaN,NaN,NaN,NaN,0.05163830594143143,0.5222619362367311,0.4706236302952997,79.81066186328665,91.38605822110969,4387316698,6779785991.080206,29.28571914561101,17.93285138806075,11.124337307794471,100,0
2010-12-08,54.02,54.14999,53.6899,54.08,47.95475172990965,50.013203909675084,51.73705202717661,53.04984462298694,47.90160235000005,49.03887839999994,51.87880979999994,52.917649999999995,52.917649999999995,54.46559490538739,51.3697050946126,48066848,63.2693864858446,57.76661368286551,NaN,NaN,NaN,NaN,NaN,NaN,0.06457093099842875,0.5513372940433356,0.4867663630449069,83.99999999999983,86.80785138764632,4435383546,6813228749.48243,27.976407385776962,18.395420223407534,10.375804588268553,92.85714285714286,0
2010-12-09,54.41,54.44,53.95,54.13499,48.01624663806975,50.094823436216174,51.83108881042459,53.15319180175009,47.94927725000005,49.12762839999994,51.97570979999994,52.93864949999998,52.93864949999998,54.53977393137264,51.33752506862732,51679728,63.673388034893705,58.35988668135985,NaN,NaN,NaN,NaN,NaN,NaN,0.06836351225319426,0.5722207533613997,0.5038572411082054,85.99963636363633,83.27009940897427,4487063274,6800570380.18741,29.498678414360157,17.498161743605685,11.606213440266444,85.71428571428571,21.428571428571427
2010-12-10,54.28999,54.55,54.09,54.495,48.080711845651145,50.18195564540001,51.935555915898135,53.28098305872627,47.99795230000005,49.226178399999945,52.08420959999994,52.99414999999999,52.99414999999999,54.72501095054397,51.26328904945601,44696144,66.28770753222881,59.11396407022367,NaN,NaN,NaN,NaN,66.28770753222881,NaN,0.08553832729320587,0.6107801502247128,0.5252418229315069,98.02158273381295,89.34040636581636,4531759418,6834578315.839584,29.236182757133772,16.675839569011654,12.966814122700233,100,14.285714285714286
2010-12-13,54.71001,54.74001,54.27,54.3,48.14259530987352,50.26350107816437,52.028279213313894,53.37803229122853,48.04240230000005,49.31147839999995,52.19000979999994,53.0836505,53.0836505,54.88864494195622,51.27865605804377,53110160,63.617086452279715,59.39942316530552,NaN,NaN,NaN,NaN,NaN,NaN,0.07458613428245708,0.6184744907845783,0.5438883565021212,85.18489836734551,89.73537248826494,4478649258,6788248032.01243,29.786408745307813,15.85591332420488,15.061071287731734,100,7.142857142857143
2010-12-14,54.42,54.62,54.23,54.395,48.20480829186483,50.3453129380027,52.121091793183936,53.47488635873057,48.08662730000005,49.39482839999995,52.30830979999994,53.1876505,53.1876505,55.042509987803754,51.33279101219624,69944000,64.37020997628915,60.39030670138872,NaN,NaN,NaN,NaN,NaN,NaN,0.06491573521132199,0.6250330255162737,0.5601172903049517,87.93675546589014,90.38107885568287,4548593258,6777487416.627817,28.532767784315354,15.620243208112283,16.491369948368614,92.85714285714286,0
2010-12-15,54.37,54.7,54.03,54.16,48.264063930751746,50.42085129566601,52.201048977764955,53.54013527694671,48.129427250000056,49.47202839999994,52.39830979999995,53.3231505,53.3231505,55.04136747625591,51.60493352374409,76951808,61.00609444712609,60.53697058640939,NaN,NaN,61.00609444712609,NaN,NaN,NaN,0.035347892896470445,0.6043021564255397,0.5689542635290693,79.72000097901747,84.2805516040844,4471641450,6730397504.269608,26.47152622915266,16.648271911145677,17.616298085681194,85.71428571428571,21.428571428571427
2010-12-16,54.21001,54.66,54.06,54.58,48.326909065769144,50.50321067594985,52.29434117471535,53.63917001247559,48.17357725000005,49.553628399999944,52.50530979999995,53.47215,53.47215,55.08011693687221,51.86418306312779,65519392,64.56997803051502,61.04741553049594,NaN,NaN,NaN,NaN,NaN,NaN,0.036578718589188375,0.6146776617655547,0.5780989431763663,94.40526431725762,87.35400692072176,4537160842,6778445058.402941,24.747375364694843,15.563931999693223,18.741226222993777,78.57142857142857,14.285714285714286
2010-12-17,54.53999,54.67999,54.41,54.52,48.388531861134624,50.58275105860431,52.381621912961805,53.72305858271601,48.213977250000056,49.638328399999935,52.607509799999946,53.57665049999999,53.57665049999999,55.17172249945849,51.981578500541495,36849552,63.67465446837887,61.66578218056794,NaN,NaN,NaN,NaN,NaN,NaN,0.02633318187178424,0.6110154205160967,0.5846822386443125,92.30736955465207,88.81087828364241,4500311290,6771622179.390831,24.216715989302003,15.087719281718934,20.065421161007798,71.42857142857143,7.142857142857143
2010-12-20,54.59,54.75999,54.16,54.56,48.449939504307416,50.66150846338442,52.46704850461036,53.802767289124006,48.25412725000005,49.726828299999944,52.70370979999995,53.68115049999999,53.68115049999999,55.24608943345961,52.116211566540365,48159600,64.03271010501342,62.737949325000734,NaN,NaN,NaN,NaN,NaN,NaN,0.015753319228104856,0.6043738876794436,0.5886205684513387,89.58379991562457,92.09881126251143,4548470890,6787676449.622002,22.564423517469674,16.901232812506045,20.459176880468856,100,0
2010-12-21,54.76019,54.89,54.62,54.89,48.51401970824465,50.74524096905998,52.56206621031192,53.90631326158839,48.29462730000006,49.81762829999994,52.80610979999995,53.78015049999999,53.78015049999999,55.387371290513386,52.172929709486596,35775344,66.92890612797582,63.40747571683156,NaN,NaN,NaN,NaN,66.92890612797582,NaN,0.023989738959017903,0.618607742150111,0.5946180031910931,100,93.96372315675892,4584246234,6823451793.622002,23.218261475441953,16.244726813265032,21.312883379075796,100,0
2010-12-22,54.86,54.96001,54.78999,54.88499,48.5774124474661,50.82721619739542,52.65316126088792,53.99952057000854,48.33320225000005,49.89977819999994,52.901609599999944,53.9208995,53.9208995,55.39165967883787,52.450139321162126,35766432,66.84090848272206,63.82525871483199,NaN,NaN,NaN,NaN,NaN,NaN,0.02215384019475064,0.6223103034345314,0.6001564632397808,94.86167902959602,94.81515964840689,4548479802,6827654906.851975,23.597156273682014,15.902004066023775,21.85784938315081,100,0
2010-12-23,54.78,54.87,54.61,54.742,48.638751627093306,50.904736668734124,52.73507650555898,54.0702328966744,48.37016220000006,49.982498199999945,52.986049599999944,54.00199949999999,54.00199949999999,55.46602814318322,52.537970856816756,21668240,64.24465582346636,63.99600352951147,NaN,NaN,NaN,NaN,NaN,NaN,0.005244993841225343,0.6067127055413124,0.6014677117000871,82.96823487133017,92.60997130030876,4526811562,6827988264.390437,22.760747440823774,17.658365387432482,21.753267268168564,92.85714285714286,0
2010-12-27,54.62,54.86,54.21001,54.77,48.69975907358989,50.981276536679985,52.81487742690961,54.13687738270541,48.40721220000006,50.06081819999995,53.07304959999995,54.092099499999996,54.092099499999996,55.51162117593738,52.672577824062614,29263424,64.53515156281253,64.2062001553036,NaN,NaN,NaN,NaN,NaN,NaN,-0.009324666449070818,0.5898118786387485,0.5991365450878193,85.03987843572648,87.62326411221757,4556074986,6849147846.300559,20.877084282014135,21.289801750797963,20.804039935936594,85.71428571428571,0
2010-12-28,54.88,54.92,54.55,54.67,48.759164455942226,51.05432056565662,52.88762733173669,54.18765096530489,48.44436215000006,50.13921819999995,53.13664939999994,54.18909949999998,54.18909949999998,55.482597306902896,52.89560169309707,24168608,62.57964817181686,64.25932040724021,NaN,NaN,NaN,NaN,NaN,NaN,-0.029811812732500664,0.5618717791721934,0.5916835919046941,77.16654462999297,81.72488597901656,4531906378,6840656173.219479,20.652038639470447,20.26184364363874,19.15478793698159,78.57142857142857,7.142857142857143
2010-12-29,54.82001,54.89999,54.73,54.78999,48.81917267031096,51.12829421782183,52.96222978931564,54.24501658765681,48.48061215000006,50.219518199999946,53.206449199999945,54.324348499999985,54.324348499999985,55.21133370971603,53.43736329028394,24132688,63.989648882991254,64.31076772132211,NaN,NaN,NaN,NaN,NaN,NaN,-0.038826759519312914,0.5431501425055529,0.5819769020248658,83.16650330194801,81.79097545588918,4556039066,6833556486.609209,20.00542697294743,19.627448913222043,17.747107531126865,71.42857142857143,0
2010-12-30,54.78999,54.8,54.55,54.66,48.87729035518349,51.198228985785754,53.02880901326405,54.28453881740378,48.51556215000005,50.295318199999954,53.28324899999994,54.39784849999999,54.39784849999999,55.12607706594156,53.66961993405842,27562160,61.29509566009017,64.14088969455044,NaN,NaN,NaN,NaN,NaN,NaN,-0.05604322107037896,0.5119228756868921,0.567966096757271,67.74120708379462,76.02475167191189,4528476906,6830249027.409209,19.29811464419418,21.4791340145713,16.305242342279442,64.28571428571429,0
2010-12-31,54.60001,54.62,54.21001,54.46001,48.932839804385644,51.262818708839504,53.08493454215566,54.30125035860342,48.548712200000054,50.37319329999995,53.34864919999995,54.43434899999998,54.43434899999998,55.095072985398446,53.77362501460152,38565920,57.29752695435591,63.49873393898808,NaN,NaN,57.29752695435591,NaN,NaN,NaN,-0.08183722045261299,0.46566957119150487,0.5475067916441179,46.23713723508325,65.714949206942,4489910986,6838715864.305718,18.060352587827772,24.947507562042517,15.49497775120142,57.142857142857146,21.428571428571427
2011-01-03,54.959,55.69,54.95,55.31,48.99629413469027,51.34296091262486,53.17219201109073,54.39732175302214,48.587812150000055,50.47229339999994,53.42904939999994,54.506348999999986,54.506348999999986,55.21731676360144,53.79538123639853,90994320,67.11427856744844,63.74853337578585,NaN,NaN,NaN,NaN,NaN,NaN,-0.04446149606806693,0.49192992155903426,0.5363914176271012,77.10843373493998,63.69559268460599,4580905306,6836256558.359773,29.007944387195128,20.98542551935713,14.461132078035643,100,14.285714285714286
2011-01-04,55.53,55.55,54.92,55.265,49.05866931742967,51.42062505296892,53.25426291261658,54.47995777654384,48.62453715000005,50.57454349999995,53.50154939999994,54.577348999999984,54.577348999999984,55.293550737557034,53.861147262442934,43851456,66.2460024958587,63.882518555755105,NaN,NaN,NaN,NaN,NaN,NaN,-0.026466344057110014,0.5033084875557137,0.5297748316128237,74.3975903614459,65.91438711048974,4537053850,6840432887.50263,26.671440906587975,19.67866926625902,13.449839456060603,92.85714285714286,7.142857142857143
2011-01-05,55.11,55.75999,55.07001,55.74001,49.12515031924629,51.50615742815766,53.35174319055319,54.59996275020633,48.66197470000006,50.68474359999995,53.578549599999945,54.670349499999986,54.670349499999986,55.4774712699347,53.86322773006527,43787168,70.5736703759266,64.5659168363837,NaN,NaN,NaN,NaN,NaN,NaN,0.01168425056368605,0.5443801448174312,0.5326958942537452,98.82469896881723,83.44357435506772,4580841018,6881684133.83348,26.99789613736911,17.971364089254738,13.256365398032212,100,0
2011-01-06,55.78999,55.96001,55.67999,55.92,49.192760763830904,51.593560251362454,53.45245914386483,54.72568058352002,48.70147470000004,50.795943599999944,53.65634959999994,54.762349499999985,54.762349499999985,55.68982581748915,53.83487318251082,46139536,72.03668181676125,65.09925282111558,NaN,NaN,NaN,NaN,NaN,NaN,0.04161385097563364,0.5847132079732873,0.5430993569976537,97.77723457091932,90.33317463372752,4626980554,6914638591.372229,28.621171566655377,17.31481017114745,13.387221983222748,100,0
2011-01-07,56.02,56.05,55.32001,55.87,49.25920095523557,51.678242226583,53.547264667634835,54.83466338508954,48.74107470000004,50.900923699999936,53.729949599999934,54.849099999999986,54.849099999999986,55.847484525162535,53.850715474837436,72261632,70.98093530471614,65.6211300237111,NaN,NaN,NaN,NaN,NaN,NaN,0.05004946148926359,0.6056611838592332,0.5556117223699696,90.4761904761905,95.69270800530904,4554718922,6951263861.887824,25.958700787236516,20.291426856148085,12.60344722868369,100,7.142857142857143
2011-01-10,55.72,56.17999,55.58,56.08,49.32706960244715,51.765405746848685,53.646587621845235,54.95326687222387,48.781474700000054,51.006223699999936,53.80554959999994,54.92834999999999,54.92834999999999,56.04620285708001,53.810497142919964,55551760,72.78498504070494,66.24629251911763,NaN,NaN,NaN,NaN,NaN,NaN,0.06104936664599259,0.6319234306774604,0.5708740640314678,94.924313952426,94.39257966651196,4610270682,6988299911.684654,25.632082200544016,18.74774347022963,12.686493494842406,100,0
2011-01-11,56.28999,56.36,55.95,56.16,49.395058959636735,51.85242741522792,53.745152813145424,55.06819383677398,48.821124700000055,51.119223699999935,53.88514979999994,55.02135,55.02135,56.22111106374517,53.82158893625483,56663776,73.46183341069246,66.71293018216883,NaN,NaN,NaN,NaN,NaN,NaN,0.06464444864967922,0.6516796248435668,0.5870351761938876,90.69763115177268,92.03271186012974,4666934458,6989681955.001726,26.600845113021194,17.753800413160647,12.84899887077365,100,21.428571428571427
2011-01-12,56.42,56.56,56.2,56.55499,49.46630205456572,51.945547466411526,53.85534250674756,55.209793471366936,48.861949650000064,51.235573599999945,53.971849599999935,55.12934949999999,55.12934949999999,56.465283071514925,53.793415928485054,51978976,76.56136409343029,67.40724844007654,NaN,NaN,NaN,NaN,NaN,NaN,0.08336445896830369,0.6912407499042672,0.6078762909359635,99.78680760343637,95.13625090254504,4718913434,7040214182.836391,27.83546143555609,16.817051548383805,13.220005217389408,100,14.285714285714286
2011-01-13,56.59,56.73,56.41,56.575,49.537035367455616,52.03721979380932,53.961995741777066,55.33981314076056,48.90402465000005,51.35652359999994,54.047749599999946,55.25009949999999,55.25009949999999,56.64883093973324,53.85136806026674,47430384,76.70976772036562,68.29761357556936,NaN,NaN,NaN,NaN,NaN,NaN,0.08646279541868496,0.7159547852093198,0.6294919897906348,93.84918194119841,94.77787356546918,4766343818,7041696382.336393,28.935077290825483,16.0858283797853,14.356929569250147,100,7.142857142857143
2011-01-14,56.59,57.02,56.46001,57,49.6112937220083,52.135492669179435,54.08113316366816,55.49792617497384,48.94822465000006,51.49002369999994,54.127349599999945,55.37109949999999,55.37109949999999,56.92689811309174,53.81530088690825,43867392,79.65604782611152,69.37767759437642,NaN,NaN,NaN,NaN,NaN,NaN,0.10525579888321368,0.7610617383946519,0.6558059395114382,99.2882536948529,97.64141441316258,4810211210,7082430333.23923,30.665795357504994,14.867529425372519,16.765306729281246,100,0
2011-01-18,56.52,57.23,56.49001,57.16,49.68640522726195,52.23498786384915,54.201873039602745,55.65621892021443,48.990974650000055,51.620923599999934,54.197149599999946,55.5030995,55.5030995,57.19010046398808,53.816098536011914,65803008,80.64854564115697,70.66831312790072,NaN,NaN,NaN,NaN,80.64854564115697,NaN,0.11574917511201777,0.8004924084014604,0.6847432332894426,97.68211153017062,96.93984905540732,4876014218,7135783955.274555,30.443280271607986,13.421005090376529,19.46909151596679,100,21.428571428571427
2011-01-19,57.24001,57.25999,56.32001,56.50999,49.754301593159845,52.3196413714957,54.29238743020656,55.737530451622575,49.02977460000005,51.75062359999993,54.25394939999995,55.60059899999999,55.60059899999999,57.28369911731874,53.91749888268124,67767184,66.46265364016398,70.84495632484162,NaN,NaN,NaN,NaN,NaN,NaN,0.06853366400589167,0.7704103132968072,0.7018766492909155,75.40967481753982,90.79334668085447,4808247034,7095409714.988932,26.867348732838746,13.968905407740209,21.657096290994236,100,14.285714285714286
2011-01-20,56.3,56.35001,55.67999,56.11,49.817542373327406,52.394697978000735,54.36366635451218,55.77300374194424,49.067174600000065,51.871023499999936,54.301399399999944,55.66159899999999,55.66159899999999,57.325585085553826,53.99761291444615,92357744,59.524131824241394,70.71845890799528,NaN,NaN,NaN,NaN,NaN,NaN,0.003421945661768566,0.7061540813681262,0.7027321357063576,62.29516259123009,78.46231631298019,4715889290,7121599935.221164,24.167867886157577,20.313053982123,21.894067740109993,92.85714285714286,7.142857142857143
2011-01-21,56.39,56.49001,55.64999,55.67999,49.875875185533104,52.45975326556508,54.41528688962935,55.7641452903305,49.10187450000006,51.991723399999934,54.345999199999945,55.70134899999999,55.70134899999999,57.32676364891794,54.07593435108205,59673280,53.10549442453991,70.41902801300843,NaN,NaN,NaN,NaN,NaN,NaN,-0.07141711037852638,0.6134607477331997,0.6848778581117261,32.478343924546465,56.72772711110547,4656216010,7066188930.881267,23.427454207807425,18.30813943639881,21.626378603260942,85.71428571428571,0
2011-01-24,55.78999,56.46001,55.67999,56.45,49.94128936279148,52.53876805238557,54.495079560624276,55.829464786489496,49.13897450000006,52.12162329999994,54.40069919999994,55.786748999999986,55.786748999999986,57.38074577042329,54.19275222957668,64103248,61.178335730902134,69.99503209611227,NaN,NaN,NaN,NaN,NaN,NaN,-0.07168463927840796,0.5952720590137162,0.6669566982921241,65.3848948072428,53.386133774339804,4720319258,7128646904.369127,21.322866509885237,16.663441523944964,21.356299940814694,78.57142857142857,7.142857142857143
2011-01-25,56.17999,56.55,56.05,56.5325,50.00687354823634,52.61785185332843,54.57497840138411,55.89642052110954,49.176286950000055,52.23934839999993,54.46364939999994,55.874874,55.874874,57.42865482322247,54.321093176777524,55305024,61.93443531189413,69.68706301154336,NaN,NaN,NaN,NaN,NaN,NaN,-0.06891005360828228,0.5808191312817712,0.6497291848900535,66.78097516872283,54.88140463350404,4775624282,7180080576.689128,21.128717676804317,15.690413669332603,21.33369074272948,71.42857142857143,0
2011-01-26,56.63,56.98,56.45,56.83,50.07476535372653,52.70126072751995,54.663410620937675,55.98533285243244,49.21383690000006,52.35504849999993,54.550049599999944,55.982874,55.982874,57.48609976834401,54.47964823165599,60547616,64.6110750571375,69.26116334591556,NaN,NaN,NaN,NaN,NaN,NaN,-0.050496320154801766,0.5866087846965513,0.6371051048513531,77.83533850864421,70.00040282820329,4836171898,7206355957.21743,24.878461094773858,14.709884786550562,21.73462719634475,64.28571428571429,0
2011-01-27,57.00999,57.35001,56.92,57.17999,50.14546410642576,52.78994843588589,54.76210000835189,56.099109723629354,49.25018685000006,52.46674849999993,54.64734939999994,56.102374,56.102374,57.58716004741962,54.61758795258037,53656080,67.50585839080978,68.93753310120475,NaN,NaN,NaN,NaN,67.50585839080978,NaN,-0.019780669684464125,0.6123792677457729,0.632159937430237,91.62463054187185,78.74698140641297,4889827978,7217582295.017945,27.744829474642934,13.798742866533505,22.37437583742128,100,7.142857142857143
2011-01-28,57.16,57.22,55.47,55.73,50.20103162775486,52.84816727873964,54.80005687076946,56.06395641661703,49.278186850000054,52.56704849999993,54.732949399999946,56.155874,56.155874,57.49929669394835,54.81245130605164,123359808,49.45636729025951,67.40006395731498,NaN,NaN,49.45636729025951,NaN,NaN,NaN,-0.09779001547964217,0.5099224180806843,0.6077124335603264,13.829713671735693,61.09656090741726,4766468170,7130877972.823659,22.658361684704293,26.459239752916147,22.051860864488976,92.85714285714286,0
2011-01-31,55.81,56.16,55.39,56,50.258732805588146,52.9105798078735,54.84711346407262,56.05786532932017,49.310536850000055,52.66454849999993,54.82094919999995,56.2328735,56.2328735,57.333208559011815,55.13253844098818,70570560,52.02848237279826,65.91745662389307,NaN,NaN,NaN,NaN,NaN,NaN,-0.1298680769540197,0.44537733736780183,0.5752454143218215,31.122290192396996,45.52554480200152,4837038730,7172120507.888595,20.847345380857345,25.174841472992387,21.61548579590797,85.71428571428571,100
2011-02-01,56.4194,57.17999,56.36,57.05,50.326307603542496,52.99254852454928,54.93350117136389,56.1523543455754,49.34828685000006,52.770748599999926,54.91334939999995,56.319873499999986,56.319873499999986,57.389294505074396,55.250452494925575,76952816,60.456241376104195,64.98848576427963,NaN,NaN,NaN,NaN,NaN,NaN,-0.08140194086922858,0.47349298823528585,0.5548949291045144,84.69344544160485,43.21514976857918,4913991546,7224675229.88296,28.491237140615116,22.241096642196315,21.070749014607518,78.57142857142857,92.85714285714286
2011-02-02,56.92,57.17,56.84,56.955,50.39226474181571,53.071012910201766,55.012775635231975,56.22879678885393,49.38431185000006,52.874298499999924,55.003049399999945,56.404373499999984,56.404373499999984,57.39089557278739,55.417851427212575,48660944,59.4387809336774,63.76544411001157,NaN,NaN,NaN,NaN,NaN,NaN,-0.0578786306768857,0.48254664075840736,0.5404252714352931,79.846531395248,65.22075567641662,4865330602,7209929489.276898,27.52517303267296,21.486958621398717,20.18817296987724,71.42857142857143,85.71428571428571
2011-02-03,56.85001,57.14,56.39999,57.0575,50.45858549065336,53.14995324861361,55.09296090443856,56.30772090420117,49.41944935000006,52.97237349999992,55.085999399999935,56.47024799999999,56.47024799999999,57.446417592880536,55.494078407119446,45341872,60.21674870642711,62.587371323301674,NaN,NaN,NaN,NaN,NaN,NaN,-0.03848622561085069,0.4923174894217297,0.5308037150325804,85.07609655052778,83.20535779579355,4910672474,7245161485.896835,25.441871974095378,24.361029291537957,18.304573902817545,64.28571428571429,78.57142857142857
2011-02-04,57.05,57.42,56.89999,57.375,50.52740553552248,53.233617540720275,55.18245263367626,56.40936653237249,49.454774350000065,53.07162349999992,55.19209919999994,56.54299799999999,56.54299799999999,57.560297114353936,55.525698885646044,47647712,62.6090799221547,61.369730758733326,NaN,NaN,NaN,NaN,NaN,NaN,-0.008891058153123077,0.5196898923411766,0.5285809504942997,97.78325123152702,87.56862639243427,4958320186,7284562637.099927,26.98059316974562,23.041291695160748,16.388795635698546,100,71.42857142857143
2011-02-07,57.49001,57.97,57.39999,57.64999,50.59827702273122,53.32107046070601,55.279218804904644,56.527521148337016,49.49042430000006,53.170623399999926,55.28269899999995,56.63199749999999,56.63199749999999,57.7079690795863,55.55602592041368,45626800,64.59492085537097,60.22304327403435,NaN,NaN,NaN,NaN,NaN,NaN,0.02285495116065195,0.5571496394451145,0.5342946882844626,87.5965116279071,90.15195313665397,5003946986,7278958643.717355,31.076681695132198,21.59942814898589,14.902000922030156,100,64.28571428571429
2011-02-08,57.64999,58.07001,57.56,58.02499,50.67217466429608,53.41421738227619,55.38689610667309,56.670137229447775,49.52849925000006,53.271473299999926,55.38383879999994,56.729247,56.729247,57.93217274670307,55.526321253296935,38099824,67.15660401363354,60.27261115785361,NaN,NaN,NaN,NaN,NaN,NaN,0.06061520171667689,0.6100636904303087,0.5494484887136318,98.32015552180772,94.56663946041397,5042046810,7310332113.03223,30.450450989716515,20.419876761261673,14.054298217051974,100,57.142857142857146
2011-02-09,57.94,58.12,57.75,57.92999,50.744391732313034,53.50363862223112,55.486625278960425,56.790123207595606,49.57144920000006,53.37082319999991,55.48783859999995,56.8177465,56.8177465,58.098078498776246,55.53741450122375,62540768,65.85662501911457,60.72493210034455,NaN,NaN,NaN,NaN,NaN,NaN,0.07003315113791286,0.6369899276360229,0.56695677649811,93.0399267399267,92.9855312965472,4979506042,7308638441.423148,29.757278559174065,19.584292566055115,14.907959377530476,100,50
2011-02-10,57.61,58.10001,57.49001,58.021,50.81679579467808,53.593091322781,55.58601252292276,56.90734956877698,49.61470420000006,53.462734199999915,55.60655839999995,56.89104699999999,56.89104699999999,58.267097062782994,55.51499693721699,70194688,66.52514818921894,61.68347879782163,NaN,NaN,NaN,NaN,NaN,NaN,0.07290409474742854,0.6580868949323957,0.5851828001849672,96.3736263736265,95.91123621178697,5049700730,7360649253.033379,27.741772533324436,21.14462511921806,14.99572998312311,92.85714285714286,42.857142857142854
2011-02-11,57.87,58.48,57.77,58.44,50.892648572840486,53.6890697124289,55.6979336004552,57.053316276512504,49.65575420000007,53.55893409999992,55.71155839999995,56.98429699999999,56.98429699999999,58.50699377325719,55.46160022674279,47853472,69.48725607554857,62.27697310815352,NaN,NaN,NaN,NaN,NaN,NaN,0.09228639471936595,0.7005407935841745,0.6082543988648086,98.70550161812301,96.03968491055873,5097554202,7403110784.526337,29.759037591966287,19.48994270965592,15.608967229439912,100,35.714285714285715
2011-02-14,58.42999,58.66,58.38,58.58,50.9691396318172,53.78591981713328,55.81095581220205,57.19871472636846,49.702466700000066,53.65783409999991,55.80855839999995,57.06329699999999,57.06329699999999,58.73746717034844,55.389126829651545,48506032,70.42881947436678,62.883714834044426,NaN,NaN,NaN,NaN,NaN,NaN,0.10298617322256387,0.7369871153930134,0.6340009421704496,97.55351681957191,97.54421493710714,5146060234,7423899083.954908,30.869629711999703,18.86302523986175,16.27839394984738,100,28.571428571428573
2011-02-15,58.44,58.57001,58.23,58.5,51.04407356582897,53.87926793956629,55.91640852544903,57.32264665719051,49.745316750000065,53.75613409999992,55.90115839999995,57.130297,57.130297,58.91798896655406,55.342605033445935,39723760,69.11633065647122,63.2055188054254,NaN,NaN,NaN,NaN,NaN,NaN,0.09340840304724551,0.7507614459795064,0.6573530429322609,95.10703363914384,97.12201735894627,5106336474,7447264146.048376,29.588431144682897,19.85886579260228,15.84916932401096,92.85714285714286,21.428571428571427
2011-02-16,58.64,59.03999,58.63,58.881,51.12205293333316,53.9783121387828,56.0326670146471,57.47106126126761,49.79757180000007,53.84834409999992,56.00187839999995,57.24884749999999,57.24884749999999,59.16604903533175,55.331645964668226,53061312,71.81065491533688,63.513004271463046,NaN,NaN,NaN,NaN,71.81065491533688,NaN,0.10083018711555669,0.7833907768267068,0.6825605897111501,95.644097655062,96.10154937125925,5159397786,7459172171.407824,33.294301673180655,18.57777177289844,15.477814536016384,100,14.285714285714286
2011-02-17,58.60001,58.97501,58.55,58.86,51.199047431508944,54.07497922514354,56.14354281799427,57.603341141146885,49.85097185000008,53.94304409999992,56.10147839999995,57.386347499999985,57.386347499999985,59.350986010535394,55.42170898946458,38361840,71.44070265324876,65.08331394024799,NaN,NaN,NaN,NaN,NaN,NaN,0.09263338701591806,0.7983523234810477,0.7057189364651296,95.0687536130235,95.27329496907646,5121035946,7476772169.482223,31.56816938636608,18.59049003628138,16.773167118827555,92.85714285714286,7.142857142857143
2011-02-18,58.88,58.97,58.50999,58.73,51.273982282936714,54.167157854348616,56.24497251140626,57.71064198484718,49.91177180000008,54.03664409999992,56.19447839999995,57.53884799999999,57.53884799999999,59.42180527292646,55.65589072707351,44341728,69.0685328593602,66.30046040357385,NaN,NaN,NaN,NaN,NaN,NaN,0.0679095951649138,0.7906059304212718,0.722696335256358,88.43316579539454,93.04867235449336,5076694218,7474845274.104469,29.76919857746363,18.026727418404516,17.856371996568196,85.71428571428571,0
2011-02-22,58,58.13,56.94,57.03,51.3312560910667,54.22384779782686,56.27575790311582,57.645818938671255,49.96987180000007,54.11404419999992,56.25237859999996,57.56784799999999,57.56784799999999,59.4000137555112,55.73568224448878,92596880,47.06168713585742,65.34370652927052,NaN,NaN,NaN,NaN,NaN,NaN,-0.06622544480966275,0.6399145292442796,0.7061399740539424,23.864015151515094,69.1219781866444,4984097338,7396254644.860772,24.030558104255043,31.459442310190006,17.932654333155124,78.57142857142857,0
2011-02-23,57,57.23,56.13,56.56,51.38328339364315,54.270108237473856,56.286904652013234,57.54240761117875,50.013821800000066,54.188944099999915,56.29367859999996,57.569223,57.569223,59.39831737021725,55.74012862978275,97842880,42.983964716206906,64.16836251373691,NaN,NaN,42.983964716206906,NaN,NaN,NaN,-0.18325908733638885,0.4770661148834563,0.6603252022198451,14.776683081385148,42.35795467609828,4886254458,7374907107.406227,21.311712420357814,36.23138892958355,18.904653757273632,71.42857142857143,100
2011-02-24,56.7,57.03,56.14,56.855,51.43772833499993,54.32129421296942,56.30918290095389,57.47694021963792,50.05949680000007,54.26739419999993,56.344778599999955,57.57047299999999,57.57047299999999,59.39757801481563,55.743367985184356,98715936,46.13851415340118,63.16277433137792,NaN,NaN,NaN,NaN,NaN,NaN,-0.23420061097169798,0.36757443850522264,0.6017750494769206,24.91417496280036,21.184957731900216,4984970394,7434802169.698361,19.399271100467157,32.9801060716291,20.601624320810533,64.28571428571429,92.85714285714286
2011-02-25,57.16,57.72,57.12,57.64999,51.49954188390541,54.38720898102943,56.36176357150472,57.493421151100975,50.104646750000065,54.35909409999992,56.40987839999996,57.59397299999999,57.59397299999999,59.41245394055596,55.77549205944402,54094576,53.59049297283546,62.518589549283675,NaN,NaN,NaN,NaN,NaN,NaN,-0.20860445175863473,0.3410194847786272,0.5496239365372619,52.233512829940985,30.64145695804218,5039064970,7476272874.812495,24.582623671607873,30.148419954434587,20.765495958972554,57.142857142857146,85.71428571428571
2011-02-28,57.87,58.05,57.42999,57.76891,51.561923656204854,54.45417335764271,56.41694578438688,57.51965818432945,50.15424125000007,54.44018319999992,56.48205659999996,57.69591849999999,57.69591849999999,59.301079835546474,56.09075716445351,51402736,54.60231677190829,61.80483211475063,NaN,NaN,NaN,NaN,NaN,NaN,-0.17904750491443588,0.3258145553942171,0.504862060308653,56.32012481142531,44.48927086805556,5090467706,7481067346.228892,26.36294627592234,28.27448287647568,19.730283468836173,50,78.57142857142857
2011-03-01,57.99001,58.02,56.69501,56.84,51.61444182877993,54.501417449570575,56.43353614578348,57.45492883344093,50.20379130000006,54.516283199999926,56.52725659999996,57.7379185,57.7379185,59.20105837613316,56.27477862386684,91992496,46.14017012132876,60.303658265300285,NaN,NaN,NaN,NaN,NaN,NaN,-0.21501941430714144,0.23608779242472622,0.45110720673186766,24.398709273915056,44.31744897176046,4998475210,7409207820.281557,23.063678180447795,31.678021493729375,19.44588481265995,42.857142857142854,71.42857142857143
2011-03-02,56.82001,57.511,56.78999,57.14,51.66942250710053,54.55366660898502,56.46124061065471,57.42493561120846,50.25409130000007,54.59358319999992,56.57965659999995,57.7424185,57.7424185,59.19759966780275,56.28723733219725,61552880,48.89482175986064,59.0921008896393,NaN,NaN,NaN,NaN,NaN,NaN,-0.21126159637176878,0.1870302112671567,0.39829180763892547,34.70802305162553,38.4756190456553,5060028090,7407415896.520166,21.487778551317128,29.51351928671011,19.097232761489572,35.714285714285715,64.28571428571429
2011-03-03,57.67999,58.36501,57.67,58.265,51.7350501438458,54.62715835930215,56.53197627298198,57.50494174347432,50.31326635000007,54.678733199999925,56.65375659999995,57.80791850000001,57.80791850000001,59.23305145419306,56.382785545806954,64249920,57.64342119987365,58.45769181897178,NaN,NaN,NaN,NaN,57.64342119987365,NaN,-0.12966786550402853,0.23620697575888983,0.36587484126291836,73.36794971804018,44.15822734786027,5124278010,7453175048.044317,26.847107498380314,26.233749369794385,18.215851604801177,28.571428571428573,57.142857142857146
2011-03-04,58.25,58.25999,57.59,57.9675,51.79706457027519,54.693303738325874,56.58827132110033,57.54899491076248,50.372803850000075,54.76070819999993,56.715306599999955,57.8534185,57.8534185,59.23732261630688,56.46951438369312,62328320,54.963822933892565,57.42030373742492,NaN,NaN,NaN,NaN,NaN,NaN,-0.09405045802785394,0.2483117687281009,0.34236222675595485,63.14454688847722,57.07350655271432,5061949690,7461083420.532265,25.186241607064986,25.344029572554227,16.74877149354843,21.428571428571427,50
2011-03-07,58.21001,58.2599,56.67,57.19,51.85072561932718,54.742743268260014,56.611868524194435,57.514804919261294,50.43700380000006,54.83150819999994,56.761406799999946,57.84416849999999,57.84416849999999,59.243131087824985,56.44520591217499,98469936,48.6047116997156,55.86143889637841,NaN,NaN,NaN,NaN,NaN,NaN,-0.11953536131317921,0.1929430251144808,0.31247838642766,36.4262420145772,57.64624620703154,4963479754,7427025544.058021,21.77001607575981,29.75516439449124,16.13129074798355,14.285714285714286,42.857142857142854
2011-03-08,57.10001,57.67999,56.77,57.42,51.90614128480651,54.79575825304695,56.64355995461818,57.50577587933165,50.49990380000006,54.90050819999994,56.81496679999996,57.832668999999996,57.832668999999996,59.24157286238186,56.42376513761813,62399104,50.43169947227263,54.52682238322137,NaN,NaN,NaN,NaN,NaN,NaN,-0.11741330692907176,0.16571175276632033,0.2831250596953921,44.33004924415544,47.96694604906995,5025878858,7453768996.789413,20.090352802791923,27.459407852988342,15.832785570054984,7.142857142857143,35.714285714285715
2011-03-09,57.21001,57.27,56.72,57.03,51.957124953614404,54.8400006638777,56.658714466201786,57.460463890823874,50.56175380000006,54.96660819999994,56.86016679999996,57.782919500000006,57.782919500000006,59.23087256337381,56.3349664366262,84764128,47.3575630615621,52.7801729650946,NaN,NaN,NaN,NaN,NaN,NaN,-0.13739833080094166,0.11137714619421502,0.24877547699515667,31.634335204445684,37.463542154392776,4941114730,7464557158.534868,18.883401344939976,26.2388672911169,14.970669385453007,0,28.571428571428573
2011-03-10,56.39,56.52,55.91,56.14,51.99874560084212,54.86574322498903,56.63837272242917,57.334705425031125,50.618953800000064,55.01310809999993,56.889566799999955,57.69341999999999,57.69341999999999,59.305883451381455,56.08095654861852,102991504,41.18743273938443,50.61922511410428,NaN,NaN,NaN,NaN,NaN,NaN,-0.20178766838344603,-0.0034591084841508746,0.19832855989929515,7.51633986928117,27.826908105960765,4838123226,7439231378.862738,17.11203434544132,30.561665224244134,15.137711413141247,0,100
2011-03-11,55.83,56.66,55.82001,56.49001,52.04343479884369,54.8979069235041,56.632554576451554,57.25425824169483,50.68040385000007,55.06500819999994,56.92356719999996,57.616870500000005,57.616870500000005,59.30351701678215,55.93022398321786,81679376,44.262989801246746,48.84740060995332,NaN,NaN,NaN,NaN,NaN,NaN,-0.21103891784661655,-0.06547008740897553,0.14556883043764102,26.32612966601163,21.825601579912828,4919802602,7487851606.238968,17.08068150950937,28.409237027411454,15.161676335366636,0,100
2011-03-14,56.17999,56.59,55.86,56.28999,52.08568907945221,54.92547292501887,56.61912067149267,57.16242317105723,50.73250380000007,55.11970799999994,56.95616699999996,57.509370000000004,57.509370000000004,59.245793041794684,55.772946958205324,73621744,42.8828750435085,48.5489140319284,NaN,NaN,NaN,NaN,NaN,NaN,-0.219866345342116,-0.12926410124000398,0.09060224410211201,18.466797642436173,17.43642239257633,4846180858,7500960310.739133,16.02442923814265,26.65243820639879,15.984222979959354,50,92.85714285714286
2011-03-15,54.64,55.82001,54.47,55.49001,52.11956291945766,54.936651876998695,56.57484182163021,57.00314572619463,50.78195380000007,55.162708099999925,56.97676699999997,57.35487049999999,57.35487049999999,59.22730149755923,55.48243950244075,101275312,37.8057000893375,48.179037987152014,NaN,NaN,NaN,NaN,NaN,NaN,-0.265752306811746,-0.2415881394125705,0.0241641673991755,26.187609274430603,23.660178860959473,4744905546,7552723614.739191,13.742694392054977,33.7323487258804,17.139778490279163,42.857142857142854,100
2011-03-16,55.03,55.34,53.77,54.14999,52.13976617399042,54.92107441408783,56.479749593330986,56.73141660941419,50.82680380000007,55.19130809999993,56.95356679999996,57.13737,57.13737,59.39762650316897,54.87711349683102,176506624,31.152280490206067,47.108592725495214,NaN,NaN,31.152280490206067,NaN,NaN,NaN,-0.36631880941476797,-0.4337343443692845,-0.0674155349545165,8.269622917033908,17.641343277966897,4568398922,7461657439.215319,12.003188566564022,34.61396718319178,18.752299881986826,35.714285714285715,100
2011-03-17,55.00999,55.24001,54.12939,54.64999,52.164743525493,54.91570640588807,56.40799431516114,56.533185503755696,50.86880375000007,55.221407999999926,56.94126659999996,56.9258195,56.9258195,59.28359551595524,54.568043484044765,94434320,35.69949478004796,45.83066428315325,NaN,NaN,NaN,NaN,NaN,NaN,-0.37762546117425316,-0.539447361422333,-0.1618219002480798,19.150992054424265,17.869408081962927,4662833242,7455754762.787378,11.032156413180223,31.813771643093542,21.490426226438554,28.571428571428573,92.85714285714286
2011-03-18,55.2,55.22,54.41,54.45,52.18748239588611,54.906484496860585,56.33121022437051,56.33478688435039,50.90760375000007,55.24700799999992,56.91546639999997,56.70531950000001,56.70531950000001,59.12241534820549,54.288223651794524,94887120,34.71194771188506,44.409923636008735,NaN,NaN,NaN,NaN,NaN,NaN,-0.3762040959910213,-0.6320770202368564,-0.25587292424583513,14.798662026850877,14.073092332769683,4567946122,7370239210.194787,10.373061232885151,29.913118427923386,24.705036463625397,21.428571428571427,85.71428571428571
2011-03-21,55.28999,55.78,54.49561,55.5,52.220442770056394,54.91823727910097,56.29861374498343,56.255283371555116,50.95964125000007,55.28170799999992,56.90706639999997,56.543819500000005,56.543819500000005,58.82608068869269,54.26155831130732,57419952,43.54241582698643,44.22436975784142,NaN,NaN,NaN,NaN,NaN,NaN,-0.2862506798538905,-0.6136862740631983,-0.3274355942093078,37.64953721537056,23.8663970988819,4625366074,7402623796.674968,13.405028310023798,27.054962209759054,25.99078808290786,14.285714285714286,78.57142857142857
2011-03-22,55.57001,55.61,55.28,55.395,52.252030404185184,54.927678125059366,56.263177911846824,56.1733516218832,51.01526625000007,55.313757999999915,56.89756639999997,56.462069500000005,56.462069500000005,58.78557263888584,54.13856636111417,36251280,42.91729064396393,43.79740324956308,NaN,NaN,NaN,NaN,NaN,NaN,-0.21857957455204452,-0.6006600623993634,-0.3820804878473189,35.364449696518655,29.270882979580033,4589114794,7391638560.311332,13.071302257439902,26.381413036101748,27.276539702190313,7.142857142857143,71.42857142857143
2011-03-23,55.19,55.87,54.82001,55.71001,52.286438161357474,54.94316984535522,56.241485052558716,56.129223848370515,51.07286630000007,55.34785809999991,56.89016659999997,56.41957000000001,56.41957000000001,58.7653412224667,54.07379877753331,60365088,45.44768039896775,42.92627890664123,NaN,NaN,NaN,NaN,NaN,NaN,-0.14111977711821122,-0.5584802092450829,-0.4173604321268717,43.2074458963159,38.74047760273504,4649479882,7433607643.722487,12.043889302426402,27.75123194280118,30.013325899531083,0,64.28571428571429
2011-03-24,56.12,56.82001,55.82001,56.7,52.33035419955292,54.97795856128878,56.25946603088975,56.18358348185904,51.13726625000007,55.39305819999991,56.900966599999975,56.41182000000001,56.41182000000001,58.752804988877834,54.07083501112219,69502320,52.56437914093995,42.75489006428747,NaN,NaN,NaN,NaN,NaN,NaN,-0.018187900430960635,-0.4400953076655725,-0.42190740723461184,65.25757811977996,47.94315790420484,4718982202,7486428016.876087,18.084300663416304,25.471888227359287,31.202524979080767,0,57.142857142857146
2011-03-25,56.89,57.22,56.7299,56.84,52.37522629706981,55.01483066898603,56.28223206889407,56.24609934072961,51.19611620000006,55.43925819999991,56.90666679999998,56.37132050000001,56.37132050000001,58.652483473759425,54.090157526240596,74133872,53.48845586114933,43.10372893296131,NaN,NaN,NaN,NaN,NaN,NaN,0.07259778031626529,-0.3311601818392802,-0.4037579621555455,78.51682485121458,62.32728295577015,4793116074,7445602201.628588,20.42534082228792,24.45839566212412,30.737381730060303,0,50
2011-03-28,57.09,57.10001,56.5,56.53,52.41656732893976,55.04483402207541,56.291948458349204,56.27313749875536,51.25126620000005,55.476758199999914,56.90576679999998,56.30937500000001,56.30937500000001,58.500890477383784,54.117859522616236,37823728,51.11401280301788,43.15246559944312,NaN,NaN,NaN,NaN,NaN,NaN,0.10959229907828127,-0.26676758830769387,-0.37635988738597514,78.85714285714279,74.21051527604578,4755292346,7411560783.390092,19.46304195639837,25.11127015084768,30.53551902287237,0,42.857142857142854
2011-03-29,56.39999,57.08,56.23,57.08,52.46296964407469,55.085134338469956,56.322852440374724,56.34998154649295,51.309216150000054,55.517358199999904,56.907366799999984,56.32137500000001,56.32137500000001,58.52696428352753,54.11578571647249,47994656,54.93622624463,43.69379868394797,NaN,NaN,NaN,NaN,NaN,NaN,0.16556565367724962,-0.16940282028941311,-0.33496847396666274,95.94202898550724,84.43866556462154,4803287002,7459555439.390092,18.157917799565457,25.55742649776284,30.58018920532404,0,35.714285714285715
2011-03-30,57.36,57.42999,57.08,57.35001,52.51159691129783,55.12998336147055,56.36313312898748,56.44522235158886,51.36241615000005,55.55415829999992,56.91116699999998,56.33187550000001,56.33187550000001,58.55488509515089,54.10886590484913,44935856,56.725055575607584,44.80362888653532,NaN,NaN,NaN,NaN,NaN,NaN,0.2122546938504808,-0.06965010665356175,-0.28190480050404254,97.81474812772714,90.8713066567924,4848222858,7483953738.529153,20.52119059415442,24.819429991345153,29.242192076455137,100,28.571428571428573
2011-03-31,57.25,57.48,57.14999,57.42999,52.56053614601128,55.17552804738202,56.40497065334091,56.53900974667564,51.41506615000006,55.591758199999916,56.92956699999998,56.29012500000001,56.29012500000001,58.39454327297993,54.18570672702009,50143328,57.266182661735876,45.73242837657027,NaN,NaN,NaN,NaN,NaN,NaN,0.23806594693559618,0.015677633165452676,-0.2223883137701435,98.6520215633423,97.46959955885889,4898366186,7518899540.19189,20.368299522475013,24.112406427180968,28.064615708641107,100,21.428571428571427
2011-04-01,57.72,57.89999,57.28999,57.46001,52.60928712963306,55.2207653137705,56.44634474536676,56.62672405651605,51.46711620000006,55.62898329999991,56.95656719999998,56.26475050000001,56.26475050000001,58.2987145142268,54.23078648577322,68031744,57.48109374344858,46.77515828370885,NaN,NaN,NaN,NaN,57.48109374344858,NaN,0.24570740807284666,0.08474594632091481,-0.16096146175193185,89.34670543996461,95.27115837701136,4966397930,7488791590.011168,22.97001913351786,22.81846130062021,26.309440956094015,100,14.285714285714286
2011-04-04,57.62,57.67999,57.02,57.27,52.655662382074524,55.261344218448315,56.47864495143081,56.68798843208595,51.518466200000056,55.667183299999905,56.98836739999998,56.268750500000024,56.268750500000024,58.31027777024786,54.22722322975219,48659040,55.57596390951549,48.04446284229299,NaN,NaN,NaN,NaN,NaN,NaN,0.22695800015051806,0.12273603843621572,-0.10422196171430234,84.74596790791263,90.91489830373985,4917738890,7476996017.639465,21.618292425944574,23.88299576245408,23.65741407209763,92.85714285714286,7.142857142857143
2011-04-05,57.16,57.49001,57,57.12,52.70008365190463,55.29814928342954,56.50379612980607,56.72913239093491,51.571066150000064,55.70123329999991,57.00176739999998,56.253750500000024,56.253750500000024,58.2654124137338,54.24208858626625,55384928,54.05290030233977,49.68022140030253,NaN,NaN,NaN,NaN,NaN,NaN,0.19468624326107184,0.13913584236203747,-0.055550400899034375,79.31390229671659,84.46885854819793,4862353962,7448737847.7056265,20.646814654006025,22.993162992272655,20.576948015524856,85.71428571428571,0
2011-04-06,57.53999,57.73,56.92999,57.25999,52.74545585437324,55.33699761445074,56.5334507913823,56.77969025846492,51.62616605000006,55.739983299999906,57.016317199999975,56.265250000000016,56.265250000000016,58.29705846296811,54.23344153703192,49532048,55.284527578664836,51.079152314489455,NaN,NaN,NaN,NaN,NaN,NaN,0.1736934338342772,0.16156639139381213,-0.012127042440465072,81.66183857260337,81.90723625907752,4911886010,7440069228.512767,21.33158495104725,21.309483003544177,17.11614121310813,78.57142857142857,0
2011-04-07,57.23,57.60001,56.81,57.22,52.78997868169291,55.37428479040221,56.560374289759466,56.8216245195635,51.682016050000065,55.78708339999991,57.024117199999985,56.31925000000001,56.31925000000001,58.391869991748294,54.24663000825173,60705856,54.83236228338315,52.51632478388217,NaN,NaN,NaN,NaN,NaN,NaN,0.14898874232249296,0.17410888546265113,0.025120143140158174,80.02602529682342,80.33392205538111,4851180154,7442373716.584361,19.79045761094193,20.867258726541657,13.840807407607999,71.42857142857143,0
2011-04-08,57.48,57.57001,56.64999,56.95,52.83137192864124,55.40548707178038,56.57565372937674,56.833850755795545,51.74001600000006,55.83343339999991,57.019517399999984,56.34224950000002,56.34224950000002,58.43207605719712,54.25242294280292,42782112,51.75456956533105,53.10290719376393,NaN,NaN,NaN,NaN,NaN,NaN,0.1082342994467741,0.1604130174486258,0.0521787180018517,69.15596854525029,76.94794413822568,4808398042,7427493305.462864,18.146267361021042,20.578535499669947,11.879667150411379,64.28571428571429,0
2011-04-11,57.16,57.28999,56.56,56.75999,52.870462655719436,55.432308911943146,56.582882602734514,56.82681639810073,51.79746595000006,55.88653329999991,57.04011719999998,56.36574950000003,56.36574950000003,58.46325307643623,54.268245923563825,42451616,49.64275554643089,53.58329754394015,NaN,NaN,NaN,NaN,NaN,NaN,0.0644146856573653,0.13269707507355832,0.06828238941619302,62.98677264138076,70.72292216115149,4765946426,7408302004.491399,16.943442978115346,20.031620426627942,10.066466132531332,57.142857142857146,7.142857142857143
2011-04-12,56.52,56.64,56.14999,56.37,52.905283922826705,55.450877052300704,56.57453426537238,56.78331007447209,51.85376595000007,55.93423319999991,57.04751719999999,56.40974900000002,56.40974900000002,58.468485774856234,54.351012225143805,50642848,45.535785835423056,53.58959078940124,NaN,NaN,NaN,NaN,NaN,NaN,0.008061908176174276,0.07835977463641086,0.07029786646023659,26.442081173857165,52.861607453496056,4715303578,7403135505.906634,15.989655467042176,22.687673490194857,8.484120538187582,50,0
2011-04-13,56.77,57,56.39999,56.85001,52.94453492856972,55.478582655225445,56.58533723535778,56.78966244833189,51.921166000000056,55.9784333999999,57.04351739999999,56.54475000000002,56.54475000000002,58.328835152157374,54.76066484784267,49979728,50.9180937409151,53.47199897511375,NaN,NaN,NaN,NaN,NaN,NaN,0.0023106850166928483,0.07318622273110265,0.0708755377144098,40.00114285714257,43.14333222412683,4765283306,7428127452.360593,18.414450288918324,21.350889207095648,7.800075304399046,42.857142857142854,0
2011-04-14,56.45,56.83,56.23,56.75,52.98240025266356,55.50375923631009,56.59179459867708,56.78588507230028,51.991365950000066,56.02123339999989,57.03941739999999,56.649750500000025,56.649750500000025,58.2083594410512,55.09114155894885,53544096,49.813550754587084,53.20950575321644,NaN,NaN,NaN,NaN,NaN,NaN,-0.008443763473555688,0.06032083337246519,0.06876459684602088,34.28628571428557,33.57650324842843,4711739210,7467393122.760593,17.332105760591766,21.70745408539828,7.958783448597241,35.714285714285715,85.71428571428571
2011-04-15,56.53,56.87,56.28,56.64999,53.018893682985315,55.52645687519504,56.59407677127798,56.77294268446216,52.061665900000065,56.058633299999904,57.031267199999995,56.75975000000002,56.75975000000002,57.948481184982214,55.57101881501782,68529936,48.6764113172315,53.03539136137456,NaN,NaN,NaN,NaN,NaN,NaN,-0.021751125666859744,0.04157568976244619,0.06332681542930593,28.571428571428573,34.286285714285576,4643209274,7484813664.796662,16.732596420702517,20.474202285880125,7.771980257614089,28.571428571428573,78.57142857142857
2011-04-18,56.09,56.27,55.32001,56.25,53.0510439945974,55.54078446182484,56.5805835645612,56.72313861927529,52.130565900000065,56.1004331999999,57.00876719999999,56.79725000000002,56.79725000000002,57.865908893262876,55.72859110673716,69073440,44.318835497431174,52.277006308003216,NaN,NaN,44.318835497431174,NaN,NaN,NaN,-0.05505545837235644,-0.0054925075361396125,0.049562950836216826,36.046403460491824,32.96803924873532,4574135834,7550978718.813651,14.704572588717294,26.74114249742823,8.637351743313324,21.428571428571427,100
2011-04-19,56.39,56.60001,56.10001,56.60001,53.08635708917852,55.56175922495702,56.581345385558805,56.711412084106215,52.200565900000065,56.13523329999989,56.98776759999999,56.857500500000015,56.857500500000015,57.71891274171087,55.99608825828916,38608384,48.650719005069874,51.700267981536236,NaN,NaN,NaN,NaN,NaN,NaN,-0.051158906246529114,-0.014385681971944564,0.03677322427458455,49.61278769602844,38.07687324264962,4612744218,7589587102.813651,17.104014618267836,25.4903230223678,9.366558916239736,14.285714285714286,92.85714285714286
2011-04-20,57.59,57.94,56.6051,57.875,53.1340052773459,55.607565972977675,56.6320769390663,56.822229980858005,52.27014085000006,56.18430329999989,56.98476779999999,56.965750000000014,56.965750000000014,57.765045558696094,56.166454441303934,67397440,60.65781420554068,51.942527377522296,NaN,NaN,NaN,NaN,NaN,NaN,0.03499684026326572,0.0805192746036667,0.04552243434040098,97.51907450028443,61.05942188560157,4680141658,7650421004.571086,26.963832406511685,22.458451946746216,9.416467355661727,100,85.71428571428571
2011-04-21,58.47,58.47,58.16,58.34,53.18580621985987,55.66167357747317,56.699054314004876,56.966779506490575,52.34084085000007,56.2404032999999,56.99296799999999,57.04775000000002,57.04775000000002,58.03545713784423,56.06004286215581,43666768,63.967095716741845,52.40581323275753,NaN,NaN,NaN,NaN,NaN,NaN,0.11642319519609506,0.1910514283355198,0.07462823313942474,95.87300277143751,81.0016216559168,4723808426,7657464031.667862,30.306438499499656,21.249828771759464,10.647571773550052,100,78.57142857142857
2011-04-25,58.39999,58.52,58.28,58.49001,53.23858436692594,55.71768023930538,56.76928787031841,57.111849077300995,52.41019090000006,56.30445329999989,57.002348199999986,57.130250500000024,57.130250500000024,58.294609048370674,55.965891951629374,25376720,64.99019289615106,53.078258160374375,NaN,NaN,NaN,NaN,NaN,NaN,0.17024947709799965,0.2874400795119243,0.11719060241392465,99.06280957127974,97.48496228100056,4749185146,7676498686.394527,30.09004374112924,20.764417548953492,11.601903436927504,100,71.42857142857143
2011-04-26,58.64999,59.03,58.50999,58.82001,53.29412094038936,55.77911251179438,56.8497083459922,57.274531069938995,52.48054095000007,56.3607533999999,57.00994839999999,57.24475100000002,57.24475100000002,58.58724370842727,55.90225829157277,49392736,67.196739213575,54.01710379689117,NaN,NaN,NaN,NaN,NaN,NaN,0.2150534135996816,0.38600736941352665,0.17095395581384504,94.33987692689205,96.42522975653644,4798577882,7685999956.335645,33.46530418927989,19.675394703412483,13.071418101881124,100,64.28571428571429
2011-04-27,58.89999,59.28999,58.66,59.22,53.35308491113176,55.847248897699444,56.94266095987486,57.4598138251829,52.549990950000065,56.415653399999904,57.02274839999998,57.35175100000002,57.35175100000002,58.94278331148213,55.76071868851791,56465488,69.6903259197448,55.046089392682596,NaN,NaN,NaN,NaN,69.6903259197448,NaN,0.2558300704701408,0.490741543901521,0.23491147343138025,98.23701882629122,97.21323510815434,4855043370,7729919151.521091,33.94773036551644,18.4590433342587,15.178768815093068,100,57.142857142857146
2011-04-28,59.06,59.23,58.88,59.13,53.41056665330955,55.91225387002223,57.028438961448394,57.61887917516548,52.617840950000065,56.468253399999895,57.03534839999998,57.44075050000002,57.44075050000002,59.210533952054185,55.67096704794586,48138336,68.42985982897339,56.01733921736762,NaN,NaN,NaN,NaN,NaN,NaN,0.2600918211820225,0.5600262499089084,0.29993442872688586,95.97000488667447,96.18230021328593,4806905034,7750549866.949664,32.736876031387624,17.800642540317465,17.100646531388414,92.85714285714286,50
2011-04-29,59.03999,59.28999,58.98,59.08,53.46697892541592,55.9749815161604,57.10889233550924,57.75803353943544,52.68524090000006,56.52060339999989,57.03932839999999,57.52325100000003,57.52325100000003,59.43173541548148,55.614766584518584,44831152,67.69730150602247,57.15610578455986,NaN,NaN,NaN,NaN,NaN,NaN,0.24320323279153483,0.6039384697163044,0.36073523692476955,94.71055269799835,96.3058588036547,4762073882,7734642971.861177,32.296500854158275,17.214974059154084,18.827772564357414,85.71428571428571,42.857142857142854
2011-05-02,59.19,59.34,58.82001,58.97,53.52173535401875,56.034288812870095,57.18187694980299,57.87345891663206,52.75839090000006,56.57150339999989,57.04152839999999,57.59875050000003,57.59875050000003,59.60806100739296,55.5894399926071,48149392,66.02275368395624,58.32610565152596,NaN,NaN,NaN,NaN,NaN,NaN,0.2095599801207968,0.6226852120757655,0.41312523195496875,90.79599700496757,93.82551819654681,4713924490,7714270757.5225935,30.484622701102452,17.975311824987635,20.075034247726386,100,35.714285714285715
2011-05-03,58.95,59,58.33,58.69,53.57316087288424,56.0868771532093,57.24101903020287,57.951224734095675,52.828240900000054,56.61760339999989,57.04072839999999,57.669750500000035,57.669750500000035,59.727349691076974,55.612151308923096,38143408,61.83021585956562,59.489993510393276,NaN,NaN,NaN,NaN,NaN,NaN,0.15585223093549078,0.6079405206243322,0.45208828968884146,83.8308055492674,89.77911841741111,4675781082,7717117280.507668,28.282903155986865,21.95922109392969,19.737086356871462,92.85714285714286,28.571428571428573
2011-05-04,58.72,58.87,58.11,58.60001,53.62317927215902,56.13664216007644,57.29431279372433,58.013013807038945,52.89494100000005,56.66225359999989,57.072128599999985,57.74375100000003,57.74375100000003,59.823280167897565,55.6642218321025,53105008,60.5004868941507,60.174450164195825,NaN,NaN,NaN,NaN,NaN,NaN,0.10415466855091904,0.5822816253774903,0.47812695682657125,81.59224276677291,85.40634844033598,4622676074,7732491180.323668,25.989877669754456,22.525782448478886,19.719639272415005,85.71428571428571,21.428571428571427
2011-05-05,58.32001,58.97,58.08,58.28,53.66951579681415,56.179084889579876,57.33296719397043,58.03844106351143,52.96314100000005,56.70010359999989,57.10652859999999,57.79475150000003,57.79475150000003,59.87435362856,55.71514937144006,72153312,55.89682433783994,60.60896970585674,NaN,NaN,55.89682433783994,NaN,NaN,NaN,0.0415103953663391,0.5300149510344951,0.48850455566815604,73.63177520342086,79.68494117315375,4550522762,7692766323.1551285,24.621282528740977,20.43625837993384,19.582546664753227,78.57142857142857,14.285714285714286
2011-05-06,58.86,59.2,58.31,58.47,53.717281808786154,56.22444954523176,57.37755671577551,58.07954191460558,53.02664100000005,56.74180359999989,57.1388286,57.85725150000003,57.85725150000003,59.93913628622449,55.775366713775576,72506752,57.94306615123123,61.27087362257101,NaN,NaN,NaN,NaN,NaN,NaN,0.007741888376348316,0.4981819161385914,0.4904400277622431,78.35815511978875,77.86072436332752,4623029514,7646329414.570858,24.656730043472372,18.523448369959112,19.87880995891063,71.42857142857143,7.142857142857143
2011-05-09,58.56,58.92,58.34,58.69,53.76676159178331,56.273272326514295,57.42902507986275,58.13768077988124,53.08979100000005,56.78475359999989,57.15962879999999,57.94425150000003,57.94425150000003,60.0125941261418,55.87590887385826,40028976,60.24319583442552,62.40832793235632,NaN,NaN,NaN,NaN,NaN,NaN,-0.004260762258300188,0.48511407493936787,0.48937483719766806,79.93820968583222,77.30938000301397,4663058490,7654611271.674306,23.183488085505015,17.41667057352173,18.818964024897433,64.28571428571429,0
2011-05-10,58.87,59.28,58.77499,59.19,53.820724163009345,56.33102931014768,57.49808291986813,58.237901657987784,53.15354100000004,56.835053599999895,57.1880506,58.06575200000003,58.06575200000003,60.12703183012624,56.00447216987382,38053600,64.93672194105594,63.57161385635532,NaN,NaN,NaN,NaN,64.93672194105594,NaN,0.01588685998357653,0.5092334121771387,0.49334655219356216,94.51533876924182,84.27056785828762,4701112090,7679101480.850361,25.50776563181742,16.34668714605185,18.976046549679634,57.142857142857146,0
2011-05-11,59.10001,59.31,58.36,58.755,53.869821435019205,56.37902872974871,57.54737378575565,58.287149119131804,53.21521600000005,56.876803599999896,57.226350599999996,58.18500200000003,58.18500200000003,60.11162855439079,56.258375445609275,61908944,58.46945545676277,63.41530251715691,NaN,NaN,NaN,NaN,NaN,NaN,-0.004576246277120333,0.48762624434716173,0.49220249062428206,53.57142857142869,76.00832567550093,4639203146,7668674711.334572,23.05205169231626,18.97845635874117,19.017182644424707,50,0
2011-05-12,58.56,59.19,58.24001,59.11,53.92196251526777,56.43310736876359,57.60865324513778,58.36551586969068,53.28051600000004,56.92270359999989,57.26575059999999,58.298001500000034,58.298001500000034,60.162270220992355,56.43373277900771,66128192,61.81202749498334,63.26136907274559,NaN,NaN,NaN,NaN,NaN,NaN,0.0010057240480856877,0.49345964568438916,0.49245392163630347,81.7460317460315,76.6109330289007,4705331338,7723665406.392499,20.886578680007638,18.382154412756442,18.217982463417407,42.857142857142854,64.28571428571429
2011-05-13,58.98,59.07001,58.39,58.41,53.96661960466809,56.472253757500944,57.64007860807355,58.369752453529664,53.34401595000004,56.96120359999989,57.268650599999994,58.38100150000004,58.38100150000004,60.10471518506215,56.65728781493793,63506560,52.78973322500631,62.38990766766381,NaN,NaN,NaN,NaN,NaN,NaN,-0.04471029988404135,0.43656604678125177,0.4812763466652931,26.190476190475948,53.83597883597874,4641824778,7663894471.456836,19.39918853160161,17.073111136741918,17.36368121511159,35.714285714285715,57.142857142857146
2011-05-16,58.16,58.32001,57.27,57.399,54.00077264342761,56.4906051682435,57.63062454501184,58.277299838907794,53.40196095000004,56.98629359999989,57.257280599999994,58.418452000000045,58.418452000000045,60.01819070830168,56.81871329169841,73140256,43.0223921727829,60.66316859332153,NaN,NaN,NaN,NaN,NaN,NaN,-0.13992779292259167,0.3063666055120535,0.4462943984346452,6.231884057970906,38.05613066482614,4568684522,7608725650.060315,17.29866642422598,25.862377583182866,16.927359018134847,28.571428571428573,100
2011-05-17,57.12,57.57001,56.98,57.56,54.03618784100544,56.51178130352581,57.62785495501138,58.208985568535624,53.45641095000005,57.01304369999989,57.26468059999999,58.483952000000045,58.483952000000045,59.806432278430435,57.161471721569654,63176064,44.77475464154618,58.88348493059305,NaN,NaN,NaN,NaN,NaN,NaN,-0.1860671637308371,0.21371044377109882,0.3997776075019359,24.576271186440838,18.999543811629252,4631860586,7669758047.340632,16.314097870075532,27.187910030968254,16.601742805719425,21.428571428571427,100
2011-05-18,57.48,58.14,57.41,58.03999,54.07602666845813,56.542042861871835,57.644017113638384,58.192890752484615,53.514260900000046,57.04602359999988,57.277080399999996,58.55595100000005,58.55595100000005,59.584440971972725,57.527461028027375,42351088,49.737841373091854,57.548340755172944,NaN,NaN,NaN,NaN,NaN,NaN,-0.17824533498204342,0.17697093877438164,0.35521627375642506,44.914830508474715,25.240995250962172,4674211674,7700504937.228633,20.668109390329253,25.271401177512164,15.206427816467846,14.285714285714286,92.85714285714286
2011-05-19,58.23,58.34,57.85001,58.21001,54.11716083096103,56.575071914111994,57.66621291310354,58.19452115700989,53.57062095000004,57.08042369999988,57.300680599999986,58.57270150000005,58.57270150000005,59.56661572550592,57.57878727449418,35024240,51.403817859637705,56.38452049471688,NaN,NaN,NaN,NaN,NaN,NaN,-0.1563870090208347,0.15973251248038167,0.31611952150121636,52.119067796610025,40.53672316384188,4709235914,7716945936.927402,21.645019573283523,24.046138002724206,13.40603036319176,7.142857142857143,85.71428571428571
2011-05-20,58.14999,58.21001,57.69,57.765,54.15345773811565,56.59863484650582,57.670086916511245,58.1536143801518,53.62529595000004,57.11137369999989,57.333180599999984,58.543951500000034,58.543951500000034,59.59476336835195,57.49313963164812,44703168,47.011569184602415,55.02657874476305,NaN,NaN,NaN,NaN,NaN,NaN,-0.1657700682554622,0.10890693618188863,0.2746770044373508,33.6909871244636,43.57496180984947,4664532746,7685137665.564005,20.508583809245355,24.399192709652528,12.18101855338672,0,78.57142857142857
2011-05-23,56.99001,57.14999,56.64999,56.92,54.18098552181599,56.60499851291164,57.640671743314726,58.03612729632782,53.676096000000044,57.13267379999989,57.34178039999999,58.465451000000044,58.465451000000044,59.732896472772396,57.19800552722769,43678432,40.019101058654755,53.46864197326941,NaN,NaN,NaN,NaN,NaN,NaN,-0.2193913508478206,0.00043781587757507623,0.21982916672539568,10.150713719121327,31.986922880065,4620854314,7688633687.261285,18.291017907390426,31.846491120390795,13.213174004753432,42.857142857142854,100
2011-05-24,57.07001,57.07001,56.56,56.57001,54.20475690965862,56.604305671071806,57.59868500828278,57.89649707762993,53.72354605000003,57.151773899999895,57.34738079999999,58.35295100000004,58.35295100000004,59.852680951176275,56.853221048823805,39314208,37.529218415130956,51.82783708191086,NaN,NaN,37.529218415130956,NaN,NaN,NaN,-0.26583895953226505,-0.11246953268993565,0.1533694268423294,0.36400000000004307,14.735233614528342,4581540106,7650862724.382282,17.36605028672281,31.128316284461306,14.730241405390549,35.714285714285715,100
2011-05-25,56.49001,57.06,56.47,56.78999,54.23048062200033,56.607982588476325,57.5669714785462,57.791115451188986,53.77413350000003,57.17507369999989,57.373380399999995,58.23145050000004,58.23145050000004,59.821530706870064,56.64137029313001,41368976,40.053777924686166,50.69619090954273,NaN,NaN,NaN,NaN,NaN,NaN,-0.2683753333814915,-0.18209973988453498,0.08627559349695653,11.267253521126895,7.26065574674944,4622909082,7654367167.467842,16.336816376958094,30.187507054984813,16.19329011217219,28.571428571428573,100
2011-05-26,56.62,57.3,56.61,57.14149,54.259445889443114,56.61854709167481,57.55028593036792,57.72924636059956,53.83284100000002,57.1933885999999,57.4332104,58.13202500000004,58.13202500000004,59.73356734461596,56.53048265538412,40564080,43.951404453002894,49.69678650252642,NaN,NaN,NaN,NaN,NaN,NaN,-0.2342510542128362,-0.20653822426908874,0.027712829943747477,23.644014084506964,11.7584225352113,4663473162,7676294110.306103,17.618047555091074,28.090705000580286,16.815274600274808,21.428571428571427,92.85714285714286
2011-05-27,57.24001,57.49001,57.19,57.42999,54.29099359203572,56.63461526807729,57.545568442902514,57.700745754828176,53.894791000000026,57.21503849999989,57.488810400000006,58.04952450000004,58.04952450000004,59.61686360169991,56.48218539830017,30132080,46.997476180628276,48.750663670112324,NaN,NaN,NaN,NaN,NaN,NaN,-0.18242404635300513,-0.20031722799750895,-0.017893181644503806,33.80246478873227,22.904577464788712,4693605242,7694369742.577026,18.961511143587416,27.068001656003986,17.058673008352933,14.285714285714286,85.71428571428571
2011-05-31,57.97,58.36,57.67,58.36,54.33148121798561,56.66878130237279,57.57750693533771,57.76353187341597,53.96299100000003,57.241238399999894,57.5670104,58.01902450000004,58.01902450000004,59.53647461045334,56.50157438954675,47588064,55.41021251564576,48.070198711154454,NaN,NaN,NaN,NaN,55.41021251564576,NaN,-0.08086271768257733,-0.11897157874772546,-0.03810886106514814,66.54929577464783,41.33192488262902,4741193306,7741957806.577026,26.025783397174052,24.50426552794506,15.710328197299248,7.142857142857143,78.57142857142857
2011-06-01,58.22,58.36,57.03999,57.09,54.35892916606536,56.67712226668224,57.55838901630486,57.699385980709685,54.02444100000003,57.25293839999989,57.59881039999999,57.93902450000004,57.93902450000004,59.475133388627334,56.40291561137274,51792336,44.92397499114577,47.10266439218181,NaN,NaN,NaN,NaN,NaN,NaN,-0.09366808899806586,-0.15519397231273047,-0.0615258833146646,22.794117647059,41.04862607014637,4689400970,7694089887.397141,22.73442357958062,27.441221352091265,15.688088617610898,0,71.42857142857143
2011-06-02,57.21001,57.41,56.89,57.21001,54.387298129587094,56.687674499025164,57.54472709409682,57.652778744451616,54.08363110000003,57.26633849999989,57.6351106,57.86952450000005,57.86952450000005,59.405500274455605,56.33354872554449,50198048,45.964629115470395,45.97070736507374,NaN,NaN,NaN,NaN,NaN,NaN,-0.08856433408420868,-0.17223130091992545,-0.08366696683571677,28.461813608409074,39.26840901003864,4739599018,7705675983.014372,21.57679486658432,27.512662089535105,16.096251774689225,0,64.28571428571429
2011-06-03,56.56,56.99001,56.27,56.35001,54.406827600934484,56.68098807330189,57.49787544334792,57.52870553069432,54.137631150000026,57.269038599999895,57.647910599999996,57.773025000000054,57.773025000000054,59.43135542595027,56.114694574049835,57773680,40.11514123208292,45.065379365579226,NaN,NaN,NaN,NaN,NaN,NaN,-0.1348431257592193,-0.2522208740347409,-0.1173777482755216,3.8282296650715075,18.361386973513195,4681825338,7660742325.060732,19.63081848997981,30.97987202043406,17.242435132120153,0,100
2011-06-06,56.24001,56.53,55.86,55.89,54.42158553525354,56.6653249431375,57.4348215043931,57.37263833729486,54.19278115000003,57.26633859999989,57.6317106,57.64402500000004,57.64402500000004,59.4593755451117,55.828674454888386,50175536,37.375259556689244,44.66201275014396,NaN,NaN,NaN,NaN,NaN,NaN,-0.1850677293491126,-0.34871240996191233,-0.16364468061279974,1.2000000000000455,11.163347757826878,4631649802,7615060120.642821,18.35981718649049,32.93609376461456,17.854918130078165,71.42857142857143,100
2011-06-07,56.05,56.25999,55.75,55.78999,54.435201500076886,56.64799157792685,57.37031830814239,57.22190992421916,54.247131100000026,57.258688599999886,57.610710399999995,57.499024500000054,57.499024500000054,59.417376250266,55.580672749734106,46311056,36.78698706635788,44.0914579233448,NaN,NaN,NaN,NaN,NaN,NaN,-0.21173646892686251,-0.4283152667713779,-0.21657879784451536,1.5321839080460953,2.186804524372553,4585338746,7576011870.303482,17.43450405103902,32.36320818224881,18.210816642789133,64.28571428571429,100
2011-06-08,55.67,55.77,55.23,55.39,54.44470198266318,56.62308085361147,57.29265876664661,57.04744231238877,54.301681100000025,57.24683859999989,57.58791039999999,57.309024500000056,57.309024500000056,59.272030021578736,55.34601897842138,46426384,34.45142253445708,42.999570863442315,NaN,NaN,NaN,NaN,NaN,NaN,-0.24090426244751817,-0.517709125903913,-0.2768048634563949,5.111821086262094,2.614668331436078,4538912362,7557097417.562741,16.45390247211261,35.76577551141173,20.136648891737526,57.142857142857146,100
2011-06-09,55.37,55.75999,55.23,55.485,54.455053206716286,56.60054459908451,57.22177018756243,56.89863828263746,54.360856150000025,57.23168859999989,57.5560104,57.14552450000006,57.14552450000006,59.14395031141952,55.14709868858059,45307504,35.49885072775545,41.86350178259358,NaN,NaN,NaN,NaN,NaN,NaN,-0.23797121567386326,-0.5742688830487239,-0.33629766737486066,8.146964856230108,4.930323283512766,4584219866,7555388523.045939,15.561799681334834,33.82661559466007,22.40285452664539,50,92.85714285714286
2011-06-10,55.23,55.34,54.59,54.64,54.45689347331612,56.561721933756104,57.1205242978541,56.683529874767224,54.41370610000003,57.206488599999886,57.501810199999994,56.92202450000006,56.92202450000006,58.990259140882316,54.85378985911781,53740544,30.786486002245553,40.704567269568095,NaN,NaN,NaN,NaN,NaN,NaN,-0.2745179587103256,-0.6794451157627677,-0.4049271570524421,1.3262599469495282,4.861681963147244,4530479322,7508813384.912605,14.165092291119311,37.20864079373568,24.987938510912805,42.857142857142854,100
2011-06-13,54.71001,54.92999,54.45,54.64,54.45871542880551,56.523668034077765,57.02324883519315,56.48890798193225,54.469206150000026,57.18778869999989,57.4460104,56.733524500000065,56.733524500000065,58.90934123762862,54.557707762371514,37745776,30.786486002245553,40.04509476553886,NaN,NaN,NaN,NaN,NaN,NaN,-0.27934242060543885,-0.7541051828092407,-0.4747627622038018,4.859335038363118,4.7775199471809175,4530479322,7500950304.135423,13.467003872531533,36.81234370715051,26.373272760174768,35.714285714285715,100
2011-06-14,55.05,55.47,55.03,55.34,54.46748442951392,56.50022906310593,56.95723907695028,56.37948817412918,54.52555610000003,57.1800886999999,57.403610199999996,56.630574500000066,56.630574500000066,58.86476210267484,54.39638689732529,40565264,38.615291429921236,40.12267140945245,NaN,NaN,NaN,NaN,NaN,NaN,-0.21872202242518646,-0.7481652902352849,-0.5294432678100984,22.762148337595942,9.649247774302863,4571044586,7517545184.862696,17.8040258055355,33.71790298541868,26.552449752901474,28.571428571428573,92.85714285714286
2011-06-15,54.83,55.14999,54.17999,54.28999,54.46571831578741,56.45646195294541,56.852641073932624,56.18048834802164,54.57895605000003,57.16618869999989,57.34400999999999,56.46707400000007,56.46707400000007,58.876963084223576,54.05718491577656,59022336,32.64957958412633,39.59380009941246,NaN,NaN,NaN,NaN,NaN,NaN,-0.2314429133959235,-0.8187469095550028,-0.5873039961590794,2.631572651740222,10.084352009233093,4512022250,7471909358.058573,15.80445597912344,38.16068255110737,27.38504299234784,21.428571428571427,100
2011-06-16,54.33,54.5,53.61501,54.08,54.4618803225955,56.40940330041184,56.74391005142546,55.98044183868625,54.63205600000004,57.142488699999895,57.28320999999999,56.26907450000008,56.26907450000008,58.77817029289798,53.75997870710218,66316192,31.59821025884969,38.711429085544374,NaN,NaN,NaN,NaN,NaN,NaN,-0.23533023424882327,-0.8814667889701084,-0.6461365547212852,9.799599156162607,11.731106715166257,4445706058,7475280656.579551,14.469313539842263,40.33006479658624,29.11932698773014,14.285714285714286,100
2011-06-17,54.45,54.59801,53.631,53.78999,54.455194846748775,56.35753373010665,56.62807004940878,55.77182737785898,54.677206000000034,57.11506359999989,57.21380999999999,56.04807350000008,56.04807350000008,58.61242952023802,53.48371747976214,70353120,30.154027746692805,37.508325625977555,NaN,NaN,30.154027746692805,NaN,NaN,NaN,-0.23804738895638233,-0.9436957909167631,-0.7056484019603808,3.687679004592317,5.372950270831716,4375352938,7428061614.921658,14.077436553906123,36.68340709012505,31.04238145487107,7.142857142857143,92.85714285714286
2011-06-20,53.66,54.23,53.64,54.07001,54.4513621617065,56.31223623050058,56.52775396903981,55.6097495323486,54.72125610000003,57.08746369999989,57.15081019999999,55.86332400000008,55.86332400000008,58.438663202563156,53.287984797437,37402832,33.32284656994929,35.93065662985638,NaN,NaN,NaN,NaN,NaN,NaN,-0.20296812739681003,-0.9593585612063933,-0.7563904338095833,9.589061304660396,7.69211315513844,4412755770,7445179433.051557,13.287975639205197,34.62620612141027,34.008321011473925,0,85.71428571428571
2011-06-21,54.25999,55.28999,54.03,55.23,54.45910980188852,56.29080581009463,56.47686165652844,55.57358291022016,54.76735615000003,57.06796379999989,57.11641019999999,55.778824000000085,55.778824000000085,58.32061825450865,53.23702974549152,55892704,44.54651362429463,35.90369510365273,NaN,NaN,NaN,NaN,NaN,NaN,-0.0894174821677568,-0.8681622865192793,-0.7787448043515225,42.55584336190608,18.610861223719596,4468648474,7495749867.330431,21.38068706136261,30.67047045966652,34.61309012000815,0,78.57142857142857
2011-06-22,55,55.32001,54.82001,54.83099,54.46281010236724,56.26189856633038,56.41231766999791,55.50285977591348,54.81301110000004,57.05897369999989,57.07783019999999,55.691873000000086,55.691873000000086,58.23843125137425,53.14531474862592,36833216,41.93184920019788,35.61563939541897,NaN,NaN,NaN,NaN,NaN,NaN,-0.03192294371703741,-0.8186484839978192,-0.7867255402807818,36.02903703703709,29.391313901201187,4431815258,7460534366.177151,20.664920853115287,29.24279710854275,34.9770569306039,0,71.42857142857143
2011-06-23,54.28,55.37,54.06,55.34,54.47153836005513,56.24364314917533,56.370265996664656,55.48734932106458,54.85846110000004,57.05237369999989,57.057230199999985,55.61937350000009,55.61937350000009,58.11887844100857,53.119868558991605,80743312,46.26484216823803,36.05490374800148,NaN,NaN,NaN,NaN,NaN,NaN,0.04544322822726854,-0.7299215049966961,-0.7753647332239646,59.17653233801843,45.92047091232053,4512558570,7537579511.21532,18.265892955828015,32.58313362249884,35.38649616722886,0,64.28571428571429
2011-06-24,55.07001,55.13,54.27,54.38,54.470627530601845,56.206739324439184,56.292216349736634,55.38188748096319,54.898211150000044,57.025673699999885,57.007829999999984,55.48129900000008,55.48129900000008,57.9338707699012,53.02872723009896,56298240,40.175859149453395,36.254946576056064,NaN,NaN,NaN,NaN,NaN,NaN,0.03735653185884025,-0.7286690684004142,-0.7660256002592545,28.922335896679876,41.3759684239118,4456260330,7495683146.564157,16.57345848557962,29.564128823511908,35.36794700161004,0,57.142857142857146
2011-06-27,54.42999,55.53,54.32001,55.245,54.47833272930232,56.18769498138098,56.25114904190382,55.36885057801431,54.94143610000005,57.008573699999886,56.977729999999994,55.372049500000095,55.372049500000095,57.65657452597245,53.08752447402774,49968848,46.950752508358654,36.980929821913264,NaN,NaN,NaN,NaN,NaN,NaN,0.09251564449010041,-0.6503810446466289,-0.7428966891367293,75.6379379950717,54.57893540992333,4506229178,7522112755.92582,18.24494170606854,26.5664371886559,34.55304380943229,0,50
2011-06-28,55.38,56.08,55.28999,56.07001,54.49417031408539,56.18536458571007,56.244045550064456,55.43562766582247,54.985536150000044,56.998698799999886,56.96613039999999,55.25755000000008,55.25755000000008,57.122616804733994,53.392483195266166,47028640,52.47845127079115,38.26857473165141,NaN,NaN,NaN,NaN,NaN,NaN,0.18166154285334057,-0.5158197605700536,-0.6974813034233942,99.59472452220922,68.05166613798693,4553257818,7567952003.098895,21.582117858533707,24.704809789464104,32.393357782931886,100,42.857142857142854
2011-06-29,56.23,56.41,55.89999,56.3,54.512138768671605,56.18763459391383,56.24623984221879,55.517948840506044,55.02978615000004,56.987948799999884,56.96713039999999,55.21805000000008,55.21805000000008,56.95528889725025,53.48081110274992,65417184,53.91994434070226,39.58436713257618,NaN,NaN,NaN,NaN,NaN,NaN,0.24904969505381547,-0.3861691846061248,-0.6352188796599403,96.06438663465703,90.43234971731265,4618675002,7605150562.993485,23.48218907188786,23.616261989363473,29.772120717157158,100,35.714285714285715
2011-06-30,56.5,57.09,56.47,57.05,54.53739111923208,56.2047111366086,56.27775984840629,55.66385847474356,55.076286150000044,56.981948899999885,56.976130199999986,55.210049500000096,55.210049500000096,56.9116282334979,53.50847076650229,50483920,58.356133092251866,41.5536276390052,NaN,NaN,NaN,NaN,NaN,NaN,0.33188610391428797,-0.22036124976708038,-0.5522473536813683,98.84891755084169,98.16934290256931,4669158922,7649120428.799936,27.76794331006707,21.9992718223959,27.396162151891627,100,28.571428571428573
2011-07-01,57.10001,57.985,56.92,57.91,54.570949416553155,56.238479232913384,56.34176926611585,55.877776715244174,55.126136150000036,56.98079899999989,56.97683019999999,55.28804900000009,55.28804900000009,57.30524483840311,53.270853161597074,53203808,62.7808486638733,43.8389392576929,NaN,NaN,NaN,NaN,NaN,NaN,0.4263262667891029,-0.019339520194989746,-0.44566578698409265,98.28374893306386,97.73235103952085,4722362730,7694830742.715429,32.85562690303486,20.010181732453397,25.815229261496736,100,21.428571428571427
2011-07-05,57.95,58.25999,57.83,58.2,54.60705937260735,56.27732122830124,56.4146410596015,56.09894083760187,55.17716115000004,56.98349909999989,56.97403019999999,55.40354900000009,55.40354900000009,57.77823651090978,53.0288614890904,43128656,64.16359640592447,45.66381818455027,NaN,NaN,NaN,NaN,NaN,NaN,0.48574097631015906,0.16151043340360616,-0.3242305429065529,98.70849820666614,98.6137215635239,4765491386,7725925220.834827,34.03191014032196,19.253271939933647,25.59004400208772,100,14.285714285714286
2011-07-06,58.14,58.49001,57.94,58.39,54.64470057287991,56.3191564515032,56.49210611608772,56.317136948306455,55.22496165000004,56.98718909999989,56.97202999999999,55.53354950000009,55.53354950000009,58.24010650849877,52.826992491501414,49282640,65.07898117908728,47.98020401276176,NaN,NaN,NaN,NaN,NaN,NaN,0.5125989246515454,0.3165181129078789,-0.19608081174366654,97.94851282051287,98.31358665341429,4814774026,7757285434.601123,34.41767292816457,18.29974066999872,24.814832919554412,100,7.142857142857143
2011-07-07,58.82001,59.36,58.74001,59.19,54.689927432851256,56.37600483860214,56.59790587624114,56.59074295322965,55.276811600000045,56.99468909999989,56.97942979999998,55.723549500000104,55.723549500000104,58.862156770789,52.58494222921121,54799760,68.70384217810471,50.63060629270855,NaN,NaN,NaN,NaN,68.70384217810471,NaN,0.55540344607347,0.49817349584817094,-0.05722995022529903,97.03264094955486,97.8965506589113,4869573786,7782033228.601671,39.16970582824577,16.72641345672955,24.311983105816847,100,0
2011-07-08,58.7,59.03999,58.37,59.03,54.73311223451443,56.428559198233785,56.69328211638855,56.82305314816016,55.32851160000004,56.99918909999988,56.97562979999998,55.900799500000105,55.900799500000105,59.35048458117004,52.451114418830166,69533568,67.20140106759628,53.276847244201655,NaN,NaN,NaN,NaN,NaN,NaN,0.5434282527566383,0.6220553657204988,0.07862711296386055,94.23076923076925,96.40397433361233,4800040218,7849493212.386025,36.32640178342938,18.787716014723,23.40399905649793,92.85714285714286,0
2011-07-11,58.41,58.71001,57.75999,57.96001,54.7652206699919,56.4588849566846,56.74295771966743,56.93133475309729,55.37496165000004,56.993789199999895,56.95222999999999,56.0668000000001,56.0668000000001,59.576821224447514,52.55677877555269,52080768,58.057724365403,55.0436242295912,NaN,NaN,NaN,NaN,NaN,NaN,0.4384339361130265,0.6266695331051437,0.1882355969921172,73.73377110694179,88.33239376242197,4747959450,7819342919.987296,32.40321434347003,21.946036968864618,21.59731570167545,85.71428571428571,0
2011-07-12,57.94,58.07001,57.46001,57.52,54.792631409593966,56.479897135760154,56.77342996595498,56.98739810994517,55.41426165000004,56.98017919999988,56.92102999999998,56.2108000000001,56.2108000000001,59.71115875248119,52.71044124751901,84000624,54.75814360904636,55.77302637135919,NaN,NaN,NaN,NaN,NaN,NaN,0.31984558284678255,0.5880425755505954,0.2681969927038128,65.28301886792458,77.74918640187855,4663958826,7751864254.78651,30.688844231611135,23.386759267466015,21.287034559239498,78.57142857142857,0
2011-07-13,57.94,58.34,57.55,57.75999,54.82215736571741,56.50524550930946,56.81211859474106,57.06097828995039,55.45611160000005,56.96917909999989,56.896829799999985,56.3317995000001,56.3317995000001,59.87048390006875,52.793115099931455,82374496,56.219625724923795,56.79358183741103,NaN,NaN,NaN,NaN,NaN,NaN,0.2416203668365151,0.5702224512494567,0.3286020844129416,69.81113207547173,69.60930735011272,4746333322,7713281709.204334,30.84797508025338,21.722948372455768,21.299183139280494,71.42857142857143,7.142857142857143
2011-07-14,57.92999,58.17999,56.87,57.09,54.84472296406848,56.516824806154816,56.823015904751216,57.06374226233607,55.494711600000045,56.9527790999999,56.86482979999999,56.4718000000001,56.4718000000001,59.89598794987516,53.04761205012504,98773872,51.24286929358093,57.14915520350696,NaN,NaN,51.24286929358093,NaN,NaN,NaN,0.13417117896707464,0.4963160581217849,0.3621448791547103,55.402750491159175,63.49896714485183,4647559450,7647684047.465482,27.48400069082755,25.01471739938279,19.623978882790652,64.28571428571429,0
2011-07-15,57.72,57.85001,57.31,57.85001,54.87462631765984,56.54322451296363,56.863290182996266,57.13862490401835,55.53751170000005,56.96097919999989,56.84982979999999,56.6603005000001,56.6603005000001,59.94947736889737,53.371123631102826,68287680,56.0010053760612,58.2795227911218,NaN,NaN,NaN,NaN,NaN,NaN,0.10499109168055892,0.49338374375540894,0.38839265207485,70.0398215075823,65.08456802473773,4715847130,7715971727.465482,25.73086165957832,23.41908807591377,17.94877462630081,57.142857142857146,0
2011-07-18,57.535,57.78999,56.98,57.53999,54.901147349324916,56.5629624434,56.8898274307219,57.1768501512547,55.57986160000005,56.9707790999999,56.83502959999999,56.8478005000001,56.8478005000001,59.87849245480005,53.81710854520014,59512192,53.69893050881049,58.76153550543978,NaN,NaN,NaN,NaN,NaN,NaN,0.057872117958065905,0.4607327995224324,0.4028606815643665,55.282419453514905,60.241663817418804,4656334938,7738747544.94234,23.85498140680932,24.477033829943302,16.714273917455834,50,0
2011-07-19,58.13,58.89999,58.09,58.85001,54.94043951500328,56.60825051382772,56.96669733539947,57.33619870827806,55.62906170000005,56.9907291999999,56.84262979999998,57.08680050000011,57.08680050000011,59.95300954486797,54.22059145513225,73904256,60.99539398060506,59.36988855614078,NaN,NaN,NaN,NaN,NaN,NaN,0.10523471804244461,0.5344040791174223,0.42916936107497766,85.2604472241409,70.19422939507938,4730239194,7803531355.714916,30.169236086913337,21.801357012206367,17.382473978393758,42.857142857142854,0
2011-07-20,59.17999,59.19,58.5,58.60001,54.976853151669914,56.64769129573212,57.03074881244263,57.45656168844206,55.679661750000044,57.00022939999989,56.840829999999976,57.25530100000011,57.25530100000011,60.06065366832899,54.44994833167123,57084224,59.08191916765868,59.73860104378053,NaN,NaN,NaN,NaN,NaN,NaN,0.10953702929926279,0.5660906476990561,0.45655361839979336,73.7027681660899,71.4152116145819,4673154970,7762994938.214162,30.83774064027354,20.572618938930393,18.78835714531014,35.714285714285715,0
2011-07-21,58.64999,59.32001,58.34,58.99001,55.01678506060852,56.694073844331484,57.1075825845037,57.60260438478091,55.72631180000004,57.012440399999896,56.83683019999999,57.463252000000104,57.463252000000104,60.132224727116494,54.79427927288371,70148752,61.13045895589132,59.936767176897625,NaN,NaN,NaN,NaN,NaN,NaN,0.12721809926653815,0.615576242482966,0.4883581432164279,85.14096385542165,81.36805974855082,4743303722,7785901135.219824,28.390301541668784,20.235614667425704,19.158281407801905,28.571428571428573,0
2011-07-22,58.97,59.7,58.92,59.60001,55.06238928886117,56.75161713454274,57.20532483609179,57.79283349099225,55.77816185000004,57.0400404999999,56.85373039999999,57.6762525000001,57.6762525000001,60.313191199534685,55.03931380046552,43620352,64.15338299808764,60.03480534362722,NaN,NaN,NaN,NaN,64.15338299808764,NaN,0.16610777535771815,0.6959928624135756,0.5298850870558575,96.46678445229662,85.10350549126939,4786924074,7818337900.049362,29.684961795811088,18.946734640576434,18.999889038951856,100,57.142857142857146
2011-07-25,59.13,59.81,59.02,59.48,55.10634561434514,56.80564451801714,57.29452778369603,57.95351601565966,55.82851185000004,57.0634404999999,56.861130399999986,57.9312525000001,57.9312525000001,60.20523372356016,55.657271276440035,48916064,63.11343429205182,59.95979376406489,NaN,NaN,NaN,NaN,NaN,NaN,0.16928580782181535,0.7414923468331267,0.5722065390113114,88.77551020408147,90.12775283726658,4738008010,7826387378.935437,28.66113865301203,17.71596154598805,18.70456078900247,100,50
2011-07-26,59.44,59.83,59.32001,59.625,55.15130734952578,56.86147333944254,57.385918851002074,58.11270496654922,55.87788685000004,57.077040499999896,56.885430399999976,58.1502525000001,58.1502525000001,60.17749501758478,56.12300998241542,40918832,63.875391797558784,59.873823093955714,NaN,NaN,NaN,NaN,NaN,NaN,0.16644035868604323,0.7802569873688654,0.6138166286828222,93.07432432432438,92.77220632690081,4778926842,7834410034.3045225,27.59215637697569,16.950462883761404,18.227191329419533,100,42.857142857142854
2011-07-27,59.25,59.28999,57.94,58.09,55.18054807241607,56.88580060004764,57.41352987645298,58.11054258878262,55.91948685000004,57.07826549999989,56.899250399999985,58.2512520000001,58.2512520000001,60.04126678488127,56.46123721511893,83969504,51.70010920244124,58.65927073855118,NaN,NaN,NaN,NaN,NaN,NaN,0.0523756446647361,0.6792861845137423,0.6269105398490062,41.21621621621641,74.35535024820742,4694957338,7769100558.30473,23.915286774150864,25.605454701663948,15.602995660633514,92.85714285714286,35.714285714285715
2011-07-28,58.10001,58.92999,57.89,58.19,55.210492867715416,56.911626330739765,57.443979685219524,58.118109961279515,55.95988685000004,57.0882654999999,56.911850399999985,58.3457520000001,58.3457520000001,59.89743025856162,56.794073741438574,61031808,52.33748958125897,57.59756277524137,NaN,NaN,NaN,NaN,NaN,NaN,-0.02119718346641497,0.6004140605159876,0.6216112439824025,44.59459459459459,59.628378378378464,4755989146,7743279747.333548,21.969370541522892,23.9132059793028,13.632570781785725,85.71428571428571,28.571428571428573
2011-07-29,57.73,58.61,57.44,58,55.238249157588896,56.9331782845865,57.46578440344621,58.10686139353861,55.99728685000004,57.0940654999999,56.91105059999999,58.393252000000096,58.393252000000096,59.83782621342651,56.94867778657368,82860432,50.961444830853246,57.09068566563068,NaN,NaN,NaN,NaN,NaN,NaN,-0.0839924825940973,0.5166206407397809,0.6006131233338782,38.17567567567575,41.32882882882891,4673128714,7739738703.230984,19.997965988998544,25.218689394629155,13.082950547766819,78.57142857142857,21.428571428571427
2011-08-01,58.67,58.82001,57.03,57.73,55.263042698309405,56.94895693241647,57.47614579938949,58.07096983224922,56.03383685000004,57.1010654999999,56.90145039999999,58.3842520000001,58.3842520000001,59.84293112924344,56.92557287075677,85421008,48.99027346976274,56.67869494139614,NaN,NaN,NaN,NaN,NaN,NaN,-0.1416547792408941,0.4235446492827606,0.5651994285236547,29.054054054054028,37.274774774774784,4587707706,7721127048.921744,17.422153441342818,24.920664694061685,13.383348916453638,71.42857142857143,14.285714285714286
2011-08-02,57.46001,57.72,56.21001,56.27,55.27306217394812,56.935512240685455,57.42884596411932,57.89944889584453,56.057736800000036,57.1023654999999,56.87155039999999,58.287752000000104,58.287752000000104,60.01335866030649,56.56214533969372,90851312,39.98404176800954,55.51901037304511,NaN,NaN,NaN,NaN,NaN,NaN,-0.2686972165501225,0.22932790783600154,0.49802512438612406,1.6571868983065197,22.962305542678763,4496856394,7637494553.214409,15.586287107354277,27.979333193795732,14.17544135586084,64.28571428571429,100
2011-08-03,56.37,56.88,55.35001,56.81,55.28835508764018,56.933026849780795,57.40457749493817,57.79569185814505,56.08528680000004,57.1055653999999,56.86935039999999,58.2087520000001,58.2087520000001,60.049244762847344,56.36825923715286,103612320,44.078861998189964,55.007295566231484,NaN,NaN,NaN,NaN,NaN,NaN,-0.30431826447474986,0.11762729379268677,0.4219455582674366,32.589135243605554,21.10012539865537,4600468714,7731625945.365208,13.988420742589582,30.87341964284406,16.527888798632144,57.142857142857146,100
2011-08-04,55.98,56.09,54.17,54.17,55.27722717632037,56.878313446814836,57.277731318666085,57.450387871655046,56.102036750000046,57.0843654999999,56.821350199999976,57.957752000000106,57.957752000000106,60.44876457044007,55.46673942956014,132829936,32.42947912350171,53.323615119620094,NaN,NaN,NaN,NaN,NaN,NaN,-0.4830174105247109,-0.18182620488845203,0.3011912056362589,0,11.41544071397069,4467638778,7598796009.365208,11.750026210149363,33.08549256416918,19.59092948225294,50,100
2011-08-05,54.78999,55.03,52.32001,53.83,55.26282690590922,56.81795080430365,57.14252616891447,57.105589026735515,56.11523675000004,57.0677653999999,56.76215039999998,57.69775200000011,57.69775200000011,60.71643843387959,54.67906556612063,214111680,31.282810362336022,51.722463680586195,NaN,NaN,NaN,NaN,NaN,NaN,-0.5941459109103914,-0.4414911830017303,0.15265472790866105,20.10641825088976,17.565184498165106,4253527098,7623287789.66078,9.983917687002451,38.37329581191132,23.692400800880073,42.857142857142854,100
2011-08-08,52.21001,53.12,50.59,50.59,55.21633111580067,56.69462504580259,56.8855643583688,56.48505673847499,56.11173680000004,57.0321654999999,56.63112059999999,57.32925150000011,57.32925150000011,61.64892384394884,53.00957915605138,204804064,22.953659625524693,49.0051969409376,NaN,NaN,22.953659625524693,NaN,NaN,NaN,-0.8408139463901816,-0.8983627050790659,-0.057548758688884344,0,6.702139416963253,4048723034,7418483725.66078,8.365057049000727,40.80907763285681,27.25501768257454,35.714285714285715,100
2011-08-09,51.31,53.08,49.92999,53.03,55.19457657733499,56.62205821321244,56.73436575607983,56.156003715763084,56.118686800000035,57.01596559999991,56.54312079999999,57.10475150000011,57.10475150000011,61.810854330694966,52.39864866930526,193707056,36.63617241858155,47.401929316003525,NaN,NaN,NaN,NaN,NaN,NaN,-0.7951040750630316,-1.0514288525176738,-0.2563247774546422,31.31320069373671,17.139872981542158,4242430090,7606041370.833513,7.151029249013487,37.927294879699375,30.705434855869004,28.571428571428573,100
2011-08-10,51.82001,53.04379,50.8,50.86,55.15144646213763,56.50795805057457,56.50399847152768,55.651622409499936,56.11353680000004,56.980065599999904,56.39312079999998,56.759752000000105,56.759752000000105,62.18052888104325,51.33897511895696,205917872,31.310667762879163,45.27194423078836,NaN,NaN,NaN,NaN,NaN,NaN,-0.8609208102169148,-1.3324757902257858,-0.47155498000887097,9.394030915120315,13.569077202952343,4036512218,7411136180.341142,6.434655023473394,34.12782272678886,34.38419355053175,21.428571428571427,92.85714285714286
2011-08-11,51.58,53.69,51.34,53.10001,55.13103415903178,56.440473930761215,56.3705087275462,55.40861170383327,56.11888685000004,56.95606569999991,56.31332099999999,56.56025250000012,56.56025250000012,62.206716114073906,50.91378888592633,143824496,40.866322879426804,43.608582793741164,NaN,NaN,NaN,NaN,NaN,NaN,-0.7097912913845311,-1.358794094239535,-0.6490028028550038,32.020371696594246,24.24253443515042,4180336714,7482743642.813448,8.39887112187226,30.040263602152557,36.82845772924599,14.285714285714286,85.71428571428571
2011-08-12,53.42,53.89999,52.88,53.57001,55.11550158033494,56.38363306084515,56.260685248034584,55.233506779658676,56.12578690000003,56.93781579999991,56.24052099999998,56.34625250000012,56.34625250000012,62.10428884106788,50.58821615893236,90483248,42.66849834782885,42.14823022629666,NaN,NaN,NaN,NaN,NaN,NaN,-0.5419466678126337,-1.3264361376207958,-0.7844894698081621,36.76784164864486,26.060748086786475,4270819962,7514681881.205432,8.940333513836016,28.7057631527029,38.89294866130589,7.142857142857143,78.57142857142857
2011-08-15,53.77,54.36,53.53,54.36,55.10798415167489,56.343561119046235,56.18614857164107,55.15031565778642,56.13608690000003,56.92431569999991,56.20072079999998,56.18725300000011,56.18725300000011,61.980170839572025,50.3943351604282,73554256,45.665887851476754,40.84755137300509,NaN,NaN,NaN,NaN,45.665887851476754,NaN,-0.35076781260763334,-1.2229492355677039,-0.8721814229600705,47.329166666666666,38.70579333730192,4344374218,7588236137.205432,10.682082939537969,27.63012857964084,40.34620801105529,0,71.42857142857143
2011-08-16,53.82001,54.35001,53.17999,53.89999,55.09596430936967,56.29517357213443,56.09649529432181,55.031237023711526,56.144686900000025,56.89631559999991,56.16092059999998,55.93975200000011,55.93975200000011,61.67918834462929,50.200315655370936,89219184,44.21624155156676,40.31298939794262,NaN,NaN,NaN,NaN,NaN,NaN,-0.23395803354622824,-1.1646289648928558,-0.9306709313466276,44.11111111111117,42.73603980880756,4255155034,7608823302.635357,10.102498485051136,27.740352102317505,43.431572457604766,0,64.28571428571429
2011-08-17,53.98,54.42,53.02,53.58,55.08088008738589,56.241407758824835,55.99780920434841,54.89302397383424,56.15148690000003,56.86371559999991,56.116720799999975,55.688751500000116,55.688751500000116,61.37974578263961,49.99775721736062,84416496,43.189174341514274,39.659538309389426,NaN,NaN,NaN,NaN,NaN,NaN,-0.1604157253095635,-1.131190587983582,-0.9707748626740185,41.05738794738369,44.16588857505385,4170738538,7591940003.435356,9.447550181726767,26.682807682737014,46.53631792523472,0,57.142857142857146
2011-08-18,52.13,52.14,50.48,50.95,55.03977680293429,56.13662740716494,55.7998559022171,54.51749788108812,56.14233690000002,56.80791559999991,56.027920799999976,55.28675100000011,55.28675100000011,61.122202133890646,49.45129986610957,130016432,35.82382964419649,38.57828008177109,NaN,NaN,NaN,NaN,NaN,NaN,-0.26490166058500897,-1.3019019384052797,-1.0370002778202707,11.473652477722272,32.214050512072376,4040722106,7535547334.134152,8.182563499660848,34.08090540989171,50.08862486754401,7.142857142857143,50
2011-08-19,50.42999,51.67,49.99001,50.03,54.98992827753196,56.015704092171575,55.573587043306624,54.0901171305083,56.12738690000002,56.73741559999989,55.91882079999998,54.8082505000001,54.8082505000001,60.719467345710754,48.897033654289444,96674496,33.661282444536866,37.48335215139781,NaN,NaN,33.661282444536866,NaN,NaN,NaN,-0.36576295493489264,-1.4942039714888864,-1.1284410165539938,1.283823769160817,17.938288064755593,3944047610,7443475262.071248,7.589489358819018,33.72468966183176,53.34223826228299,0,42.857142857142854
2011-08-22,51.21001,51.24001,50.06,50.21001,54.94236690163612,55.90073985272263,55.36325068866715,53.720583118078935,56.110086950000024,56.6660155999999,55.83022099999997,54.3447510000001,54.3447510000001,60.17114541782221,48.518356582177994,77107680,34.494512174363535,37.091242894708806,NaN,NaN,NaN,NaN,NaN,NaN,-0.38803136272178906,-1.6134802199562301,-1.225448857234441,4.029058950994317,5.595511732625802,4021155290,7385972370.296432,7.1855232338924395,31.92962393962861,55.82886610701555,0,35.714285714285715
2011-08-23,50.56,52.28,50.34,52.28,54.915875688684515,55.82904203385684,55.24233889695471,53.58338472588094,56.10313695000003,56.6145156999999,55.78302099999997,53.977501000000096,53.977501000000096,59.333228317557456,48.621773682442736,75688368,43.31200440751301,37.0364673525176,NaN,NaN,NaN,NaN,NaN,NaN,-0.2383734148468184,-1.523415625792964,-1.2850422109461457,38.14945105608598,14.487444592080372,4096843658,7461660738.296432,11.030567788584703,29.07818749689937,56.35450415931228,0,28.571428571428573
2011-08-24,52.17999,53.42,51.71001,52.69,54.893727671881685,55.76688278566165,55.14224717550551,53.49830046627323,56.09789945000002,56.566815599999906,55.73002099999997,53.70750100000011,53.70750100000011,58.74150708462352,48.67349491537669,80197632,44.89421712140654,37.926805780939375,NaN,NaN,NaN,NaN,NaN,NaN,-0.09419405746589793,-1.402784782778518,-1.30859072531262,54.11773702404502,32.09874901037511,4177041290,7473385137.868172,15.125418871010329,26.938030016891464,54.9614155211147,0,21.428571428571427
2011-08-25,52.64,52.905,51.64999,51.83,54.86324281942515,55.68892471069805,55.012355129407254,53.33941470758054,56.089799450000015,56.512415599999905,55.680821199999976,53.389501000000095,53.389501000000095,58.0395723762299,48.73942962377029,93623632,42.23158926197857,38.70886141662812,NaN,NaN,NaN,NaN,NaN,NaN,-0.04184044036568313,-1.360891275769724,-1.3190508354040409,42.31638682319192,44.86119163444098,4083417658,7406618965.16542,14.293908454334886,25.720039911266042,52.80768213186011,0,14.285714285714286
2011-08-26,51.67999,53.31,51.14999,53.13,54.845996622216944,55.638252934248584,54.9385372811952,53.31947044971572,56.086874450000025,56.47251559999991,55.66182119999998,53.14600100000009,53.14600100000009,57.28703018995208,49.004971810048104,91573248,47.31800512866889,40.44917180970985,NaN,NaN,NaN,NaN,NaN,NaN,0.08815563524135461,-1.2088562913523475,-1.2970119265937021,71.26955173819218,55.90122519514304,4174990906,7482930075.8234625,12.972112967763797,25.482200373677937,50.41871938705786,50,7.142857142857143
2011-08-29,53.64,54.67,53.64,54.61,54.843648397120255,55.61789149000604,54.925653466246374,53.44237802593327,56.092999500000026,56.446015699999904,55.67822139999998,52.9900010000001,52.9900010000001,56.63373919037972,49.34626280962048,45985744,52.45094718862508,41.57879857899867,NaN,NaN,NaN,NaN,NaN,NaN,0.2712881455268399,-0.9579017446851523,-1.2291898902119922,98.717945978517,70.76796151330036,4220976650,7523558257.415695,17.966662280217335,23.792887608439212,46.53864577165875,100,0
2011-08-30,54.39,55.3,54.11,54.97,54.844905626999655,55.605061955550475,54.92739254600142,53.58786583298725,56.105299550000026,56.42351569999991,55.696221199999975,52.92500100000009,52.92500100000009,56.3735265573994,49.47647544260077,61617824,53.63433239678575,43.17334605284914,NaN,NaN,NaN,NaN,NaN,NaN,0.406031330808299,-0.7216507267016183,-1.1276820575099173,93.785299030695,87.92426558246807,4282594474,7551001489.95351,19.79524371567321,22.548918004176386,42.12651784306526,100,50
2011-08-31,55.28999,55.74001,54.60001,55.06,54.84704586951707,55.59426864949997,54.93259283831509,53.72806908698846,56.11902455000002,56.4046156999999,55.69282119999998,52.83750100000009,52.83750100000009,55.96075318642931,49.71424881357087,60899248,53.94293897549556,44.1073900597112,NaN,NaN,NaN,NaN,53.94293897549556,NaN,0.485225367443856,-0.5211503482050972,-1.0063757156489532,88.17373913043485,93.55899471321561,4343493722,7539247935.089511,20.757512781437217,21.394892775545703,38.213065644939334,100,42.857142857142854
2011-09-01,55.21001,55.64,54.46001,54.56,54.84418969171093,55.57378808218314,54.91798135445959,53.80730060251337,56.134574550000025,56.382615799999904,55.68740139999998,52.857001000000096,52.857001000000096,56.01793014568371,49.696071854316486,57158368,51.87709970576941,44.7651472995641,NaN,NaN,NaN,NaN,NaN,NaN,0.48669244319579796,-0.3980101616542058,-0.8847026048500037,79.4780869565218,87.14570837255054,4286335354,7491776539.379649,19.637229217793152,20.880537597911268,34.682014700818975,92.85714285714286,35.714285714285715
2011-09-02,53.58,54.6143,52.99001,53.28,54.82862561517649,55.5283665360013,54.853746791539606,53.7570814975121,56.14297450000003,56.3517157999999,55.64620139999998,52.82950100000009,52.82950100000009,55.96556354466223,49.693438455337954,58185104,46.92292157548137,44.854935422707285,NaN,NaN,NaN,NaN,NaN,NaN,0.38847781084863153,-0.39910534128921427,-0.7875831521378458,57.2172173913044,74.95634782608703,4228150250,7454367403.105806,18.18251857174518,26.03797319024675,32.79113030311275,85.71428571428571,28.571428571428573
2011-09-06,52.03999,53.366,51.91,53.28999,54.81331580806031,55.48404224815969,54.792422995792954,53.71259659298713,56.14727450000003,56.316115599999904,55.62440119999999,52.964500500000085,52.964500500000085,55.93120336716744,49.99779763283273,52992176,46.96549069688521,45.051310361658594,NaN,NaN,NaN,NaN,NaN,NaN,0.31437191697640743,-0.39461825591733657,-0.708990172893744,57.39095652173922,64.69542028985514,4281142426,7501826700.949543,16.969029420409072,29.25070706699135,31.36000269202575,78.57142857142857,21.428571428571427
2011-09-07,54.03,54.64999,53.89999,54.64,54.81159127265673,55.46732854027534,54.786445623408916,53.80092072698836,56.15812450000003,56.2950155999999,55.61230119999999,53.045000500000086,53.045000500000086,56.10048844467555,49.98951255532462,48952112,52.508661579470335,45.7169880215126,NaN,NaN,NaN,NaN,NaN,NaN,0.34406209540662347,-0.27891255363546463,-0.6229746490420881,80.86939130434787,65.15918840579717,4330094538,7549474728.685863,21.840965488365132,27.41052247996107,28.76039006249411,71.42857142857143,14.285714285714286
2011-09-08,54.37,55.1684,54.21001,54.39,54.80739633462034,55.44599530185405,54.77089873621641,53.85702351489423,56.16552450000002,56.27241569999989,55.578700999999995,53.22150050000008,53.22150050000008,56.15720431238645,50.28579668761372,61422784,51.43650341559488,46.832179005183924,NaN,NaN,NaN,NaN,NaN,NaN,0.33436014548098236,-0.2050244671908601,-0.5393846126718425,76.52156521739134,71.59397101449281,4268671754,7511122900.960782,23.31056344501315,26.161485026167803,24.79498833997687,64.28571428571429,7.142857142857143
2011-09-09,54.00999,54.2399,52.85001,53.17999,54.79120323676342,55.401123909738125,54.708510158325566,53.79254413252335,56.17107440000002,56.2417155999999,55.516300799999996,53.22549950000008,53.22549950000008,56.16074830411494,50.29025069588523,63663488,46.48873595280017,47.748425684345584,NaN,NaN,46.48873595280017,NaN,NaN,NaN,0.23844889505379874,-0.24132349385459406,-0.4797723889083928,54.92930470192829,70.77342040788916,4205008266,7477688679.694466,21.606801403539052,30.70406652620461,21.518640916224495,57.142857142857146,0
2011-09-12,52.61,53.89999,52.57001,53.86,54.78193753291503,55.3706066045948,54.675235250155936,53.798968500854464,56.174774400000025,56.21431549999989,55.452500799999996,53.23999900000009,53.23999900000009,56.184761346953145,50.295236653047034,65973008,49.432611145542964,48.81543275371554,NaN,NaN,NaN,NaN,NaN,NaN,0.2136043391607349,-0.21276696495747416,-0.42637130411820906,65.18506447210282,65.54531146380748,4270981274,7539694318.877009,20.231505167893385,30.089762423318504,18.39942657750083,50,0
2011-09-13,54.08,54.69,53.8,54.58,54.77992820422931,55.354951028266186,54.67150053446355,53.87335245315404,56.18283440000002,56.18136549999989,55.3859008,53.25099900000008,53.25099900000008,56.214001087079396,50.28799691292076,59019984,52.41746867434905,49.46582305848955,NaN,NaN,NaN,NaN,NaN,NaN,0.23667062416400575,-0.13053302391320187,-0.3672036480772076,74.72756109995161,64.94731009132757,4330001258,7584125093.34892,23.237313646470277,28.770059688033577,15.945260808997533,42.857142857142854,0
2011-09-14,54.85001,55.98,54.32001,55.36,54.78570006289369,55.35505100790448,54.69850051350419,54.01493793380604,56.19598440000002,56.15156549999989,55.3291008,53.32399950000009,53.32399950000009,56.41647492528843,50.23152407471175,90757312,55.48313207200294,50.22217412638929,NaN,NaN,NaN,NaN,NaN,NaN,0.2918469628818114,-0.0023949444749433724,-0.29424190735675476,87.16358765302768,75.69207107502736,4420758570,7607087378.342733,27.647728435090112,26.440730068674263,14.09873841056073,100,14.285714285714286
2011-09-15,55.97,56.28,55.39,56.17999,54.79957359460619,55.37138643349053,54.756598140425595,54.221133368681656,56.216459300000025,56.128465299999895,55.2849006,53.45399900000009,53.45399900000009,56.7877707186441,50.12022728135608,83536064,58.509516275145174,51.38488319875834,NaN,NaN,NaN,NaN,NaN,NaN,0.3661437164556945,0.16343773821286334,-0.20270597824283115,98.05049112964683,86.6472132942087,4504294634,7671849415.914328,27.87640850391881,25.221921778395085,12.416154086019008,100,7.142857142857143
2011-09-16,56.25,56.64999,56.09,56.59,54.81738878271956,55.39551739520358,54.82849625256577,54.4467397145215,56.23345930000002,56.10616519999989,55.2329006,53.735999000000085,53.735999000000085,57.128466557403414,50.343531442596756,91901936,59.974740834297336,52.288935749160366,NaN,NaN,NaN,NaN,NaN,NaN,0.421531535640445,0.3242084413077251,-0.0973230943327199,98.73438551558128,94.64948809941859,4596196570,7744061010.513088,28.996647239745915,24.48216507920627,10.69538901496394,100,0
2011-09-19,55.89999,56.91,55.42999,56.61,54.83522571025469,55.4195665556946,54.89835914462201,54.65276450361469,56.247859300000016,56.0800651999999,55.1845006,54.06499900000008,54.06499900000008,57.224265174293606,50.90573282570655,73042816,60.048855669041345,52.83164349776153,NaN,NaN,NaN,NaN,60.048855669041345,NaN,0.436313797369011,0.44806915237854383,0.011755355009532842,94.00000000000006,96.92829221507606,4669239386,7787492074.160064,26.762525246786335,26.031808288050733,9.797692071263976,100,35.714285714285715
2011-09-20,56.89999,57.35001,56.23,56.36,54.85039759373474,55.43818900013629,54.95567839385252,54.81535836041329,56.26030930000002,56.0523651999999,55.1525004,54.37249850000008,54.37249850000008,57.14449360641904,51.600503393581114,66570064,58.58843626357482,53.18550805967504,NaN,NaN,NaN,NaN,NaN,NaN,0.4066451551258815,0.5200617989168848,0.11341664379100323,81.80132021816141,91.51190191124756,4602669322,7736375637.038396,27.50244851542308,24.49380491802091,9.74649142619393,100,28.571428571428573
2011-09-21,56.64999,56.92999,55.37,55.38,54.85566726941897,55.437036742707846,54.9723184568387,54.86913375465964,56.267984300000016,56.015365199999884,55.1097004,54.52749850000007,54.52749850000007,57.1571674392422,51.89782956075794,79938000,53.133245361817025,53.12767280155515,NaN,NaN,NaN,NaN,NaN,NaN,0.30315710553062614,0.4923630257042859,0.18920592017365978,63.78664745101581,79.86265588972576,4522731322,7657462489.761811,25.263561763335417,26.987682652085905,9.874176412078935,92.85714285714286,21.428571428571427
2011-09-22,53.92999,54.46001,52.75,53.58,54.84297406275809,55.40026373790175,54.9177177330411,54.74635911135872,56.26648430000002,55.961465199999886,55.0261006,54.57199850000008,54.57199850000008,57.10409412694843,52.03990287305172,151885440,44.8694443582966,52.62712599102138,NaN,NaN,44.8694443582966,NaN,NaN,NaN,0.10580405539593835,0.3214609894185827,0.21565693402264435,30.698472980748225,58.76214688330848,4370845882,7653020532.782378,22.010389168528,36.34047005151952,11.409170940620253,85.71428571428571,14.285714285714286
2011-09-23,53.14,54.38,53.091,54.14999,54.83607869894955,55.37550584210172,54.88761076311792,54.68956205313408,56.26683425000002,55.916065099999884,54.96730039999999,54.68799800000007,54.68799800000007,56.89924014142765,52.476755858572496,85940560,47.64622106067002,52.67879023996342,NaN,NaN,NaN,NaN,NaN,NaN,0.010969890615913025,0.22936929729253563,0.2183994066766226,41.17621107314151,45.22044383496851,4456786442,7708290513.72016,20.609626679701858,34.02772733330966,11.894470120708618,78.57142857142857,7.142857142857143
2011-09-26,54.42,54.88,53.21001,54.78,54.83552070194508,55.36371364720861,54.883390733191725,54.69817519093084,56.270059300000014,55.87786499999989,54.9059002,54.770498000000075,54.770498000000075,56.86300561719617,52.677990382803976,96260944,50.607468914956705,52.93893154125425,NaN,NaN,NaN,NaN,NaN,NaN,-0.01083072573822913,0.20486099950383618,0.2156917252420653,46.23410041841005,39.36959482409993,4553047386,7793023131.921802,21.370565494096226,31.252684176352254,11.337800918390318,71.42857142857143,0
2011-09-27,55.7,56.2,54.98,55.35001,54.84063999844314,55.36344228785795,54.90168952796852,54.76025469655647,56.27433435000002,55.84856509999989,54.86210059999999,54.80749850000008,54.80749850000008,56.9134725952938,52.70152440470636,81148496,53.18740617567196,52.987413298125794,NaN,NaN,NaN,NaN,NaN,NaN,0.010483121084844393,0.2287956265981208,0.2183125055132764,58.15899581589954,48.52310243581703,4634195882,7761097185.11026,26.345102080450804,29.080959871548163,10.88263276710026,64.28571428571429,21.428571428571427
2011-09-28,55.57001,55.97,54.39999,54.53,54.83754905318499,55.34693848017759,54.887113468048184,54.73832567783681,56.27548435000001,55.80916509999989,54.7757004,54.785498500000074,54.785498500000074,56.893414680983376,52.67758231901677,76757056,49.20556915733551,52.828060851107274,NaN,NaN,NaN,NaN,NaN,NaN,-0.03102875112178491,0.17952656661104527,0.21055531773283018,41.00397489539749,48.46569037656902,4557438826,7697052385.529722,24.331879541352635,29.681761908616394,11.17848961376201,57.142857142857146,14.285714285714286
2011-09-29,55.36,55.42999,52.97,53.88,54.82802120190952,55.3178901934414,54.847618822242374,54.65658037518569,56.27290935000002,55.7610650999999,54.681300199999995,54.72649850000007,54.72649850000007,56.86619518833017,52.58680181166997,116900128,46.24984538143678,52.810997238867024,NaN,NaN,NaN,NaN,NaN,NaN,-0.09882208411769725,0.08702771258570863,0.18584979670340587,27.40564853556487,42.189539748953955,4440538698,7666639695.67378,21.552742034028903,32.93105131470468,11.427994424488007,50,7.142857142857143
2011-09-30,53.17999,53.61,52.46001,52.49001,54.80475740885569,55.2618925658485,54.755163574311304,54.45024033945372,56.26455940000002,55.6940651999999,54.55130019999999,54.62299900000007,54.62299900000007,56.97465483027703,52.27134316972311,104957936,40.62937424826391,52.1821946033471,NaN,NaN,NaN,NaN,NaN,NaN,-0.2265334865700746,-0.0973170615091874,0.1292164250608872,0.6134969325153606,23.0077067878259,4335580762,7567157873.518249,20.12390326220548,33.12887491814907,11.773035145861575,42.857142857142854,100
2011-10-03,52.03999,52.85001,51.11,51.14,54.768292161006386,55.1802709308812,54.61339245375007,54.13497935474384,56.247359400000015,55.6179151999999,54.3821,54.515999000000065,54.515999000000065,57.263728296724885,51.768269703275244,99147936,36.047458679667265,51.01290817515554,NaN,NaN,36.047458679667265,NaN,NaN,NaN,-0.38203778556389084,-0.34833080689397633,0.0337069786699145,0.480768460306973,9.499971309462392,4236432826,7471428812.214371,18.50499990271895,36.705334797405946,13.367825255623307,35.714285714285715,100
2011-10-04,50.595,52.28999,50.095,52.19,54.74263751263816,55.12105764512118,54.518357455563795,53.94974322572062,56.23570940000001,55.54871519999989,54.2363,54.46099950000006,54.46099950000006,57.3453280464846,51.57667095351551,137011440,41.56699001949067,50.018898028547525,NaN,NaN,NaN,NaN,NaN,NaN,-0.39277656862944,-0.45726373211688554,-0.06448716348744551,28.87659699986629,9.99028746422954,4373444266,7595957485.654523,16.681865055383398,37.64486586628336,15.964637568943918,28.571428571428573,100
2011-10-05,52.07001,53.6787,51.66,53.53,54.73057146773629,55.08955155313858,54.47959833965933,53.90976768041389,56.23055940000001,55.49991519999989,54.114399999999996,54.40549950000006,54.40549950000006,57.31650859343581,51.49449040656431,108825680,47.76313644219711,49.25129946905123,NaN,NaN,NaN,NaN,NaN,NaN,-0.29281384637439206,-0.4305044714554356,-0.13769062508104352,47.346592216964595,25.567985892379284,4482269946,7688750690.67954,21.314656092817543,34.2981115373533,17.27513663478981,21.428571428571427,92.85714285714286
2011-10-06,53.47,54.44,53.21001,54.42999,54.72758060736081,55.07649092832395,54.477652914574655,53.959312663231614,56.228259350000016,55.47022509999989,54.041199799999994,54.407499000000065,54.407499000000065,57.31851769799551,51.49648030200462,71939120,51.48417685850341,48.64483061363738,NaN,NaN,NaN,NaN,NaN,NaN,-0.1561188045804943,-0.3328391308066614,-0.1767203262261671,59.75167504937966,45.32495475540352,4554209066,7759518889.62945,23.551434335268855,32.40759959525406,17.802603111862943,14.285714285714286,85.71428571428571
2011-10-07,54.41,54.66,53.72,54.07001,54.72103761624279,55.056560612911596,54.46166691792467,53.96985526673337,56.224184450000024,55.43532519999989,53.95879999999999,54.452000000000055,54.452000000000055,57.31338648212514,51.59061351787497,72525184,49.951463702872275,47.92358833033959,NaN,NaN,NaN,NaN,NaN,NaN,-0.08361895203672726,-0.2812440162720762,-0.19762506423534892,54.78986245367002,53.96270990667142,4481683882,7741003364.463153,23.545047317191056,31.0012311472944,18.680130376333462,7.142857142857143,78.57142857142857
2011-10-10,54.98,55.94,54.89,55.94,54.733166595185644,55.07405446216087,54.51964076428056,54.157488098473046,56.23017445000002,55.41432529999989,53.91759999999999,54.55600000000006,54.55600000000006,57.474390755208134,51.63760924479199,48229040,57.09679602972841,47.81704259935056,NaN,NaN,NaN,NaN,NaN,NaN,0.08734609777141808,-0.08844244202107632,-0.1757885397924944,85.51585298588587,66.68579682964518,4529912922,7789232404.463153,27.364751032430757,28.36417975919558,18.394923594654063,0,71.42857142857143
2011-10-11,55.81,56.46001,55.7,56.32001,54.74895608180071,55.098726849048774,54.590243479406816,54.36344256528513,56.23792450000002,55.395425299999886,53.88940019999999,54.64300050000006,54.64300050000006,57.661105751329664,51.62489524867046,66449056,58.396665131968454,48.19300115436137,NaN,NaN,NaN,NaN,NaN,NaN,0.21577883305954682,0.09393500153193912,-0.1218438315276077,97.80047478322903,79.36873007426165,4596361978,7831200551.422483,28.838464668604168,27.346059426244206,18.348965201135314,0,64.28571428571429
2011-10-12,56.87,57.23,56.56,56.60001,54.76737452874797,55.12845522827553,54.66905785276341,54.57644898763893,56.24757455000002,55.383775399999884,53.89600039999999,54.70500100000006,54.70500100000006,57.82857949911292,51.5814225008872,85627568,59.373381048121374,49.228996632206,NaN,NaN,NaN,NaN,NaN,NaN,0.3039462732190386,0.25808900999619055,-0.04585726322284804,91.17042747021725,91.4955850797774,4681989546,7755799726.693169,31.305835956459028,26.1363639743603,17.23760505478627,100,57.142857142857146
2011-10-13,56.49001,57.19,56.42999,57.12,54.790783737417144,55.167891758408686,54.765173231086415,54.81869194119713,56.25922460000002,55.385775399999886,53.90220039999999,54.75200150000006,54.75200150000006,57.98916568738607,51.514837312614056,63443632,61.195368284016844,50.19679286244506,NaN,NaN,NaN,NaN,NaN,NaN,0.3768771696582734,0.4252391988499937,0.04836202919172032,98.45830413454802,95.80973546266478,4745433178,7807556527.625156,30.10791186042116,25.790828825131516,16.035074138136885,92.85714285714286,50
2011-10-14,57.84,58.19,57.50999,58.17999,54.82450718281598,55.227537268143166,54.89908761418106,55.13881556584502,56.27682455000001,55.401875199999886,53.982400199999994,54.83150100000006,54.83150100000006,58.31410413962453,51.34889786037559,65643504,64.67335926023739,51.201499315679385,NaN,NaN,NaN,NaN,64.67335926023739,NaN,0.47003749672808925,0.6359089001018319,0.16587140337374265,99.87634342186534,96.50169167554354,4811076682,7871267438.060238,33.58173304449885,24.376579698374925,15.82817214109084,100,42.857142857142854
2011-10-17,57.89999,58.09,56.9716,57.28,54.848939947166066,55.268180094516566,54.99245672735044,55.3427378929074,56.29092450000001,55.40677529999989,54.05140019999999,54.86500100000005,54.86500100000005,58.42736725856,51.3026347414401,65161280,59.77464102222552,51.67201609043321,NaN,NaN,NaN,NaN,NaN,NaN,0.44484096545961604,0.7219226101982628,0.2770816447386467,88.75849289684994,95.69771348442112,4745915402,7842042743.811311,31.482150111240465,25.63812412920606,16.206389242246633,92.85714285714286,35.714285714285715
2011-10-18,57.19,58.28999,56.66,57.99001,54.88019437555247,55.32207771640733,55.11000783608179,55.59485904596384,56.30432455000002,55.41526049999989,54.199400399999995,54.94650150000005,54.94650150000005,58.71080965451403,51.18219334548608,91434320,62.2067485026465,52.600671757955425,NaN,NaN,NaN,NaN,NaN,NaN,0.44851404834655895,0.8377242051718454,0.3892101568252865,96.33947082302718,94.99143571391416,4837349722,7899822296.219362,28.860934095584362,25.09514630567942,15.997437108843215,100,28.571428571428573
2011-10-19,57.71001,57.85001,56.67999,56.87,54.899993436492245,55.352729642815106,55.1790271366276,55.71630104158633,56.312349550000015,55.40966059999989,54.276200399999986,55.02100150000007,55.02100150000007,58.8745972219374,51.16740577806274,67639312,56.41246149511982,53.32657290893279,NaN,NaN,NaN,NaN,NaN,NaN,0.35227964163347486,0.82955970886713,0.4772800672336552,82.67246207743995,89.2568085991057,4769710410,7854152088.46223,26.92091537927431,23.40826211266205,15.00425965557528,92.85714285714286,21.428571428571427
2011-10-20,56.81,56.92,55.78999,56.59,54.91680942219879,55.377230045927675,55.234359405779465,55.799510466197155,56.316599500000024,55.39196059999989,54.39080039999999,55.17150150000007,55.17150150000007,59.02333913704191,51.31966386295823,80378256,55.03238967643478,54.355359725230706,NaN,NaN,55.03238967643478,NaN,NaN,NaN,0.25127448180987977,0.7913731694960049,0.5400986876861251,79.25574039748678,86.0892244326513,4689332154,7887584167.91512,25.338688653538462,26.66147899645088,13.441589049233187,85.71428571428571,14.285714285714286
2011-10-21,57.17,57.66,56.78,57.3,54.940522761281386,55.41530469848356,55.31536491927831,55.94241423132124,56.32349950000002,55.3940605999999,54.47480019999999,55.329002000000074,55.329002000000074,59.257720821206746,51.4002831787934,60455680,57.848348093673636,55.91256611194545,NaN,NaN,NaN,NaN,NaN,NaN,0.21518074555037303,0.8090746196240914,0.5938938740737184,87.91957037165383,83.2825909488602,4749787834,7898576109.733302,27.816458492794577,25.153931704853377,11.445945784843667,78.57142857142857,7.142857142857143
2011-10-24,57.52,58.64999,57.3105,58.49001,54.97584104226366,55.47618995197894,55.43986080479681,56.185042399766836,56.33659955000002,55.4068605999999,54.573200199999995,55.51450250000007,55.51450250000007,59.66604480498927,51.36296019501087,61449360,62.12900207004333,57.3812812584135,NaN,NaN,NaN,NaN,NaN,NaN,0.25180700169779824,0.9086526261959662,0.656845624498168,97.7112985855487,88.29553645156311,4811237194,7945347243.523625,31.06390849511243,23.359289819636235,9.700943348552908,100,0
2011-10-25,58.27,58.32001,57.22,57.34,54.99936501199238,55.51309708164272,55.514376067353794,56.295038361693805,56.34289955000001,55.4167604999999,54.6328002,55.61400200000007,55.61400200000007,59.83973028943213,51.38827371056801,65299184,56.1902873115251,57.983220606222645,NaN,NaN,NaN,NaN,NaN,NaN,0.18218420261745183,0.8845758777699828,0.702391675152531,75.9192129382829,87.18336063182848,4745938010,7894295024.69667,28.96989212442273,22.26499979785673,8.968114566226712,92.85714285714286,0
2011-10-26,57.64999,57.78,56.2126,57.27,55.02195839495763,55.547887238441874,55.58322406471247,56.3878918510563,56.34844955000001,55.43056049999989,54.70020039999999,55.751002000000085,55.751002000000085,60.00484231013155,51.49716168986862,98193744,55.840400382563146,58.29437942936976,NaN,NaN,NaN,NaN,NaN,NaN,0.11812477673048727,0.8500476460656401,0.7319228693351528,72.00825965164233,81.87959039182466,4647744266,7928588284.531811,26.58777377515129,25.719128921964916,7.956293951933153,85.71428571428571,0
2011-10-27,58.64,59.2,58.03,58.85001,55.06004846067945,55.61327580797768,55.71133331707669,56.62237929381285,56.35992465000001,55.461160699999894,54.8056006,55.99950250000008,55.99950250000008,60.366284817692865,51.63272018230729,104455440,61.64572747600229,59.129683984593335,NaN,NaN,NaN,NaN,NaN,NaN,0.16594101955428564,0.9393491437780099,0.7734081242237243,91.8795823665892,79.93568498550484,4752199706,7970550802.402579,31.207466748860995,23.19048100695276,8.03259382673349,100,0
2011-10-28,58.5,59.00999,58.5,58.94,55.09865494365776,55.67915153455238,55.83794769679917,56.84310507535448,56.37174965000001,55.49666069999989,54.965400599999995,56.322002000000076,56.322002000000076,60.55505783333146,52.08894616666869,42949952,61.95252125574186,59.47652150073715,NaN,NaN,NaN,NaN,NaN,NaN,0.18590434908112763,1.0057885605751338,0.8198842114940061,92.57142857142843,85.48642352988668,4795149658,8001712024.660897,30.35809909729893,22.55931012243394,8.957185762248198,92.85714285714286,0
2011-10-31,58.41,58.64,57.91,57.95,55.127026536258185,55.72411883089788,55.92077327731685,56.948523639606435,56.376499650000014,55.521310699999894,55.123800599999996,56.662502000000075,56.662502000000075,60.214184311258066,53.11081968874208,60520128,56.589671846999124,59.34745055181077,NaN,NaN,NaN,NaN,NaN,NaN,0.11801734906982253,0.9674058978312843,0.8493885487614617,63.34321600229911,82.59807564677226,4734629530,7947824239.455419,28.6614368127379,24.499876967949866,9.326608379194818,85.71428571428571,0
2011-11-01,56.56,57.9064,56.12,56.44,55.14009094883273,55.738294695632575,55.94113510957893,56.900092816786774,56.37289965000001,55.539310699999895,55.248400399999994,56.87500200000007,56.87500200000007,59.78069793042782,53.969306069572326,99932816,49.54496992564201,58.64542118591938,NaN,NaN,49.54496992564201,NaN,NaN,NaN,-0.034827957429917955,0.8058536019740643,0.8406815594039823,19.061820933076287,58.32548850226795,4634696714,7883693596.6753025,25.892613351739673,31.582370429351688,9.390901535354606,78.57142857142857,42.857142857142854
2011-11-02,57.00999,57.16,56.38499,56.92,55.15780148665529,55.76169480066955,55.979521968026816,56.90198873899756,56.37494970000001,55.56211069999989,55.34120039999999,57.04450200000008,57.04450200000008,59.512445501805146,54.57655849819501,65178768,51.60728222930012,57.96055789629677,NaN,NaN,NaN,NaN,NaN,NaN,-0.10583455003198272,0.7083883718640038,0.8142229218959866,33.13802598819355,38.514354307856316,4699875482,7908504100.214199,24.799943646910787,30.249592663506057,9.546365461814734,71.42857142857143,35.714285714285715
2011-11-03,57.36,58.175,56.71001,58.10001,55.18707719325573,55.80799807194342,56.06267836143753,57.01608600195017,56.38489975,55.58971079999989,55.44940059999998,57.22800300000008,57.22800300000008,59.421570753246144,55.034435246754015,78994192,56.33265313550415,57.36479317310153,NaN,NaN,NaN,NaN,NaN,NaN,-0.07690971812865854,0.7180857742351634,0.7949954923638219,67.74232333629504,39.9807234191883,4778869674,7979411172.905426,28.31906815666646,27.85654015361354,8.47072199640476,64.28571428571429,28.571428571428573
2011-11-04,57.78999,58.05,57.22,57.8,55.213076425163635,55.847443654677214,56.13080862177331,57.090744477954914,56.39549980000001,55.62481089999989,55.56880059999999,57.41450250000007,57.41450250000007,59.07084286057742,55.758162139422716,61527712,54.86578125223394,57.014160332387846,NaN,NaN,NaN,NaN,NaN,NaN,-0.08114221882172301,0.6935677188366682,0.7747099376583912,58.94440192257484,53.27491708235448,4717341962,8003873998.158438,26.94035583919397,26.500345987213574,7.79874143303786,57.142857142857146,21.428571428571427
2011-11-07,57.75,58.25,57.17,58.21001,55.242896659739124,55.8942271466638,56.21234593072338,57.19734119434016,56.40429985000001,55.666110999999894,55.67040079999999,57.52800300000008,57.52800300000008,59.07191648464776,55.98408951535241,65558624,56.53167864626878,56.60879819978944,NaN,NaN,NaN,NaN,NaN,NaN,-0.06043846134782438,0.6991618609736108,0.7596003223214352,70.96812032809271,65.88494852898754,4782900586,8064577641.836659,26.431212685151706,24.898264490576505,7.5135363956628956,50,14.285714285714286
2011-11-08,58.63,58.98,57.97,58.88,55.2790867427268,55.95335136158135,56.316959815793055,57.35759441392681,56.41603735,55.717011099999894,55.75580079999999,57.65600250000008,57.65600250000008,59.20256744207992,56.10943755792024,62906880,59.18288297898135,56.8066854486367,NaN,NaN,NaN,NaN,59.18288297898135,NaN,-0.008461397810420879,0.7490235750584091,0.75748497286883,90.61586329658857,73.50946184908538,4845807466,8115027713.915868,29.062379334870904,23.46931841729761,7.775512357465327,42.857142857142854,7.142857142857143
2011-11-09,57.72,57.83,56.63,56.81,55.29431971046086,55.970314700955974,56.33629472497764,57.3054425649814,56.415937350000014,55.74441099999989,55.79260079999998,57.66650200000007,57.66650200000007,59.18687766938678,56.14612633061336,69538752,49.19873563037867,56.3899958739184,NaN,NaN,NaN,NaN,NaN,NaN,-0.11444803090226918,0.6144249342409935,0.7288729651432627,22.40259740259752,61.328860342426275,4776268714,8066350587.515868,25.545147426692033,27.836602432357537,7.900423922241322,35.714285714285715,0
2011-11-10,57.39999,57.42,56.23,56.78,55.30910259891399,55.98634807321427,56.35369493184126,57.25540041593555,56.413937400000016,55.75991099999988,55.827000799999986,57.64950200000006,57.64950200000006,59.20122054666693,56.09778345333319,66052368,49.06953566251466,55.762937843121335,NaN,NaN,NaN,NaN,NaN,NaN,-0.1834383699337896,0.49957500272602573,0.6830133726598153,21.428571428571512,44.8156773759192,4710216346,8061355030.272171,23.89782950817614,28.209130988881554,8.132388339216845,28.571428571428573,50
2011-11-11,57.28,58.02,57.2,57.85001,55.334385259621314,56.02325226978429,56.412373954121996,57.31202990013216,56.42453745000002,55.79010119999988,55.89280099999999,57.633003000000066,57.633003000000066,59.16874346246365,56.09726253753648,54470944,53.736145989188536,55.16344812306027,NaN,NaN,NaN,NaN,NaN,NaN,-0.15500539948553782,0.489256623302893,0.6442620227884308,56.169155844155746,33.33344155844159,4764687290,8093241789.465926,25.55040605982591,26.305531836311907,7.225197933263688,21.428571428571427,42.857142857142854
2011-11-14,57.69,58.00999,57.28,57.49001,55.35583426201314,56.05229697731331,56.45463419121525,57.32898038583386,56.43198750000001,55.811601299999886,55.9770012,57.64350350000005,57.64350350000005,59.17230201584878,56.114704984151324,44617600,52.009489902061794,54.864819736670036,NaN,NaN,NaN,NaN,NaN,NaN,-0.15790649812876634,0.4468789001274729,0.6047853982562392,44.480844155844096,40.69285714285712,4720069690,8074296163.536803,24.50214417411048,25.226289246471545,6.394456840161709,14.285714285714286,35.714285714285715
2011-11-15,57.34,58.36,57.25999,58.13,55.38343790119709,56.09343961142592,56.520334811167594,57.4052679681354,56.437387500000014,55.84910129999989,56.073801399999994,57.65050300000005,57.65050300000005,59.18684649936981,56.114159500630294,52203872,54.790631737202425,54.789836262001415,NaN,NaN,NaN,NaN,NaN,NaN,-0.11611817736056129,0.45963767655553767,0.575755853916099,65.25974025974031,55.30324675324672,4772273562,8104669523.8869095,24.958870604620103,23.651593002342405,6.4679299089142015,7.142857142857143,28.571428571428573
2011-11-16,57.73,58.15739,57.06,57.17,55.401214638498615,56.11475763892244,56.54581187739632,57.38286149497964,56.438462500000014,55.86835129999989,56.124401399999996,57.665503000000044,57.665503000000044,59.17672468726442,56.15428131273567,68342560,50.100425750821614,53.96517185305994,NaN,NaN,NaN,NaN,NaN,NaN,-0.15035297422692173,0.3878146361324468,0.5381676103593686,36.332305648116524,48.690963354566975,4703931002,8050027984.672592,23.390218123268603,23.310480937503424,5.4274355346261105,0,21.428571428571427
2011-11-17,57.02,57.03999,55.48,55.83,55.40548115950858,56.10911887379526,56.51774082338078,57.2349699240292,56.43232500000002,55.86595119999989,56.1532014,57.62750300000005,57.62750300000005,59.27689316004547,55.978112839954626,101706816,44.38859586151862,52.71060575347257,NaN,NaN,NaN,NaN,NaN,NaN,-0.2543509712012072,0.22022889635785958,0.4745798675590668,10.00000000000004,37.197348635952295,4602224186,7993959135.069813,21.182289175134798,29.935210693102814,5.5978268746038315,0,100
2011-11-18,55.85001,55.89999,55.3,55.39999,55.40542652110551,56.09507671787852,56.473907457758,57.06020993126452,56.422449950000015,55.85695109999989,56.197601399999996,57.53250250000006,57.53250250000006,59.44438605034521,55.620618949654904,60416976,42.70599490120418,51.718914543058645,NaN,NaN,NaN,NaN,NaN,NaN,-0.337970290404708,0.0521170045531818,0.3900872949578898,2.717119565217537,16.349808404444705,4541807210,7953679472.792509,20.44443928564635,29.937484938045333,6.384540608626341,42.857142857142854,100
2011-11-21,54.67999,54.73,53.78,54.34,55.39482526218904,56.060322723465084,56.390224812355726,56.801142318763134,56.40590000000001,55.8298510999999,56.207201399999995,57.325002000000055,57.325002000000055,59.63543988059192,55.01456411940819,52289440,38.801489574398616,50.9515230893984,NaN,NaN,NaN,NaN,NaN,NaN,-0.4438667354907148,-0.16474612440550374,0.2791206110852111,10.769230769230822,7.828783444816135,4489517770,7963036530.47672,18.56415579278293,35.81349795375075,7.943243703344725,35.714285714285715,100
2011-11-22,54.2,54.67999,53.87,54.52,55.38612053321203,56.029821283396466,56.31688266285158,56.583890669357125,56.388375050000015,55.79595109999989,56.2060014,57.184002000000056,57.184002000000056,59.79784236545313,54.570161634546984,51940096,39.80789308129826,50.10870957882684,NaN,NaN,NaN,NaN,NaN,NaN,-0.4780298578307902,-0.31841671120327675,0.1596131466275135,14.230769230769281,9.239039855072548,4541457866,7994458111.534462,17.688196949381144,34.123620396380986,9.501946798063111,28.571428571428573,92.85714285714286
2011-11-23,54.11,54.17,53.25999,53.28999,55.365263512981066,55.975567198576734,56.19818098979858,56.27018584370406,56.36517505000002,55.7468509999999,56.164601199999986,56.98500150000005,56.98500150000005,60.100277317660776,53.86972568233933,48467328,35.510466302970286,48.62141051936013,NaN,NaN,NaN,NaN,NaN,NaN,-0.5543350532722112,-0.5333056699627505,0.021029383309460692,0.5244746075618952,8.508158202520667,4492990538,7949186396.417837,16.392419065426076,35.170420239560876,12.044399734490364,21.428571428571427,100
2011-11-25,53.09,53.67,52.87,52.88,55.34053452280215,55.914268838208876,56.0680562451006,55.947311001446536,56.33947005000001,55.691750999999904,56.098601399999986,56.68650100000006,56.68650100000006,60.15393367390819,53.21906832609192,25447856,34.185718198047226,47.1442631583468,NaN,NaN,34.185718198047226,NaN,NaN,NaN,-0.5994588368719062,-0.728294162780422,-0.12883532590851585,0.16366612111301337,4.972969986481398,4467542682,7924374736.817838,15.61049539217015,35.81811094589208,14.792199606737642,14.285714285714286,100
2011-11-28,54.16,54.78999,54.14,54.72,55.33436004993845,55.890619950323554,56.01519129431234,55.83042423940401,56.32087005000001,55.6470509999999,56.06120139999999,56.47550100000005,56.47550100000005,59.88178622529867,53.06921577470143,46710688,44.23956625290617,46.266255130249476,NaN,NaN,NaN,NaN,NaN,NaN,-0.47771785895333985,-0.7259826496001907,-0.2482647906468508,30.278232405892005,10.322124378188972,4514253370,7961025943.739298,20.31112936395197,31.905130890696455,16.16486584700694,7.142857142857143,92.85714285714286
2011-11-29,54.64999,55.10001,54.22,54.38,55.32486393003856,55.86070668398051,55.951066145515775,55.69228859755601,56.29987005000002,55.6005509999999,56.01660139999999,56.29700100000006,56.29700100000006,59.74935171568405,52.84465028431607,52056608,42.93440726065588,45.105649721797654,NaN,NaN,NaN,NaN,NaN,NaN,-0.39580483594224286,-0.7430208355746544,-0.3472159996324115,27.504553734062014,19.315484087022345,4462196762,7927898796.268156,21.078193705342482,30.264611896189297,16.68238707754886,0,85.71428571428571
2011-11-30,55.84,56.44,55.67,56.39,55.3354622988939,55.87118773974327,55.96827923784849,55.75873730255067,56.289320050000015,55.5848508999999,56.0172014,56.29450100000006,56.29450100000006,59.74650628448066,52.84249571551946,66918496,51.95792961471355,45.302735006393,NaN,NaN,NaN,NaN,NaN,NaN,-0.19227559023681756,-0.5875604874284335,-0.3952848971916159,64.11657559198547,40.633120577313164,4529115258,7986126578.501923,26.12371787162631,26.79175992636106,16.465950559970018,28.571428571428573,78.57142857142857
2011-12-01,56.37,56.925,56.35001,56.78,55.349835808357646,55.88918402212459,56.00011142459953,55.85600041659347,56.27881505000001,55.5774508999999,56.045201399999996,56.287501000000056,56.287501000000056,59.734969134745455,52.840032865254656,45361472,53.49452348914301,45.61880556543788,NaN,NaN,NaN,NaN,NaN,NaN,-0.02613537204148275,-0.42795411224346935,-0.4018187402019866,71.22040072859748,54.28051001821499,4574476730,8008609692.826138,28.06511872808758,25.89844894532553,16.161744478799786,21.428571428571427,71.42857142857143
2011-12-02,57.33,57.34,56.57001,56.62,55.36247425802573,55.90365562564688,56.024420780497586,55.9287622816798,56.26761505000001,55.566050999999895,56.1060014,56.21350050000005,56.21350050000005,59.564351971800725,52.86264902819938,36938336,52.7491179032383,45.54830355929858,NaN,NaN,NaN,NaN,NaN,NaN,0.07282063598467892,-0.310792945221138,-0.3836135812058169,68.30601092896173,67.88099574984822,4537538394,7976467646.171817,29.250251697597047,24.71025291576162,16.658698732337147,14.285714285714286,64.28571428571429
2011-12-05,57.49001,57.62,56.91499,57.24001,55.381156205707065,55.93011808850535,56.07209094596827,56.05364301675792,56.260165100000016,55.5675510999999,56.1678018,56.18550100000006,56.18550100000006,59.49192171069056,52.879080289309556,40501888,55.34574487466556,45.78660748591314,NaN,NaN,NaN,NaN,55.34574487466556,NaN,0.1740918881883734,-0.16599872097035018,-0.3400906091587236,79.59945355191256,73.04195506982393,4578040282,7973309692.691214,29.1748638276078,23.220270268432078,17.366454751133226,7.142857142857143,57.142857142857146
2011-12-06,57.28999,57.45,56.89,57.08,55.39806012405824,55.95288802734683,56.111616791224414,56.15139130087621,56.26041510000001,55.559850999999895,56.2138018,56.12900050000005,56.12900050000005,59.332115709303196,52.92588529069691,38669472,54.51314942829683,45.76678732099132,NaN,NaN,NaN,NaN,NaN,NaN,0.22132963944607847,-0.0634285598511255,-0.284758199297204,79.62340587700169,75.84295678595866,4539370810,7960880219.548356,28.151162960367632,22.562089109309944,17.96157196715358,0,50
2011-12-07,56.89999,57.34,56.35001,57.08,55.41479584421686,55.97520707631026,56.14959260333326,56.23983022460229,56.26301510000001,55.55525109999991,56.248401599999994,56.03900050000006,56.03900050000006,59.02142022298788,53.056580777012236,44576160,54.51314942829683,46.0819818693824,NaN,NaN,NaN,NaN,NaN,NaN,0.24193096750487605,0.0176555100838911,-0.22427545742098495,88.63157894736844,82.61814612542756,4539370810,7982042402.437476,26.388358756781884,24.56483413758929,18.20500640868709,0,42.857142857142854
2011-12-08,56.74001,57.14999,56.00999,56.12,55.42181280099082,55.97807426291798,56.1484321090849,56.22841782225921,56.25934010000001,55.5279509999999,56.2802016,56.00450050000006,56.00450050000006,58.96633954729208,53.042661452708046,51692560,49.34767770238573,46.43620200087291,NaN,NaN,NaN,NaN,NaN,NaN,0.18294077899944755,0.0044005163283245,-0.17854026267112305,68.42105263157895,78.89201248531634,4487678250,7940326506.517476,24.486845714857303,24.94397010709452,17.04798035590972,78.57142857142857,35.714285714285715
2011-12-09,56.25999,57.19,56.24001,57.02,55.437715161179966,55.99870645573149,56.18261124206197,56.303806601091665,56.25619015,55.51215089999991,56.3430016,56.01650050000005,56.01650050000005,58.992719996957945,53.04028100304215,55757856,53.77035482645491,47.2265134241051,NaN,NaN,NaN,NaN,NaN,NaN,0.19544042867398378,0.06576027317135669,-0.1296801555026271,87.3684210526317,81.47368421052636,4543436106,7976128709.257969,23.07825563392974,23.250480735533436,15.728664643096774,71.42857142857143,28.571428571428573
2011-12-12,56.42,57.0087,55.89999,56.38,55.447091129725436,56.00625682294473,56.19035197766738,56.31106311527341,56.2492456,55.4860507999999,56.42080139999999,55.943000000000055,55.943000000000055,58.804878432087854,53.081121567912255,55411696,50.40026962202633,48.05499771322137,NaN,NaN,NaN,NaN,NaN,NaN,0.15336862109109634,0.062030620861243335,-0.091338000229853,73.89473684210537,76.561403508772,4488024410,7968697401.631773,21.437605499041837,23.755806240722336,13.829245386303304,64.28571428571429,21.428571428571427
2011-12-13,56.75999,56.98,55.53,55.75999,55.450204551320205,56.00138025219335,56.1734750373667,56.25857996143785,56.243845549999996,55.4476505999999,56.5132012,55.856499000000056,55.856499000000056,58.629307866843234,53.08369013315688,68557680,47.30693973967837,48.59064390310566,NaN,NaN,NaN,NaN,NaN,NaN,0.08022411198688748,0.00894213975375635,-0.07128197223313112,60.84189473684221,74.03501754385975,4419466730,7921888108.974118,19.50440665256306,23.914586620258387,12.288951091838195,57.142857142857146,14.285714285714286
2011-12-14,55.52,55.59,54.58,54.89,55.4446303766802,55.979372722446946,56.123142682960165,56.12823901272949,56.232595550000006,55.40175059999991,56.56720119999999,55.69449900000005,55.69449900000005,58.289986568077865,53.099011431922236,63682704,43.29181179548251,49.146454295427965,NaN,NaN,NaN,NaN,NaN,NaN,-0.02469779499982619,-0.10215421598291385,-0.07745642098308766,42.52631578947375,59.0876491228071,4355784026,7897297757.924613,18.075860604244383,28.059698599747424,11.233416891417972,50,7.142857142857143
2011-12-15,55.36,55.42,54.66,54.74001,55.43761922865353,55.95483088635889,56.06890218558918,55.99602672580287,56.21497060000001,55.3529006999999,56.591401399999995,55.57299950000006,55.57299950000006,58.10761907935824,53.03837992064188,58732816,42.62019325503147,49.74891679949826,NaN,NaN,NaN,NaN,NaN,NaN,-0.09803197038995856,-0.19999638397053587,-0.10196441358057731,17.24166666666661,40.203292397660846,4297051210,7850931290.8934555,17.20196508661277,26.70312447200407,9.972535755177722,42.857142857142854,0
2011-12-16,54.88,55.61,54.77,54.86,55.43187177364205,55.93315106682703,56.02149425674255,55.88783370429783,56.19943310000001,55.32060069999989,56.6000016,55.52449950000006,55.52449950000006,58.07466640004082,52.974332599959304,60978704,43.37698663489856,49.687303969640574,NaN,NaN,NaN,NaN,NaN,NaN,-0.1302703413506245,-0.26480234026885796,-0.13453199891823345,18.82352941176473,26.197170622635017,4358029914,7803019452.036312,17.46280579007738,25.20113796258202,9.682111407482466,35.714285714285715,0
2011-12-19,55.06,55.2,54.17,54.32001,55.420808472411785,55.90120767936511,55.95476938392912,55.738517161031375,56.18508315,55.281900799999896,56.605001599999994,55.47050050000005,55.47050050000005,58.07410302689822,52.86689797310188,46733808,40.77087157383307,49.53276570629608,NaN,NaN,40.77087157383307,NaN,NaN,NaN,-0.1768821388832698,-0.3556346725223207,-0.17875253363905091,4.348115942029041,13.471104006820115,4311296106,7769898340.226759,16.29425872985899,27.41280928968377,10.221145316223447,28.571428571428573,100
2011-12-20,55.2,56,55.17,55.92999,55.42587495527336,55.90177762630837,55.95379764338288,55.75675266950458,56.177633099999994,55.2612006999999,56.6048014,55.55000000000005,55.55000000000005,58.10735904403203,52.992640955968064,81758752,50.34901846169869,49.41784348108074,NaN,NaN,NaN,NaN,NaN,NaN,-0.09245024143051919,-0.2943153354271999,-0.2018650939966807,51.014202898550636,24.728616084114805,4393054858,7837864489.268879,19.58895417594836,24.529596221317952,10.930865980240387,21.428571428571427,92.85714285714286
2011-12-21,55.64,55.64,54.4875,55.13,55.422930925867654,55.88649490103494,55.92149185344629,55.697061939075574,56.1681331,55.23520069999989,56.5810012,55.58050000000005,55.58050000000005,58.10229782696577,53.058702173034334,78552000,46.339040815431694,48.90673757581563,NaN,NaN,NaN,NaN,NaN,NaN,-0.0838966967504175,-0.30673596493470257,-0.22283926818428507,27.8260869565218,27.729468599033826,4314502858,7846895413.346971,17.85268325901896,26.549098189428815,12.043056978779854,14.285714285714286,85.71428571428571
2011-12-22,55.22,55.6261,55.17,55.60001,55.42469290670479,55.880821932697614,55.90888472193859,55.68781889725885,56.16543315,55.2285007999999,56.5610012,55.69600100000006,55.69600100000006,57.988792153175964,53.403209846824154,40334016,48.91337756715012,48.63275612323792,NaN,NaN,NaN,NaN,NaN,NaN,-0.04211097393554364,-0.2754779856037146,-0.23336701166817098,41.44956521739123,40.09661835748789,4354836874,7882615026.902594,17.28523960460775,25.705240877933587,12.841069513461084,7.142857142857143,78.57142857142857
2011-12-23,55.67999,56.08,55.58099,56.08,55.431213375294796,55.88476605284222,55.915595124999825,55.725169478472296,56.16338309999999,55.2212007999999,56.5402012,55.85600100000006,55.85600100000006,57.752843110476846,53.95915888952328,26594528,51.47369561820335,48.35618117634776,NaN,NaN,NaN,NaN,NaN,NaN,0.019046437395007304,-0.20955896492441184,-0.22860540231941914,58.231707317073045,42.50245316366203,4381431402,7909209554.902594,19.737473769564968,24.849653657198306,12.848270403905415,0,71.42857142857143
2011-12-27,56.00999,56.42,55.92999,56.24001,55.4392611029038,55.8918005864493,55.92831727696062,55.77420190909398,56.16313319999999,55.24190089999989,56.5014016,55.932001500000055,55.932001500000055,57.76129060128983,54.10271239871028,21443440,52.3313633635397,48.20033931457939,NaN,NaN,NaN,NaN,NaN,NaN,0.06867588848354172,-0.14276054171499197,-0.2114364301985337,65.29999999999986,54.99375751148805,4402874842,7914899827.556621,21.42561478546804,24.004725594308702,12.466565636473527,0,64.28571428571429
2011-12-28,56.17,56.25999,55.44,55.59,55.440760992427144,55.88582433721268,55.91504993276609,55.756658870132654,56.163633149999995,55.25950089999989,56.46760160000001,55.99250150000006,55.99250150000006,57.6875852413224,54.29741775867772,38189536,48.575444200191114,47.77621751257184,NaN,NaN,NaN,NaN,NaN,NaN,0.056628069304100886,-0.14065134356840758,-0.19727941287250847,47.019867549668994,56.85052495558063,4364685306,7890682243.409693,20.18854899516743,26.068899366003112,13.118951405022122,0,57.142857142857146
2011-12-29,55.67999,56.03,55.5,55.99001,55.4462261566816,55.887887419644116,55.91798954324585,55.77888278726288,56.17283325,55.313500999999896,56.42760160000001,55.972502000000055,55.972502000000055,57.65776435349565,54.28723964650446,28077808,50.91040262044783,47.88784072100485,NaN,NaN,NaN,NaN,NaN,NaN,0.07343445513463737,-0.10548634395421175,-0.17892079908884911,60.265231788079426,57.5283664459161,4392763114,7914522951.251504,19.40853178536819,25.06168531853123,13.960911953615781,7.142857142857143,50
2011-12-30,55.86,56.12,55.82001,55.83,55.450044801888744,55.88674113410661,55.914538972922486,55.783751093237846,56.1787333,55.34150099999989,56.40680160000001,55.92500200000005,55.92500200000005,57.56960984386762,54.28039415613248,21832336,49.93369788879793,47.61379379688649,NaN,NaN,NaN,NaN,NaN,NaN,0.07153853908143265,-0.08949762523705829,-0.16103616431849094,58.47747208229116,55.25419047334653,4370930778,7894144697.298505,19.65225799355913,24.485031285630697,14.716459486230006,0,42.857142857142854
2012-01-03,56.91,57.19,56.75,56.89999,55.464472117292836,55.90680546808469,55.95318411123925,55.89005956054853,56.19098325,55.401900899999895,56.41300140000001,55.93900150000005,55.93900150000005,57.61156447105313,54.26643852894698,39512880,56.011089754011465,48.01456666345685,NaN,NaN,NaN,NaN,NaN,NaN,0.13635244527805698,0.009404392279080298,-0.12694805299897668,90.39701986754982,69.71324124597346,4410443658,7881570621.258506,25.613212249417632,22.012246897142752,14.890137974796902,100,35.714285714285715
2012-01-04,56.8,57.22,56.56,57.14,55.48114403652375,55.93122516178598,55.999725910798496,56.00910150716295,56.19918325,55.44230079999989,56.40980140000001,55.934001000000045,55.934001000000045,57.59150566911136,54.276496330888726,29403360,57.26422406073738,48.72580125781821,NaN,NaN,NaN,NaN,NaN,NaN,0.18630296419469256,0.10593065224438902,-0.08037231195030353,97.37704918032792,82.08384704338964,4439847018,7903845893.985779,24.329104628030663,22.351940351672432,14.467153387032669,100,28.571428571428573
2012-01-05,57.02,57.66,56.8,57.61,55.5023266829265,55.96446822788923,56.062873914296596,56.16156803029029,56.210258249999995,55.482700699999896,56.39220120000001,55.96050100000004,55.96050100000004,57.70510540103964,54.21589659896045,41260528,59.68615545984755,49.896825805272854,NaN,NaN,NaN,NaN,NaN,NaN,0.23857171353576878,0.21784232996940744,-0.020729383566361337,98.56733524355309,95.44713476381027,4481107546,7940308686.171825,26.09282721093482,20.882793628122975,13.713632497262052,100,21.428571428571427
2012-01-06,57.64999,57.94,57.39999,57.81,55.52528860647947,56.00101341149538,56.131388662755555,56.318561551215026,56.2207582,55.5172006999999,56.4016012,55.99700100000005,55.99700100000005,57.86027479204571,54.13372720795439,46325168,60.70663954763426,51.188714826173054,NaN,NaN,NaN,NaN,NaN,NaN,0.2717789481608174,0.31899430163466036,0.04721535347384301,96.55172413793115,97.49870285393739,4527432714,7964329556.695853,27.18896458192863,19.994123962723624,13.257100119586521,100,14.285714285714286
2012-01-09,57.95,57.98,57.431,57.62,55.54613150591749,56.03307255186181,56.189765577941614,56.44250807014693,56.22535819999999,55.5544007999999,56.408601200000014,56.07200100000004,56.07200100000004,58.06526180183377,54.078740198166315,39195456,59.174167829637334,52.31708491151154,NaN,NaN,NaN,NaN,NaN,NaN,0.26578968844638284,0.37945246403182153,0.11366277558543872,90.55118110236221,95.22341349461549,4488237258,7952121135.974542,26.302935258696724,19.104037596324776,13.093978278668933,100,7.142857142857143
2012-01-10,58.25999,58.405,57.6398,58.03999,55.57094601829642,56.0728134914289,56.262323398414495,56.59464920632341,56.231358149999984,55.5990006999999,56.39240080000001,56.123000500000046,56.123000500000046,58.25784020080823,53.98816079919186,35949856,61.48845500949796,53.796912299773325,NaN,NaN,NaN,NaN,NaN,NaN,0.27386914062170753,0.4559992013625731,0.1821300607408656,90.68257817485647,92.59516113838328,4524187114,7953773927.315473,28.08877328507752,17.878457205967965,12.863504694170583,100,0
2012-01-11,58.02,58.28999,57.81,58.16,55.59670774945765,56.1141439173412,56.33674208867275,56.743730234292606,56.23950814999999,55.6711006999999,56.37680080000001,56.212000500000045,56.212000500000045,58.52338973423717,53.90061126576292,37144048,62.14873146571387,54.639748942917265,NaN,NaN,NaN,NaN,NaN,NaN,0.2705748246580597,0.5203485915634403,0.24977376690538056,93.74601148691757,91.65992358804543,4561331162,7970799411.180718,26.95028839157886,17.153813475838593,13.650190656941348,92.85714285714286,7.142857142857143
2012-01-12,58.28999,58.47,57.86,58.39,55.62450170219937,56.15921037442355,56.41726200676401,56.90051783102664,56.24605814999999,55.754700699999894,56.38560080000001,56.343501000000046,56.343501000000046,58.82970781604041,53.85729418395968,26188208,63.44235573899229,55.86141429460016,NaN,NaN,NaN,NaN,NaN,NaN,0.2667269547440787,0.5831824603354789,0.31645550559140023,97.57575757575762,94.00144907917722,4587519370,7990118581.016784,27.08481034868258,16.252261774337754,14.036640520173544,100,0
2012-01-13,58.10001,58.2,57.67999,58.17999,55.64992944645609,56.19922581255378,56.48638859473405,57.02237232330982,56.25020804999999,55.834400499999894,56.420400600000015,56.50800050000006,56.50800050000006,59.022953646311315,53.9930473536888,35985088,61.37959637346346,56.75185849505112,NaN,NaN,NaN,NaN,NaN,NaN,0.23404550469775742,0.609012386463597,0.3749668817658396,90.42871287128706,93.91682731132074,4551534282,8023334254.5406,25.410765762678512,16.81476584836869,14.091756039472491,92.85714285714286,0
2012-01-17,58.71001,58.96001,58.49001,58.71001,55.68037800917792,56.248944311315086,56.57358943415625,57.18309972108983,56.256608149999984,55.89870059999989,56.45620080000001,56.70650050000006,56.70650050000006,59.25836088296411,54.15464011703601,41790752,64.51538201462063,57.68340752336663,NaN,NaN,NaN,NaN,NaN,NaN,0.23169848954596262,0.6645899936982929,0.43289150415233024,92.8977474495811,93.63407263220859,4593325034,8020666759.732089,30.318640885554586,15.668969059251772,15.548191538807993,100,14.285714285714286
2012-01-18,58.84,59.49001,58.68221,59.49001,55.71828479515625,56.313123829902906,56.687958868110904,57.40280546193842,56.26675814999999,55.96670069999989,56.48400080000001,56.93800100000006,56.93800100000006,59.61480762285498,54.26119437714513,48692624,68.56100362705904,58.84266754218944,NaN,NaN,NaN,NaN,NaN,NaN,0.2639125967985933,0.7627822501505719,0.4988696533519786,100,94.44215344028937,4642017658,8069359383.732089,32.81128547919415,14.56227210990752,17.89422373959435,100,7.142857142857143
2012-01-19,59.75999,59.97,59.64999,59.86,55.75949589172186,56.383359001588,56.81235263798891,57.63682398937286,56.279708149999976,56.04700069999989,56.525200800000015,57.21500050000005,57.21500050000005,59.89739104951818,54.53260995048193,47774416,70.29125611832491,60.393796964913285,NaN,NaN,NaN,NaN,NaN,NaN,0.2893328387466192,0.8605357017852526,0.5712028630386334,97.53914988814319,96.81229911257475,4689792074,8084289915.103483,35.71664479076962,13.932573608098647,20.120204891827118,100,0
2012-01-20,59.61,59.8,59.56,59.77,55.79940140523707,56.450421199576354,56.928338809048164,57.839983609432586,56.292958149999976,56.11340069999989,56.5564006,57.40700100000006,57.40700100000006,60.23951161500511,54.57449038499501,41050560,69.2922623996707,61.7067869491435,NaN,NaN,NaN,NaN,NaN,NaN,0.27914731120788083,0.9201370020484845,0.6409896908406036,95.18071127882246,97.57328705565521,4648741514,8115077835.103485,34.70648992586842,14.386905806668768,22.1685923961687,92.85714285714286,0
2012-01-23,59.8,60.21001,59.44,59.78999,55.83910875443869,56.51655127483227,57.040560424379606,58.02569850377234,56.30560814999997,56.16520059999989,56.57460040000001,57.64000050000006,57.64000050000006,60.45153778770224,54.82846321229788,40964624,69.39630000736611,63.096972814755496,NaN,NaN,NaN,NaN,NaN,NaN,0.2535617909929627,0.957941929581807,0.7043801385888443,88.49263426675559,93.73749847790707,4689706138,8111352230.736374,36.05085522641585,13.34373704332548,24.670124356029483,100,0
2012-01-24,59.53999,59.84,59.41,59.67999,55.87732647827512,56.57919362582569,57.1440674665608,58.18325007484164,56.317908099999975,56.212300499999884,56.6320002,57.843999500000066,57.843999500000066,60.62577568368891,55.062223316311226,38440192,68.03042704594108,63.95549690703619,NaN,NaN,NaN,NaN,NaN,NaN,0.2107915122321754,0.9678695288790635,0.7570780166468881,85.47894389330438,89.71742981296079,4651265946,8121183980.308838,34.544515089289476,13.07770016754317,27.349860324979268,92.85714285714286,7.142857142857143
2012-01-25,60.28,60.58,59.8335,60.42999,55.92262661281965,56.655447019373696,57.27292717375449,58.3972253058091,56.33530804999997,56.26600039999988,56.70500000000001,58.06149900000006,58.06149900000006,60.936248577294585,55.18674942270554,61591776,72.067260114558,65.01285662516624,NaN,NaN,NaN,NaN,NaN,NaN,0.21389500281418217,1.0244467701646158,0.8105517673504337,96.03148148148144,90.0010198805138,4712857722,8158021885.397223,38.648334519490476,11.952026311578553,30.815835363945435,100,0
2012-01-26,60.67,60.8,59.92999,60.22,55.96538654702045,56.72603222691085,57.388498657136665,58.57082289573204,56.352608099999976,56.322600399999885,56.752399800000006,58.260498500000054,58.260498500000054,61.15429234306036,55.366704656939746,37852656,69.42402509781357,65.7084187421638,NaN,NaN,NaN,NaN,NaN,NaN,0.18383676412682814,1.0403477225089688,0.8565109583821406,82.94122664345107,88.15055067274561,4675005066,8145404913.507889,37.54952972909273,10.969114889763642,33.93676307622331,100,0
2012-01-27,60.09,60.50999,60.06,60.39999,56.00951195451278,56.798783865981925,57.5065963568568,58.7450292866147,56.37275804999999,56.39380029999988,56.81059940000001,58.50099800000006,58.50099800000006,61.263579237927004,55.738416762073115,45540384,70.42529828794846,66.40260865218625,NaN,NaN,NaN,NaN,NaN,NaN,0.1590377098875857,1.0553080957416228,0.8962703858540371,88.1267438409025,89.03315065527833,4720545450,8168680615.003833,35.90482132105951,10.488656263036852,36.7607022764061,92.85714285714286,0
2012-01-30,59.88,60.53999,59.66,60.45,56.0536959151644,56.87108517556644,57.62202395070555,58.907407449794256,56.390757999999984,56.46540039999988,56.856999400000014,58.72399750000005,58.72399750000005,61.35680011320958,56.091194886790525,42797536,70.71227789107172,67.22675937086014,NaN,NaN,NaN,NaN,NaN,NaN,0.13017751892092022,1.0589922845051873,0.9288147655842671,88.9247515980003,86.66424069411795,4763342986,8202724982.752739,32.872490523278124,13.441733456305085,38.6249895067971,85.71428571428571,0
2012-01-31,60.75,60.86,60.14,60.53,56.09823625431699,56.94353893446612,57.736062227148466,59.061940073623376,56.40965799999998,56.52430039999988,56.92419940000001,58.95899750000005,58.95899750000005,61.34395752065436,56.57403747934575,51449600,71.19381986159466,67.91999971743847,NaN,NaN,NaN,NaN,NaN,NaN,0.1019019758705525,1.0561922354224578,0.9542902595519053,89.6226741425342,88.89138986047898,4814792586,8207012449.419406,33.67407595009631,12.510740758120454,40.31148818216015,100,0
2012-02-01,60.85001,61.24001,60.66,61.02,56.14720902790587,57.02426093576382,57.86484410059362,59.24842197137353,56.431508049999984,56.59060039999988,57.027999400000006,59.16499800000005,59.16499800000005,61.51445184294108,56.815544157059016,46146672,74.01225429051131,68.767394204924,NaN,NaN,NaN,NaN,NaN,NaN,0.1014081164470031,1.081050405110659,0.979642288663656,93.81997853944655,90.78913475999366,4860939258,8218150313.617059,35.033935221713236,11.653571304858994,42.301934865394564,100,14.285714285714286
2012-02-02,61.2,61.41,60.97,61.21001,56.19758515698144,57.107147055847705,57.99602707704093,59.435239878861765,56.45630809999998,56.670900599999875,57.14419980000002,59.368498500000044,59.368498500000044,61.6859486034849,57.051048396515185,46373504,75.03240432193661,69.59525481799145,NaN,NaN,NaN,NaN,NaN,NaN,0.09897737644834503,1.1033640092240873,1.0043866327757422,94.63835217599954,92.69366828599341,4907312762,8222368194.594513,35.19135533562077,11.144008196609969,44.22353792302493,100,7.142857142857143
2012-02-03,61.78,62.12,61.6799,62.05,56.255818140494064,57.20502533196953,58.15500640735305,59.684264652303504,56.483558049999985,56.75280059999988,57.29839980000001,59.590498500000045,59.590498500000045,62.03857236451888,57.14242463548121,36453760,78.96378715090101,70.85126844495127,NaN,NaN,NaN,NaN,NaN,NaN,0.136714676302369,1.1752799781537036,1.0385653018513346,98.0716200320111,95.5099835824857,4943766522,8247225666.478175,38.99246372749131,10.155025724000145,46.960534404370044,100,0
2012-02-06,61.82001,62.02,61.66,62,56.31297417889711,57.29997532539588,58.30579046980979,59.904810875893645,56.50418304999998,56.827000599999884,57.44799980000002,59.79999850000005,59.79999850000005,62.31884926178371,57.28114773821639,28541040,78.17471720123248,71.82693524399498,NaN,NaN,NaN,NaN,NaN,NaN,0.14054159071262173,1.2142422902421117,1.07370069952949,96.50938539003262,96.40645253268106,4915225482,8272595479.811508,37.45817716334207,9.956220025652316,48.82822696229958,92.85714285714286,0
2012-02-07,61.95,62.25,61.67,62.13,56.37085503283843,57.39561937835833,58.45575947099372,60.11673364961806,56.52313304999998,56.89470059999989,57.624800000000015,60.02549850000005,60.02549850000005,62.530795062512915,57.52020193748718,37935696,78.76876424547305,72.55606100245312,NaN,NaN,NaN,NaN,NaN,NaN,0.13408037607629164,1.2413011696248546,1.107220793548563,95.77464788732402,96.78521776978921,4953161178,8294833646.432199,37.588422392944636,9.365981988975266,50.36997966974978,100,0
2012-02-08,62.14,62.46001,61.91,62.46001,56.43144363947685,57.49590434116312,58.61278890350377,60.339902825844916,56.542983049999975,56.95750079999988,57.816400200000004,60.24649950000005,60.24649950000005,62.79170392128834,57.70129507871176,41171072,80.239161740871,73.26662568977784,NaN,NaN,NaN,NaN,NaN,NaN,0.13396804365705228,1.2746808481198784,1.140712804462826,100,97.4280110924522,4994332250,8336004718.432199,37.622361327380375,8.831312692510041,51.66298107717101,100,21.428571428571427
2012-02-09,62.67,62.98,62.32001,62.91,56.49590688684524,57.60311415618959,58.78130698571931,60.584673985288255,56.563432999999975,57.02070079999989,57.980200200000006,60.48399950000005,60.48399950000005,63.09179387382311,57.876205126177,46856288,82.06331799346964,74.17884394647776,NaN,NaN,NaN,NaN,82.06331799346964,NaN,0.14519245929864422,1.3222033785861314,1.1770109192874871,98.0392156862745,97.93795452453281,5041188538,8372921643.229726,40.45050882090975,8.224580373791547,53.435592097809135,100,14.285714285714286
2012-02-10,62.47,62.64,62.25,62.47501,56.555400450160214,57.69958734121554,58.92615808431855,60.76470598668937,56.57970804999998,57.07935089999988,58.14210040000001,60.68825000000005,60.68825000000005,63.24746398287875,58.12903601712136,58093568,74.86854403743409,74.56971852005404,NaN,NaN,NaN,NaN,NaN,NaN,0.1061258474705391,1.309668228625661,1.2035423811551218,85.85462184873951,94.63127917833799,4983094970,8381862094.387058,37.66382585071585,8.388747719212205,54.69258942127965,92.85714285714286,7.142857142857143
2012-02-13,62.92999,63.13,62.64999,63.05,56.620023331253144,57.80553610673603,59.08787737512959,60.9823530355761,56.59930804999999,57.14625089999988,58.275300400000006,60.93175050000004,60.93175050000004,63.41563962859428,58.44786137140581,36810176,77.65706552468855,75.25733555425029,NaN,NaN,NaN,NaN,NaN,NaN,0.10179841209920992,1.3307903962791343,1.2289919841799244,97.69452449567709,93.86278734356368,5019905146,8406402467.341288,40.21126057449267,7.8134633534575215,56.29140015985873,100,0
2012-02-14,62.89999,63.22,62.69,63.21001,56.685595337907344,57.912555391751155,59.24952963492843,61.194510841711704,56.61995809999999,57.22455099999988,58.40390060000001,61.15675050000006,61.15675050000006,63.60992646253124,58.703574537468874,51685264,78.37611950575399,75.70796836790714,NaN,NaN,NaN,NaN,NaN,NaN,0.09275659753027665,1.3449377310927702,1.2521811335624935,99.71938202247186,94.4228427889628,5071590410,8456139294.407853,38.90130861510132,7.372860468719916,57.38960632682796,100,21.428571428571427
2012-02-15,63.52,63.86,62.67,62.77,56.746136677828666,58.00874241369668,59.387587296303785,61.34455742821535,56.638958099999996,57.31645099999987,58.526900600000005,61.320750000000054,61.320750000000054,63.744672228563786,58.89682777143632,105708880,71.55635184802517,75.86027742149369,NaN,NaN,NaN,NaN,NaN,NaN,0.04273060258121375,1.3055943867890107,1.262863784207797,74.04761904761916,90.48717518858935,4965881530,8368196612.727181,40.68679183810217,6.488187202054715,58.654547831444525,100,14.285714285714286
2012-02-16,62.78999,63.7,62.63,63.63,56.81463283028808,58.12005444510863,59.55395642193893,61.562218625528175,56.66365809999999,57.41125109999987,58.65470040000001,61.50925000000005,61.50925000000005,64.03373786293915,58.984762137060955,83642256,75.95938523706766,76.25556934643078,NaN,NaN,NaN,NaN,NaN,NaN,0.052505172137470746,1.3284952493796354,1.2759900772421646,94.52380952380959,89.43027019796686,5049523786,8440895022.147741,36.45149605345964,6.201939259104059,59.80708160319138,92.85714285714286,7.142857142857143
2012-02-17,63.64,63.69,63.14999,63.42999,56.88045727973795,58.22520168381935,59.70595773872564,61.74010161357311,56.687808,57.49775099999987,58.78170020000002,61.692249500000045,61.692249500000045,64.21651850689007,59.16798049311002,76112256,73.12429859102264,76.42785653928442,NaN,NaN,NaN,NaN,NaN,NaN,0.0314821461769883,1.3153427599634,1.2838606137864117,88.44059139784937,85.67067332309269,4973411530,8443712532.929837,34.4996409176189,5.869846250430259,61.87602464100146,85.71428571428571,0
2012-02-21,63.50999,63.89,63.21001,63.61,56.94741790382016,58.33183135344669,59.8590574352462,61.91818717418519,56.71445800000001,57.58035089999988,58.91230020000001,61.883250000000054,61.883250000000054,64.38081769880688,59.38568230119323,38141232,74.06259702204113,76.63276919360202,NaN,NaN,NaN,NaN,NaN,NaN,0.016438080179617787,1.3044082140109339,1.287970133831316,91.33126934984517,91.43189009050137,5011552762,8450442876.652068,34.15523233189104,5.472470756382618,63.772984379033424,100,0
2012-02-22,63.49001,63.67999,63.23,63.32001,57.010826780399064,58.43060716822992,59.994781065236545,62.05169410997708,56.73870804999999,57.66825099999987,59.05630040000001,62.06525100000006,62.06525100000006,64.42052845459344,59.709973545406676,43174688,69.83287176819555,76.33424187057946,NaN,NaN,69.83287176819555,NaN,NaN,NaN,-0.024101622449973714,1.257843105768849,1.2819447282188228,80.47979452054805,86.75055175608087,4968378074,8424540366.5532675,32.58322888400601,5.220598867065939,65.36599610919403,92.85714285714286,0
2012-02-23,63.39999,63.81,63.09,63.74001,57.07778382736027,58.535743857967944,60.14165278816844,62.21248609950307,56.763958099999996,57.766851099999876,59.19070060000001,62.23075200000005,62.23075200000005,64.568254384621,59.893249615379105,54249248,72.30027240024022,76.1390895904583,NaN,NaN,NaN,NaN,NaN,NaN,-0.0331315023808354,1.2405303502427785,1.2736618526236139,93.27399103139004,88.3616849672611,5022627322,8468242656.587934,30.189032541275413,6.265758608052768,66.34642635904754,85.71428571428571,0
2012-02-24,63.92,64.07001,63.8,63.96001,57.1462636897746,58.643155068701255,60.291392286671645,62.378916947169444,56.787808150000004,57.88155109999989,59.342300800000004,62.41775250000006,62.41775250000006,64.67905358015554,60.15645141984458,41369696,73.52193161614125,75.75038562368975,NaN,NaN,NaN,NaN,NaN,NaN,-0.03462629403148498,1.2303789850842577,1.2650052791157427,95.43570358629219,89.72982971274342,5063997018,8475904959.824702,31.890064353066155,6.046461422965374,67.02128139264113,100,7.142857142857143
2012-02-27,63.60001,64.25999,63.33,64.05,57.21495758340868,58.7502213049646,60.43878866758648,62.538067714105686,56.81428315,58.01065109999988,59.508101,62.60025300000005,62.60025300000005,64.76793151031931,60.432574489680796,42678416,74.02654704029027,75.454087755051,NaN,NaN,NaN,NaN,NaN,NaN,-0.039537893023318116,1.2155829128365951,1.2551208058599133,91.89224668821097,93.53398043529774,5106675434,8499309963.044264,28.82794506150546,10.318605298746775,66.25548028359151,100,0
2012-02-28,64.10001,64.7,64.03,64.7,57.289435617404614,58.86803870486629,60.60589499434779,62.743966027048,56.84223315,58.13575109999988,59.70430100000001,62.812753000000065,62.812753000000065,64.92823758375226,60.697268416247866,43727280,77.37985469421555,75.35487992996119,NaN,NaN,NaN,NaN,77.37985469421555,NaN,-0.010504961756438558,1.241989603664365,1.2524945654208035,100,95.7759834248344,5150402714,8543037243.044264,31.382544830493654,9.603182003685209,65.75782603864205,100,0
2012-02-29,64.74001,64.96001,64.2,64.41,57.36028700429611,58.977780512690714,60.75507558280474,62.90263592923391,56.87223315,58.24455109999988,59.8977008,63.00675300000006,63.00675300000006,64.9542586785785,61.05924732142163,59784400,72.86021823688064,74.82781253681902,NaN,NaN,NaN,NaN,NaN,NaN,-0.02168287182571449,1.2253909756386605,1.247073847464375,79.70450293541349,90.53224987454148,5090618314,8516291155.698044,31.60343279368115,8.853326242919508,65.34748045504892,100,0
2012-03-01,64.66,64.98,64.46001,64.92,57.43550802912899,59.0954482253107,60.91840595210652,63.09476584073544,56.909838150000006,58.349451199999876,60.0989008,63.20175300000005,63.20175300000005,65.09472518365688,61.30878081634324,67558816,75.56338871309265,74.36353187393495,NaN,NaN,NaN,NaN,NaN,NaN,-0.006374643009567915,1.239105543702415,1.245480186711983,97.80219780219772,92.50223357920373,5158177130,8568259175.875047,29.936596134884198,8.328097362196662,64.65211695874825,100,7.142857142857143
2012-03-02,64.83,65.0784,64.66,64.87,57.50948307361527,59.209795785205536,61.07337042457293,63.2638357606654,56.946388150000004,58.45745109999988,60.3099006,63.38475250000006,63.38475250000006,65.1771224381228,61.59238256187733,33358160,74.77703160448111,74.35699527158117,NaN,NaN,NaN,NaN,NaN,NaN,-0.010991260749025455,1.231741110775701,1.2427323715247265,91.48831890214028,89.66500654658383,5124818970,8568386740.54044,29.649075733049486,7.955031477505019,64.23224576280883,100,0
2012-03-05,64.83,64.91,63.99001,64.2,57.576055381340495,59.30861171025097,61.19598334909948,63.35299425964965,56.9771882,58.54005109999987,60.47530080000001,63.49225250000005,63.49225250000005,65.20776345743873,61.77674154256137,45788688,65.01360782856109,73.45389115042921,NaN,NaN,NaN,NaN,NaN,NaN,-0.06739627583101737,1.1584870267359548,1.2258833025669722,64.12350923051791,84.4713419782853,5079030282,8543500815.816389,26.80564816405027,14.176315047066584,61.61482757508105,92.85714285714286,21.428571428571427
2012-03-06,63.59,63.72,63.23,63.57001,57.63569672082964,59.39299583480046,61.28908243344852,63.3736624253973,57.0039882,58.61255109999988,60.644101,63.57075300000006,63.57075300000006,65.14370381680666,61.99780218319346,54638576,57.42166025081191,71.9571440607905,NaN,NaN,57.42166025081191,NaN,NaN,NaN,-0.15059745648902823,1.037636481955687,1.1882339384447151,38.39282796928611,64.6682187006481,5024391706,8564689432.5745945,24.173316763568867,20.47836286803034,57.33918820940388,85.71428571428571,14.285714285714286
2012-03-07,63.86,64.21001,63.77,64.06,57.699620136542784,59.48541175886382,61.397745867430935,63.43902790869279,57.0354632,58.68715100000002,60.8133008,63.66725300000005,63.66725300000005,65.10587871786281,62.2286272821373,42741792,61.21523258294512,71.21849268471335,NaN,NaN,NaN,NaN,NaN,NaN,-0.17441466203998535,0.9702156108947335,1.1446302729347189,58.40548929913413,53.640608832979375,5067133498,8578287813.207035,27.5905044462522,19.142661144939744,53.45230696586737,78.57142857142857,7.142857142857143
2012-03-08,64.42,64.94,64.3,64.75,57.76977317001002,59.58966103096552,61.52920681380619,63.56388239357919,57.0746132,58.763451000000025,60.98670079999999,63.78175250000005,63.78175250000005,65.18181838955192,62.38168661044819,43711008,65.83188542497945,70.49509984099276,NaN,NaN,NaN,NaN,NaN,NaN,-0.14660090794616232,0.961379138002016,1.1079800459481783,83.48420840877075,60.09417522573032,5110844506,8596045410.207035,32.46667524321296,17.456642576185363,50.53422015112027,71.42857142857143,0
2012-03-09,64.85001,65.14,64.82001,65.02,57.84191473050743,59.69719249569888,61.666100664245164,63.70256026085736,57.11686315000001,58.83185110000002,61.16230059999999,63.88725250000006,63.88725250000006,65.32611468418662,62.4483903158135,43117168,67.46392449322693,70.09078740543592,NaN,NaN,NaN,NaN,NaN,NaN,-0.11435319723442783,0.9650385494051434,1.0793917466395713,94.1463414634144,78.67867972377307,5153961674,8606823691.616829,33.22570119722473,16.752428918277037,47.8229037273261,100,21.428571428571427
2012-03-12,64.97,65.11,64.72,65.05,57.91363697199492,59.80318868390286,61.79880259898065,63.83088785506142,57.1581632,58.909551100000016,61.35150059999999,64.01600200000004,64.01600200000004,65.38550162543939,62.646502374560704,32687296,67.6488265525624,69.6326609433303,NaN,NaN,NaN,NaN,NaN,NaN,-0.09607245194539926,0.9593011817078221,1.0553736336532213,95.6097560975608,91.0801019899153,5186648970,8629453358.078367,31.842346737757705,17.122613038832522,44.80013155738181,92.85714285714286,14.285714285714286
2012-03-13,65.42,66.25999,65.27,66.25999,57.99668526083079,59.931046135706765,61.97375112451082,64.06223091648414,57.2037557,58.992250900000016,61.556900199999994,64.17650150000006,64.17650150000006,65.78676648505648,62.56623651494363,61558512,74.05354236721605,69.9341374146889,NaN,NaN,NaN,NaN,NaN,NaN,-0.011981063194147268,1.0403973046605373,1.0523783678546845,100,96.58536585365839,5248207482,8691011870.078367,39.56034940332299,15.031559227218061,42.83946027455262,100,7.142857142857143
2012-03-14,66.31,66.74001,66.08,66.49001,58.08119595475287,60.060926608267025,62.15085931570648,64.29344797205708,57.24905580000001,59.08845100000001,61.77010039999999,64.34050150000004,64.34050150000004,66.17598848554482,62.50501451445527,59926896,75.06419457280812,70.13156042701519,NaN,NaN,NaN,NaN,NaN,NaN,0.0464388636175741,1.1104269473766522,1.063988083759078,92.87751316947815,96.16242308901298,5308134378,8705540290.297697,41.78054091208637,14.025406210755802,41.7045020867003,100,0
2012-03-15,66.69,66.82001,66.35001,66.67999,58.166756094506574,60.19199717047956,62.328472283717986,64.52073768900402,57.290655750000006,59.18935090000001,61.965700399999996,64.53600100000006,64.53600100000006,66.48983787961052,62.582164120389585,65531136,75.89918658792487,70.30136435357116,NaN,NaN,NaN,NaN,NaN,NaN,0.08304484350357488,1.1677941381385466,1.0847492946349717,96.09973231272357,96.32574849406723,5373665514,8732026023.477613,40.5716428208424,13.340600451567191,40.44640697431007,100,50
2012-03-16,66.64999,66.67,66.36,66.52,58.24987294928761,60.317304157202734,62.49284591965061,64.71114362338459,57.33780575000001,59.28155090000001,62.1533004,64.68050100000006,64.68050100000006,66.76785348487661,62.59314851512352,53023024,73.66215068152543,70.2753360422308,NaN,NaN,NaN,NaN,NaN,NaN,0.08153577430591907,1.1866690125173704,1.1051332382114514,91.64319876546303,93.5401480825549,5320642490,8733736443.606644,39.16940348687434,12.879521890500653,40.67696182692024,92.85714285714286,42.857142857142854
2012-03-19,66.62,67.14999,66.45,66.99001,58.33683948710564,60.449436946169016,62.66920529535059,64.92817851639558,57.38670575000001,59.366550900000014,62.3409006,64.85850200000006,64.85850200000006,67.09105967766767,62.625944322332444,60966112,75.90860089857028,70.170246485399,NaN,NaN,NaN,NaN,NaN,NaN,0.09623533033727627,1.2254274011330466,1.1291920707957703,95.91886713996708,94.55393273938455,5381608602,8766835418.653944,41.38308548888879,11.909806331443942,40.83163599342498,100,35.714285714285715
2012-03-20,66.66,67.185,66.46001,67.11,58.42413461658718,60.58132928386864,62.84335410729762,65.13597103864362,57.4405057,59.4642509,62.52690059999999,65.03350200000007,65.03350200000007,67.3922963920798,62.67470760792034,47290544,76.46059521459108,70.42741626952117,NaN,NaN,NaN,NaN,NaN,NaN,0.09776676515822125,1.251400527243547,1.1536337620853256,98.10366624525909,95.22191071689639,5428899146,8804341577.214144,38.551144150639374,10.987121436709575,40.78940309076167,100,28.571428571428573
2012-03-21,67.13,67.49001,67.03,67.12,58.51066064030273,60.71080791191085,63.01106571093301,65.32492617782042,57.4966557,59.56275090000001,62.71690059999999,65.22350150000005,65.22350150000005,67.61159604546972,62.835406954530384,39648096,76.50890282053577,70.49495299148141,NaN,NaN,NaN,NaN,NaN,NaN,0.08372226129218485,1.2582865887005568,1.174564327408372,91.31433963770054,95.11229100764223,5468547242,8780207616.298164,39.946517360907634,10.43472646055927,40.93981920842492,100,21.428571428571427
2012-03-22,66.71001,67.14,66.67999,66.98,58.59493267373256,60.83495032949677,63.16671019285721,65.48255225612323,57.552605750000005,59.64405080000002,62.895700799999986,65.38550100000006,65.38550100000006,67.78860902838454,62.982392971615575,56960464,74.21269618847771,70.45464331890973,NaN,NaN,NaN,NaN,NaN,NaN,0.05088782737192665,1.2381741116232803,1.1872862842513536,88.02796237567532,92.48198941954497,5411586778,8797544271.076626,37.894743688417556,13.806849806171623,40.146934246653,92.85714285714286,14.285714285714286
2012-03-23,67.06,67.08,66.56,66.939,58.67795821926756,60.9558226001998,63.31464312647065,65.62126156506388,57.61035075000001,59.72404080000001,63.07128079999998,65.53445050000006,65.53445050000006,67.93496113156792,63.133939868432215,45547680,73.51682915137737,71.06201627053947,NaN,NaN,NaN,NaN,NaN,NaN,0.014199429663360963,1.205035571330555,1.190836141667194,87.06552332036769,88.80260844458117,5366039098,8818391093.845856,35.66471696956498,14.352261136474254,40.98933669571465,85.71428571428571,7.142857142857143
2012-03-26,67.37,68.11,67.33,68.11,58.771809381264895,61.09748947940377,63.50269633719729,65.85828427315303,57.67347575000001,59.82564080000001,63.265680799999984,65.73745050000005,65.73745050000005,68.2837395017191,63.191161498281005,40855232,79.44502697419598,72.63511389363833,NaN,NaN,NaN,NaN,NaN,NaN,0.054333353723118094,1.2587528338210916,1.2044194800979735,100,91.69782856534766,5406894330,8859246325.845856,42.195807849877376,12.559791681871534,44.26427333805928,100,0
2012-03-27,68.145,68.49001,68.13,68.21001,58.865721825232406,61.23833146991063,63.68729687299348,66.08225815190036,57.741325800000006,59.94334090000001,63.46628119999998,65.91295100000006,65.91295100000006,68.62732668631978,63.198575313680344,37278176,79.85968509722984,73.96686050180153,NaN,NaN,NaN,NaN,79.85968509722984,NaN,0.0720422176784794,1.2944722521960728,1.2224300345175934,93.31743838320192,93.46098723452319,5444172506,8838537838.808718,44.613271556342774,12.034521118919365,47.08100943684035,100,0
2012-03-28,68.25,68.50999,67.53999,67.938,58.95599324985696,61.37099817347675,63.85399111326824,66.25899547076699,57.80781580000001,60.05352090000001,63.650840999999986,66.08935100000005,66.08935100000005,68.84829280353449,63.33040919646561,44421856,75.40420063787255,74.65059730272246,NaN,NaN,NaN,NaN,NaN,NaN,0.050861514414765496,1.2860069275360502,1.2351454131212847,84.90787574637403,92.74177137652532,5399750650,8830570298.079975,40.013193193068766,17.065391422003977,47.80513065441695,100,0
2012-03-29,67.61,67.92999,67.2,67.67999,59.04279918766933,61.49592870469503,64.00403028529693,66.3943282830749,57.86951575,60.149320700000004,63.814640599999976,66.22735050000006,66.22735050000006,69.01448784155839,63.44021315844172,53975296,71.33856848919731,74.92735758814891,NaN,NaN,NaN,NaN,NaN,NaN,0.007193434912667218,1.2441372067621188,1.2369437718494516,78.10020606914536,85.44184006624043,5345775354,8847575706.821245,36.89609242182738,19.32483369347434,47.68320107491637,92.85714285714286,7.142857142857143
2012-03-30,67.99001,68.02,67.28,67.55,59.12744795197113,61.61581130460206,64.14308792116765,66.50439225611538,57.93581580000001,60.24682070000001,63.96844059999998,66.36135050000006,66.36135050000006,69.1322187438377,63.59048225616242,39480224,69.31092170102177,75.04607867018173,NaN,NaN,NaN,NaN,NaN,NaN,-0.040126601448512655,1.1867855200388107,1.2269121214873233,70.37058756354178,77.7928897930204,5306295130,8836905376.010435,34.97698596178469,17.825337287625246,47.85612847478654,85.71428571428571,0
2012-04-02,67.46001,68.34,67.36,68.25,59.21821961414057,61.74718137777826,64.30414329680814,66.67064061267583,58.00666580000001,60.34722060000002,64.13804059999998,66.56385050000006,66.56385050000006,69.26436860116267,63.86333239883744,40031536,73.65363705057642,75.01751400470746,NaN,NaN,NaN,NaN,NaN,NaN,-0.034195539686589616,1.1841676968790864,1.218363236565676,89.30077901555144,79.2571908827462,5346326666,8869584180.908394,34.7454343364358,16.049253167901384,47.27585510219161,78.57142857142857,0
2012-04-03,68.31,68.55,67.85001,68.23,59.307889070716286,61.87555402376285,64.4580984616392,66.81915103051622,58.078865850000014,60.44072060000001,64.30684079999997,66.79685000000005,66.79685000000005,69.21309452199922,64.38060547800087,45539664,73.33433514051484,74.89395261668652,NaN,NaN,NaN,NaN,NaN,NaN,-0.04106941672122022,1.1670264656641507,1.208095882385371,85.45447933854275,81.70861530587867,5300787002,8873486985.867552,34.40764885718686,14.906745666671215,46.5479232827649,100,0
2012-04-04,67.73,67.75999,66.91,67.3,59.387412562549954,61.982968795569526,64.5695455807906,66.86494617046706,58.14501580000001,60.545620600000014,64.45924099999998,66.95885000000006,66.95885000000006,69.02907317398126,64.88862682601885,54087968,60.25370385632257,73.77641813585778,NaN,NaN,NaN,NaN,NaN,NaN,-0.11358930989381877,1.0661092450180973,1.179698554911916,42.92237442922369,72.55921092777264,5246699034,8869033266.55283,30.061700556980586,22.01863943613423,44.04318212133789,92.85714285714286,0
2012-04-05,67.19,67.78,67.13,67.72,59.47032388033553,62.09657337387508,64.69309281291646,66.94637986851782,58.20746580000001,60.655020600000014,64.60504119999997,67.10735000000005,67.10735000000005,68.93428217993792,65.28041782006218,42938464,63.426477980910754,73.04529865724245,NaN,NaN,NaN,NaN,NaN,NaN,-0.13704050240562005,1.008397926904891,1.145438429310511,60.47619047619045,62.951014747985646,5289637498,8904044629.506676,28.367788210829765,20.636387099388706,41.56225955431977,85.71428571428571,0
2012-04-09,66.88,67.48,66.75999,67.21001,59.54733568252124,62.197829544689434,64.79179544770405,66.97148750008755,58.26936090000001,60.74862060000001,64.74484139999998,67.21685050000005,67.21685050000005,68.77262090809829,65.66108009190181,36908144,57.43147360917829,71.72550385085731,NaN,NaN,NaN,NaN,NaN,NaN,-0.18754447984757272,0.9110078295010453,1.098552309348618,35.885339164302216,46.4279680232388,5252729354,8913273075.173151,25.792437802180114,22.261963877062108,38.13672332921624,78.57142857142857,0
2012-04-10,67.19,67.44,65.92,66.13,59.61283482995884,62.27569430618073,64.844274057598,66.89134583341254,58.32331090000002,60.83502050000001,64.85944159999998,67.27085050000005,67.27085050000005,68.57697382752738,65.96472717247272,69254192,47.246896626863915,69.63881109459109,NaN,NaN,NaN,NaN,NaN,NaN,-0.2883070097562712,0.7381685471532791,1.0264755569095503,7.984790874524491,34.78210683833907,5183475162,8863154909.909992,22.33503482893853,26.68559194142321,34.79622841367041,71.42857142857143,100
2012-04-11,66.705,66.89,66.28,66.45,59.68086632418811,62.35835382487022,64.90724370239808,66.84931289689706,58.38366090000002,60.918220500000004,64.97944159999997,67.28035100000005,67.28035100000005,68.55940863251303,66.00129336748708,62949952,50.072060005438836,67.750465179227,NaN,NaN,NaN,NaN,NaN,NaN,-0.32528601084602915,0.6198680433520138,0.945154054198043,20.15209125475293,21.34074043119321,5246425114,8835291816.401796,20.831437527745067,24.88911459848723,31.246086425179843,64.28571428571429,92.85714285714286
2012-04-12,66.58,67.28,66.4807,67.205,59.755733325937484,62.45432701645695,64.99735179250011,66.88318785909735,58.44346090000001,61.0185705,65.11294159999997,67.31610050000005,67.31610050000005,68.54373403476356,66.08846696523653,57407344,56.05223635846317,66.45328947708312,NaN,NaN,NaN,NaN,NaN,NaN,-0.2918461550443687,0.580346360392582,0.8721925154369508,48.859315589353564,25.66539923954366,5303832458,8881925856.76111,22.75046696796057,23.063070686632443,27.966951013241697,57.142857142857146,85.71428571428571
2012-04-13,66.96001,67.20219,66.16,66.19,59.81975587990826,62.52830073890335,65.04412231044128,66.81716996775474,58.49406085000001,61.12217050000001,65.21634159999996,67.29160100000004,67.29160100000004,68.58673664820527,65.99646535179481,55227424,47.76867143604807,64.6141353545596,NaN,NaN,NaN,NaN,NaN,NaN,-0.3283141850164958,0.46179978416633105,0.7901139691828268,10.266159695817358,26.425855513307948,5248605034,8829877935.001585,20.69207234262964,23.75304166987063,25.415282045861062,50,78.57142857142857
2012-04-16,66.53,66.56,65.24001,65.45,59.87577820946141,62.58615616981615,65.06003908258084,66.68696330415905,58.53981085000002,61.22267060000001,65.30114139999996,67.23810100000006,67.23810100000006,68.72979553148001,65.7464064685201,57587264,42.80227329938188,61.99679580635859,NaN,NaN,NaN,NaN,NaN,NaN,-0.38838925707048066,0.30462739784472603,0.6930166549152067,6.344127927879082,21.823201071016666,5191017770,8790613157.637636,18.42444459347103,28.787975039270947,23.117187906532994,42.857142857142854,100
2012-04-17,65.75,66.99001,65.63,66.78,59.94447693374538,62.669202582295036,65.12748853032276,66.6958239418582,58.58846085000002,61.34707060000001,65.39574139999996,67.22760050000005,67.22760050000005,68.72905746229804,65.72614353770206,47362400,52.384222322207926,60.03426275099989,NaN,NaN,NaN,NaN,NaN,NaN,-0.3271237494280471,0.28411196813014783,0.611235717558195,46.52551820398259,21.045268609226344,5238380170,8823348345.155375,19.573968107183802,25.303862483348166,19.92123745845451,35.714285714285715,92.85714285714286
2012-04-18,66.59,67,66.41,66.61,60.010800546344925,62.747238174724835,65.18562623501599,66.68765023310979,58.63196085000002,61.46797060000001,65.48794139999997,67.20260050000005,67.20260050000005,68.72752446847747,65.67767653152262,42536000,51.20347628032982,58.30563958260399,NaN,NaN,NaN,NaN,NaN,NaN,-0.2879968708678746,0.2512396289733516,0.5392364998412262,41.38955102583397,31.419732385898545,5195844170,8809650311.25707,18.723578404981847,24.100437192598182,17.94636858969851,28.571428571428573,85.71428571428571
2012-04-19,66.38,67.17,65.62,65.86,60.06900153593353,62.80887702275009,65.21207226501537,66.60882640138504,58.67026085000001,61.59367070000001,65.56254139999997,67.13960050000006,67.13960050000006,68.77320625465164,65.50599474534847,81110256,46.2504669647978,56.51363233086117,NaN,NaN,NaN,NaN,NaN,NaN,-0.30115499363791065,0.16279275779383795,0.4639477514317486,18.730872298707897,35.54864717617482,5114733914,8753658070.01836,16.50302941443439,27.286802807926865,17.472958336773313,21.428571428571427,78.57142857142857
2012-04-20,66.22,66.50999,65.58,65.67999,60.12483226691926,62.86573074507187,65.23042198011281,66.52036579172933,58.70671080000002,61.72167060000001,65.62694099999997,67.07460000000006,67.07460000000006,68.8275305747955,65.32166942520462,59906832,45.122280738956846,54.785872262142234,NaN,NaN,NaN,NaN,NaN,NaN,-0.30933274842723407,0.077281815897706,0.38661456432494007,13.292487288481407,24.47097020434109,5054827082,8706633277.89337,15.328403209631688,25.650764787208193,16.951996654493545,14.285714285714286,71.42857142857143
2012-04-23,65.08,65.17999,64.49001,65.08,60.17413741849221,62.90957766101104,65.22452307893191,66.38318809727892,58.736160800000015,61.8252706,65.67034099999996,66.98165000000004,66.98165000000004,68.93874354657903,65.02455645342106,70514128,41.489532691885344,52.48843623652145,NaN,NaN,NaN,NaN,NaN,NaN,-0.3400573241777435,-0.038457090897239254,0.3016002332805042,14.531809191648264,15.518389592945857,4984312954,8756709979.710814,13.9592726379728,31.541102347657006,17.082975946684822,7.142857142857143,100
2012-04-24,64.97,65.23,64.45,64.73,60.21946938447736,62.945625628119735,65.205130017013,66.22574161182378,58.76466080000002,61.92877060000001,65.71544079999997,66.81265000000005,66.81265000000005,68.92814567479115,64.69715432520894,49661440,39.49213929196314,50.07113653305347,NaN,NaN,39.49213929196314,NaN,NaN,NaN,-0.3665743402653173,-0.1566176920511424,0.2099566482141749,8.408408408408446,12.077568296179374,4934651514,8742702906.8903,13.511610532385603,29.670374529290218,16.931269688793257,0,100
2012-04-25,66.06,66.49001,65.97,66.45,60.281464713985045,63.01501918003816,65.25394844771837,66.24709955355485,58.80711075000002,62.029370600000014,65.78344079999997,66.72464950000006,66.72464950000006,68.74458158020241,64.7047174197977,57526768,51.778220599457576,49.46574487184883,NaN,NaN,NaN,NaN,NaN,NaN,-0.2561260124951453,-0.11020086740475676,0.14592514509038856,60.06006006006009,27.66675922003893,4992178282,8791377360.559116,20.82785305634506,25.932811267953053,16.607958361386036,7.142857142857143,92.85714285714286
2012-04-26,66.42,66.99001,66.35001,66.84,60.346723771557336,63.09076137449285,65.31614654780785,66.3035662627401,58.85371075000002,62.129970600000014,65.85604059999996,66.66974950000005,66.66974950000005,68.61301655036586,64.72648244963425,41799488,54.05619775292625,48.796439141278505,NaN,NaN,NaN,NaN,NaN,NaN,-0.14991407438956292,-0.04146744789656509,0.10844662649299783,78.87788778877886,49.11545208574913,5033977770,8813582032.325117,23.52146958790125,24.713674664000028,15.657574582883393,0,85.71428571428571
2012-04-27,67.12,67.45,66.77,67.24001,60.41531368427816,63.172924713611806,65.39159217338401,66.39275138057438,58.90111085000002,62.23617070000001,65.94544079999996,66.64775050000006,66.64775050000006,68.55438975246321,64.7411112475369,46012480,56.334620441167324,48.71809248642058,NaN,NaN,NaN,NaN,56.334620441167324,NaN,-0.05094472924078494,0.04476571494201664,0.09571044418280159,93.00033333333317,77.31276039405738,5079990250,8831176392.692175,25.773828552442463,23.45214087289949,15.469686052807962,0,78.57142857142857
2012-04-30,67.02,67.17,66.71001,66.75999,60.47844479189728,63.24395570938187,65.44525483325131,66.42772648718635,58.94946080000002,62.33137050000001,66.00804059999997,66.60825000000007,66.60825000000007,68.47070558069164,64.7457944193085,37787616,52.94166522401945,49.12486167193169,NaN,NaN,NaN,NaN,NaN,NaN,-0.01774838300324466,0.07352496542874576,0.09127334843199042,76.99966666666664,82.9592959295929,5042202634,8801600368.455822,24.714887369659657,22.95363432076533,15.099674670223438,92.85714285714286,71.42857142857143
2012-05-01,66.67999,67.63,66.59,66.87,60.54204235615701,63.31575856662184,65.50112719273166,66.46984777412098,58.99456075000002,62.42927050000001,66.07684079999996,66.53925000000007,66.53925000000007,68.24931748113951,64.82918251886062,37643728,53.63093402064496,49.37906695873213,NaN,NaN,NaN,NaN,NaN,NaN,0.010177302764651314,0.10399497688780457,0.09381767412315326,76.10062893081783,82.03354297693922,5079846362,8784226340.14813,26.273952989740362,21.119936905496413,15.242524773480588,100,64.28571428571429
2012-05-02,66.5,67.11,66.38,67.06,60.60689765609575,63.3899019613422,65.56225945968336,66.52605274801422,59.04216080000002,62.52907050000002,66.14584079999997,66.48075000000007,66.48075000000007,68.02773118606704,64.9337688139331,38299216,54.8606738916711,49.293955353961266,NaN,NaN,NaN,NaN,NaN,NaN,0.03841710886401166,0.14183906020316783,0.10342195133915617,82.07547169811338,78.39192243186595,5118145578,8817279088.202925,24.777679278610307,21.5554360461179,15.69053729747928,92.85714285714286,57.142857142857146
2012-05-03,67.10001,67.14999,66.175,66.35001,60.66404305255251,63.4485179621077,65.59315163773499,66.50928677201287,59.07966080000002,62.63137060000002,66.20644079999997,66.43325050000007,66.43325050000007,67.9343535800931,64.93214741990704,51307360,49.570262562335984,49.422640434410404,NaN,NaN,NaN,NaN,NaN,NaN,0.00785060258045979,0.1132352045647309,0.10538460198427112,59.74874213836475,72.64161425576532,5066838218,8784390996.243828,22.901750720464374,21.515341368401526,15.421556209827335,85.71428571428571,50
2012-05-04,65.75,66.3524,64.69,64.7,60.704201828149,63.47329978464022,65.55812608331401,66.33697374610688,59.11016075000002,62.70817060000001,66.22564059999996,66.28225050000006,66.28225050000006,67.8416712453637,64.72282975463642,107553936,39.93254277811648,49.217659682891444,NaN,NaN,NaN,NaN,NaN,NaN,-0.11797998772212981,-0.04209038266839116,0.07588960505373865,7.861635220125804,49.89528301886798,4959284282,8678131020.012836,20.106548425788908,29.79208868121223,15.240097212610493,78.57142857142857,42.857142857142854
2012-05-07,64.31,65.07001,64.28999,64.75999,60.74455792936145,63.49877879880576,65.5268266290664,66.18678481790623,59.13901065000002,62.79197050000002,66.24164019999998,66.15974950000006,66.15974950000006,67.79164255687145,64.52785644312867,50266736,40.386354516631606,48.36066912535028,NaN,NaN,NaN,NaN,NaN,NaN,-0.18752690746188697,-0.15851902927362005,0.02900787818826691,14.07181415624504,27.22739717157853,5009551018,8688440592.107502,18.93854007016735,31.04045896104097,16.057686257921198,71.42857142857143,100
2012-05-08,64.34,64.74001,63.48,64.52,60.782124517129,63.5190010008096,65.48734323184812,66.02804340667707,59.16361060000003,62.87957060000001,66.25104019999998,66.07924950000007,66.07924950000007,67.86102743988477,64.29747156011538,72659680,39.11326337249192,47.49708248907614,NaN,NaN,NaN,NaN,NaN,NaN,-0.23686715947228543,-0.26707607115208987,-0.030208911679804447,25.06024096385541,15.66456344674208,4936891338,8735726098.574276,17.175348483959112,34.04207289113572,17.513108167856846,64.28571428571429,100
2012-05-09,63.77,64.67999,63.50999,64.321,60.81733720850085,63.5348821691104,65.44160428157956,65.8654678441364,59.18781560000002,62.9738806,66.24346019999999,65.97279950000006,65.97279950000006,67.90158235228402,64.0440166477161,85715248,38.04239208272508,46.91079142607094,NaN,NaN,NaN,NaN,NaN,NaN,-0.26780001186721386,-0.3649589265138218,-0.09715891464660792,20.265060240963887,19.79903845368811,4851176090,8768841488.660566,15.733430975805968,31.184147710671528,18.106351868085948,57.142857142857146,92.85714285714286
2012-05-10,64.61,64.63,63.95,64.19,60.850896042247115,63.547854799425046,65.3925217607333,65.70589947802817,59.210640600000026,63.06838050000001,66.23906019999998,65.82204950000008,65.82204950000008,67.81235405917226,63.83174494082789,49448864,37.3180641517979,46.35334738413103,NaN,NaN,NaN,NaN,NaN,NaN,-0.280623940020102,-0.4479388396717354,-0.16731489965163343,17.108433734939787,20.81124497991969,4801727226,8754297705.131155,14.94796966194382,29.627339048265927,18.659375116949573,50,85.71428571428571
2012-05-11,63.94,64.86,63.91,64.17999,60.884021355259584,63.560372328149306,65.3449714956065,65.56057476583501,59.241090550000024,63.16158040000001,66.22425999999997,65.72154900000007,65.72154900000007,67.82704305187546,63.61605494812466,47106688,37.25968549946453,46.05121544181526,NaN,NaN,NaN,NaN,NaN,NaN,-0.2730643959129075,-0.5086453945427678,-0.23558099862986032,16.86722891566282,18.08024096385549,4754620538,8733966458.590355,15.595080248151946,27.55748237091437,17.87938371864237,42.857142857142854,78.57142857142857
2012-05-14,63.63,64.08,63.48,63.58,60.9108470134162,63.560760994918624,65.27575692715135,65.37194859766025,59.26804055000002,63.25418030000001,66.19845999999998,65.62804900000006,65.62804900000006,67.93035976409863,63.325738235901504,46359984,33.84233234161535,45.647657802504696,NaN,NaN,NaN,NaN,NaN,NaN,-0.2901539463858597,-0.5982734316121849,-0.30811948522632526,2.4096385542169023,12.128433734939833,4708260554,8703059802.590355,14.775944655904032,29.33661611036128,17.564229657227347,35.714285714285715,71.42857142857143
2012-05-15,63.78999,64.27,63.25999,63.37,60.93531619736231,63.556983549474694,65.20102136138071,65.18128682645451,59.29489055000002,63.32858040000001,66.18185999999997,65.45754900000007,65.45754900000007,67.89449641233311,63.02060158766704,66908432,32.71146757766499,44.285746872376656,NaN,NaN,NaN,NaN,NaN,NaN,-0.29624763908621154,-0.6784290340840897,-0.3821813949978782,2.517385543740075,7.264751004539929,4641352122,8650726665.100943,13.660962294744774,28.76662199335408,19.327528725055622,28.571428571428573,100
2012-05-16,63.62,63.78,62.81,62.94,60.95526329987612,63.54476605344549,65.11235385701283,64.96783093822074,59.320940550000024,63.406680400000006,66.16925979999998,65.27404900000008,65.27404900000008,67.88288123348666,62.6652167665135,52825904,30.46651577939396,42.60076958855292,NaN,NaN,NaN,NaN,NaN,NaN,-0.3084945774648481,-0.7677996168289383,-0.4593050393640902,2.697095435684557,2.5413731778805064,4588526218,8612060281.760736,12.67198116763769,30.042513220202178,22.055739184215515,21.428571428571427,100
2012-05-17,62.94,63.06,61.60001,61.61,60.96177809291218,63.506453854367365,64.9750066469339,64.64803751553305,59.347640550000015,63.4667803,66.12025979999999,65.06154900000007,65.06154900000007,68.1015759608148,62.021522039185335,62253440,24.797764613165683,40.348137029409955,NaN,NaN,NaN,NaN,NaN,NaN,-0.3806890221713439,-0.93516631707827,-0.5544772949069261,0.16567191653720728,1.7933842986539428,4526272778,8550658781.658407,11.341139927346013,35.59127264901075,25.409592229900007,14.285714285714286,100
2012-05-18,61.78999,61.96001,60.75999,60.81,60.96026786313196,63.45305872853831,64.8116730529365,64.28251013310133,59.36764055000001,63.5140803,66.04145979999997,64.81804950000007,64.81804950000007,68.35969259639765,61.27640640360249,79496432,22.130430083552028,38.147334519376564,NaN,NaN,22.130430083552028,NaN,NaN,NaN,-0.4519818212704122,-1.1194545714949413,-0.6674727502245291,0.7279465386513321,1.196904630291032,4446776346,8477788266.833654,10.376518951280268,38.517950450146756,29.25678198164075,7.142857142857143,100
2012-05-21,60.92,62.57001,60.85001,62.50999,60.97568798389682,63.43438410025042,64.72141097242918,64.11369869185359,59.40934050000001,63.57678010000001,65.99125959999998,64.68954900000007,64.68954900000007,68.36771300211875,61.01138499788139,61471328,37.512056212783406,36.995986104529315,NaN,NaN,NaN,NaN,NaN,NaN,-0.3583985206712701,-1.1154709010636168,-0.7570723803923467,27.38654147104851,9.426719975412349,4508247674,8534969467.965561,13.252317990317572,33.95621030969595,31.612596340628897,0,92.85714285714286
2012-05-22,62.66,62.95,61.989,62.44,60.990258252713765,63.41469332598803,64.63194387547118,63.95429881643896,59.45239050000002,63.6452801,65.93905959999998,64.57504900000006,64.57504900000006,68.3813879642129,60.76871003578722,62954720,37.18637505714385,35.73353618777737,NaN,NaN,NaN,NaN,NaN,NaN,-0.2785189920974327,-1.1052211205141376,-0.8267021284167049,26.291236306729196,18.13524143880968,4445292954,8531104401.909369,14.963881767500126,31.74544935151719,33.682106412702375,7.142857142857143,85.71428571428571
2012-05-23,61.92999,62.71001,61.37,62.56,61.00587757358228,63.39776870567144,64.5506911744723,63.82150845296858,59.512240500000026,63.71098,65.86505979999998,64.38054900000007,64.38054900000007,68.18132412548196,60.579773874518175,56951072,38.17743228835264,34.91976259677856,NaN,NaN,NaN,NaN,NaN,NaN,-0.19865662015506091,-1.075022903610531,-0.8763662834554701,32.18666013400305,28.621479303926918,4502244026,8575304479.050048,13.631201284587064,33.03220649934088,36.42890241404253,0,78.57142857142857
2012-05-24,62.66,62.71001,61.69,62.14999,61.01726177683022,63.37306021645022,64.45654603037535,63.662316219352526,59.55784045000002,63.77417989999999,65.77825939999998,64.14604850000006,64.14604850000006,67.88920605248157,60.40289094751856,83129568,36.0826395303895,34.6447695076552,NaN,NaN,NaN,NaN,NaN,NaN,-0.156362740539019,-1.0718197091292438,-0.9154569685902249,32.25043039243443,30.24277561105556,4419114458,8567152156.340428,12.703742686886507,30.78471537370735,38.012192097157715,0,71.42857142857143
2012-05-25,62.21001,62.3201,61.88989,62.07001,61.027736883528426,63.34725724186705,64.36295638212533,63.51066800798562,59.613890500000025,63.82588009999999,65.68605979999998,63.88754850000006,63.88754850000006,67.45004861659,60.32504838341011,32082832,35.671464323243285,34.307991636698894,NaN,NaN,NaN,NaN,NaN,NaN,-0.11841505324290647,-1.0634757851438579,-0.9450607319009514,31.951629386269847,32.12957330423578,4387031626,8561934156.398447,12.322909816708615,29.86185100197535,39.25236908914639,0,64.28571428571429
2012-05-29,62.63,63.14999,62.28,62.86,61.04596835732416,63.33760858361226,64.30401691615964,63.448699626272706,59.66269045000003,63.8830801,65.61285979999998,63.692549000000064,63.692549000000064,67.02425952321255,60.36083847678757,44221456,42.626006959711376,34.55890189292885,NaN,NaN,NaN,NaN,42.626006959711376,NaN,-0.029391410716130495,-0.9817999952961145,-0.952408584579984,51.21963117163126,38.47389698344518,4431253082,8576675319.463034,17.159894352429532,27.623151237106757,38.568991268665336,21.428571428571427,57.142857142857146
2012-05-30,62.28999,62.55,61.67731,62.33,61.05874479157964,63.317655938392214,64.22660448807495,63.342156804722926,59.70649040000003,63.93028009999999,65.51965959999998,63.46554900000007,63.46554900000007,66.50631337668007,60.424784623320065,56431792,39.537734237798546,34.66571204686267,NaN,NaN,NaN,NaN,NaN,NaN,0.002807195505300397,-0.9488995901983586,-0.951706785703659,38.29283343211352,40.48803133000487,4374821290,8604654867.848463,15.76596848123691,29.518780462581123,38.38599248812589,14.285714285714286,50
2012-05-31,62.25,62.41,61.59,62.06,61.06870752997188,63.29275186040425,64.14163960618966,63.22004663284455,59.74499040000003,63.972780099999994,65.41865959999998,63.21554900000007,63.21554900000007,65.82463811202484,60.60645988797529,55260016,38.026271930023846,34.71629831673595,NaN,NaN,NaN,NaN,NaN,NaN,0.014287260136838675,-0.9338477105326106,-0.9481349706694493,31.707483640283833,40.4066494146762,4319561274,8612741699.45822,14.864397371072608,28.4396367155115,38.272925033443286,7.142857142857143,42.857142857142854
2012-06-01,60.97,61.32001,60.39,60.409,61.06214327594231,63.23564786316852,63.99526158241751,62.95232790590698,59.77753545000002,64.0006701,65.28443959999998,62.91849850000008,62.91849850000008,65.38117271760474,60.45582428239541,71430752,30.378711948882398,34.22480020598009,NaN,NaN,30.378711948882398,NaN,NaN,NaN,-0.07598521696127203,-1.0431164918710394,-0.9671312749097674,0.4896907216494426,23.496669264682268,4248130522,8544229591.963117,13.207867273707807,33.278109936582354,39.37675690984109,0,100
2012-06-04,60.57001,60.96001,60.03999,60.87,61.06023140254985,63.18880335102657,63.87270230467565,62.754010962487264,59.813985450000025,64.02897019999999,65.16223959999998,62.72699850000007,62.72699850000007,65.20138630389324,60.252610696106906,74119312,34.34897419713377,34.26098890994569,NaN,NaN,NaN,NaN,NaN,NaN,-0.09034589186094932,-1.080063639735954,-0.9897177478750047,19.621939428039077,17.27303792999078,4322249834,8603846003.432432,12.388751929399627,33.57366100006849,40.311315348863495,7.142857142857143,100
2012-06-05,60.64999,61.24001,60.63,61.12,61.06082611496229,63.147836948035945,63.76475319468837,62.59839087082181,59.86483545000003,64.05857019999999,65.04585959999997,62.54499900000006,62.54499900000006,64.92826937493635,60.161728625063766,47916880,36.464966908894276,34.529096005033495,NaN,NaN,NaN,NaN,NaN,NaN,-0.06963331999339228,-1.076759397866745,-1.0071260778733526,28.877195515519876,16.329608555069466,4370166714,8632909078.515135,13.809838828331408,32.14996507977174,40.61855222317932,0,92.85714285714286
2012-06-06,61.60001,62.57001,61.52,62.52,61.075345258096995,63.13540453322335,63.715939343916276,62.59092507360069,59.92728545000003,64.0998702,64.93405959999997,62.444999000000074,62.444999000000074,64.6495345247856,60.240463475214554,58781184,46.80488530224128,35.69612239952259,NaN,NaN,NaN,NaN,NaN,NaN,0.0455257180349129,-0.9502189303297115,-0.9957446483646244,79.74308681672028,42.74740725342641,4428947898,8686090988.199957,21.43931802852266,29.00176912394916,38.78469809368465,0,85.71428571428571
2012-06-07,63.16,63.17999,62.22,62.27,61.08723236995672,63.11826780979319,63.659235840233286,62.56036078087681,59.98758540000003,64.1407703,64.81525939999997,62.34244900000008,62.34244900000008,64.37226668876852,60.312631311231634,38414784,45.38449399807993,37.1666030698736,NaN,NaN,NaN,NaN,NaN,NaN,0.10844223663648622,-0.8601918525690166,-0.9686340892055029,71.0194267515925,59.879903027944216,4390533114,8651677785.8831,24.18685649627438,27.109091654976865,35.50087553781172,100,78.57142857142857
2012-06-08,62.16,62.95,61.96001,62.87,61.10497135135019,63.113351615539855,63.6282854151261,62.58985023031712,60.040535400000024,64.18237019999998,64.71389939999996,62.27644900000007,62.27644900000007,64.14077432612845,60.4121236738717,39737104,49.356725261737914,39.111338439744024,NaN,NaN,NaN,NaN,NaN,NaN,0.1893138207495736,-0.7319918132685359,-0.9213056340181095,90.12770700636942,80.29674019156073,4430270218,8684992666.789938,22.552328750611927,27.051837889312647,32.03768838138686,92.85714285714286,71.42857142857143
2012-06-11,63.35001,63.38,61.77,61.80499,61.11193671103825,63.087443464737085,63.556783634140764,62.51510163695358,60.08611035000003,64.20551999999999,64.59639939999997,62.15769900000007,62.15769900000007,63.81271069834033,60.50268730165981,51008832,43.33227804865772,39.52706857087791,NaN,NaN,NaN,NaN,NaN,NaN,0.17051133707989696,-0.7081664626682382,-0.8786777997481352,52.84415316121789,71.33042897305994,4379261386,8636200976.444199,22.9921348760838,24.18891878196778,29.086282868081337,100,64.28571428571429
2012-06-12,62.09,62.59,61.67999,62.56,61.126345300978166,63.07699903969279,63.51769407986073,62.51937767152943,60.139760350000024,64.23252,64.49659939999997,62.10669900000007,62.10669900000007,63.64176932856714,60.571628671433,48802592,48.16282078322597,40.311100408455204,NaN,NaN,NaN,NaN,NaN,NaN,0.20598153066848912,-0.6212008864125238,-0.8271824170810129,75.44917530187034,72.80701182315255,4428063978,8681785850.485056,21.600633135569204,23.323603764819282,26.793970386989166,92.85714285714286,57.142857142857146
2012-06-13,62.38,62.85001,61.92,62.13,61.13633191489878,63.05824658346125,63.463274704179916,62.48229408376473,60.184760350000026,64.25612,64.37419939999997,62.04469900000007,62.04469900000007,63.46666510987935,60.622732890120794,50841088,45.76983584987866,40.8534149485642,NaN,NaN,NaN,NaN,NaN,NaN,0.19751533739170168,-0.5802882453413858,-0.7778035827330875,62.57496235041212,63.622763604500115,4377222890,8653905006.955545,21.997629599005595,21.867068016286492,23.845481824537792,85.71428571428571,50
2012-06-14,62.14,62.61,61.8,62.36,61.14850771674059,63.044419918442216,63.4200090295062,62.47064702816809,60.223510350000026,64.28182009999999,64.25679939999996,62.015699000000076,62.015699000000076,63.38617110319803,60.64522689680212,65170496,47.278727304721215,41.65313550387361,NaN,NaN,NaN,NaN,NaN,NaN,0.20362396057074816,-0.5232736320196523,-0.7268975925904004,69.4611692779362,69.16176897673955,4442393386,8678846801.720978,20.78042918796364,21.4768439034125,20.993449619631395,78.57142857142857,42.857142857142854
2012-06-15,62.37,63.08,62.36,62.99001,61.16683112254417,63.04334249431465,63.40314632246674,62.520110168342555,60.26361040000003,64.3149203,64.17059959999996,62.08469950000007,62.08469950000007,63.50458948125627,60.66480951874387,41536032,51.277706068092456,42.767867057077126,NaN,NaN,NaN,NaN,NaN,NaN,0.24361117573080515,-0.422383622926894,-0.6659947986576992,88.32368765362965,73.45327309399265,4483929418,8709999979.499645,23.018826038740425,20.39647167267182,18.45514076938062,71.42857142857143,35.714285714285715
2012-06-18,62.75,63.74001,62.63,63.58,61.19084275316562,63.05396937561535,63.410081760801376,62.621052057071836,60.306210400000026,64.34642039999999,64.08779959999995,62.22319950000008,62.22319950000008,63.65901686751862,60.78738213248153,32191120,54.73996829106907,43.633150009316964,NaN,NaN,NaN,NaN,NaN,NaN,0.29962741805977633,-0.2914605260829788,-0.5910879441427551,95.67542878146605,84.48676190434396,4516120538,8732910280.207567,25.82772437053098,18.8242969962878,17.906578724070947,100,28.571428571428573
2012-06-19,63.89999,64.50999,63.85001,64.239,61.22117267601969,63.077435328573465,63.442588358417005,62.77514233735071,60.35460540000004,64.3866104,64.02837939999996,62.30964999999999,62.30964999999999,63.99129126082006,60.62800873917992,36476480,58.30407947248308,44.973603240365854,NaN,NaN,NaN,NaN,NaN,NaN,0.36647502558493994,-0.13299416216158022,-0.49946918774652016,93.9375838926175,92.6455667759044,4552597018,8739432030.321207,29.531996597897386,17.600243240596193,17.54556789983767,100,21.428571428571427
2012-06-20,64.36,64.57001,63.81,64.28999,61.25170817178069,63.10144631216607,63.47581979534183,62.919413543317305,60.40965535000003,64.4255104,63.99157919999996,62.402149499999986,62.402149499999986,64.29282233756679,60.511476662433175,51389680,58.57589471508335,46.44143343929868,NaN,NaN,NaN,NaN,58.57589471508335,NaN,0.39697021243839015,-0.003256422198532505,-0.40022663463692265,93.81857033743795,94.47719433717383,4603986698,8752953423.868135,28.360906356429087,16.647540289504285,17.16529261685655,100,14.285714285714286
2012-06-21,64.21001,64.31,62.62,62.69,61.26601953325551,63.09329886044001,63.4450033327794,62.89756463442994,60.456655400000024,64.4479104,63.91637919999996,62.40864949999998,62.40864949999998,64.30233981383672,60.51495918616324,42492624,48.001570396318954,47.700209042687,NaN,NaN,NaN,NaN,NaN,NaN,0.2968153361698172,-0.029207464424651164,-0.32602280059446836,58.49885872468551,82.08500431824699,4561494074,8713980898.89772,25.10646473514656,22.817316983221126,14.422564784239096,92.85714285714286,7.142857142857143
2012-06-22,62.88,63.42999,62.731,63.35001,61.286755756805206,63.09838224934219,63.44127810404295,62.940654669246136,60.50020545000003,64.47611049999999,63.83927939999996,62.46865049999998,62.46865049999998,64.40139815438164,60.535902845618324,29513104,51.86203317419874,48.95114182676308,NaN,NaN,NaN,NaN,NaN,NaN,0.2635732335979947,0.003443741403025058,-0.26012949219496967,69.03561158474216,73.78434688228855,4591007178,8736740092.089497,23.8176820219864,21.646042413149743,11.471481235021352,85.71428571428571,0
2012-06-25,62.84,62.85001,61.95,62.13,61.29514624678725,63.0792063632166,63.38985543329617,62.86344946265127,60.53890545000003,64.48721049999999,63.75807939999996,62.471649999999975,62.471649999999975,64.40209852044867,60.54120147955127,33136336,45.18423038562895,49.573946360815555,NaN,NaN,45.18423038562895,NaN,NaN,NaN,0.15343414616500542,-0.0683368094887129,-0.22177095565371832,19.99993442644453,49.17813491195741,4557870842,8716858143.218529,21.562492381933158,24.87853731475845,9.131168743009441,78.57142857142857,0
2012-06-26,62.33,62.7,62.0575,62.52,61.307333846321704,63.068132969885575,63.35574345551985,62.83073999001781,60.58560550000002,64.50031039999999,63.699479399999966,62.45464999999998,62.45464999999998,64.37709112786281,60.532208872137154,30610736,47.51092235945618,49.62437757918804,NaN,NaN,NaN,NaN,NaN,NaN,0.10326856079007113,-0.09268525466612942,-0.19595381545620055,29.065888817378656,39.36714494285511,4588481578,8730317338.424755,20.598558847979177,23.766362712275363,8.570289720162949,71.42857142857143,0
2012-06-27,62.75999,63.17999,62.6899,62.89999,61.32318117123393,63.06480340612546,63.33787077098966,62.83733522906373,60.63080545000002,64.5088103,63.62187919999996,62.48314949999999,62.48314949999999,64.41423443410157,60.552064565898405,35705776,49.74897621981046,49.93612630931165,NaN,NaN,NaN,NaN,NaN,NaN,0.09244878275143331,-0.08039283701690891,-0.17284161976834223,42.21424073189826,30.426687991907148,4624187354,8725224006.995508,23.055005878647794,22.646418068262047,8.227234190738379,64.28571428571429,21.428571428571427
2012-06-28,62.42,62.47,61.53999,62.2,61.33190573669429,63.04767858620219,63.2932483878136,62.77663663581957,60.66890545000002,64.51081029999999,63.53367919999995,62.49014949999999,62.49014949999999,64.4160562087256,60.56424279127437,49793376,45.86903169324834,49.68700534013383,NaN,NaN,NaN,NaN,NaN,NaN,0.03772487509368769,-0.1256855259012326,-0.1634104009949203,21.782364472841802,31.02083134070624,4574393978,8746105411.038218,20.872322008813654,28.507217463517538,8.683721966851476,57.142857142857146,100
2012-06-29,63.37,64.16,63.21001,64.16,61.36004597812022,63.069704752812044,63.327238647115024,62.90838552764628,60.712905450000015,64.5311103,63.49967919999995,62.677699499999996,62.677699499999996,64.48320777494895,60.87219122505104,44765808,56.1754497614265,50.60437474818874,NaN,NaN,NaN,NaN,NaN,NaN,0.1280197921784638,-0.0033856607718405485,-0.13140545295030434,86.46840614913431,50.155003784624796,4619159786,8790871219.038218,29.244690981126396,24.855113010669978,9.082098722168956,50,92.85714285714286
2012-07-02,64.23,64.38,63.87,64.35001,61.38979686391007,63.09505733196428,63.367347327620315,63.04568309644187,60.753755550000015,64.5500103,63.473079599999956,62.85169999999998,62.85169999999998,64.59655656147902,61.10684343852095,33432704,57.02960416368071,51.23771641822122,NaN,NaN,NaN,NaN,NaN,NaN,0.1912278805887414,0.10762939778562242,-0.08359848280311899,92.73932185266106,66.99669749154573,4652592490,8820371974.83053,29.726141848165415,23.993751797755653,9.570356428440416,42.857142857142854,85.71428571428571
2012-07-03,64.38,64.89,64.28999,64.89,61.424624755811465,63.1306007511333,63.4270591971254,63.221332325352165,60.79525555000002,64.56981029999999,63.46927959999996,63.04019999999999,63.04019999999999,64.8103897695252,61.27001023047479,15895086,59.44851374463377,52.21476483927516,NaN,NaN,NaN,NaN,NaN,NaN,0.25604405606565617,0.23645658727895125,-0.019587468786704934,100,93.06924266726513,4668487576,8836267060.83053,32.05096024757108,22.98454876406418,10.725792329326643,100,78.57142857142857
2012-07-05,64.78,65.25,64.48,64.92999,61.45950401197254,63.16623222140789,63.48599765998323,63.38406162769958,60.83685550000002,64.59436009999999,63.47327939999995,63.160699499999986,63.160699499999986,65.09347753768415,61.22792146231583,37025568,59.62975706650738,53.09698125083131,NaN,NaN,NaN,NaN,59.62975706650738,NaN,0.28597797023497395,0.33788499400701255,0.05190702377203857,91.37441678054785,94.70457954440297,4705513144,8842517169.049543,32.858647679607,21.72186549635717,12.0655269111223,100,71.42857142857143
2012-07-06,64.64999,64.69,63.64999,64.12,61.485976608868334,63.18511871207308,63.51086049684663,63.4541509964901,60.87565550000002,64.60506009999999,63.426679399999955,63.253199499999994,63.253199499999994,65.18368863826305,61.322710361736945,40684064,54.33275768659315,53.31519922358137,NaN,NaN,NaN,NaN,NaN,NaN,0.23758363402089339,0.3488865662981553,0.1113029322772619,69.54186107315084,86.97209261789958,4664829080,8838605668.622278,29.9164464232143,25.58311878336062,12.191790953857586,92.85714285714286,64.28571428571429
2012-07-09,64.03,64.25999,63.67999,64,61.51099176698905,63.20125497520034,63.530042438146765,63.506136615871995,60.918755500000024,64.61295999999999,63.36987939999997,63.3096995,63.3096995,65.25808168503175,61.361317314968254,35636976,53.57347590557821,53.23187833890345,NaN,NaN,NaN,NaN,NaN,NaN,0.18612362770645058,0.34395746691032514,0.15783383920387456,66.3073684437508,75.74121543248316,4629192104,8842293481.207657,28.663991609850576,24.512079134874405,11.62917674545886,85.71428571428571,57.142857142857146
2012-07-10,64.33,64.50999,63.12,63.37,61.529489361347366,63.20459646083994,63.523766264101795,63.49317122388418,60.96770550000002,64.61895999999999,63.29247919999996,63.387950000000004,63.387950000000004,65.20992630888225,61.56597369111777,47365648,49.65055690046693,52.61376958375944,NaN,NaN,NaN,NaN,NaN,NaN,0.10246851538614118,0.28591948343655105,0.18345096805040986,49.32628213940113,61.72517055210093,4581826456,8811965958.661797,25.868886397294222,26.050368533765045,9.84589571636143,78.57142857142857,50
2012-07-11,63.28999,63.46001,62.5,63.02,61.54432031297575,63.200941085377764,63.5040107243331,63.44810729779997,61.01205555000002,64.61286,63.21767939999996,63.41095,63.41095,65.20188798612088,61.62001201387912,43431952,47.566668624665525,51.82739629158674,NaN,NaN,NaN,NaN,NaN,NaN,0.02065487296068677,0.20926955925126833,0.18861468629058156,39.89234530365151,51.84199862893448,4538394504,8815584797.88272,24.119526996307844,28.65607897400737,8.600974892262757,71.42857142857143,42.857142857142854
2012-07-12,62.55,62.69,61.86,62.42999,61.553132946677486,63.185674727251474,63.46189226455533,63.35114374562855,61.05030550000003,64.60285999999999,63.128879199999965,63.4259495,63.4259495,65.1783332633195,61.67356573668051,57680384,44.19893218612917,51.555779276573176,NaN,NaN,44.19893218612917,NaN,NaN,NaN,-0.0710797196097051,0.09976503677845017,0.17084475638815527,23.989153668049255,37.73592703703397,4480714120,8837126683.945757,22.168742546424888,30.800716953056494,9.423795751171744,64.28571428571429,35.714285714285715
2012-07-13,62.56,63.52,62.56,63.38,61.571310728302585,63.189522752454415,63.45868080320022,63.35389196033059,61.090455450000036,64.60056,63.05527919999996,63.4769495,63.4769495,65.16028471853112,61.79361428146889,32358944,50.30049279788895,51.44424067826533,NaN,NaN,NaN,NaN,NaN,NaN,-0.06578120891201053,0.0886182452481421,0.15439945416015263,49.59582319185126,37.825774054517346,4513073064,8860047602.612423,26.252347827645167,28.47051779711699,9.3721399196579,57.142857142857146,28.571428571428573
2012-07-16,63.24001,63.52,62.95,63.2,61.58751659170256,63.18973022270284,63.44853645797668,63.33923558315625,61.133805450000025,64.5993599,62.99227899999996,63.48744899999999,63.48744899999999,65.161096122225,61.813801877774985,27623184,49.20270991529621,51.73127493038442,NaN,NaN,NaN,NaN,NaN,NaN,-0.07190665522494147,0.0645161351289758,0.13642279035391727,44.74408424775138,39.4430203692173,4485449880,8856655281.770317,25.17957049280283,27.30709704692377,9.151648938933786,50,21.428571428571427
2012-07-17,63.58,63.74001,62.63,63.53,61.60684478481995,63.196468238094866,63.451731106683475,63.35740362285566,61.18205545000003,64.5972598,62.96887899999996,63.48494899999999,63.48494899999999,65.1581849874597,61.81171301254028,42476976,51.30111509633603,52.002002983018706,NaN,NaN,NaN,NaN,NaN,NaN,-0.052160412096275116,0.07122227523357338,0.1233826873298485,53.638938978601125,49.32628213940126,4527926856,8883059267.923811,23.192026048970586,27.427194145094404,9.239247847201337,42.857142857142854,14.285714285714286
2012-07-18,63.39999,64.58,63.39,64.39,61.63453787153816,63.22010253040982,63.48852596524491,63.45574613496464,61.241555400000024,64.6015597,62.96147919999996,63.492498999999995,63.492498999999995,65.18057350668705,61.804424493312936,44489600,56.360500477541216,52.474254715713755,NaN,NaN,NaN,NaN,NaN,NaN,0.01670882001603996,0.14426871234989846,0.1275598923338585,76.81946948930056,58.40083090521768,4572416456,8913342104.898602,27.150535633258134,25.13644689715336,9.45053009537821,35.714285714285715,7.142857142857143
2012-07-19,64.84,65.31,64.72,65.10001,61.66902018127409,63.257328420896755,63.55172141758825,63.61234269353944,61.31135545000002,64.61205979999998,62.97307939999995,63.532999999999994,63.532999999999994,65.33095833103388,61.7350416689661,53017696,60.05061263169023,53.48722478274532,NaN,NaN,NaN,NaN,60.05061263169023,NaN,0.10314705682784903,0.2564937133686698,0.15334665654082075,93.9133333333332,74.79058060041162,4625434152,8928620187.39677,30.54423320498521,23.50215710825357,9.276817969682728,100,0
2012-07-20,65.09,65.10001,64.21001,64.235,61.69455231877385,63.27668825414632,63.578516656114196,63.67164338939283,61.37158045000002,64.60740979999999,62.971359399999955,63.61024999999999,63.61024999999999,65.38935508687146,61.83114491312853,40572544,54.05371421935034,53.335672244025595,NaN,NaN,NaN,NaN,NaN,NaN,0.0953167803379174,0.2724926319632175,0.17717585162530008,68.84057971014487,79.85779417759288,4584861608,8890326088.058702,28.60657193703593,25.646363019956315,9.086993627955737,92.85714285714286,57.142857142857146
2012-07-23,63,63.67999,62.50999,63.46001,61.71211906187063,63.28031838772758,63.57386933626658,63.65148782849827,61.42123050000002,64.59790989999999,62.95675959999995,63.615750000000006,63.615750000000006,65.39228126911033,61.83921873088969,48657616,49.30316618847879,52.783783817225455,NaN,NaN,NaN,NaN,NaN,NaN,0.034338921901445524,0.22009950400210698,0.18576058210066146,46.37710144927525,69.7103381642511,4536203992,8920686776.934464,25.261577550801572,34.171209971178435,9.395580608675047,85.71428571428571,50
2012-07-24,63.58,63.66,62.55,62.96001,61.72453588712565,63.27397564737654,63.54979642111887,63.58563279721272,61.46388060000003,64.57830999999999,62.932359999999946,63.657250499999996,63.657250499999996,65.32868179118444,61.985819208815556,57269680,46.46583207384315,51.85644941216898,NaN,NaN,NaN,NaN,NaN,NaN,-0.039283297134834305,0.13665646068211856,0.17593975781695287,31.884347826086856,49.03400966183566,4478934312,8905725459.99176,23.368064254245244,31.609863978050168,9.289677583719907,78.57142857142857,42.857142857142854
2012-07-25,62.49001,62.95,62.14999,62.53999,61.73264985839803,63.25944127812156,63.510196169310284,63.486047768906744,61.50623050000003,64.55500989999999,62.91155979999995,63.658249999999995,63.658249999999995,65.32698156324575,61.98951843675424,46267408,44.16644158951402,50.751926878098025,NaN,NaN,44.16644158951402,NaN,NaN,NaN,-0.11177768672376165,0.03621764941225081,0.14799533613601246,19.709855072463856,32.657101449275316,4432666904,8904568210.914774,22.068103192974302,32.59856527577247,9.208157616701145,71.42857142857143,35.714285714285715
2012-07-26,63.44,63.73,62.97,63.37,61.748941899608,63.26163055974291,63.504698280317726,63.474995600439435,61.54338050000003,64.54670989999998,62.91155979999995,63.681750499999985,63.681750499999985,65.32006728962237,62.043433710377606,41934256,49.486146577089684,50.405740370276355,NaN,NaN,NaN,NaN,NaN,NaN,-0.09973614071089347,0.023325160247395615,0.12306130095828909,43.76811594202889,31.787439613526534,4474601160,8906775277.020037,25.585150859234858,29.961556757237023,9.2132238093933,64.28571428571429,28.571428571428573
2012-07-27,63.83,64.99001,63.64,64.87,61.77999720408951,63.293479459549985,63.558239524226835,63.60785316230235,61.58613045000003,64.5597098,62.950159799999945,63.81525050000001,63.81525050000001,65.38243375959257,62.24806724040745,42623488,57.38781286803175,50.67819301045161,NaN,NaN,NaN,NaN,NaN,NaN,0.007644169684677279,0.1326165130641357,0.12497234337945841,87.24637681159427,50.241449275362335,4517224648,8941820680.717136,31.118682578917433,26.78500101101727,9.19011200086936,57.142857142857146,21.428571428571427
2012-07-30,65.00999,65.31,64.60001,64.82001,61.81024608763091,63.32370778708365,63.60772071935519,63.723296670654506,61.62723045000003,64.5673099,63.014359999999954,63.84825100000002,63.84825100000002,65.46993072305266,62.22657127694739,37821200,57.06742723023926,51.2079694625782,NaN,NaN,NaN,NaN,NaN,NaN,0.0702177539183334,0.21274453577737518,0.14252678185904177,85.79739130434767,72.27062801932361,4479403448,8927438300.98221,31.78351173468294,25.50856974167267,9.94746913250181,50,14.285714285714286
2012-07-31,64.91,65.17999,64.74001,64.8,61.83999488277886,63.35294129625031,63.654476769576554,63.82583984487788,61.66563045000002,64.56780989999999,63.094159999999945,63.87075050000001,63.87075050000001,65.53166381114778,62.20983718885223,34595376,56.93041908661016,51.876808781288524,NaN,NaN,NaN,NaN,NaN,NaN,0.10318035265724879,0.27150222268060276,0.16832187002335397,85.21739130434769,86.08705314009654,4444808072,8902276883.826885,30.803849979170174,24.722320241543407,10.115799192026524,42.857142857142854,7.142857142857143
2012-08-01,65.25,65.27991,64.35001,64.61,61.86755712275121,63.37783354780971,63.691948268808844,63.90052176441332,61.69778050000003,64.56370989999999,63.13616019999994,63.85675050000001,63.85675050000001,65.48750893801173,62.22599206198829,30919776,55.56627400933002,52.68876176866002,NaN,NaN,NaN,NaN,NaN,NaN,0.10477187188685769,0.29928670988192607,0.19451483799506838,77.84817136654621,82.95431799174719,4413888296,8888646778.893108,28.784459308506722,25.85104956818542,9.335293405621838,35.714285714285715,0
2012-08-02,64.10001,65.02,63.91,64.38,61.892556554365626,63.3976784280511,63.71893068963987,63.946186358278716,61.73328050000003,64.5570099,63.174960199999944,63.82925100000001,63.82925100000001,65.40428674439411,62.254215255605914,40544544,53.88310505506854,52.944662644172844,NaN,NaN,NaN,NaN,NaN,NaN,0.08382567332905949,0.29929692965639276,0.21547125632733327,70.56971338698274,77.87842535262554,4373343752,8882437254.13635,26.54725150904646,26.92280695029552,9.095929473856561,28.571428571428573,57.142857142857146
2012-08-03,65.38,65.88,65.19,65.60001,61.92944663840179,63.441288954228305,63.792698505732425,64.10369337177598,61.77133050000003,64.5504101,63.23576039999995,63.90325150000001,63.90325150000001,65.65512015693123,62.15138284306878,42122944,60.68586837081152,53.76488824813823,NaN,NaN,NaN,NaN,NaN,NaN,0.1421964992771566,0.393216880423779,0.2510203811466224,92.49358580808098,80.30382352053664,4415466696,8890374681.93183,29.675617283780326,24.1870126292193,9.534254047840694,100,50
2012-08-06,65.94,66.39,65.8,66.10001,61.97094478130327,63.49393689572874,63.88318130942919,64.29381876494017,61.817480550000035,64.54651009999999,63.31476079999995,64.00825200000001,64.00825200000001,66.00530505341416,62.01119894658587,23529616,63.08897325361511,54.606878116515304,NaN,NaN,NaN,NaN,NaN,NaN,0.20094835369940955,0.5022058232708844,0.3012574695714748,93.16062933813828,85.40797617773399,4438996312,8890774286.596779,31.576459853899998,22.868983564858855,10.078990546942858,100,42.857142857142854
2012-08-07,66.38,66.92,66.28,66.64999,62.0175024451709,63.556432996803416,63.9916836110202,64.51821602542206,61.86778050000004,64.5462101,63.406360399999954,64.17225150000002,64.17225150000002,66.45148829401188,61.89301470598814,28222368,65.58116675051593,55.2654971360135,NaN,NaN,NaN,NaN,NaN,NaN,0.25959076498772327,0.6257459258061289,0.3661551608184056,94.3394248649374,93.3312133370522,4467218680,8895183149.64778,33.47455154810259,21.555933639568185,11.35086346852263,100,35.714285714285715
2012-08-08,66.48,66.76199,66.37,66.62,62.063298440741335,63.617097689936024,64.09475484196058,64.71838592776282,61.914380500000036,64.54721009999999,63.48156039999995,64.35225150000001,64.35225150000001,66.80134892623312,61.9031540737669,20723504,65.3221663330933,55.64203668611373,NaN,NaN,NaN,NaN,NaN,NaN,0.2774864569906776,0.7130132320567526,0.435526775066075,93.71070500900423,93.73691973735997,4446495176,8900893360.793575,32.51349455711084,20.937061100173835,11.96718644227177,92.85714285714286,28.571428571428573
2012-08-09,66.62,66.91,66.49001,66.82001,62.11062890401754,63.68052169607591,64.20162759325625,64.91854060130922,61.956030500000026,64.54551009999999,63.571360599999956,64.5717525,64.5717525,67.07860391066754,62.064901089332466,20726176,66.2786685190859,56.515247707523415,NaN,NaN,NaN,NaN,NaN,NaN,0.2829503879075146,0.7892147599504682,0.5062643720429536,97.90377797950097,95.31796928448085,4467221352,8912737665.424067,32.60096173247183,20.265717273750504,13.244074179600071,85.71428571428571,21.428571428571427
2012-08-10,66.59,66.88,66.41,66.86,62.15788632785816,63.74348166249025,64.30587749155993,65.10344149642262,62.00363050000003,64.54301009999999,63.667360599999945,64.74575250000001,64.74575250000001,67.37755046245096,62.11395453754907,20320928,66.47775942552349,57.74200436731231,NaN,NaN,NaN,NaN,NaN,NaN,0.2694788997983061,0.8431129967908362,0.5736340969925301,98.74214100180079,96.78554133010198,4487542280,8931329152.743216,31.388028463513194,20.145085577032322,13.731632933853689,78.57142857142857,14.285714285714286
2012-08-13,66.84,67.03,66.5,67.02,62.206265568376985,63.808363213728065,64.41231366836149,65.2859708777157,62.05238050000003,64.54201009999998,63.79958059999994,64.9367525,64.9367525,67.64544345600963,62.228061543990364,19890256,67.30937608500852,59.23082893953841,NaN,NaN,NaN,NaN,NaN,NaN,0.2518898164630099,0.8884963675712925,0.6366065511082826,99.79508238712616,98.8136671228093,4507432536,8950468833.045101,31.254617055840967,19.274229825427504,14.354410713021528,100,7.142857142857143
2012-08-14,67.28,67.41,66.86,67.05,62.254461930880694,63.872554041178994,64.51575234803359,65.45397365126658,62.09338045000002,64.54271009999998,63.92318059999995,65.1127525,65.1127525,67.88952673914241,62.33597826085759,24218672,67.47231665501178,60.89553430135969,NaN,NaN,NaN,NaN,NaN,NaN,0.22377154888399997,0.9163209872132825,0.6925494383292825,91.8918918918919,96.80970509360628,4531651208,8942983061.699646,32.998297584979696,18.385979485526487,15.009717389575565,100,0
2012-08-15,67,67.3199,66.99001,67.22,62.3038702698769,63.93884009976951,64.62180127556168,65.62216663686024,62.134780450000015,64.54552009999999,64.04518059999995,65.25425249999999,65.25425249999999,68.15494385641284,62.35356114358714,29110352,68.43250942470902,62.2488459333325,NaN,NaN,NaN,NaN,NaN,NaN,0.19895225096518998,0.94123975203577,0.7422875010705801,94.96021220159157,95.54906216020322,4560761560,8954462541.804165,32.044400236885956,17.854487306932015,16.478185090823427,92.85714285714286,0
2012-08-16,67.47,68.17,67.39,68.02,62.360747182614446,64.01965514729882,64.75506397063769,65.85053171906402,62.18513045000002,64.54462009999999,64.15518059999995,65.400252,65.400252,68.53933795392946,62.26116604607053,35706448,72.54045255225512,63.33117733934845,NaN,NaN,NaN,NaN,NaN,NaN,0.21725342770786094,1.0138542857054063,0.7966008579975453,96.4788732394365,94.44365911097333,4596468008,8976435740.573395,36.77019987176109,16.385528249253685,18.68280449769669,100,0
2012-08-17,68.17,68.33,68.00999,68.32001,62.420043330051115,64.10481068893647,64.89486577571073,66.08572012677222,62.24453050000001,64.54572009999998,64.27618079999995,65.6045025,65.6045025,68.93923224469727,62.269772755302725,22584720,73.91153423757905,64.53432783987272,NaN,NaN,NaN,NaN,NaN,NaN,0.22921894642002016,1.0831245410225705,0.8539055946025503,99.77398190045244,97.07102244716016,4619052728,8997610371.183687,37.153568539112065,15.910657878603388,20.75994054718073,100,21.428571428571427
2012-08-20,68.27,68.42999,68,68.42,62.47974439144364,64.19025998222486,65.03310633352599,66.30803249565105,62.30203050000001,64.55054009999998,64.38718079999995,65.85250199999999,65.85250199999999,69.24956589109183,62.45543810890814,26923936,74.37084826322679,65.78007278105962,NaN,NaN,NaN,NaN,74.37084826322679,NaN,0.22329889969586325,1.1330292192223794,0.9097303195265162,99.77898181190662,98.67727898393184,4645976664,9023283254.272503,36.5941289539278,15.270273215266053,22.914374885782713,100,14.285714285714286
2012-08-21,68.63,68.88,67.88,68.14999,62.53616474575763,64.26867047762634,65.15533706554459,66.48345701987476,62.35228040000002,64.55524009999998,64.51408079999995,66.11200099999999,66.11200099999999,69.37590546921595,62.848096530784034,41390944,70.74853042240825,66.86451966770805,NaN,NaN,NaN,NaN,NaN,NaN,0.18235738671521695,1.1376770529205373,0.9553196662053204,85.31167002012086,94.95487791082662,4604585720,9004242592.213623,37.36397410067035,13.871923501111851,25.80592564561949,100,7.142857142857143
2012-08-22,67.99001,68.5601,67.81,68.42999,62.59480977316303,64.35107284440602,65.2837548276801,66.66884111322003,62.40543035000002,64.56403999999999,64.63148059999995,66.40650099999999,66.40650099999999,69.37784976246002,63.435152237539974,44555648,72.25753887311964,68.17697922614028,NaN,NaN,NaN,NaN,NaN,NaN,0.15629604283158693,1.150689719744804,0.9943936769132171,87.80460704607067,90.96508629269937,4649141368,9033341273.512436,34.79042436622838,13.55922952208653,28.892312546172285,92.85714285714286,0
2012-08-23,68.14,68.34,67.69051,67.87,62.647299228156434,64.42075457025936,65.38517620698676,66.78323719767526,62.45373030000002,64.56024,64.74628059999995,66.631501,66.631501,69.31677783268698,63.94622416731301,28802208,65.03188358419597,68.48740888423917,NaN,NaN,NaN,NaN,NaN,NaN,0.08696504964463148,1.1030999889690065,1.016134939324375,67.20779220779248,80.108023091328,4620339160,9020458350.840677,32.419703143981195,13.736361770608296,31.055785552610466,85.71428571428571,0
2012-08-24,67.72,68.45,67.60001,68.28999,62.703445404990696,64.49737309362057,65.49909047337944,66.92673746456333,62.50078025000002,64.56083989999999,64.86488039999995,66.8025005,66.8025005,69.45264924114494,64.15235175885505,38384752,67.64511180107318,68.81284735191475,NaN,NaN,NaN,NaN,NaN,NaN,0.05648974702231646,1.0867471231022705,1.030257376079954,77.30730769230793,77.43990231539034,4658723912,9044391299.48412,30.904483988125836,12.667812720510058,32.90298491729123,78.57142857142857,0
2012-08-27,68.60001,68.67,68.25,68.39999,62.760127440761934,64.57465263632115,65.61285123912927,67.06704722984301,62.55873020000002,64.57183979999999,64.97307999999994,66.9814995,66.9814995,69.55433190926912,64.40866709073087,20671328,68.31303143678237,69.00798054379092,NaN,NaN,NaN,NaN,NaN,NaN,0.03205441504061746,1.0703253948807259,1.0382709798401084,80.8760956175301,75.13039850587683,4679395240,9038484221.420881,31.75815488739821,12.164278206402319,34.54241139906707,71.42857142857143,0
2012-08-28,68.34,68.58501,68.11,68.39999,62.81624547617724,64.65040189104747,65.7221507983791,67.19399416033416,62.61683015000001,64.57863969999998,65.06947979999994,67.16149899999999,67.16149899999999,69.5988135821183,64.72418441788169,27337856,68.31303143678237,69.221613765483,NaN,NaN,NaN,NaN,NaN,NaN,0.005592758606972836,1.0452619280988245,1.0396691694918516,80.56639676113387,79.58326669032395,4679395240,9044525472.64574,30.291633345298752,12.963559742768831,35.85683213057288,64.28571428571429,0
2012-08-29,68.41,68.57001,68.11,68.39999,62.87180512318045,64.72465116053168,65.82716410040345,67.308850906969,62.669580050000015,64.59053949999999,65.15269959999995,67.35099849999999,67.35099849999999,69.54225491863838,65.1597420813616,26674512,68.31303143678237,69.36692540246132,NaN,NaN,NaN,NaN,NaN,NaN,-0.020764542008811393,1.0137134919808375,1.0344780339896489,80.56639676113387,80.66962971326593,4679395240,9051482150.119362,28.899830611586996,12.367926034841965,37.05164359911823,57.142857142857146,7.142857142857143
2012-08-30,68.11,68.13,67.60001,67.71001,62.919946465238354,64.78376717715481,65.90100119450527,67.34705653487671,62.72068005000002,64.60633959999998,65.22109999999994,67.517499,67.517499,69.23538329768942,65.79961470231058,24430944,58.80300554547162,68.81872869674332,NaN,NaN,58.80300554547162,NaN,NaN,NaN,-0.08966032625747178,0.9224026261678091,1.0120629524252809,50.84075630252098,70.65784994159624,4654964296,9037192544.031399,26.610033733228118,16.439067533477825,37.18089374290087,50,0
2012-08-31,68.2,68.45,67.47,68.16,62.972086301405135,64.8506232726567,65.98958938295604,67.42447972203131,62.770830050000015,64.6234396,65.33049999999994,67.6454985,67.6454985,69.13975405586196,66.15124294413805,42127920,62.47228898511133,68.4732224753221,NaN,NaN,NaN,NaN,NaN,NaN,-0.10865220084245863,0.8762477013722076,0.9848999022146663,64.35643564356434,65.25452956907306,4697092216,9054387613.419153,27.181921846613164,14.883339493000832,37.57567332126579,42.857142857142854,0
2012-09-04,68.03,68.35001,67.42,68.09,63.02301081581901,64.91476934646548,66.07195842676168,67.48786260564738,62.825430050000016,64.63228959999998,65.42529979999993,67.744998,67.744998,69.06976531549323,66.42023068450676,32017184,61.553848957410224,68.05047478263627,NaN,NaN,NaN,NaN,NaN,NaN,-0.1283065928660465,0.8245166611321082,0.9528232539981547,58.200837041466194,57.7993429958505,4665075032,9068502220.00205,24.784809890739147,14.044934060926318,37.52007017125429,35.714285714285715,0
2012-09-05,68.03999,68.35001,67.84,68.02,63.07273210123375,64.97625906237705,66.1483522139475,67.53854235749048,62.886380050000014,64.65058959999999,65.54309979999994,67.8134985,67.8134985,69.04295198923224,66.58404501076775,26133792,60.5944898537247,67.49061624185168,NaN,NaN,NaN,NaN,NaN,NaN,-0.14705348559895715,0.7690063969994583,0.9160598825984154,42.28187919463071,54.94638395988707,4638941240,9060815448.883993,23.557878997296317,13.349662902031659,37.46446702124278,28.571428571428573,0
2012-09-06,68.42,69.55,68.42,69.53,63.136983523112015,65.06643215025078,66.28096585261623,67.72820499011044,62.95703010000002,64.69138959999998,65.68329979999994,67.95899849999999,67.95899849999999,69.27477303546641,66.64322396453358,43099504,71.06934177008466,67.38553690026804,NaN,NaN,NaN,NaN,71.06934177008466,NaN,-0.06308175879135902,0.8372076841092166,0.9002894429005757,99.06103286384995,66.5145830333156,4682040744,9102389306.7247,31.12372180905688,11.5090173078543,38.01158012967759,100,0
2012-09-07,69.37,69.55,69.23,69.42999,63.199600502981546,65.15283923638442,66.40445699565089,67.89027975295707,63.032480050000025,64.71788949999998,65.81389979999994,68.0894975,68.0894975,69.4446531774662,66.73434182253379,32966128,69.74692853141924,67.08806506411376,NaN,NaN,NaN,NaN,NaN,NaN,-0.02173322875674155,0.8731229069546487,0.8948561357113902,94.36572769953081,78.56954658600381,4649074616,9110628778.341702,30.18626244650498,11.162360950519803,38.43844421502592,92.85714285714286,78.57142857142857
2012-09-10,69.25999,69.39999,68.49001,68.53999,63.25273870693198,65.21991152873325,66.4882033879783,67.95215691934212,63.10258000000002,64.73718939999998,65.94069959999995,68.17349699999998,68.17349699999998,69.41707213813316,66.9299218618668,25489968,59.191507546679794,66.00382644150328,NaN,NaN,NaN,NaN,NaN,NaN,-0.05963343279530364,0.8203143447172607,0.8799477775125644,52.58169014084525,82.00281690140865,4623584648,9087938846.827427,27.5602465950225,17.039801917687093,37.186571919173325,85.71428571428571,71.42857142857143
2012-09-11,68.53999,68.82001,68.32001,68.42999,63.304253645171464,65.28347743905536,66.5643518825674,67.99766483178573,63.178280000000015,64.76288929999998,66.02609939999995,68.2439965,68.2439965,69.3725553474625,67.1154376525375,29810080,58.022719097612914,65.0948399183036,NaN,NaN,58.022719097612914,NaN,NaN,NaN,-0.09530472229128739,0.7608168746484552,0.8561215969397425,47.41737089201897,64.78826291079834,4593774568,9071242817.221027,26.252009019093503,17.844873394460034,35.27331357467817,78.57142857142857,64.28571428571429
2012-09-12,68.67999,68.81,68.21001,68.632,63.35726604671205,65.3497848164998,66.6454361224667,68.05807770494899,63.25704000000002,64.79240939999998,66.11173919999995,68.32309649999999,68.32309649999999,69.3198921896914,67.32630081030858,42212160,59.600397459145604,64.19075838873404,NaN,NaN,NaN,NaN,NaN,NaN,-0.10758005536582593,0.7216465277324602,0.8292265830982861,56.9014084507045,52.3001564945229,4635986728,9088408678.18271,24.734717054720583,17.873122659662823,33.28704807280627,71.42857142857143,57.142857142857146
2012-09-13,68.71001,69.86,68.62,69.56,63.41898479251591,65.43315541419288,66.75973274511507,68.20111792352527,63.331240000000015,64.83720939999998,66.20513919999995,68.44009650000001,68.44009650000001,69.44082989255486,67.43936310744516,45417792,65.93442171608608,64.25522539815476,NaN,NaN,NaN,NaN,NaN,NaN,-0.05797158050424667,0.7567621074679778,0.8147336879722245,87.70491803278699,64.00789912517016,4681404520,9111850119.21497,31.566761044706432,15.836011292246402,32.76609577127614,100,50
2012-09-14,69.84,70.42999,69.78999,70.17999,63.486258476172466,65.5271521386643,66.89386048060075,68.38958193080857,63.410239950000026,64.89170929999999,66.31013919999995,68.548096,68.548096,69.78298928259126,67.31320271740874,38888048,69.38761714836701,64.37969006581861,NaN,NaN,NaN,NaN,NaN,NaN,0.008299558382689254,0.8251081359505861,0.8168085775678968,91.69432456586235,78.76688368311795,4720292568,9120356879.71497,34.25864059012152,14.580384504752555,32.654542374906086,100,42.857142857142854
2012-09-17,70.2,70.24001,69.96001,70.21001,63.55316147640956,65.61988199730462,67.02390555979288,68.56295603263634,63.47934000000002,64.92930939999998,66.43193939999996,68.642596,68.642596,70.06780735393521,67.21738464606479,31798336,69.54857925175288,64.46794348117365,NaN,NaN,NaN,NaN,NaN,NaN,0.043871066168072126,0.871647410277987,0.8277763441099149,92.69167007199337,90.69697089021425,4752090904,9145341286.572113,33.34233726249796,14.190408294091464,32.34610618984739,92.85714285714286,35.714285714285715
2012-09-18,70.03999,70.3,70.02,70.27,63.61999569057463,65.71196354191244,67.15120338097748,68.72553164857574,63.54679000000001,64.96360939999998,66.55733939999996,68.735096,68.735096,70.321532687482,67.14865931251799,27169760,69.88930126521593,64.5805341832046,NaN,NaN,NaN,NaN,NaN,NaN,0.06014854706305006,0.9029620279387274,0.8428134808756773,94.68469994916902,93.02356486234157,4779260664,9166688955.143541,33.00868015637345,13.793110604025156,32.417337495989564,85.71428571428571,28.571428571428573
2012-09-19,70.28999,70.58,70.06,70.39999,63.68745832051916,65.80479574900328,67.2786067778019,68.88500387252091,63.615689950000004,64.99520919999998,66.69793919999995,68.847596,68.847596,70.56575226861683,67.12943973138316,36484576,70.65548913756574,64.74785259040343,NaN,NaN,NaN,NaN,70.65548913756574,NaN,0.06780975900645614,0.9275756796337475,0.8597659206272914,94.30348101265835,93.89328367794025,4815745240,9177913575.275234,34.113608836238605,13.061716591591988,32.743387136723406,100,21.428571428571427
2012-09-20,70.07001,70.39999,69.87,70.33,63.753553262603546,65.8944037539735,67.39826925710378,69.02262255132844,63.681139900000005,65.03090929999999,66.84413919999996,68.94259650000001,68.94259650000001,70.7648440004712,67.12034899952882,42523440,69.62815886802616,65.52107782772875,NaN,NaN,NaN,NaN,NaN,NaN,0.056752038538711025,0.9307059688006802,0.8739539302619692,92.0886075949367,93.6922628522547,4773221800,9209205801.231195,32.23733048180802,14.31507744704138,33.805719863640924,92.85714285714286,14.285714285714286
2012-09-21,70.47,70.53999,70.08,70.14999,63.81719939929406,65.9786727885483,67.50617987447225,69.12999087977335,63.74648985000001,65.06370919999999,66.99853919999995,69.05659599999998,69.05659599999998,70.88144382143373,67.23174817856624,23681200,66.93260970336392,65.8396721647468,NaN,NaN,NaN,NaN,NaN,NaN,0.027390749111776636,0.90819236665169,0.8808016175399134,86.39208860759506,90.92805907173003,4749540600,9192731050.014866,32.1492274443277,13.615143243794572,34.610150490721914,85.71428571428571,7.142857142857143
2012-09-24,69.56,69.86,69.42,69.735,63.87608298736079,66.05305550560675,67.59358458527726,69.1876107959854,63.80976485000001,65.09045919999998,67.12563919999997,69.1288465,69.1288465,70.94094431137287,67.31674868862711,32341552,61.06353088419697,65.80464944523156,NaN,NaN,NaN,NaN,NaN,NaN,-0.026961999132411263,0.8470991186243992,0.8740611177568105,69.16058394160582,82.54709338137918,4717199048,9206696720.196684,29.66990572649183,19.53766827593899,34.10528760588982,78.57142857142857,0
2012-09-25,69.92,70.08,68.73,68.75999,63.92467907703879,66.10665816886207,67.63932597408991,69.14688500589156,63.872964800000005,65.11455899999997,67.23683899999996,69.1468465,69.1468465,70.93664177935038,67.35705122064961,41308848,49.97568750977916,65.04616356352116,NaN,NaN,NaN,NaN,NaN,NaN,-0.12980736496291512,0.7118019115531666,0.8416092765160818,23.206005088629265,59.58622587927672,4675890200,9167223209.01375,25.719620609387366,23.741392496611688,32.41533627844224,71.42857142857143,0
2012-09-26,68.67,68.71001,67.85001,68.2,63.967219583734924,66.14811048234995,67.66131319079227,69.05670548152094,63.928864800000014,65.14955899999997,67.33023899999995,69.13684699999999,69.13684699999999,70.94535796612146,67.32833603387851,32770368,44.92961223234847,63.17904002511143,NaN,NaN,44.92961223234847,NaN,NaN,NaN,-0.23087417593797044,0.5530165565936187,0.7838907325315891,12.820193480562391,35.06226083693249,4643119832,9161125634.261005,23.45293047480334,30.171672229888053,30.023955304738482,64.28571428571429,100
2012-09-27,68.35001,69.3,68.25,69.14,64.01869003563806,66.20735581933312,67.71930090880042,69.06463829280466,63.992664800000014,65.19335909999997,67.42523899999996,69.1738475,69.1738475,70.9505427769586,67.39715222304139,25334736,53.429912495521464,62.01353887969017,NaN,NaN,NaN,NaN,NaN,NaN,-0.22927606745179252,0.49729564821684846,0.726571715668641,47.25255403865958,27.75958420261708,4668454568,9178739307.861006,26.559344819860982,27.06637476669685,26.805165954090796,57.142857142857146,92.85714285714286
2012-09-28,68.92,69.12,68.50999,68.57001,64.06397680145261,66.25414105063345,67.75266204963178,69.01753083634708,64.05671490000002,65.23385919999997,67.49463899999996,69.21684749999999,69.21684749999999,70.88825708689696,67.54543791310302,30116096,48.53755592214673,61.25254233508066,NaN,NaN,NaN,NaN,NaN,NaN,-0.259254819537455,0.4025031912468222,0.6617580107842772,26.37372298067021,28.815490166630727,4638338472,9154549567.435242,24.97397378214433,25.450738276333663,25.187814695526082,50,85.71428571428571
2012-10-01,68.89999,69.33,68.25,68.47,64.10781782830382,66.2980194456704,67.78079294964623,68.96538504240927,64.12461490000001,65.27534919999998,67.57933899999996,69.23234749999997,69.23234749999997,70.8696684572883,67.59502654271165,37715200,47.71204552027414,60.516065650985034,NaN,NaN,NaN,NaN,NaN,NaN,-0.2768698805456281,0.3156706601022421,0.5925405406478702,22.710339598313592,32.112205539214465,4600623272,9132199819.287094,22.49505849697685,25.313998754812424,24.24717897668494,42.857142857142854,78.57142857142857
2012-10-02,68.78999,68.98,68.13,68.67,64.1532126757834,66.34498935763733,67.81566381436598,68.93725313360838,64.19426485000001,65.32014919999997,67.68353879999997,69.26134749999999,69.26134749999999,70.83605740889492,67.68663759110505,33254272,49.55958837075981,59.798865001814626,NaN,NaN,NaN,NaN,NaN,NaN,-0.2660352291206516,0.2599965042470558,0.5260317333677074,30.036373759610985,26.373478779531595,4633877544,9141198034.063564,20.749399466902474,24.445140714518036,23.680989048605365,35.714285714285715,71.42857142857143
2012-10-03,68.88,69.24001,68.59,69.11,64.20253394269102,66.39974204362471,67.86642209615555,68.95370521612186,64.26551485,65.36944929999997,67.80653859999995,69.31584749999999,69.31584749999999,70.78697726557715,67.84471773442283,38235968,53.45599258775248,58.90754863550507,NaN,NaN,NaN,NaN,NaN,NaN,-0.22201423201940268,0.248513943343454,0.4705281753628567,46.153648914464945,32.96678742412984,4672113512,9164138673.684986,21.90582839668931,22.976733927165476,21.48104062712726,28.571428571428573,64.28571428571429
2012-10-04,69.24001,69.53999,69,69.35001,64.25375260992793,66.4581631912757,67.92460201395336,68.99144852887216,64.34066485,65.42714939999996,67.94273899999996,69.30684799999999,69.30684799999999,70.77482619459218,67.8388698054078,26128544,55.476391303051976,57.913889646554004,NaN,NaN,NaN,NaN,55.476391303051976,NaN,-0.17175720902717884,0.25583166407888314,0.427588873106062,54.94525620972969,43.7117596279352,4698242056,9171882059.481611,23.62182896176111,21.80491988075665,18.888724338498633,21.428571428571427,57.142857142857146
2012-10-05,69.67999,69.8,68.8,68.98,64.30077994714257,66.5081005538247,67.96599017026891,68.99035819278909,64.4059149,65.48324939999996,68.05493899999995,69.2843485,69.2843485,70.7578708793275,67.81082612067249,25207824,51.74708537052115,56.642354369323165,NaN,NaN,NaN,NaN,NaN,NaN,-0.15876470386920244,0.22913299326955894,0.3878976971387614,41.39172670962187,47.496877277938836,4673034232,9155749052.121613,23.84147694291565,19.791862999150062,16.673648230809555,14.285714285714286,50
2012-10-08,68.58,68.72,68.19,68.35001,64.34107079343966,66.5445740082044,67.98104977143484,68.9293726506187,64.47201495,65.53734949999996,68.12453919999996,69.27484949999999,69.27484949999999,70.76973780672753,67.77996119327244,30911408,46.068632708376676,54.940878043834644,NaN,NaN,NaN,NaN,NaN,NaN,-0.1860394245099256,0.15534841650135434,0.34138784101127995,18.31508540324323,38.21735610753159,4642122824,9143502302.21248,22.105241602070496,23.97366808390724,14.030612704727416,7.142857142857143,42.857142857142854
2012-10-09,68.17,68.33949,67.10001,67.2592,64.37010690494772,66.55872501794293,67.95274193726092,68.77030858865501,64.5303109,65.59384149999997,68.17332299999994,69.21630999999998,69.21630999999998,70.91654369681171,67.51607630318824,67973936,38.24334781407969,52.625725092157076,NaN,NaN,NaN,NaN,NaN,NaN,-0.266107510610252,0.008753452748464952,0.27486096335871696,4.6276431839722685,21.44481843227912,4574148888,9092988544.46762,19.66497917987229,30.953319898429076,12.436049408173464,0,100
2012-10-10,67.25,67.42999,66.8,66.92,64.39547897554526,66.56587897798367,67.91224225344678,68.59408872306882,64.5845109,65.65494149999996,68.21572299999994,69.13070999999998,69.13070999999998,71.09229340933616,67.1691265906638,45134288,36.18501764306235,50.23692929037394,NaN,NaN,NaN,NaN,NaN,NaN,-0.32649564687688815,-0.13325859523739325,0.1932370516394949,3.2085647287828136,8.717097771999436,4529014600,9065048543.869009,18.553321040856748,31.89556329098082,11.575189551188105,7.142857142857143,100
2012-10-11,67.44,67.47,66.67,66.71001,64.41850913499258,66.56873305762755,67.86509589056651,68.41465265420513,64.6368609,65.69694169999997,68.25772319999996,68.98821049999997,68.98821049999997,71.2021853776728,66.77423562232713,30476080,34.93157418647546,47.951141039167624,NaN,NaN,NaN,NaN,NaN,NaN,-0.362393095997614,-0.2597543183575226,0.10263877764009138,1.1733137829910631,3.003173898582048,4498538520,9037620833.77101,17.221944327504033,30.772845768493713,10.699130336477358,0,100
2012-10-12,66.73,67.06,66.55,66.67999,64.44101143215683,66.5709361653973,67.81862114975998,68.24944668713798,64.69231085,65.73934159999996,68.30372299999995,68.81321049999997,68.81321049999997,71.17132276598029,66.45509823401964,24894928,34.746271835423826,46.07133682139811,NaN,NaN,NaN,NaN,NaN,NaN,-0.36874722115046243,-0.3582952487979867,0.01045197235247576,3.6824362606234122,2.6881049241324297,4473643592,9025416461.420893,16.413330995984847,30.432748437434082,11.365969311204097,7.142857142857143,100
2012-10-15,66.94,67.25999,66.53,67.17,64.46816554725974,66.58279881558745,67.79318502623998,68.14664224074389,64.74821080000001,65.78544159999996,68.33512279999995,68.66120999999997,68.66120999999997,71.03146214519138,66.29095785480855,22220000,40.312079085096165,45.381079076777894,NaN,NaN,NaN,NaN,NaN,NaN,-0.3222235202273439,-0.39232742793170416,-0.07010390770436023,19.571865443425118,8.142538495679863,4495863592,9042158091.032257,17.154575950300515,28.37882370524959,12.841041516300793,0,100
2012-10-16,67.28999,68.2,67.25,68.12,64.50450220848104,66.61323844300156,67.80600129972076,68.14410488448256,64.8096608,65.84514169999996,68.37552259999995,68.55370999999998,68.55370999999998,70.81486254500336,66.2925574549966,33960304,49.33477205546554,45.69573334985768,NaN,NaN,NaN,NaN,49.33477205546554,NaN,-0.2149059718514912,-0.33873637251872424,-0.12383040066723303,48.62385321100934,23.95938497168596,4529823896,9070398764.88489,24.047715588030357,25.739192446578546,12.188771377061665,50,92.85714285714286
2012-10-17,67.75,68.3,67.67999,68.08,64.54007930093397,66.64228322630846,67.81674634679054,68.13799965738899,64.86556085000001,65.90524159999995,68.40412279999994,68.43771049999997,68.43771049999997,70.54059365436858,66.33482734563135,33439360,48.99891286141212,45.37923337599273,NaN,NaN,NaN,NaN,NaN,NaN,-0.1377994538831427,-0.2960797180211614,-0.1582802641380187,47.400611620795075,38.53211009174318,4496384536,9080107348.929663,23.59738154963668,24.275457477229935,12.222408006766594,42.857142857142854,85.71428571428571
2012-10-18,67.87,68.08,67.03999,67.28999,64.56744159644707,66.65510910301522,67.7960892351517,68.05723683287574,64.9163108,65.94954149999995,68.41752259999994,68.28570999999997,68.28570999999997,70.25472028737481,66.31669971262512,61706320,42.8013758894021,44.96950623079669,NaN,NaN,NaN,NaN,NaN,NaN,-0.13122048878420486,-0.3223058751182748,-0.19108538633406993,23.241284403669813,39.755249745158075,4434678216,9048067243.677597,21.399085177304837,27.746767449614445,13.077444458792682,35.714285714285715,78.57142857142857
2012-10-19,67.21001,67.27,65.60001,65.67999,64.57851172981576,66.6357998138466,67.71310495142026,67.83083237260186,64.95666075000001,65.98304139999996,68.39472219999995,68.06220999999996,68.06220999999996,70.14548623511278,65.97893376488715,75362624,33.501537671215544,43.954469955863935,NaN,NaN,NaN,NaN,NaN,NaN,-0.2212224758165091,-0.46761348110470635,-0.24639100528819724,1.9042902483102617,24.182062090925047,4359315592,8979923228.97169,18.399523848443444,35.80109625326913,14.949559280537382,28.571428571428573,100
2012-10-22,65.62,66.19,65.5,66.02,64.59285489668326,66.62360575812687,67.64670867881554,67.65837214663978,64.99771075000001,66.02264139999996,68.37792219999994,67.87645999999997,67.87645999999997,69.99223566905975,65.76068433094018,38621408,36.63289086581746,43.03113441979662,NaN,NaN,NaN,NaN,NaN,NaN,-0.2420921862870431,-0.5490062381470011,-0.306914051859958,12.093023255813868,12.412865969264649,4397937000,8999513798.247051,17.33133795452319,34.5641227798116,16.73736800817823,21.428571428571427,100
2012-10-23,65.49001,65.95,65.19,65.39,64.60078668875607,66.59917792133228,67.55821029925414,67.44233670410266,65.03656075000002,66.07245139999995,68.34532219999994,67.70796049999997,67.70796049999997,70.04105071898499,65.37487028101495,52598736,33.48642661945874,41.60473685063278,NaN,NaN,NaN,NaN,NaN,NaN,-0.2798890954320122,-0.6567754211499732,-0.37688632571796105,4.33839479392631,6.1119027660168115,4345338264,8974598607.51021,16.119082213249065,34.75894128655213,19.183821537919734,14.285714285714286,100
2012-10-24,65.75999,65.87,65.06,65.164,64.60639080130576,66.57075855655343,67.4643196992834,67.22535225609288,65.07218080000001,66.11539139999996,68.30760219999993,67.55616049999996,67.55616049999996,70.12463542515064,64.98768557484928,39872368,32.41096205710896,39.95720619020828,NaN,NaN,NaN,NaN,NaN,NaN,-0.29989400829141516,-0.75175383608223,-0.45185982779081485,2.194092827004205,6.20850362558146,4305465896,8944965069.811445,15.015289604597317,33.47775962942998,21.61759003641659,7.142857142857143,100
2012-10-25,65.61,65.72,64.97,65.16,64.61189935054651,66.54282274355236,67.37395422088012,67.02865204122689,65.10718080000001,66.15579139999996,68.26640219999994,67.35716049999996,67.35716049999996,70.01897697698048,64.69534402301944,52688672,32.39113356535161,38.57463820412475,NaN,NaN,NaN,NaN,NaN,NaN,-0.2928475115038718,-0.8179192171706546,-0.5250717056667829,5.066666666666606,3.866384762532372,4252777224,8918971991.624779,14.055544773079532,32.10494769308111,23.747618645431324,0,100
2012-10-26,65.17999,65.623,64.64999,65.35001,64.61924373511819,66.5192026892246,67.29458385927698,66.86878137063385,65.14198085000002,66.18409149999997,68.21300239999994,67.19616049999996,67.19616049999996,69.93351557399505,64.45880542600487,54222192,34.44285749632415,37.74422568897814,NaN,NaN,NaN,NaN,NaN,NaN,-0.25616638055496954,-0.8452796813604948,-0.5891133008055253,18.973302615530447,8.744687369733752,4306999416,8942768769.304104,12.903254110046216,32.16919779727437,26.51115771724485,0,100
2012-10-31,65.31,65.39,64.73,64.95,64.62253484223145,66.4881293686459,67.2026393942073,66.68604028771634,65.17583090000002,66.21089149999996,68.14560219999994,67.02016049999996,67.02016049999996,69.85806867066563,64.18225232933429,38524480,32.22569924071854,37.31439364802378,NaN,NaN,32.22569924071854,NaN,NaN,NaN,-0.23990356353631082,-0.8889927552259138,-0.649089191689603,8.219429535809512,10.75313293933552,4268474936,8929927275.97077,12.174189950933565,30.35156257585081,27.97140622493851,0,92.85714285714286
2012-11-01,65.32001,66,65.17,65.87289,64.63497618708486,66.47594641085094,67.15049235914034,66.60859740317193,65.21164530000001,66.24092039999996,68.09465999999995,66.88030499999996,66.88030499999996,69.65417168506045,64.10643831493948,26944928,41.570934404074684,37.699101988096096,NaN,NaN,NaN,NaN,NaN,NaN,-0.1523198976486312,-0.839489063750392,-0.6871691661017608,33.504017797211446,20.232249982850465,4295419864,8948619264.698288,16.22721255613294,27.672713242175405,27.94460254310402,35.714285714285715,85.71428571428571
2012-11-02,66.21001,66.21001,65.11,65.17,64.64029980711386,66.4500860858836,67.07282599211523,66.47158812667936,65.24004525000002,66.27457049999995,68.03506019999995,66.68330499999996,66.68330499999996,69.35347747879109,64.01313252120883,44082992,37.34712360952537,37.87164123259965,NaN,NaN,NaN,NaN,NaN,NaN,-0.12803129951885794,-0.8472082905003333,-0.7191769909814754,14.246810282711554,18.656752538577503,4251336872,8909345282.652742,16.48661383425562,25.166688654909564,27.416370703283707,28.571428571428573,78.57142857142857
2012-11-05,65.19501,65.73,65.03999,65.60001,64.64984916226696,66.43325289606412,67.01506850222836,66.38858068604324,65.26874530000002,66.30497059999995,67.97846059999995,66.49580499999996,66.49580499999996,68.90446408058656,64.08714591941336,28104128,41.27801692251716,38.33819445310632,NaN,NaN,NaN,NaN,NaN,NaN,-0.07209723151077463,-0.8092985303699436,-0.737201298859169,26.0278738962358,24.5929006587196,4279441000,8926860417.453455,15.536181287199339,24.30077809593034,26.850271755855456,21.428571428571427,71.42857142857143
2012-11-06,65.71001,66.17,65.46001,65.72,64.66049742930907,66.41912907634007,66.96428150214098,66.32490633499151,65.29849530000001,66.34087059999995,67.93546059999996,66.33280499999996,66.33280499999996,68.4732470773495,64.19236292265043,29608304,42.3646682659958,38.484807966027724,NaN,NaN,NaN,NaN,42.3646682659958,NaN,-0.018880980291607008,-0.7608025242236778,-0.7419215439320708,29.315262149966657,23.19664877630467,4309049304,8918936539.873432,18.32447180768459,22.84163289127072,25.873302420550278,14.285714285714286,64.28571428571429
2012-11-07,65.03999,65.10001,63.89999,64.17,64.65561685787317,66.3745918669076,66.85470183539034,66.11967716023041,65.32039535000001,66.35897059999995,67.85306079999995,66.12380449999996,66.12380449999996,68.25182925119299,63.99577974880694,70737632,33.691445830045936,37.3674275213549,NaN,NaN,NaN,NaN,NaN,NaN,-0.07668971463301211,-0.837783687223336,-0.7610939725903239,6.1365769623250745,20.493237669509174,4238311672,8880031490.690918,15.718881149215367,31.781701382348,28.046060699403842,7.142857142857143,100
2012-11-08,64.33,64.495,63.16,63.16,64.64073509809334,66.31093658241437,66.70981156733582,65.83780314497037,65.33779540000002,66.36067049999994,67.74826099999994,65.91884449999996,65.91884449999996,68.33947618818583,63.4982128118141,58585728,29.459190655606903,35.97173307808309,NaN,NaN,NaN,NaN,NaN,NaN,-0.16641999979989897,-0.9691189723401976,-0.8026989725402986,0,11.817279704097244,4179725944,8821445762.690918,14.131585622245831,34.16970717045984,30.908151640511896,0,100
2012-11-09,63.19,64.11,63.16,63.42999,64.62868788318694,66.25388813523784,66.58119111371481,65.60848760735414,65.35279540000002,66.35917039999994,67.64886099999995,65.74434399999997,65.74434399999997,68.34743311665423,63.14125488334572,51549536,31.921120010819195,35.1945719438986,NaN,NaN,NaN,NaN,NaN,NaN,-0.18938900842742878,-1.0394352330745846,-0.8500462246471558,6.569099756690997,4.235225573005357,4231275480,8799196982.953318,13.116546701912357,31.715376594857915,32.948842759298785,0,92.85714285714286
2012-11-12,63.78999,63.87,63.25,63.42,64.6166611380806,66.19777153850046,66.45722283474561,65.40006021617755,65.36879540000001,66.35098039999994,67.54926119999995,65.57984349999995,65.57984349999995,68.32972424879692,62.829962751202984,32663664,31.876788533651677,35.078518434072606,NaN,NaN,NaN,NaN,NaN,NaN,-0.18674528257023648,-1.0834778278599515,-0.896732545289715,8.524562214550283,5.031220657080426,4198611816,8784445650.824286,12.486206396354227,30.19123456052359,33.61883053557868,0,85.71428571428571
2012-11-13,62.92,63.58,62.78011,62.98,64.60037595262706,66.13405329021333,66.32086115495166,65.1695782908273,65.38169545000001,66.33788049999994,67.45466099999994,65.39484399999995,65.39484399999995,68.3162679085103,62.473420091489594,43287632,29.906748073503607,34.59807966319305,NaN,NaN,NaN,NaN,NaN,NaN,-0.19520318276168547,-1.1407365237418219,-0.9455333409801364,5.827866701653009,6.973842890964762,4155324184,8762792905.522406,11.704688901700958,31.97838598419778,34.56198381409529,50,100
2012-11-14,63.27,63.36,62.14,62.24001,64.57688972424272,66.0569435220903,66.1608277763261,64.89057178693899,65.3906455,66.33338059999994,67.33626119999994,65.14834449999996,65.14834449999996,68.25511603776216,62.04157296223776,82655184,26.896176303836356,34.12734749779145,NaN,NaN,NaN,NaN,NaN,NaN,-0.22887574341172967,-1.2316280202447984,-1.0027522768330688,2.457242119798172,5.603223678667153,4072669000,8693689106.689356,10.613543001275955,33.88849178006047,35.680876519001544,42.857142857142854,100
2012-11-15,62.28999,62.49001,61.8,62.02991,64.55154664240946,65.9772002840291,65.9988310007839,64.61812780723052,65.39814505000001,66.32017959999993,67.21505939999994,64.84383999999996,64.84383999999996,67.91953778908639,61.76814221091352,55124160,26.093039820712946,33.676067338048874,NaN,NaN,26.093039820712946,NaN,NaN,NaN,-0.24224919748114848,-1.3055637736845043,-1.0633145762033558,5.213366863113777,4.499491894854985,4017544840,8675299474.089249,10.043275572864728,34.71519251985801,36.898729347214505,35.714285714285715,100
2012-11-16,62.08,62.48,61.31,62.3,64.52914319323126,65.90438443682059,65.85377880467472,64.39735373035143,65.40454505000001,66.32187959999993,67.10065939999996,64.55483999999996,64.55483999999996,67.44023615474075,61.66944384525916,70868000,29.027031758979973,33.435774351879466,NaN,NaN,NaN,NaN,NaN,NaN,-0.21100176733234943,-1.3270667853687925,-1.116065018036443,20.204040399917467,9.291549794276472,4088412840,8724361935.62771,9.145927192535975,35.35538556512458,38.31262312589643,28.571428571428573,100
2012-11-19,62.97,63.83,62.96001,63.78059,64.52169490275135,65.86232910143801,65.77247728292276,64.33861432746082,65.41739795000001,66.33448549999994,66.98567119999996,64.37936999999997,64.37936999999997,66.99203829011749,61.76670170988243,55306384,42.502240175245944,34.01144454323103,NaN,NaN,NaN,NaN,NaN,NaN,-0.07569267556776915,-1.2106808624961545,-1.1349881869283853,50.42010118346691,25.279169482166054,4143719224,8773386205.043772,17.98531442065935,31.403906930763252,37.200100473710634,21.428571428571427,92.85714285714286
2012-11-20,63.77,63.89,63.19,63.8,64.51451385894288,65.82149090140953,65.69512523261207,64.28731772484551,65.42614795000003,66.34348559999994,66.87307139999996,64.28537049999996,64.28537049999996,66.83870232580949,61.73203867419042,52012656,42.655951646365104,34.756462572205784,NaN,NaN,NaN,NaN,NaN,NaN,0.02467054841178795,-1.1041500014136503,-1.1288205498254382,50.816222824035,40.480121469139796,4195731880,8812024178.072342,17.49397225498064,29.764832069515062,36.001589583294056,14.285714285714286,85.71428571428571
2012-11-21,63.83,64.02,63.60001,63.92999,64.50869770114245,65.78403543801528,65.62590424309788,64.25328651295546,65.43579790000003,66.36078549999993,66.78087139999995,64.18086999999996,64.18086999999996,66.60971605403275,61.75202394596716,19620064,43.74067493414844,34.91144403863962,NaN,NaN,NaN,NaN,NaN,NaN,0.10486990152907394,-0.9977331729140957,-1.1026030744431696,53.46907455290902,51.56846618680365,4215351944,8823234508.69469,17.933062251180356,28.7937867807188,35.79953292778732,7.142857142857143,78.57142857142857
2012-11-23,64.32001,64.92,64.25011,64.89999,64.51259115685248,65.76652958775755,65.59743701787835,64.31487732124542,65.44964785000006,66.36818539999994,66.7102714,64.15636949999995,64.15636949999995,66.54549480012173,61.76724419987818,16462832,51.16427738383833,35.89838359394769,NaN,NaN,NaN,NaN,NaN,NaN,0.2215952044803171,-0.8256090688427733,-1.0472042733230904,73.86810699588479,59.384468124276275,4231814776,8838713832.153528,23.51443356460707,26.591545294873036,34.74970030399095,0,71.42857142857143
2012-11-26,64.77,65.22,64.53999,65.181,64.51924199111265,65.75493494245542,65.58110615443213,64.39736519541252,65.46325280000005,66.37649529999995,66.64125139999999,64.15721949999995,64.15721949999995,66.54778982882911,61.766649171170805,26430880,53.09523131000029,36.74247033591077,NaN,NaN,NaN,NaN,NaN,NaN,0.3106205394132766,-0.6589285990564946,-0.9695491384697712,79.65020576131678,68.99579577003686,4258245656,8862112979.326069,24.617616172315376,25.16767740815911,33.25710728867513,7.142857142857143,64.28571428571429
2012-11-27,65.16,65.39999,64.85001,64.96001,64.52362774244486,65.739193854486,65.55674944249363,64.45095041489704,65.47350285000006,66.37719539999995,66.54925159999999,64.14721999999995,64.14721999999995,66.52255309416272,61.77188690583717,25828576,51.37486657961269,37.38605592974055,NaN,NaN,NaN,NaN,NaN,NaN,0.34487278158750156,-0.5384581614853943,-0.8833309430728958,89.24251648537025,80.92027641419061,4232417080,8846616209.428108,24.97895498581079,24.046204130774303,32.60922054282711,0,57.142857142857146
2012-11-28,64.66,65.57001,64.25,65.52,64.53354189426133,65.73485338211995,65.55530828788604,64.55276466109731,65.48872780000005,66.38309549999994,66.45605179999998,64.15571949999995,64.15571949999995,66.54935325876119,61.76208574123871,37295776,55.325084761203755,38.93131585339468,NaN,NaN,NaN,NaN,NaN,NaN,0.39205303547625237,-0.3932646487275804,-0.7853176842038327,98.82605909375799,89.23959378014833,4269712856,8881086004.173784,22.399120919702966,26.257306809663838,30.760177582881816,100,50
2012-11-29,65.82001,66.13499,65.58,65.91,64.54723799481594,65.73832163197896,65.56921776679246,64.68202516956424,65.50302780000004,66.40099549999995,66.37005159999998,64.20371949999995,64.20371949999995,66.69562445065128,61.71181454934862,41135808,57.89078793511855,40.96214423050265,NaN,NaN,NaN,NaN,57.89078793511855,NaN,0.43312111693554733,-0.24391628803439858,-0.6770374049699459,95.33698515437327,94.4685202445005,4310848664,8888869335.761885,25.821618185913664,24.963700890083988,27.9175788742572,100,42.857142857142854
2012-11-30,65.92,65.97,65.61,65.8,64.55970328839986,65.73954298580117,65.57826805044766,64.78849896293907,65.51597775000005,66.41899549999995,66.28065159999998,64.20007499999994,64.20007499999994,66.68239919496047,61.71775080503942,33502048,56.89823375909531,42.746223783950946,NaN,NaN,NaN,NaN,NaN,NaN,0.435309347890923,-0.13290072010629217,-0.5682100679972152,93.05718768329044,95.74007731047391,4277346616,8890730560.650774,25.04381202133058,24.211737155537403,25.074980165632585,92.85714285714286,35.714285714285715
2012-12-03,66.32001,66.37,65.64,65.67,64.57075101687349,65.73816589697341,65.58186538180266,64.87245144265916,65.53047775000005,66.44199549999995,66.18605179999997,64.22507499999995,64.22507499999995,66.75557266031925,61.694577339680656,28239968,55.68315632478195,44.446678626174545,NaN,NaN,NaN,NaN,NaN,NaN,0.41074521976152145,-0.0547785432953134,-0.46552376305683485,86.16600790513829,91.52006024760067,4249106648,8864811685.911049,26.880023808860592,22.717390319333354,22.71120588645083,100,28.571428571428573
2012-12-04,65.69,65.77,65.2,65.63,64.58129080775036,65.73602399802344,65.58375301388882,64.94459892431067,65.54047775000005,66.46809549999995,66.09205179999998,64.22657449999994,64.22657449999994,66.76036277354689,61.692786226453,49671696,55.291894064066305,46.259903339786156,NaN,NaN,NaN,NaN,NaN,NaN,0.37550834172648007,0.0038616641012652053,-0.37164667762521486,85.37549407114606,88.19956321985826,4199434952,8890083250.542627,25.55379765438278,25.40514668391979,19.416979656074357,92.85714285714286,21.428571428571427
2012-12-05,65.53,65.53999,64.55,64.9032,64.58449388429015,65.71953243370615,65.55706466040299,64.94065616961441,65.54784380000005,66.49282759999994,65.98711599999997,64.18573449999994,64.18573449999994,66.64722020205151,61.72424879794836,54076128,48.60851519562869,47.810784689199906,NaN,NaN,48.60851519562869,NaN,NaN,NaN,0.2907433352106012,-0.008217508611963353,-0.29896084382256455,71.01185770750978,80.85111989459803,4145358824,8874592741.406656,23.21647923090972,28.586357784422066,16.421631726024646,85.71428571428571,14.285714285714286
2012-12-06,64.71001,65.4801,64.53,65.32001,64.59181245260568,65.71162109838524,65.54776839921071,64.97678510584161,65.55639385000005,66.51222769999994,65.89881619999998,64.24323499999993,64.24323499999993,66.75380332181368,61.732666678186185,47519072,52.178494916022416,49.674031481722004,NaN,NaN,NaN,NaN,NaN,NaN,0.25169843463756486,0.015662199474391514,-0.23603623516317335,79.24920948616585,78.54552042160722,4192877896,8906098071.197458,21.365091293984165,26.474616856902074,13.247215092457987,78.57142857142857,7.142857142857143
2012-12-07,65.64999,65.71001,64.71001,64.92999,64.59517740332602,65.69614325485286,65.5235417953201,64.97232842909479,65.56444375000005,66.52952759999994,65.82221619999997,64.33173449999992,64.33173449999992,66.8078749494595,61.855594050540354,30092672,48.76487524496116,51.08387744500637,NaN,NaN,NaN,NaN,NaN,NaN,0.19129313158663633,0.003080179320122056,-0.18821295226651427,57.770843902768114,69.34397036548124,4162785224,8889244971.170578,21.49987303416008,24.279970308015123,9.474131677380257,71.42857142857143,0
2012-12-10,64.75,65.455,64.75,65.12,64.6003995187158,65.68473447752903,65.50771662687617,64.98639238822862,65.57134370000006,66.54542759999995,65.76061619999997,64.41623499999993,64.41623499999993,66.87882592390372,61.95364407609614,33219552,50.46511061134555,51.652653904727785,NaN,NaN,NaN,NaN,NaN,NaN,0.1572462516859358,0.008344862340905479,-0.14890138934503033,60.69182389937115,65.9039590961017,4196004776,8890894168.7876,20.226848083295703,22.842333538754225,7.967251907833689,64.28571428571429,0
2012-12-11,65.58,66.34,65.515,65.97,64.61402738420122,65.69038329975618,65.52584538660652,65.08006930363543,65.58139365000005,66.56122759999995,65.69721619999997,64.54373499999993,64.54373499999993,67.05045982703828,62.03701017296158,40750800,57.29274228564648,52.698138950390735,NaN,NaN,NaN,NaN,NaN,NaN,0.1832657384002594,0.08018078365529391,-0.10308495474496548,85.5595146552874,68.00739415247556,4236755576,8895092736.060326,25.42581622235337,20.57226708153627,6.866280335747119,57.142857142857146,0
2012-12-12,66.28999,66.32001,65.64999,65.83,64.62612661420917,65.69314798688971,65.5377730185043,65.15149127471777,65.59029365000005,66.56852749999993,65.64241599999997,64.68623499999993,64.68623499999993,67.14474805843479,62.22772194156506,45917680,55.92544752893135,53.568479850018086,NaN,NaN,NaN,NaN,NaN,NaN,0.18197248867310858,0.12438065609642024,-0.05759183257668834,74.5283018867922,73.59321348048358,4190837896,8873847876.503895,24.014316023677154,19.43020899306162,5.959753693094545,50,0
2012-12-13,65.71001,66.16,65.03,65.3111,64.63294226978918,65.68558268021863,65.52888388052374,65.16669210569702,65.59334915000005,66.57928849999993,65.57923799999998,64.83978949999992,64.83978949999992,67.0378018803417,62.641777119658144,45467648,51.061422855904674,53.56113309802283,NaN,NaN,NaN,NaN,NaN,NaN,0.13903267423631674,0.1161990102187076,-0.022833664017609147,50.05188679245254,70.04656777817738,4145370248,8851001389.305311,21.814774669114776,22.675910648823436,5.659349084474941,42.857142857142854,21.428571428571427
2012-12-14,64.89999,65.08,64.47,64.69,64.63351000839825,65.66586817169944,65.49598647344438,65.12129285753541,65.59474915000006,66.59158839999995,65.49963799999998,64.97279399999994,64.97279399999994,66.75770308844271,63.18788491155716,39630256,45.91395602296237,53.0481848632344,NaN,NaN,45.91395602296237,NaN,NaN,NaN,0.06540152706485139,0.05891824481345509,-0.0064832822513962995,20.754716981131924,48.444968553458885,4105739992,8839956891.73154,20.32267877369697,25.678844921702638,6.412105289084795,35.714285714285715,14.285714285714286
2012-12-17,64.73,65.57001,64.66,65.55,64.64262931179726,65.66357375245786,65.49810465095636,65.1621221091987,65.59789915000005,66.61748829999993,65.42843799999997,65.13529399999993,65.13529399999993,66.44607363594396,63.82451436405591,42302832,52.98181832067835,53.162967130453374,NaN,NaN,NaN,NaN,NaN,NaN,0.07076479210043199,0.08197270787414368,0.011207915773711698,61.320754716980865,44.04245283018844,4148042824,8880399349.299788,22.797158319603376,23.78343237662966,6.427444828026585,28.571428571428573,7.142857142857143
2012-12-18,65.85001,66.64999,65.7,66.5472,64.66158026391868,65.68107130191414,65.5392456450365,65.29403428927502,65.60628515000005,66.65756039999994,65.37238179999997,65.27362449999993,65.27362449999993,66.56716733660558,63.98008166339427,55596000,59.57795499624747,53.466743575813645,NaN,NaN,NaN,NaN,59.57795499624747,NaN,0.13395356931610963,0.17864987741884875,0.04469630810273911,95.28484075615032,59.12010415142104,4203638824,8923964248.256618,29.405445996635464,21.698529516760544,6.938259654457601,100,0
2012-12-19,66.72,66.75999,66.22,66.2605,64.67748991303392,65.6925451375198,65.56753012954488,65.38607864267739,65.61658765000004,66.68646539999995,65.31799179999997,65.39664949999992,65.39664949999992,66.56847853391801,64.22482046608184,34832448,57.09783023881527,53.41010374036341,NaN,NaN,NaN,NaN,NaN,NaN,0.14783299132779235,0.22948754726247955,0.0816545559346872,78.18811435857764,78.26456994390294,4168806376,8894356764.21521,29.00528739874372,20.73747328967506,8.004819558678056,100,78.57142857142857
2012-12-20,66.38,66.41,65.92999,66.25999,64.69323618255598,65.70378166945011,65.59468541858233,65.46930829575574,65.63003755000004,66.70036529999994,65.27619139999997,65.51314949999991,65.51314949999991,66.53184848927022,64.4944505107296,40754272,57.09327721339777,53.42403541567072,NaN,NaN,NaN,NaN,NaN,NaN,0.14800571845927651,0.26666170400878286,0.11865598554950635,78.16584351896736,83.87959954456511,4128052104,8909638448.799448,27.82548183874661,22.3514792199892,8.663397608969062,92.85714285714286,71.42857142857143
2012-12-21,64.89,65.28,64.60001,65.2,64.69827860860019,65.69380579480753,65.57920755903008,65.44365988663614,65.63573755000004,66.70416519999995,65.23500739999997,65.52814999999993,65.52814999999993,66.5187393085,64.53756069149985,51144544,48.446417506370096,52.907125500069874,NaN,NaN,NaN,NaN,NaN,NaN,0.07162742670860997,0.20819026893526882,0.13656284222665885,31.877868462307827,62.74394211328428,4076907560,8948748805.473164,24.164860465749573,29.95133213394155,8.827671672495468,85.71428571428571,64.28571428571429
2012-12-24,65.06,65.14,64.92,65.07001,64.70197742841512,65.68145340283114,65.5592390273034,65.40807418314698,65.63733760000005,66.70686529999993,65.19800759999997,65.52260049999992,65.52260049999992,66.52211028871282,64.52309071128703,11418230,47.496409899034106,52.35030520256758,NaN,NaN,NaN,NaN,NaN,NaN,0.010459489581234632,0.14963720420320215,0.1391777146219675,26.201424460368678,45.41504548054795,4065489330,8952901927.130436,23.600859565252524,29.252276647212287,9.570598340766285,78.57142857142857,57.142857142857146
2012-12-26,65.08,65.17999,64.28999,64.5,64.69996770275925,65.6580582859434,65.51770024191896,65.32159092760917,65.63473760000005,66.70576529999994,65.15380739999996,65.49959999999993,65.49959999999993,66.56859226756332,64.43060773243654,21760848,43.47089692384707,51.98333246886889,NaN,NaN,NaN,NaN,NaN,NaN,-0.06607325532791217,0.0565861454620773,0.12265940078998946,8.50242914979745,22.193907357491316,4043728482,8941410732.362974,21.854800202515637,32.32518213402493,10.21054062818892,71.42857142857143,100
2012-12-27,64.56,64.64,63.60001,64.39999,64.69698284999548,65.63314604265739,65.47386846772606,65.23381941069401,65.63148755000005,66.70596519999994,65.10820739999997,65.44359949999992,65.44359949999992,66.61490024811444,64.2722987518854,52943136,42.785716584516734,51.3124197309042,NaN,NaN,NaN,NaN,NaN,NaN,-0.11807949482793363,-0.02493996774492757,0.09313952708300606,25.315983012550834,20.00661220757232,3990785346,8969917321.720488,19.993392462864158,35.222692396706925,11.417737980583647,64.28571428571429,100
2012-12-28,63.92999,64.42999,63.75,63.78,64.68785864253283,65.59645008141665,65.40744225330543,65.09536041919934,65.61908760000004,66.68776509999994,65.04040739999996,65.33709949999994,65.33709949999994,66.69230546830346,63.98189353169642,33082048,38.71211006992766,50.594365075544665,NaN,NaN,38.71211006992766,NaN,NaN,NaN,-0.18490152466221912,-0.13798737874476785,0.04691414591745128,5.695922126089513,13.171444762812598,3957703298,8939754320.882946,18.862178956656496,33.229814727839084,12.954060872563062,57.142857142857146,92.85714285714286
2012-12-31,63.67999,65.25211,63.58,65.1301,64.69225905404991,65.58721542633909,65.39656608650914,65.09866895070417,65.61228805000005,66.67806599999993,64.98060939999998,65.30360449999992,65.30360449999992,66.64442885108566,63.96278014891418,57553104,49.898646914903054,50.553903382941634,NaN,NaN,NaN,NaN,NaN,NaN,-0.1313589143394066,-0.11728449700680699,0.014074417332599627,48.74543630640344,26.585780481681258,4015256402,8988908391.064548,22.81108624931143,28.899708468050722,13.361319422367972,50,100
2013-01-02,66.69,67.23,66.48,67.2,64.71721170027827,65.61915175453039,65.4672889850774,65.29879571730378,65.61488810000004,66.68356609999994,64.96300939999998,65.38010449999993,65.38010449999993,66.95071424989186,63.80949475010801,70695872,61.50084541552844,50.85448217793321,NaN,NaN,NaN,NaN,61.50084541552844,NaN,0.041054476428116875,0.06539251286774572,0.024338036439628848,99.17808219178079,51.20648020809125,4085952274,9053948593.304548,33.50566544170649,24.569698348329155,13.706691785176194,100,92.85714285714286
2013-01-03,67.2,67.34,66.64999,66.8521,64.73845436992724,65.64356657127236,65.5215952993881,65.44672945851293,65.61654860000004,66.68588709999993,64.95425159999996,65.44120949999993,65.44120949999993,67.13612669578777,63.74629230421208,47366432,59.02667885820323,51.075998701452626,NaN,NaN,NaN,NaN,NaN,NaN,0.12454365559042449,0.18001760592765947,0.05547395033723498,87.02393617021251,78.31581822279891,4038585842,9034330250.669977,32.621322775766465,23.332611326195497,14.138763718324439,100,85.71428571428571
2013-01-04,66.87,66.88,66.47,66.63,64.7572757194802,65.6630999064947,65.56506215039248,65.55942189103551,65.61474855000004,66.68398699999993,64.97325179999996,65.52754949999994,65.52754949999994,67.2790287731668,63.77607022683308,33973328,57.43803611921725,51.531471077403516,NaN,NaN,NaN,NaN,NaN,NaN,0.15566462286040716,0.25005472891274394,0.09439010605233678,81.11702127659557,89.10634654619628,4004612514,9026872690.865099,31.603098955536506,23.974590353580442,14.980928348612267,92.85714285714286,78.57142857142857
2013-01-07,66.46001,66.75999,66.25,66.65041,64.7761128765003,65.68265060141559,65.6076248111614,65.6633255204607,65.61245060000005,66.68189109999993,64.98585999999996,65.59406949999995,65.59406949999995,67.40887764809871,63.779261351901184,26766192,57.5510998899054,52.36269563932802,NaN,NaN,NaN,NaN,NaN,NaN,0.16745242741710104,0.30370564032371306,0.13625321290661202,81.65984042553168,83.26693262411325,4031378706,9042136542.351128,30.334733637750123,24.743702648053283,14.874326961371725,85.71428571428571,71.42857142857143
2013-01-08,66.64,66.815,66.17,66.52,64.79346498718189,65.69923177762519,65.64340423033154,65.74491356613112,65.60945060000005,66.67689109999993,65.00845999999996,65.67356999999994,65.67356999999994,67.50428473422527,63.842855265774624,28743936,56.518002687228694,52.61528023693876,NaN,NaN,NaN,NaN,NaN,NaN,0.1564980059261965,0.33187572031435764,0.17537771438816113,78.19148936170195,80.32278368794307,4002634770,9044587575.653454,28.762476065647835,24.104085865173154,15.352487718928861,78.57142857142857,64.28571428571429
2013-01-09,66.62,66.95,66.55,66.77,64.81313200223481,65.72043510876132,65.68758445659304,65.8425408455472,65.60840060000004,66.67409109999993,65.04057999999996,65.75606999999994,65.75606999999994,67.62781657422191,63.88432342577796,25609168,58.07184556332904,52.507700991730296,NaN,NaN,NaN,NaN,NaN,NaN,0.15578363349576496,0.37010725625786733,0.21432362276210237,84.84042553191472,81.56391843971613,4028243938,9047148492.453453,28.856934227945665,23.239316522998486,15.045508901139028,71.42857142857143,57.142857142857146
2013-01-10,67.21001,67.27,66.55,67.17,64.83658342509814,65.74913936403337,65.74571839947174,65.96896552692367,65.60955560000004,66.67359109999994,65.08077999999996,65.81606999999993,65.81606999999993,67.78577090067424,63.846369099325614,37534256,60.503811402008516,52.75098536052981,NaN,NaN,NaN,NaN,NaN,NaN,0.1707425611770811,0.4277518242334537,0.2570092630563726,95.47872340425528,86.17021276595733,4065778194,9074256566.231232,29.804066492997016,21.827243254659802,14.96182639130397,64.28571428571429,50
2013-01-11,67.14,67.28999,67,67.25999,64.86069692335587,65.77905719840895,65.80510159949246,66.09192023864523,65.60530555000004,66.66599099999993,65.11897959999996,65.88756949999993,65.88756949999993,67.95547063603459,63.81966836396526,21160464,61.05116147334781,53.033691379097675,NaN,NaN,NaN,NaN,61.05116147334781,NaN,0.17456776722396128,0.47521897208632424,0.30065120486236296,97.87207446808507,92.73040780141837,4086938658,9091038852.225094,29.215751156278756,21.26675022038964,15.307301931197662,57.142857142857146,42.857142857142854
2013-01-14,66.89999,67.14999,66.67,66.96001,64.88158561068566,65.80244240240086,65.85039212500256,66.17459545401235,65.59905555000005,66.65239099999994,65.15917979999996,65.97001499999993,65.97001499999993,68.07063118932548,63.86939881067439,36777296,58.15781270134056,53.72736246445271,NaN,NaN,NaN,NaN,NaN,NaN,0.14592919901265222,0.48306270362817827,0.33713350461552605,89.89388297872324,94.41489361702122,4050161362,9098703247.147654,27.659560110370446,23.113272763505037,15.18312281919403,50,35.714285714285715
2013-01-15,66.63,66.729,66.33211,66.63,64.89898276878829,65.81882968156124,65.8809649828456,66.21796731553498,65.59251555000006,66.63449099999994,65.17432199999996,66.06701499999993,66.06701499999993,68.10033266698083,64.03369733301902,31675280,55.06602228892824,54.268049063730864,NaN,NaN,55.06602228892824,NaN,NaN,NaN,0.09619520048532582,0.45737750522218334,0.36118230473685753,81.11702127659557,89.62765957446798,4018486082,9114576402.024822,26.068134564097296,24.879601184343787,14.585991934202854,42.857142857142854,28.571428571428573
2013-01-16,66.75,67.13,66.60001,66.89999,64.91889328850183,65.84023879677785,65.9209267482242,66.2829218569126,65.58861555000004,66.62199099999994,65.20892179999996,66.13451449999994,66.13451449999994,68.18426194125426,64.08476705874561,33828112,57.07651374570895,55.239878836721,NaN,NaN,NaN,NaN,NaN,NaN,0.07391748327707992,0.45357915883320743,0.3796616755561275,88.29760638297871,86.43617021276584,4052314194,9119042435.339867,28.53297920506564,23.643065328372767,13.875046708918333,35.714285714285715,21.428571428571427
2013-01-17,67.17999,67.48,67.06,67.22,64.94178987269585,65.86756080080205,65.97187079731346,66.37216739434949,65.58696555000004,66.60989109999996,65.24132159999996,66.16815449999993,66.16815449999993,68.26542221402495,64.0708867859749,32030736,59.39551976718362,56.426293349768635,NaN,NaN,NaN,NaN,NaN,NaN,0.07304035267909048,0.47096211640499064,0.39792176372590016,93.33333333333321,87.58265366430253,4084344930,9111416069.62558,30.29320614202306,22.33479423695123,12.985099302236197,100,14.285714285714286
2013-01-18,67.00999,67.14,66.77,67.07001,64.96296619237052,65.8913716760337,66.01493507977175,66.43862859488763,65.58106560000004,66.60189119999995,65.26832179999997,66.20862999999994,66.20862999999994,68.34239238840819,64.0748676115917,31991952,57.81878272392627,57.79105568219711,NaN,NaN,NaN,NaN,NaN,NaN,0.05546190007288798,0.46724913881701013,0.41178723874412215,89.48743589743572,90.37279187124925,4052352978,9131304688.001364,28.95453979653527,24.19563297712134,11.654558239540261,92.85714285714286,7.142857142857143
2013-01-22,67.14999,67.23,66.73,67.17999,64.98502613075489,65.91688887056769,66.060623508016,66.50923444299357,65.57581555000004,66.59079119999996,65.32852159999997,66.25462999999993,66.25462999999993,68.4300974003978,64.07916259960207,32123008,58.68484879262045,58.4186415306055,NaN,NaN,NaN,NaN,NaN,NaN,0.04480114309657457,0.4677886676148404,0.4229875245182658,77.09847328244277,86.63974750440393,4084475986,9157001809.481043,28.404384050060123,22.980486857867863,11.567491264357908,85.71428571428571,0
2013-01-23,67.56,67.78999,67.46001,67.59,65.01094626875732,65.95001978402179,66.12059905672125,66.6121644960418,65.57726555000004,66.58269129999995,65.41712159999996,66.37412999999994,66.37412999999994,68.56723992204897,64.1810200779509,31977408,61.831190898588616,58.442237636538366,NaN,NaN,NaN,NaN,61.831190898588616,NaN,0.05808022102756666,0.49558780080272413,0.4375075797751575,87.65486206704983,84.74692374897613,4116453394,9150218311.814518,32.328627676658435,21.558011568210308,11.89611256306941,100,28.571428571428573
2013-01-24,66.69,67.28,66.56,66.66,65.02735476359555,65.96407879819958,66.14175203488904,66.61672025832354,65.57196555000004,66.56529139999995,65.48172179999997,66.45362949999993,66.45362949999993,68.56565435418331,64.34160464581656,42603376,52.13315500883646,57.9498430758693,NaN,NaN,52.13315500883646,NaN,NaN,NaN,0.00001952821453438114,0.43753199004332544,0.43751246182879105,30.247100290742193,65.00014521341161,4073850018,9119449206.925629,29.057917481129625,28.217229541466622,10.815195799522254,92.85714285714286,21.428571428571427
2013-01-25,66.89,67.19,66.74001,67,65.04698307440555,65.98459208932434,66.17540881783457,66.65322309086416,65.57091550000004,66.55129149999995,65.55332179999996,66.57862949999993,66.57862949999993,68.5007427861224,64.65651621387747,39248720,54.9171484361583,57.76977966993652,NaN,NaN,NaN,NaN,NaN,NaN,-0.01866352482211575,0.41418305580114634,0.4328465806232621,51.23488416595149,56.37894884124784,4113098738,9125553826.834517,27.51531975265637,26.719261415473344,9.939621429143413,85.71428571428571,14.285714285714286
2013-01-28,67.00999,67.38,66.92999,67.14999,65.06790851645127,66.00766927567435,66.2136276877234,66.70053422506757,65.57601545000006,66.54569129999996,65.63672159999997,66.71612949999994,66.71612949999994,68.36988009627744,65.06237890372243,32933920,56.129351909685866,57.66822624277798,NaN,NaN,NaN,NaN,NaN,NaN,-0.023769495959810982,0.4031347106734984,0.42690420663330936,60.493583293724036,47.32518925013924,4146032658,9124821246.360306,28.196131096729367,25.482295514683422,9.575671020160858,78.57142857142857,7.142857142857143
2013-01-29,67.06,67.31,66.63,67.16,65.08872534713335,66.03048770585902,66.25074032742053,66.74429287029923,65.57956545000005,66.53569129999994,65.73512139999997,66.88512949999993,66.88512949999993,67.85253838495402,65.91772061504585,35554608,56.213968629472255,57.64650952436681,NaN,NaN,NaN,NaN,NaN,NaN,-0.02897697284259898,0.3906829905800606,0.4196599634226596,56.787252723131864,56.171906727602455,4181587266,9144689997.889717,26.220754541311926,26.78775587910219,9.022673995470049,71.42857142857143,0
2013-01-30,67.28,67.48,66.87,67.02,65.10794201034595,66.05008200871329,66.28090737340403,66.77055069217549,65.57864045000005,66.52499129999995,65.83492319999998,66.97962449999994,66.97962449999994,67.5160711718732,66.4431778281267,34444960,54.62700076065238,57.400449181318486,NaN,NaN,NaN,NaN,NaN,NaN,-0.043482330383528334,0.3653070504432492,0.4087893808267775,47.18426756660318,54.82170119448636,4147142306,9127185182.152012,26.32522837365355,25.08966531879179,8.424100511630987,64.28571428571429,28.571428571428573
2013-01-31,66.99001,67.35001,66.81,66.87,65.1254749256659,66.06631800854075,66.30400904503524,66.78002205482544,65.58204045000004,66.51349129999994,65.92632319999998,66.96312449999995,66.96312449999995,67.49168524935781,66.43456375064208,34870432,52.90371244795607,56.85758497031473,NaN,NaN,NaN,NaN,NaN,NaN,-0.06359409619148176,0.3292967605874253,0.39289085677890706,36.89535489889451,46.955625062876514,4112271874,9100063591.543839,24.82495749484624,24.293017851961235,7.39791467994971,57.142857142857146,21.428571428571427
2013-02-01,67.34,67.78,67.07001,67.66,65.1506940806344,66.09787606777756,66.35718516091622,66.86382947817539,65.59309045000005,66.49479129999995,66.00391139999998,67.00351949999994,67.00351949999994,67.609746558327,66.39729244167287,53124512,60.05149919944088,56.786180522178526,NaN,NaN,NaN,NaN,60.05149919944088,NaN,-0.02603201029267138,0.3603508439130678,0.3863828542057392,91.08362828216272,58.38775024922014,4165396386,9135230269.095465,26.927014704433965,22.016029523883006,6.9899168186800065,50,14.285714285714286
2013-02-04,67.25,67.4599,66.46001,66.48,65.1639210052052,66.10544287831662,66.36200142911558,66.82727428977773,65.59159045000006,66.46529139999993,66.05751139999998,66.99601949999995,66.99601949999995,67.62387092847999,66.3681680715199,48483696,48.267791955458016,56.079750468901196,NaN,NaN,48.267791955458016,NaN,NaN,NaN,-0.07995160358706593,0.28644334972190677,0.3663949533089727,10.144181962850409,46.041055047969216,4116912690,9088685164.506601,23.76388053569575,25.40126696223588,6.588217338246909,42.857142857142854,7.142857142857143
2013-02-05,66.75999,67.67,66.61,67.46001,65.18676766186982,66.13226598963709,66.4050605887581,66.88753483360843,65.59584050000005,66.45449159999994,66.12811179999999,67.03649949999993,67.03649949999993,67.67431698656729,66.39868201343258,35129984,55.991530115236216,56.145858170780336,NaN,NaN,NaN,NaN,NaN,NaN,-0.050354569026822504,0.30345174202544456,0.35380631105226706,75.18910058797842,58.80563694433051,4152042674,9109896383.713846,23.082978599068888,22.569802109303055,6.501877170827435,35.714285714285715,0
2013-02-06,67.22,67.55,67.03999,67.24001,65.20719793389102,66.15420151459477,66.43780370292446,66.92110389707429,65.60274055000005,66.44259179999993,66.17491219999998,67.07249999999993,67.07249999999993,67.66962306955264,66.47537693044723,43595136,54.0409388749668,55.929031394298754,NaN,NaN,NaN,NaN,NaN,NaN,-0.04642952208101858,0.29576940845099386,0.34219893053201245,58.647498458623254,47.99359366981736,4108447538,9100496259.979174,21.953505016046513,21.465438773042425,5.9127438771544165,28.571428571428573,85.71428571428571
2013-02-07,67.33,67.371,66.56,67.3,65.22802183504633,66.17689059351369,66.47161532241762,66.95718924021007,65.61084060000005,66.42927179999994,66.21729219999997,67.09899999999995,67.09899999999995,67.68704503244876,66.51095496755113,46011200,54.50634874819666,55.57980489294254,NaN,NaN,NaN,NaN,NaN,NaN,-0.04082680710476322,0.2911654216510584,0.33199222875582163,63.15809260289601,65.66489721649923,4154458738,9138451244.936018,20.256166981009653,24.38172811441585,5.4927634064375885,21.428571428571427,78.57142857142857
2013-02-08,67.64,68.13,67.63,67.99001,65.25550430434936,66.21279394809758,66.53116021173457,67.05555312209482,65.62539065000004,66.41357189999994,66.27789219999998,67.14000049999994,67.14000049999994,67.84487237502739,66.43512862497249,39845728,59.576900928524985,55.705384764699595,NaN,NaN,NaN,NaN,NaN,NaN,0.005833191224258849,0.3392837177861452,0.33345052656188634,91.6173150737431,71.14096871175413,4194304466,9155984959.085138,25.846118199264943,22.467225998176573,5.352763706554634,100,71.42857142857143
2013-02-11,68.02,68.06,67.78,68.00999,65.28291212221653,66.24838198872932,66.58915353676458,67.1464518723715,65.64179060000005,66.39187189999994,66.32769199999998,67.17750049999994,67.17750049999994,67.97732311171531,66.37767788828457,17650352,59.7169086654523,55.779103327044716,NaN,NaN,NaN,NaN,NaN,NaN,0.0330080608221609,0.37471060258958744,0.34170254176742654,92.81372942352986,82.52971236672299,4211954818,9167330353.202852,25.1292560972529,21.844080087782555,5.098354261332602,92.85714285714286,64.28571428571429
2013-02-12,67.92,68.05,67.66,67.73,65.3072612553288,66.27772095924954,66.63389261375421,67.2020278845266,65.64819060000005,66.36707179999993,66.36409199999997,67.21599999999994,67.21599999999994,68.04387564295237,66.3881243570475,22061312,56.750546340434106,55.416200144319404,NaN,NaN,NaN,NaN,NaN,NaN,0.02732686098954007,0.3758611180043516,0.34853425701481155,76.04776076503501,86.82626842076934,4189893506,9153188486.536186,24.125545085663543,22.20056783992275,3.967477831849341,85.71428571428571,57.142857142857146
2013-02-13,67.92999,68.23,67.765,67.97,65.3337561682111,66.311231435304,66.68628898184228,67.27516808600026,65.65384060000005,66.34407179999994,66.40749199999998,67.28299999999994,67.28299999999994,68.12706521086324,66.43893478913665,23497136,58.64677066497079,55.881458405471854,NaN,NaN,NaN,NaN,NaN,NaN,0.03447219481337849,0.39162450053153464,0.35715230571815615,85.31065147260696,84.72404722039062,4213390642,9150409255.3964,24.746156838054777,21.04026756419567,4.440767445016459,100,50
2013-02-14,67.64,68.05,67.62,67.95,65.35978844514432,66.34368229797124,66.73584627667199,67.33943779209548,65.65739055000004,66.31957189999994,66.45309199999998,67.33550049999995,67.33550049999995,68.20788764924337,66.46311335075653,24482416,58.41691714492111,56.131441884669194,NaN,NaN,NaN,NaN,NaN,NaN,0.032611219538116853,0.3979163301408022,0.36530511060268533,84.18070158588466,81.84637127450888,4188908226,9163504501.163843,23.60362539556281,21.625734467402154,4.64828305578424,92.85714285714286,42.857142857142854
2013-02-15,67.95,68.11,67.56,67.75,65.38357164469512,66.37153017325895,66.77561701092014,67.37853895475305,65.66234060000005,66.29377189999995,66.49549199999998,67.36200049999995,67.36200049999995,68.25078856931758,66.47321243068232,25334048,56.051127678087305,56.12585443955502,NaN,NaN,NaN,NaN,NaN,NaN,0.01364131254669454,0.3823567512860535,0.36871543873935897,72.88120271865931,80.79085192571698,4163574178,9155673977.23657,22.19225577204732,20.332632064614447,4.599518465657076,85.71428571428571,35.714285714285715
2013-02-19,67.89,68.25999,67.86,68.24001,65.41199391688721,66.40852977378847,66.8330441869625,67.46058381620514,65.66919065000005,66.27467209999995,66.56222819999998,67.42050049999995,67.42050049999995,68.37621158509089,66.464789414909,23433248,60.293940561710606,56.41728100614347,NaN,NaN,NaN,NaN,60.293940561710606,NaN,0.028946027381629214,0.4048979729663955,0.3759519455847663,98.88998766652942,85.31729732369114,4187007426,9176766185.23537,22.598964169182096,19.186981026628146,5.1063572179642644,100,28.571428571428573
2013-02-20,68.24001,68.25,67.17999,67.19,65.42968551970425,66.42400443173325,66.84704245414044,67.4348139289475,65.66984065000004,66.24922209999995,66.59962799999998,67.42100099999995,67.42100099999995,68.37621810209839,66.4657838979015,38200240,49.30883861013638,56.037412281106604,NaN,NaN,NaN,NaN,NaN,NaN,-0.033415339757987994,0.3341827708872813,0.3675981106452693,40.55545061611789,70.77554700043554,4148807186,9139280675.756393,20.046768404433514,24.19727952999474,5.6047732999419635,92.85714285714286,21.428571428571427
2013-02-21,66.96001,67.00999,66.23,66.47,65.44003690756789,66.42491523506527,66.8322564755467,67.34292688809536,65.67044060000003,66.22632219999996,66.63042819999998,67.36500099999995,67.36500099999995,68.40185400797203,66.32814799202787,45855568,43.461492459931804,55.36296799624773,NaN,NaN,NaN,NaN,NaN,NaN,-0.12005058896947485,0.21753487443342578,0.33758546340290063,11.822718338513743,50.42271887372035,4102951618,9121644280.617584,18.074525366715495,31.55232601238231,7.46729466819071,85.71428571428571,100
2013-02-22,66.84,67.14999,66.59,67.13901,65.45694211246771,66.43905572546002,66.84428602552526,67.32350623208627,65.68263565000004,66.21571229999996,66.67080839999997,67.38895149999995,67.38895149999995,68.38070689260343,66.39719610739647,21969536,49.4588994475151,54.60635372825304,NaN,NaN,NaN,NaN,NaN,NaN,-0.1284416814833761,0.17703336154868055,0.30547504303205664,44.77903832038561,32.38573575833908,4124921154,9142752281.571316,18.250023354507448,29.34972388341015,8.416204699458294,78.57142857142857,92.85714285714286
2013-02-25,67.60001,67.81,66.25,66.31,65.46543025065212,66.43650016654003,66.82333363236741,67.22698182903044,65.69038570000004,66.18741229999995,66.67760839999997,67.35445149999995,67.35445149999995,68.44136841161531,66.26753458838459,40927520,43.325829587780504,54.25335641627607,NaN,NaN,43.325829587780504,NaN,NaN,NaN,-0.18265836966420118,0.07715208095180515,0.2598104506160063,3.940906112837914,20.18088759057909,4083993634,9104973032.340548,21.788979008984672,25.03240602584014,8.673122832411904,71.42857142857143,85.71428571428571
2013-02-26,66.42,66.67999,65.96001,66.56,65.47632149193916,66.43894570779666,66.81300682325497,67.16345975007516,65.70058570000005,66.16731219999996,66.69220839999997,67.32495199999995,67.32495199999995,68.46327411035764,66.18662988964226,42088736,45.519830657243325,53.505377883562296,NaN,NaN,NaN,NaN,NaN,NaN,-0.1934793122281048,0.017961310330875335,0.21144062255898013,26.086748580422615,24.935564337882045,4126082370,9133032969.11657,20.304472095341495,26.07107143727773,9.481014538334836,64.28571428571429,100
2013-02-27,66.57001,67.64999,66.47,67.239,65.49386058157161,66.45478836704821,66.82971243802928,67.17065405959181,65.71517570000003,66.15500219999996,66.73076639999998,67.32890199999994,67.32890199999994,68.46545403740758,66.1923499625923,36339456,51.0612267125433,53.292541300532044,NaN,NaN,NaN,NaN,NaN,NaN,-0.1487146341974822,0.025547329812127373,0.17426196400960958,55.608744423864756,28.545466372375092,4162421826,9144058391.910458,26.948946122157473,23.27253127266698,9.92360865827764,57.142857142857146,92.85714285714286
2013-02-28,67.24001,67.74001,67.09,67.10001,65.50984216782463,66.46756503304725,66.84031234242029,67.1639260539164,65.72972575000004,66.13930229999995,66.77896659999998,67.33290249999996,67.33290249999996,68.46563403842204,66.20017096157788,28557152,49.941427498809446,52.96647549700439,NaN,NaN,NaN,NaN,NaN,NaN,-0.1233198645361143,0.02011213333946671,0.143431997875581,49.5656483969425,43.75371380040996,4133864674,9116380786.660568,26.164691246374467,21.879272046771703,9.900573143859976,50,85.71428571428571
2013-03-01,66.86,67.5,66.53999,67.38,65.52845070346817,66.48563305219483,66.86147656428616,67.18450452497198,65.74572580000005,66.12200229999996,66.81556659999997,67.35840249999994,67.35840249999994,68.47108737369183,66.24571762630805,31617696,52.214876796590275,52.440616630437624,NaN,NaN,NaN,NaN,NaN,NaN,-0.08437761826897947,0.037959975039356664,0.12233759330833613,61.73923251506515,55.63787511195747,4165482370,9140094140.99746,23.889892870645152,24.958118611470603,9.55722541874889,42.857142857142854,78.57142857142857
2013-03-04,67.19,67.69,67.07001,67.67999,65.54985905467744,66.50928368482464,66.89357513039259,67.2316936178318,65.76622575000005,66.10530209999996,66.83822239999998,67.35940199999996,67.35940199999996,68.47320410350186,66.24559989649806,19380448,54.594271034113085,52.07471394248483,NaN,NaN,NaN,NaN,NaN,NaN,-0.037516826085702684,0.07544156070120778,0.11295838678691046,74.78238941208197,62.02909010802987,4184862818,9158848777.986057,24.27510326089498,23.53501850703659,9.168244193994964,35.714285714285715,71.42857142857143
2013-03-05,68.10001,68.77,68.08,68.67999,65.58100463622294,66.55226796829346,66.96363061547524,67.36962660660971,65.79277570000005,66.10230199999995,66.88661219999999,67.46940149999996,67.46940149999996,68.64680394750457,66.29199905249536,35589440,61.47983799040385,52.41252048891124,NaN,NaN,NaN,NaN,NaN,NaN,0.056609148394582864,0.18371982228013906,0.1271106738855562,96.79678575368622,77.77280256027778,4220452258,9185152984.668957,31.56414648947077,21.241800168741683,10.267702912764461,100,64.28571428571429
2013-03-06,68.88989,68.908,68.42,68.50999,65.61014876919585,66.59103474119854,67.0242721599664,67.47823264407546,65.82062565000005,66.10390179999996,66.93161219999998,67.52190049999996,67.52190049999996,68.78356574427109,66.26023525572883,29070976,59.81909474566399,52.49625792324647,NaN,NaN,NaN,NaN,NaN,NaN,0.1006300939751193,0.2528982913544553,0.152268197379336,86.49893656355691,86.02603724310836,4191381282,9166803718.21912,31.416724326402836,20.288656904756095,11.22686061405489,100,57.142857142857146
2013-03-07,68.57001,68.8,68.45,68.69,65.6407940550745,66.63259840968966,67.08959482035988,67.59363905892542,65.85602565000005,66.11820979999996,67.00141219999998,67.59439999999995,67.59439999999995,68.94635166932282,66.24244833067708,21775872,61.0198263547467,52.68218000966259,NaN,NaN,NaN,NaN,NaN,NaN,0.1330459916017896,0.318575686881573,0.1855296952797834,92.60513095363271,91.96695109029194,4213157154,9174891899.247692,30.3643651901809,19.609052206520612,12.451792317744657,92.85714285714286,50
2013-03-08,68.92999,69.02,68.5,68.77,65.67193043263595,66.6749231936562,67.15549306269871,67.70567343426586,65.89582565000005,66.13670979999996,67.07541199999997,67.66789999999995,67.66789999999995,69.10499328722547,66.23080671277442,26162112,61.569469285963315,53.076347267368014,NaN,NaN,NaN,NaN,NaN,NaN,0.14980313179410093,0.37278361002240956,0.22298047822830863,91.83003866025706,90.31136872581556,4239319266,9175898134.324615,30.971905006671452,18.611568016237015,13.920029184850335,100,42.857142857142854
2013-03-11,68.67999,68.99001,68.47,68.97,65.70474704524653,66.72037025912836,67.22665019749483,67.82608548814531,65.92812570000005,66.15930969999995,67.16481199999997,67.71689949999995,67.71689949999995,69.25767048355442,66.17612851644549,23194128,62.975050813040475,53.267855142463006,NaN,NaN,NaN,NaN,62.975050813040475,NaN,0.1631839172270585,0.4269603747621318,0.2637764575350733,98.3660077320515,94.26705911531376,4262513394,9197307240.877798,29.363307375938742,17.944565720789107,15.06086494347001,92.85714285714286,35.714285714285715
2013-03-12,68.78999,68.9299,68.39,68.72,65.73474956220926,66.75996688766047,67.28521293484798,67.91122020356005,65.95952570000006,66.17970979999997,67.25121219999997,67.75239999999994,67.75239999999994,69.35020968708889,66.15459031291098,27579248,60.01996502529951,54.03293560068895,NaN,NaN,NaN,NaN,NaN,NaN,0.14465714815058817,0.4445978927233085,0.29994074457272035,90.19604639230856,93.46403092820572,4234934146,9203442206.028381,27.63904436906499,17.70078484388446,15.956475117709074,85.71428571428571,28.571428571428573
2013-03-13,68.8,68.89,68.39,68.63,65.76355802427683,66.79699724632066,67.33794968250099,67.97967542226861,65.98987570000006,66.19430979999996,67.34821219999998,67.79739999999995,67.79739999999995,69.44021216094352,66.15458783905639,34297264,58.94757032274586,55.13908401946138,NaN,NaN,NaN,NaN,NaN,NaN,0.11698366921774755,0.4461703310949048,0.3291866618771572,87.25486031000099,91.93897147812037,4200636882,9202070315.46838,26.21016680086823,16.785693349939315,15.5822756621998,78.57142857142857,21.428571428571427
2013-03-14,68.87,69.00999,68.711,68.86,65.79436839219447,66.83784878599748,67.39763793024605,68.06351585824304,66.02342575000006,66.20170979999996,67.42281019999997,67.84189999999995,67.84189999999995,69.5479997614863,66.13580023851361,31537680,60.8716390801302,55.95427970750531,NaN,NaN,NaN,NaN,NaN,NaN,0.10518292221820669,0.46066531464991556,0.35548239243170887,94.77122474256463,90.74071048162473,4232174562,9201965889.557146,26.42803370875405,16.104295779995876,15.650408631493027,71.42857142857143,14.285714285714286
2013-03-15,68.75,68.78999,68.34,68.50999,65.8213895027199,66.87096049320544,67.44125958004032,68.10603720507703,66.05562565000005,66.20600969999995,67.44900999999997,67.86989949999995,67.86989949999995,69.60038273764478,66.13941626235511,30743664,56.52958880020371,56.89740536553553,NaN,NaN,NaN,NaN,NaN,NaN,0.06669489439913284,0.4388510104306249,0.37215611603149207,83.332952068471,88.45301237367887,4201430898,9194449921.476433,24.936242097909634,19.222550484024605,16.079818116467646,64.28571428571429,7.142857142857143
2013-03-18,67.88499,68.6367,67.73,68.36,65.84664930866298,66.90044642403306,67.47728861611718,68.13022413792683,66.08312565000004,66.21670979999995,67.47916799999997,67.90039949999996,67.90039949999996,69.64281614298744,66.15798285701248,36164496,54.72799882695926,57.55513166337239,NaN,NaN,NaN,NaN,NaN,NaN,0.02611019995913344,0.4047938659804089,0.37868366602127546,74.11764705882364,84.0739412899531,4165266402,9208541590.64683,22.546418585852674,23.827955962667783,15.389024570826452,57.142857142857146,0
2013-03-19,68.53999,68.7,67.62,68.23,65.87036424091508,66.92677421761657,67.50680670960278,68.13972660098142,66.11262565000006,66.24220989999996,67.51116799999997,67.89989899999995,67.89989899999995,69.64193085830287,66.15786714169703,33134576,53.14702450803344,57.70411722019311,NaN,NaN,NaN,NaN,NaN,NaN,-0.012444923081660453,0.3631275121691999,0.37557243525086037,68.14528973673517,75.19862962134327,4132131826,9212836813.461645,20.07809470304852,22.334380528083546,15.246128853955755,50,0
2013-03-20,68.74001,68.86,68.39,68.709,65.89860937284628,66.96206581726773,67.55395154452032,68.19394311517367,66.14587065000005,66.26909989999996,67.55233979999998,67.97584899999995,67.97584899999995,69.71990718507847,66.23179081492144,28035344,57.96538377154744,58.27725695396011,NaN,NaN,NaN,NaN,NaN,NaN,-0.00881350506762224,0.36455555391633254,0.3733690589839548,87.45972798496805,76.57422159350897,4160167170,9222857957.699944,20.420348333632163,20.8971912318634,14.691436435737446,42.857142857142854,7.142857142857143
2013-03-21,68.09,68.25,67.77,67.92999,65.91882211540502,66.98123263276737,67.56869815061756,68.16880472325236,66.18347560000005,66.29449979999995,67.58053959999998,68.04884849999995,68.04884849999995,69.65113674259432,66.44656025740558,30050784,49.118345018869114,58.05607611269432,NaN,NaN,49.118345018869114,NaN,NaN,NaN,-0.05919391684088915,0.2993766629328434,0.3585705797737325,44.10176462443435,66.56892744871253,4130116386,9212839777.583944,18.50862937158202,25.12223318509259,15.617954339887842,35.714285714285715,0
2013-03-22,68.21001,68.64,68.13,68.59,65.94540099982885,67.01308941231653,67.60874920353453,68.2089185591331,66.22207560000005,66.32875979999996,67.61693959999998,68.12139799999994,68.12139799999994,69.68321798403561,66.55957801596428,28838416,55.3379151947854,58.10919355274234,NaN,NaN,NaN,NaN,NaN,NaN,-0.04881706320989504,0.29754925076136374,0.3463663139712588,69.28571428571463,66.94906896503902,4158954802,9236023602.211395,21.088393936459802,23.342740144665644,15.869799468985391,28.571428571428573,0
2013-03-25,68.81,68.96001,68.00999,68.34,65.96922785555195,67.03936486949839,67.6374257053567,68.22140250588232,66.25817560000006,66.36055979999996,67.64033959999999,68.22289799999996,68.22289799999996,69.54630175038056,66.89949424961935,24909760,52.70968303837539,57.48275391331174,NaN,NaN,NaN,NaN,NaN,NaN,-0.05886615279060786,0.27278362298299896,0.3316497757736068,51.42857142857166,54.93868344624021,4134045042,9228419730.29291,22.254990426610885,21.18084647503853,14.650174277063602,21.428571428571427,71.42857142857143
2013-03-26,68.60001,68.73,68.45,68.71001,65.9964993196758,67.0724469512905,67.6794878345584,68.26793655294115,66.28912565000005,66.39415979999995,67.66933999999998,68.33039849999994,68.33039849999994,69.4256526828082,67.23514431719168,19734752,56.03765684399778,57.21265120604987,NaN,NaN,NaN,NaN,NaN,NaN,-0.04148928036577859,0.27978817531638356,0.32127745568216215,77.85785714285707,66.19071428571446,4153779794,9245336641.632338,21.379606158941513,20.34771289804096,13.28952255188913,14.285714285714286,64.28571428571429
2013-03-27,68.25,68.85001,68.14,68.80099,66.02440469957953,67.10667552651248,67.72346831163455,68.31870354789913,66.32178060000005,66.43266969999996,67.70615959999998,68.40849799999994,68.40849799999994,69.39907597884596,67.41792002115392,22539424,56.8418995852924,56.91422786537456,NaN,NaN,NaN,NaN,NaN,NaN,-0.02554575092415068,0.28934526702697383,0.3148910179511245,84.35642857142867,71.2142857142858,4176319218,9264763764.215513,19.84889842475549,22.016891221227077,12.122120194845849,7.142857142857143,57.142857142857146
2013-03-28,68.81,69.06,68.64,68.97,66.05371410555387,67.14357304083896,67.77235190725672,68.38073178143254,66.35228060000004,66.46364079999995,67.75295959999998,68.50199749999993,68.50199749999993,69.3186399163287,67.68535508367115,23669808,58.36563450685354,56.685382524009576,NaN,NaN,NaN,NaN,58.36563450685354,NaN,-0.006298483013277789,0.3070179141845273,0.3133163971978051,93.74999999999976,85.3214285714285,4199989026,9278289368.786942,21.16400562534622,21.056499815506875,10.359712256953973,100,50
2013-04-01,69.00999,69.09,68.31,68.5,66.07805525873243,67.17043298062433,67.80088712657998,68.39209065939134,66.38575565000005,66.49694079999996,67.78495979999998,68.55799749999994,68.55799749999994,69.19249411633504,67.92350088366484,28118832,52.78448649254484,55.9574850725456,NaN,NaN,NaN,NaN,NaN,NaN,-0.026755239261702923,0.2798723481206764,0.30662758738237933,59.86394557823103,79.3234580498865,4171870194,9263869454.940788,19.465784730078102,22.761716671826978,9.193147503468273,100,42.857142857142854
2013-04-02,68.81,69.27,68.77,69.03999,66.10752724620774,67.20745391170107,67.84947939612586,68.45379535849693,66.41815560000005,66.53134059999996,67.8213596,68.62599749999994,68.62599749999994,69.1517102315771,68.10028476842278,29431872,57.77976305770499,55.79747064628885,NaN,NaN,NaN,NaN,NaN,NaN,-0.006509148811152998,0.29849115136843807,0.30500030017959107,86.06000000000036,79.89131519274372,4201302066,9266222827.425909,19.773178460496624,20.972635190629916,7.83773779546818,100,35.714285714285715
2013-04-03,69.08,69.17999,68.24001,68.41,66.13043742286239,67.23126670552877,67.87146059627779,68.44962437197341,66.44955560000005,66.55824059999996,67.84815939999999,68.61249799999993,68.61249799999993,69.14578298585255,68.07921301414731,35131104,51.00050840127336,55.229823366183666,NaN,NaN,NaN,NaN,NaN,NaN,-0.03646319075797205,0.259421311732126,0.29588450249009807,47.87878787878764,64.60091115233969,4166170962,9243798241.370886,17.92132045148881,24.28900538910275,7.349603445482207,92.85714285714286,28.571428571428573
2013-04-04,68.41,68.60001,68.06,68.42999,66.15331854303291,67.2550038004688,67.89336371014925,68.44775443178547,66.47990555000005,66.60084049999996,67.87315939999999,68.60849799999994,68.60849799999994,69.14598207616147,68.07101392383841,32287360,51.19617822135683,54.53871901912843,NaN,NaN,NaN,NaN,NaN,NaN,-0.054748150662011275,0.22744931416258396,0.28219746482459523,49.09030303030323,61.00969696969708,4198458322,9255754507.697805,16.93978291876809,24.78442418995629,6.958781387935194,85.71428571428571,21.428571428571427
2013-04-05,67.35001,67.96001,67.19,67.86099,66.17031029882362,67.26700352719219,67.89209415288849,68.39187210494876,66.50426045000006,66.64785039999997,67.87857919999999,68.56704749999994,68.56704749999994,69.19349916065381,67.94059583934607,55613280,45.61272999283052,53.758943390030346,NaN,NaN,45.61272999283052,NaN,NaN,NaN,-0.10222381189890117,0.15441769995096877,0.25664151184986994,32.2591346153848,43.076075174825235,4142845042,9297064526.738598,14.919172020893711,30.197134256170305,8.453391179994144,78.57142857142857,100
2013-04-08,67.88,68.24001,67.69,68.22,66.19070522122338,67.2858747444755,67.9049532057164,68.37550333304888,66.52746045000006,66.69575049999996,67.90977919999997,68.53954749999994,68.53954749999994,69.17615344808794,67.90294155191194,17898512,49.36500519981125,53.37587241666263,NaN,NaN,NaN,NaN,NaN,NaN,-0.10605046765701243,0.12407842727860441,0.23012889493561683,49.519230769230866,43.62288947163964,4160743554,9313660701.598837,16.859233228113133,28.569295203398077,10.097207622513912,71.42857142857143,92.85714285714286
2013-04-09,68.42,68.96001,68.09,68.67999,66.21547422399728,67.31348098715917,67.93534680549223,68.4045020632347,66.54966540000005,66.74835039999996,67.94337899999998,68.52504699999994,68.52504699999994,69.13440159573592,67.91569240426396,30931360,53.76631983898038,53.420107797444565,NaN,NaN,NaN,NaN,NaN,NaN,-0.0756321546247925,0.13558870165462622,0.21122085627941872,71.63413461538497,51.13750000000021,4191674914,9324681027.410265,22.40171411394653,26.16643435176247,10.270890085978914,64.28571428571429,85.71428571428571
2013-04-10,68.89,70.17,68.88,70.015,66.25328045062417,67.36697641315601,68.01690183272783,68.55788281911711,66.57829045000005,66.81870039999997,68.00067919999998,68.58979699999993,68.58979699999993,69.47914138062532,67.70045261937454,55271264,63.64352772956232,53.825689508731344,NaN,NaN,NaN,NaN,63.64352772956232,NaN,0.030669776349821515,0.2495580767166956,0.2188883003668741,94.79865771812078,71.9840077009122,4246946178,9366670049.67383,30.29877184744556,22.652491505905846,11.219899337563081,100,78.57142857142857
2013-04-11,69.84,70.14999,69.77,69.99001,66.29046183917518,67.41891767230143,68.09427862360124,68.6942758839631,66.61479050000007,66.89620039999997,68.05727939999998,68.65779749999993,68.65779749999993,69.736793880061,67.57880111993886,37238272,63.370611070593185,54.84370851242592,NaN,NaN,NaN,NaN,NaN,NaN,0.0920996406472882,0.33401285117598434,0.24191321052869613,93.96006711409385,86.79761981586653,4209707906,9372552871.506405,29.221033377151585,21.846734042638225,11.168623362651884,92.85714285714286,71.42857142857143
2013-04-12,69.85001,69.99001,69.41,69.94,66.3267756517207,67.4688400946321,68.16665985404825,68.81291627596661,66.64774045000007,66.97530129999997,68.11567939999998,68.71179749999993,68.71179749999993,69.92555228090943,67.49804271909044,32791328,62.79032279078591,55.37602334071166,NaN,NaN,NaN,NaN,NaN,NaN,0.12037767621377282,0.39238530579591213,0.2720076295821393,92.28187919463075,93.68020134228179,4176916578,9399689489.024586,27.606848797147887,24.0685712235633,11.29528912348667,85.71428571428571,64.28571428571429
2013-04-15,69.67999,69.78999,68.48,68.56,66.34899678951452,67.49044722147107,68.18208495781106,68.78882901158885,66.67989045000007,67.03790129999996,68.14947939999998,68.71429799999993,68.71429799999993,69.92658464142467,67.50201135857519,48795792,49.358747517690816,55.13667080351991,NaN,NaN,NaN,NaN,NaN,NaN,0.041243186662866804,0.32356161291072283,0.282318426247856,45.973154362416196,77.40503355704693,4128120786,9356853533.908836,24.011226778304167,29.2301423063121,11.818819485198711,78.57142857142857,57.142857142857146
2013-04-16,68.99001,69.55,68.81,69.47,66.3800515478278,67.52964628639243,68.23259143005376,68.85370243905658,66.71464045000006,67.09479539999995,68.18567939999998,68.76979799999992,68.76979799999992,70.01335322152394,67.5262427784759,27682576,56.037076229877954,55.13662933108278,NaN,NaN,NaN,NaN,NaN,NaN,0.0449814165780017,0.3385451969703581,0.2935637803923564,76.5100671140939,71.58836689038027,4155803362,9378550688.071,21.925867002258904,26.691523035565822,12.342349846910752,71.42857142857143,50
2013-04-17,68.84,68.88901,67.71001,68.11501,66.39731481600862,67.54123764705793,68.22798039358106,68.78335077819405,66.74071555000006,67.13794549999996,68.21837959999998,68.76404849999992,68.76404849999992,70.01854858003583,67.509548419964,60204800,46.25555074778937,54.380461556975426,NaN,NaN,NaN,NaN,NaN,NaN,-0.044182194763773885,0.23833603693763905,0.28251823170141294,31.040604026845607,51.17460850111857,4095598562,9359707964.406878,18.799915542285632,31.796675538328095,13.807249257467832,64.28571428571429,42.857142857142854
2013-04-18,68.33,68.33,66.88,67.16901,66.40499337505331,67.53386680256173,68.18645214285239,68.62960403741366,66.76556060000006,67.17033569999995,68.21255959999998,68.68704899999992,68.68704899999992,70.12171908564103,67.2523789143588,56798112,40.88919550656634,53.13214448552634,NaN,NaN,40.88919550656634,NaN,NaN,NaN,-0.1606992900714173,0.08164411911214131,0.24234340918355862,8.784498480243286,38.778389873727605,4038800450,9325551538.405664,16.68888178427805,34.65392691213133,16.288374477603202,57.142857142857146,100
2013-04-19,67.31,68.231,67.2,68.09,66.42175961012741,67.54487934112487,68.18266970587779,68.57821317670759,66.78521060000007,67.20223579999995,68.22955939999999,68.69504949999991,68.69504949999991,70.11444657567029,67.27565242432954,43066864,47.29950132105596,52.74035983042,NaN,NaN,NaN,NaN,NaN,NaN,-0.16873979417327728,0.03141866646696201,0.2001584606402393,36.77811550151993,25.534406002869606,4081867314,9356838717.005083,15.331043342169906,31.834419006237614,18.230174746617354,50,92.85714285714286
2013-04-22,68.33,69.03999,68.08,68.78999,66.44532409161867,67.56953499773626,68.20648618800023,68.59838239797354,66.80741050000006,67.23832569999996,68.25935919999998,68.70504899999992,68.70504899999992,70.12416272293792,67.28593527706191,34412096,51.59600047945581,52.29866250340219,NaN,NaN,NaN,NaN,NaN,NaN,-0.12208688751707117,0.04754985124390032,0.1696367387609715,58.05440729483295,34.53900709219872,4116279410,9373327659.638903,20.390651201634487,29.498031566754317,19.323863963205266,42.857142857142854,85.71428571428571
2013-04-23,69.2,69.7,68.82001,69.45,66.47522136433888,67.60677192847415,68.25525143552963,68.67948883626177,66.83021050000006,67.28322559999995,68.28855899999999,68.76054899999993,68.76054899999993,70.20481386581407,67.31628413418578,53078208,55.29669315131052,52.60553284269056,NaN,NaN,NaN,NaN,NaN,NaN,-0.045872002529472655,0.11229673559913067,0.15816873812860333,78.11550151975692,57.64934143870326,4169357618,9396247452.202364,24.024626722138752,27.442008564342835,18.720605759252663,35.714285714285715,78.57142857142857
2013-04-24,69.25999,69.67,69.12,69.42,66.5045226442957,67.64267743484099,68.30092784982259,68.75001370899874,66.85266055000007,67.32222559999995,68.31675919999999,68.79604849999991,68.79604849999991,70.26823205880339,67.32386494119643,44500624,55.09051907433279,52.88370004647455,NaN,NaN,NaN,NaN,NaN,NaN,0.0009461729172628996,0.15935145427518194,0.15840528135791904,77.20364741641342,71.12451874366776,4124856994,9400292963.475092,22.982011230078438,26.25108628307925,17.851950008828886,28.571428571428573,71.42857142857143
2013-04-25,69.63,70.05,69.59,69.78999,66.5372138617654,67.68519847573523,68.35932244394719,68.84905907004648,66.88101050000006,67.36102549999995,68.357959,68.84549849999992,68.84549849999992,70.3801392651969,67.31085773480294,26437040,57.20954010749118,53.71204362609318,NaN,NaN,NaN,NaN,NaN,NaN,0.05240904504334715,0.22391658766210298,0.17150754261875584,88.4495440729484,81.25623100303957,4151294034,9396843504.473352,24.879166485270616,24.917169388711986,15.438579476360802,21.428571428571427,64.28571428571429
2013-04-26,69.62,69.77,69.27,69.57001,66.56739093776773,67.72252147621572,68.40680038732181,68.91772106337538,66.90886055000006,67.39872559999995,68.38995919999999,68.8754989999999,68.8754989999999,70.44183402681757,67.30916397318224,24083904,55.53182928214062,54.152531060545265,NaN,NaN,NaN,NaN,NaN,NaN,0.06631539633269729,0.25440178803462743,0.18808639170193014,81.76322188449835,82.47213779128673,4127210130,9401661248.629513,23.804012216139338,26.499811275674094,13.98016117131829,14.285714285714286,57.142857142857146
2013-04-29,69.78,70.48,69.75999,70.21001,66.60363590356108,67.7717786747065,68.47751448977978,69.04079620019678,66.94306060000007,67.44412569999996,68.4351594,68.96099949999991,68.96099949999991,70.61995944413867,67.30203955586116,31663920,59.273828525447676,54.545924538150075,NaN,NaN,NaN,NaN,NaN,NaN,0.11068382236600169,0.32644116965943226,0.21575734729343057,92.5002777777776,87.57101457840811,4158874050,9409578437.998549,27.887273368146765,24.504090167543925,13.887739937936749,100,50
2013-04-30,70.28999,70.73,70.03999,70.72,66.64459475029182,67.83015929500934,68.5654550980237,69.20072037160661,66.98156060000007,67.49502569999996,68.4945594,69.04499999999992,69.04499999999992,70.8729749484698,67.21702505153003,30146320,62.01674733884134,54.429725938812865,NaN,NaN,NaN,NaN,NaN,NaN,0.1632702151992041,0.4198451162924357,0.2565749010932316,99.7402597402596,91.33458646751184,4189020370,9438850964.285414,28.370688361298956,23.084444546475698,13.590116991276748,100,42.857142857142854
2013-05-01,70.71001,70.85001,70.25,70.39,66.68186246421926,67.88084920995965,68.63700587849337,69.31398509812027,67.02136065000006,67.54989369999996,68.53755919999999,69.14399999999992,69.14399999999992,71.03699984475203,67.25100015524781,28539536,59.23660830813906,54.134440027209,NaN,NaN,NaN,NaN,NaN,NaN,0.16427247953008578,0.46191550050583885,0.29764302097575307,88.41287553431863,93.55113768411861,4160480834,9423629656.448278,27.93998722109362,21.89648005846535,13.424863692024541,100,35.714285714285715
2013-05-02,70.50999,71.42999,70.45,71.28,66.72761507651559,67.9481591265941,68.74065270678774,69.501224612585,67.06086065000005,67.60949359999995,68.6193592,69.2865004999999,69.2865004999999,71.36321906211178,67.20978193788802,31744160,63.93265546092475,54.216035217933204,NaN,NaN,NaN,NaN,NaN,NaN,0.21037341076176008,0.5606097844279532,0.3502363736661931,96.7035092384818,94.95221483768667,4192224994,9445656765.134693,30.378837259952952,19.977459423270545,14.411181288202823,100,28.571428571428573
2013-05-03,71.94,72.34,71.91,72.12,66.78127064789355,68.03076983695858,68.87317613005096,69.75063179233881,67.10546065000005,67.68139369999996,68.7323592,69.49945099999991,69.49945099999991,71.80828104367852,67.1906209563213,34061648,67.71325255594752,55.5270712920944,NaN,NaN,NaN,NaN,NaN,NaN,0.2786542589589763,0.6985541973649134,0.41989993840593715,95.970695970696,93.69569358116547,4226286642,9444864633.785856,35.246774026030295,18.224314105673862,15.984932489221862,100,21.428571428571427
2013-05-06,72.25,72.50999,72.19,72.39999,66.83717830313839,68.11728904810792,69.01148255632347,70.00295162163988,67.14981060000005,67.75419359999995,68.8375788,69.70845049999991,69.70845049999991,72.26015568132883,67.156745318671,19244272,68.88403816546145,56.44471143035037,NaN,NaN,NaN,NaN,NaN,NaN,0.32088401518586507,0.8210049573882685,0.5001209422024034,98.04617770191423,96.90679430369732,4245530914,9450878055.32178,35.52706641142102,17.61193955422151,17.692884936510044,100,14.285714285714286
2013-05-07,72.5,72.57001,72.09,72.36,66.8921317528584,68.20130312636321,69.14279696587941,70.22743241957895,67.18966060000005,67.81809359999994,68.9585788,69.89245099999991,69.89245099999991,72.64388178172042,67.1410202182794,25838016,68.5019622535812,58.03374082362121,NaN,NaN,NaN,NaN,NaN,NaN,0.3234199624093639,0.9043958952141082,0.5809759328047444,96.30914532663394,96.77533966641472,4219692898,9454107201.755896,34.01217386076924,17.74928295011116,18.102305895536258,100,7.142857142857143
2013-05-08,72.31,72.77,72.2,72.71001,66.95002108865086,68.29058445059364,69.28268767309983,70.46386837961904,67.22771060000005,67.88689369999994,69.081579,70.0272014999999,70.0272014999999,73.04091426830058,67.01348873169923,24257984,70.06689802105976,60.11786243179931,NaN,NaN,NaN,NaN,NaN,NaN,0.32509540997592956,0.9873451952746564,0.6622497852987268,98.92298025134652,97.75943442663156,4243950882,9473259092.913229,34.067699398319654,16.831470797037333,18.02181262168892,100,0
2013-05-09,72.55,73.099,72.47,72.60651,67.00630456040558,68.37604832285912,69.41303364670375,70.667929486322,67.26956815000005,67.95984779999995,69.1889292,70.15802649999992,70.15802649999992,73.37428111576116,66.94177188423868,29344432,68.9755759618832,61.66615347757268,NaN,NaN,NaN,NaN,NaN,NaN,0.29646077638086565,1.0328257557748088,0.7363649793939432,90.18748754732012,95.13987104176687,4214606450,9456651730.586742,35.12354320671935,15.857030308776194,18.221918990897667,100,0
2013-05-10,72.73,73.08,72.63,73.05,67.06644083343637,68.46860182141637,69.55565977820557,70.89479334476752,67.31751810000006,68.04344779999995,69.307929,70.31352649999991,70.31352649999991,73.764724522052,66.86232847794781,20663680,71.05588780270209,63.05614542923313,NaN,NaN,NaN,NaN,NaN,NaN,0.28456137578147933,1.0920666991207924,0.807505323339313,98.85486995763003,95.98844591876555,4235270130,9474560253.253408,33.54898926794906,15.14617521699528,19.617380996438047,92.85714285714286,0
2013-05-13,72.92999,73.32001,72.86,73.14,67.1268742579793,68.56110475564574,69.69622213984456,71.10862255002776,67.36841805000006,68.11934779999996,69.423129,70.54252649999992,70.54252649999992,74.10396205878853,66.98109094121132,29730016,71.47392041501355,64.21166166235477,NaN,NaN,NaN,NaN,NaN,NaN,0.2605676023315485,1.1332148262537487,0.8726472239222002,95.71405782367194,94.9188051095407,4265000146,9481022513.421318,34.383463019922665,14.467601692732476,22.055133571515622,100,0
2013-05-14,73.13,73.74001,73.13,73.52,67.19048744944219,68.65930070107851,69.84617421279184,71.33827754526321,67.42331810000006,68.18907579999994,69.5399292,70.74502649999991,70.74502649999991,74.49506720770097,66.99498579229885,36017632,73.23182183078292,65.50746900210122,NaN,NaN,NaN,NaN,NaN,NaN,0.2481643397718929,1.1828526486370663,0.9346883088651734,95.07808707363067,96.54900495164422,4301017778,9491059459.149551,36.45612748979159,13.597617955595313,24.8428432521475,100,0
2013-05-15,73.38,73.74001,73.2,73.67,67.25496021113928,68.75852246937399,69.99612816523137,71.56034635047624,67.47481810000005,68.26317079999994,69.63972940000001,71.02277599999992,71.02277599999992,74.77536481407138,67.27018718592846,27214320,73.91515581355245,66.70072726681988,NaN,NaN,NaN,NaN,NaN,NaN,0.22843230500467615,1.2202286901210186,0.9917963851163425,98.43378426446482,96.40864305392249,4328232098,9511217337.442177,34.4794989237655,12.860363564314584,28.099387076232762,92.85714285714286,7.142857142857143
2013-05-16,73.77,74.095,73.55,73.59,67.31799543291899,68.85419529176262,70.13706431561445,71.75364669804993,67.51841810000006,68.33647089999995,69.7413296,71.34382549999992,71.34382549999992,74.81044590298228,67.87720509701757,27253360,72.84706137616087,67.9375295592499,NaN,NaN,NaN,NaN,NaN,NaN,0.18994241755952057,1.2292244070657432,1.0392819895062226,88.35066124414948,93.95417752741501,4300978738,9487964470.653187,36.18552738246349,12.144681635815768,31.269662945932676,100,0
2013-05-17,73.95,74.33,73.7301,74.3,67.3874681151785,68.96203300875742,70.30031669539427,71.99615653633089,67.56581805000006,68.42747089999995,69.8535296,71.65432549999993,71.65432549999993,75.01023573067829,68.29841526932157,31117104,76.14210603892624,69.14240652449836,NaN,NaN,NaN,NaN,76.14210603892624,NaN,0.1916962121821819,1.27890225473395,1.087206042551768,99.30070093076704,95.3617154797938,4332095842,9515969345.548336,35.85225917023012,11.230785505494948,34.543676888072,100,0
2013-05-20,74.09,74.425,73.89,74.19,67.45515499960459,69.0655571075939,70.45285329557488,72.20509400906128,67.61276805000006,68.51867079999995,69.9619296,71.92432599999992,71.92432599999992,75.18248159159634,68.6661704084035,25135776,74.6310415817391,70.0434275418482,NaN,NaN,NaN,NaN,NaN,NaN,0.16581463148892395,1.294474331912923,1.128659700423999,94.37125748502994,94.00753988664883,4306960066,9519023224.875439,34.8507508063538,10.609201071691489,37.618788704721375,100,0
2013-05-21,74.17999,74.53999,73.89,74.27,67.5229644025936,69.16861538269106,70.6025453231994,72.40175172248402,67.66106805000005,68.61637079999996,70.06792960000001,72.16532599999992,72.16532599999992,75.36832979816337,68.96232220183647,25899968,75.01932096400131,71.17076416012408,NaN,NaN,NaN,NaN,NaN,NaN,0.13571591920039872,1.2983045994244975,1.1625886802240988,93.39876136616454,95.69023992732052,4332860034,9523406762.283215,33.69204098629107,9.892814495780469,40.6529081517831,100,0
2013-05-22,74.36,74.95,73.24001,73.619,67.58362147321456,69.25674181075658,70.72083766346609,72.51768012986649,67.70726305000005,68.70856089999995,70.1659096,72.37527599999993,72.37527599999993,75.3749739800384,69.37557801996145,59843168,66.1471749763534,71.32894412551184,NaN,NaN,NaN,NaN,NaN,NaN,0.05759177847823338,1.2345784033218905,1.1769866248436571,56.21710526315788,81.3290413714508,4273016866,9490090021.034622,28.281520013413274,14.408297434832335,41.498777207546254,100,0
2013-05-23,72.95,73.7,72.83,73.45,67.64199339885423,69.33977662638516,70.8278636374478,72.60647249845063,67.74651300000005,68.80526089999995,70.26230960000001,72.55827649999993,72.55827649999993,75.34368433985357,69.7728686601463,48229440,64.03012882572216,71.06586385906716,NaN,NaN,NaN,NaN,NaN,NaN,-0.01590952318095451,1.157099720867464,1.1730092440484186,47.55244755244754,65.72277139392334,4224787426,9510601392.069105,25.994337203732044,17.054371436122516,40.70822063648252,92.85714285714286,0
2013-05-24,72.96001,73.42999,72.75999,73.41,67.69938649936314,69.420375109031,70.92912388695966,72.68299892716962,67.78306295000006,68.88805989999996,70.35330960000002,72.75027599999991,72.75027599999991,75.19367135307208,70.30688064692775,26435952,63.512005882626646,70.68214726743611,NaN,NaN,NaN,NaN,NaN,NaN,-0.07439151953265322,1.0800198446326021,1.1544113641652554,46.153846153845926,49.97446632315047,4198351474,9535459867.410955,24.31479992848128,16.60802493577559,39.64527474430067,85.71428571428571,7.142857142857143
2013-05-28,74.25,74.53999,73.66,73.89,67.76098464364809,69.50888253261455,71.04523667570633,72.79795141029632,67.81926300000005,68.95495989999996,70.46090980000001,72.93427549999993,72.93427549999993,75.1260696227426,70.74248137725725,27065808,66.96638846288492,70.57246342524347,NaN,NaN,NaN,NaN,NaN,NaN,-0.08703924489818715,1.0456123080425215,1.1326515529407086,61.454545454545375,51.72027972027964,4225417282,9522542256.185919,31.875960063133675,14.909127973563008,39.99145686248392,78.57142857142857,0
2013-05-29,73.59,73.8,73.12,73.53999,67.8184871845073,69.5887064428598,71.14307013940413,72.86862175217286,67.85386295000006,69.02183879999995,70.56450960000002,73.07527499999993,73.07527499999993,75.02904388438881,71.12150611561106,32095600,62.33236777059811,70.01999697878193,NaN,NaN,NaN,NaN,NaN,NaN,-0.12306684160387915,0.9788180009358598,1.101884842539739,43.14475806451623,50.2510498909692,4193321682,9530093218.080036,29.650204092487442,18.764945847424165,39.178577490088365,71.42857142857143,0
2013-05-30,73.57001,74.27499,73.55,73.92999,67.87929815779579,69.67467245389228,71.25236111432946,72.96970444244211,67.88941285000006,69.09483869999995,70.67850940000001,73.25227449999991,73.25227449999991,74.8001326145372,71.70441638546262,32390464,65.22035380298041,69.75176682457459,NaN,NaN,NaN,NaN,NaN,NaN,-0.12435365894254424,0.9464427688615586,1.070796427804103,56.03405172413811,53.54445174773326,4225712146,9531656470.449532,31.992486751476896,17.508228051155204,38.569208527376645,64.28571428571429,0
2013-05-31,73.64999,74.21001,73.17,73.25,67.9327379771212,69.74547101916174,71.33069989415968,72.99639925744762,67.92136285000005,69.16083459999996,70.76932940000002,73.35077449999991,73.35077449999991,74.60739036681692,72.09415863318291,38354672,57.012667812772364,68.74867968243674,NaN,NaN,NaN,NaN,NaN,NaN,-0.17179900668879067,0.8560476694431145,1.0278466761319052,22.374783676786766,40.51786448848039,4187357474,9499202460.481627,29.029901407570296,19.270443361875866,37.313058628866806,57.142857142857146,0
2013-06-03,73.31,73.39999,72.42999,73.38,67.98693958928915,69.81744189006943,71.41106460419263,73.03293266150023,67.95316285000004,69.22943459999996,70.87832960000001,73.41377449999993,73.41377449999993,74.53645748674552,72.29109151325434,47613024,58.098329299191725,67.7932803170209,NaN,NaN,NaN,NaN,NaN,NaN,-0.19360522932334212,0.7858401394777275,0.9794453688010696,37.69865992595236,38.70249844229244,4234970498,9544853042.523357,26.559530483733802,24.1226365815157,34.7444627237312,50,100
2013-06-04,73.52,73.82001,72.7,73,68.03682078740567,69.88046284274132,71.47337579618508,73.02979621754783,67.98291285000005,69.29173459999997,70.96652960000002,73.44377499999993,73.44377499999993,74.48565168829246,72.4018983117074,35256032,53.81955874316708,66.40669009647691,NaN,NaN,NaN,NaN,NaN,NaN,-0.23030396989373947,0.6915654064338952,0.9218693763276347,22.61935468510032,27.564266095946504,4199714466,9528484001.889505,27.606567717767156,21.81433074767452,32.319626128000124,42.857142857142854,92.85714285714286
2013-06-05,72.77,73.03999,71.99001,72.05,68.07675291887428,69.92342397456822,71.49598851006017,72.93648229206708,68.00706285000005,69.34053459999997,71.04072960000002,73.42827499999993,73.42827499999993,74.54099874541348,72.31555125458638,48654176,44.91398958221166,64.33517822280972,NaN,NaN,NaN,NaN,NaN,NaN,-0.3102644026108121,0.5340388730641195,0.8443032756749316,2.0266960361352235,20.78157021572932,4151060290,9485389482.298656,25.174512381489517,25.84961769272775,29.15213896274749,35.714285714285715,100
2013-06-06,72.14999,72.41,71.47,72.39999,68.11977020326358,69.9724648859629,71.53143954888134,72.8853877880607,68.02896280000006,69.39193459999996,71.11452920000002,73.41277399999993,73.41277399999993,74.5727249023249,72.25282309767496,62524016,48.307621805505626,62.582361110620056,NaN,NaN,NaN,NaN,NaN,NaN,-0.3294792877158782,0.4324541660300838,0.761933453745962,26.723850574712717,17.123300431982752,4213584306,9546581869.787678,23.203681146764474,28.156775360614162,26.28791703585606,28.571428571428573,100
2013-06-07,72.73,73.47,72.52,73.39,68.17221030074354,70.0401388486171,71.60432427245462,72.93344609395967,68.05431275000005,69.45623449999995,71.20630940000002,73.45194849999993,73.45194849999993,74.55169344019194,72.35220355980792,31971152,56.47576322362513,61.17762233809855,NaN,NaN,NaN,NaN,NaN,NaN,-0.2680172332461619,0.42691191218825963,0.6949291454344215,55.17241379310344,27.97432013465046,4245555458,9573168406.713993,29.846494968339744,25.69120443254618,23.087075017372996,21.428571428571427,92.85714285714286
2013-06-10,73.55,73.75999,73.25999,73.42,68.22442711367147,70.10706679220884,71.67552724216227,72.97978456120161,68.07931275000004,69.52413449999996,71.29530940000002,73.47044849999993,73.47044849999993,74.55486611119969,72.38603088880018,25393168,56.69904872777557,59.89676570567258,NaN,NaN,NaN,NaN,NaN,NaN,-0.21986510843226448,0.4200977598940909,0.6399628683263554,56.034482758620705,45.97691570881229,4270948626,9564027881.960712,31.03465569517817,24.606883004700737,20.103292504254476,14.285714285714286,85.71428571428571
2013-06-11,72.67,73.34,72.44,72.69,68.26886067472947,70.15821398444233,71.71531048756768,72.95218603156336,68.10201280000005,69.58203459999996,71.37910940000002,73.44794849999994,73.44794849999994,74.57662794318762,72.31926905681226,40281424,49.979943881325696,58.10823877119575,NaN,NaN,NaN,NaN,NaN,NaN,-0.2305799110659834,0.3517379794938762,0.5823178905598596,35.05747126436774,48.75478927203063,4230667202,9546125026.849602,28.496029904704457,29.43842908613777,16.319172188670738,7.142857142857143,78.57142857142857
2013-06-12,73.12,73.14,71.74001,71.85001,68.30449400134907,70.19171489564148,71.72059282138855,72.84721688570018,68.11911290000006,69.62833469999995,71.43530980000003,73.36444899999994,73.36444899999994,74.68946666995762,72.03943133004225,42081840,43.58022300330759,56.496313630263906,NaN,NaN,43.58022300330759,NaN,NaN,NaN,-0.2841234423069944,0.22716358767611666,0.511287029983111,12.378216215687937,34.49005674622546,4188585362,9510656094.656086,25.31079749091693,31.736722735502642,14.802488617035133,0,71.42857142857143
2013-06-13,71.75999,72.92,71.55,72.75999,68.34882729486799,70.24257182840105,71.76135349505958,72.83890956325254,68.14356285000005,69.68523449999996,71.52230960000001,73.31894849999993,73.31894849999993,74.66125714465565,71.97663985534422,28230368,50.91308368135939,55.559381834238,NaN,NaN,NaN,NaN,NaN,NaN,-0.24937777857628773,0.19956480676275135,0.4489425853390391,42.019355111905945,29.81834753065387,4216815730,9532292095.964582,22.643449529044943,29.853790411329083,14.300175099271897,14.285714285714286,64.28571428571429
2013-06-14,72.75999,72.84,72.17101,72.28,68.38794344118772,70.28291694070994,71.7816925736847,72.78568008103801,68.16351290000006,69.73623459999996,71.59930980000001,73.25344849999992,73.25344849999992,74.66263993892048,71.84425706107936,27697008,47.41265398075073,54.40942812696115,NaN,NaN,NaN,NaN,NaN,NaN,-0.24925183876581436,0.13737778688177116,0.3866296256475855,26.384450763683308,26.92734069709239,4189118722,9513619727.800514,21.454467405080493,28.286201379184444,13.936049656357634,7.142857142857143,57.142857142857146
2013-06-17,72.88,73.39999,72.60001,72.98,68.43363554625053,70.33632452604242,71.82868502177548,72.80418673998678,68.18641295000006,69.79013459999996,71.70169000000001,73.18744849999993,73.18744849999993,74.51571704194389,71.85917995805598,32443504,52.53763079930712,53.37880257956274,NaN,NaN,NaN,NaN,NaN,NaN,-0.19495917269880403,0.14293065977408048,0.3378898324728845,53.83263398443499,40.74547995334141,4221562226,9511997512.04512,23.923120804688892,25.839937009914326,11.620793645372794,0,50
2013-06-18,73.07001,73.72,73.06,73.58,68.4848431527555,70.40055572354653,71.89736404052938,72.87807371713089,68.21231300000005,69.85933459999995,71.80889000000002,73.15694849999993,73.15694849999993,74.4180487154954,71.89584828450445,24861264,56.45493657717937,52.95898606574712,NaN,NaN,NaN,NaN,56.45493657717937,NaN,-0.11549937825866613,0.19351560964955183,0.30901498790821796,75.22308457427644,51.81338977413157,4246423490,9526311573.136028,25.04316830245652,24.342020385896316,10.116264219048634,7.142857142857143,42.857142857142854
2013-06-19,73.57001,73.67999,72.67999,72.75999,68.52738192735495,70.44727719436739,71.93119250952823,72.86682764883271,68.23411300000006,69.91693449999997,71.89049000000001,73.08144799999992,73.08144799999992,74.24390700286249,71.91898899713736,43145072,50.339850647592556,51.89609298321942,NaN,NaN,NaN,NaN,NaN,NaN,-0.11478920339973597,0.165528483658548,0.28031768705828397,47.07975518337539,58.7118245806956,4203278418,9490069712.656029,23.094831841094884,25.404676982926926,8.366400603750687,0,35.714285714285715
2013-06-20,71.92,72.16,70.78999,71.02499,68.55223374897331,70.45871705190467,71.8956551562134,72.69141453942007,68.25068790000006,69.95568449999996,71.91068980000001,72.95174749999993,72.95174749999993,74.39120348235794,71.51229151764191,60908384,40.37486389845363,50.707678417910934,NaN,NaN,NaN,NaN,NaN,NaN,-0.22160588940276807,0.003310325304823891,0.22491621470759196,7.755724384657525,43.35285471410311,4142370034,9450056753.127382,19.822974123089164,35.397326120996176,8.937704924086837,0,100
2013-06-21,70.78,70.97,69.84,70.42999,68.57091789077457,70.4581481993917,71.83817809126386,72.47604077376101,68.26203785000006,69.98838439999996,71.91948940000002,72.80074699999992,72.80074699999992,74.59044808905333,71.0110459109465,51565552,37.6242193612209,49.24524199377016,NaN,NaN,NaN,NaN,NaN,NaN,-0.31696160006580487,-0.1712857853746641,0.14567581469114074,14.823832100924403,23.219770556319105,4090804482,9452337502.055666,18.15668869950157,39.16072386459526,11.211771560226657,7.142857142857143,100
2013-06-24,69.84,70.27,69.14999,69.73,68.58245104609024,70.44372942316612,71.75550444062605,72.21451308102186,68.27023785000004,70.01548439999996,71.91528940000002,72.61674699999992,72.61674699999992,74.82565296725137,70.40784103274846,41492208,34.63474427746742,47.874898103363044,NaN,NaN,34.63474427746742,NaN,NaN,NaN,-0.40611288642382615,-0.3619652933386419,0.044147593085184206,12.581561822125847,11.720372769235928,4049312274,9453819723.859114,16.53942460251198,40.47421631315183,13.373242858586815,0,100
2013-06-25,70.41,70.52,69.81,70.24001,68.59894417000974,70.43969537518264,71.6960732860917,72.0264651685436,68.28133790000005,70.04918449999995,71.94888960000002,72.43424749999993,72.43424749999993,74.7904271228607,70.07806787713915,28897392,38.47076126135888,47.41466750901642,NaN,NaN,NaN,NaN,NaN,NaN,-0.40855691544501194,-0.46654855122108074,-0.05799163577606879,23.644685466377346,17.016693129809198,4078209666,9459925620.687057,17.38377053728811,38.211942254010765,15.954708526870604,21.428571428571427,92.85714285714286
2013-06-26,70.82001,71,70.59,70.87,68.6215417404574,70.4482162588424,71.66367825526457,71.9163256286823,68.28803790000006,70.08128449999997,71.97688960000002,72.30074799999993,72.30074799999993,74.69347337123956,69.90802262876029,23746656,42.92638572872003,47.03029350353173,NaN,NaN,NaN,NaN,NaN,NaN,-0.34793836816863344,-0.4929145959868606,-0.14497622781822717,37.310412147505474,24.512219812002886,4101956322,9468613421.662668,19.88937555711082,36.12031739416295,17.33578134855992,14.285714285714286,85.71428571428571
2013-06-27,71.22,71.62,71.13,71.17,68.6468995340847,70.46250900619205,71.64431832368557,71.84524699737922,68.29673795000006,70.12818449999996,72.03798940000001,72.16274849999994,72.16274849999994,74.48089249103104,69.84460450896883,23546416,44.969999575675836,46.20845324296392,NaN,NaN,NaN,NaN,NaN,NaN,-0.2712373131711324,-0.48402286928214266,-0.21278555611101027,43.81800433839478,34.92436731742586,4125502738,9448911318.478994,23.340563224130175,34.13459944239578,18.14281144888458,7.142857142857143,78.57142857142857
2013-06-28,70.92,71.69,70.78999,71.27,68.6730000362331,70.47849892686152,71.62963917373712,71.79046156905738,68.31038800000006,70.16628439999995,72.12000920000001,72.06374849999993,72.06374849999993,74.35668643530451,69.77081056469535,28301072,45.668360133031655,45.42054691476793,NaN,NaN,NaN,NaN,NaN,NaN,-0.20062217801056875,-0.4635632786242212,-0.26294110061365245,46.38961402710268,42.50601017100097,4153803810,9450798350.101665,21.79231654318442,34.376307797611865,18.917942851819358,0,71.42857142857143
2013-07-01,71.75999,72.3,71.64,71.71001,68.7032190408477,70.50288528474545,71.63279097084546,71.78279951486144,68.32678810000006,70.21098439999997,72.19240940000002,71.98024899999993,71.98024899999993,74.19569439363644,69.76480360636342,24951296,48.75026374324526,45.33271261919076,NaN,NaN,NaN,NaN,NaN,NaN,-0.11536743917102377,-0.40715039957743215,-0.2917829604064084,56.01782052993312,48.74181296514352,4178755106,9431140509.35306,24.621144677234533,31.77833533897904,19.708193353879498,35.714285714285715,64.28571428571429
2013-07-02,71.67999,72.1796,71.35001,71.74001,68.73343586631191,70.5273828038594,71.63699563865545,71.77872432296988,68.34232815000006,70.25538449999996,72.25140980000002,71.91724949999993,71.91724949999993,74.08424905680832,69.75024994319153,23069568,48.962830921078755,45.717184613317265,NaN,NaN,NaN,NaN,NaN,NaN,-0.0513090092600576,-0.3559192219814804,-0.3046102127214228,56.67427423572372,53.02723626425317,4201824674,9429761490.949848,23.10646830248433,31.973812168291182,20.053534953010907,28.571428571428573,57.142857142857146
2013-07-03,71.48,72.37,71.42,72.03101,68.76624754923418,70.55715759982257,71.6524471822376,71.80275153030608,68.35468320000005,70.29579449999997,72.30303000000002,71.91629999999992,71.91629999999992,74.08308268966458,69.74951731033526,18847424,51.082299690409364,45.72927147110655,NaN,NaN,NaN,NaN,NaN,NaN,0.012879289974996655,-0.288511100252677,-0.30139039022767367,63.041875181892266,58.577989982516364,4220672098,9435158202.819826,22.89037675723067,29.719095481518448,19.999628727184152,21.428571428571427,50
2013-07-05,72.45,72.61,71.86,72.58,68.80419533481394,70.59721388497461,71.68882180254201,71.87677519408645,68.36668325000007,70.34149459999996,72.36623000000003,71.92530049999992,71.92530049999992,74.10152004844012,69.74908095155972,28796000,54.888436963213834,46.263255969853915,NaN,NaN,NaN,NaN,NaN,NaN,0.09021909665562466,-0.18861651940814284,-0.2788356160637675,75.054759179958,64.92363619919132,4249468098,9461650522.819826,23.405644790921425,28.038092932484837,19.66178428504287,14.285714285714286,42.857142857142854
2013-07-08,72.94,72.99001,72.38,72.64999,68.84246194839788,70.63786291695531,71.72651467303056,71.95041469941155,68.37888315000005,70.39069449999997,72.42343000000002,71.88829999999993,71.88829999999993,73.98744778522803,69.78915221477183,20563728,55.365249613438465,46.46522874229187,NaN,NaN,NaN,NaN,NaN,NaN,0.1409734444125501,-0.10261881054807986,-0.24359225496062997,76.58626567556752,71.56096667913926,4270031826,9459289778.1241,25.241468484732682,26.71454132103266,19.589166069948572,7.142857142857143,35.714285714285715
2013-07-09,72.98,73.25,72.64999,73.09,68.88472600861283,70.6864200869166,71.7799846858529,72.05894663280093,68.39298315000006,70.44189449999996,72.49382980000001,71.87179999999992,71.87179999999992,73.92726297077614,69.8163370292237,26115184,58.346014312015264,46.60030572335158,NaN,NaN,NaN,NaN,NaN,NaN,0.1956964197550164,0.0010282697331405188,-0.19466815002187587,86.97593818984548,79.53898768179033,4296147010,9471477096.121866,26.102926174958707,25.442340453386347,19.57929541497951,0,28.571428571428573
2013-07-10,73,73.62,72.98,73.50999,68.93074853589032,70.7423323624232,71.84782803150573,72.19714123920083,68.40853315000005,70.49749439999997,72.55982940000001,71.91279949999992,71.91279949999992,74.0624616212298,69.76313737877004,25598896,61.02171999757208,47.36329639120726,NaN,NaN,NaN,NaN,NaN,NaN,0.24831452383455713,0.11572500477132053,-0.1325895190632366,97.53893168024227,87.03371184855176,4321745906,9488275571.656366,27.74757887778066,24.122744856685742,19.738270148445782,0,21.428571428571427
2013-07-11,74.28999,75.03,74.25,74.97,68.99084059025957,70.8260485532663,71.97026614791727,72.46122302594361,68.43173315000006,70.56969439999996,72.64482940000002,72.06879899999993,72.06879899999993,74.59708109158368,69.54051690841618,47777680,68.5781279677566,49.377815253300334,NaN,NaN,NaN,NaN,NaN,NaN,0.36266069511645355,0.32073634983233035,-0.04192434528412321,98.97959357211974,94.49815448073582,4369523586,9528702839.348673,35.36221820022353,21.297457001916165,19.49678414468712,100,14.285714285714286
2013-07-12,75.02,75.35001,74.82001,75.3,69.05361829582912,70.91464165122143,72.10084394603817,72.7315827377585,68.45748320000006,70.64029429999997,72.74302940000003,72.19579949999992,72.19579949999992,75.08028850282375,69.3113104971761,31417856,69.99406108640135,51.689946805098934,NaN,NaN,NaN,NaN,NaN,NaN,0.43676143242922216,0.5040274452524045,0.06726601282318234,99.1933896987429,98.57063831703498,4400941442,9554191612.410711,36.416104656659094,20.40026400545997,18.89275972568236,100,7.142857142857143
2013-07-15,75.36,75.52,75.17,75.47,69.11746288990048,71.00484676703883,72.2329677128602,72.9923843817815,68.48615820000005,70.72309429999997,72.82682940000002,72.35529949999992,72.35529949999992,75.57417751033452,69.13642148966531,19790960,70.72589737468257,54.26788631204287,NaN,NaN,NaN,NaN,70.72589737468257,NaN,0.4705463344550823,0.6554489308920353,0.18490259643695295,99.12434325744313,99.09910884276859,4420732402,9568328012.410711,36.769596392529955,19.806859812643655,18.035699351478517,100,0
2013-07-16,75.53999,75.59,75.17999,75.37,69.17967718950347,71.09128544491925,72.35598858686568,73.21882396446898,68.51920825000006,70.81209429999996,72.89182940000002,72.47479949999992,72.47479949999992,75.94520125245081,69.00439774754902,31747088,69.64977368728411,56.49495862818038,NaN,NaN,NaN,NaN,NaN,NaN,0.4589877520708138,0.7586372865254702,0.2996495344546564,95.60000000000002,97.97257765206201,4388985314,9566005885.708632,36.07237478706275,19.105743839375773,17.556071488168122,100,0
2013-07-17,75.60001,75.74001,75.35001,75.56,69.24316298861288,71.17977484204957,72.4816360932631,73.44179311071004,68.55600825000006,70.89630419999997,72.95502960000003,72.57379949999992,72.57379949999992,76.2702685069592,68.87733049304065,24631504,70.5661402320435,58.4692268069892,NaN,NaN,NaN,NaN,NaN,NaN,0.43707566867224346,0.8459941202949608,0.40891845162271734,96.36344903656963,97.02926409800426,4413616818,9567899353.631504,36.15606449326801,18.437208689137968,17.804450537875752,100,0
2013-07-18,75.53999,75.74001,75.25,75.37,69.30412654096499,71.26274959765254,72.59490526607632,73.62543186207098,68.58715825000007,70.98690419999997,73.01522960000003,72.7042999999999,72.7042999999999,76.59693094374482,68.81166905625498,36278800,68.34389639785651,60.13879086571639,NaN,NaN,NaN,NaN,NaN,NaN,0.38457598292738493,0.8896384302819484,0.5050624473545635,92.52508070674475,94.82950991443813,4377338018,9549389399.16527,34.521597337584474,18.526380876819747,18.616736906177497,92.85714285714286,7.142857142857143
2013-07-19,74.72,74.74001,74.37,74.59,69.35672229677628,71.32863574423368,72.6731442752498,73.7172954942547,68.61725820000007,71.06720419999998,73.05282940000004,72.88255049999991,72.88255049999991,76.77775770680982,68.98734329319,37734064,59.99150582156546,61.16187270061166,NaN,NaN,NaN,NaN,NaN,NaN,0.2771277527813121,0.8514721383312036,0.5743443855498915,73.80387243735775,87.56413406022403,4339603954,9556527063.388832,31.401780750038316,24.804912754062435,17.854797626926153,85.71428571428571,0
2013-07-22,74.87,74.98,74.58,74.81,69.4109837664601,71.39757365028846,72.75694253896549,73.82136259003997,68.64895820000007,71.14291419999998,73.09689920000004,73.1015509999999,73.1015509999999,76.91216722598791,69.29093477401189,21135856,61.42351713909382,62.067105086029414,NaN,NaN,NaN,NaN,NaN,NaN,0.20405748692070413,0.8294162442007718,0.6253587572800676,78.81526195899782,81.7147383677001,4360739810,9559697441.788832,32.473294258251215,23.875444995140604,18.038234066079468,78.57142857142857,7.142857142857143
2013-07-23,74.95,74.96001,74.2,74.25999,69.45923258470428,71.45425516216395,72.81588557665312,73.86313662908378,68.67690815000006,71.21451399999998,73.12109900000003,73.3280504999999,73.3280504999999,76.83668454788582,69.81941645211398,24748784,56.02461207559455,62.57151802563768,NaN,NaN,56.02461207559455,NaN,NaN,NaN,0.10675979953617853,0.7588085067002908,0.6520487071641122,65.74035708250682,72.7864971596208,4335991026,9538855657.833988,30.1607860622071,25.735796018333733,17.453765699164617,71.42857142857143,0
2013-07-24,74.99001,75.02,74.33,74.5,69.50938947440872,71.514566941131,72.88192927952946,73.92379028345675,68.70385815000006,71.28571399999998,73.14829900000004,73.5410499999999,73.5410499999999,76.78088518626616,70.30121481373364,24426800,57.76901056267927,63.049140230799814,NaN,NaN,NaN,NaN,NaN,NaN,0.049551242843904664,0.7139877607189931,0.6644365178750884,68.04106174984089,70.86556026378184,4360417826,9526465252.036886,28.574718856866806,23.90268681727809,17.162545888335888,64.28571428571429,0
2013-07-25,74.89,75.06,74.46001,74.97,69.56372390749918,71.5829913581383,72.96381440582242,74.02342930407993,68.73195810000006,71.35861409999998,73.17729900000003,73.7460499999999,73.7460499999999,76.79726451788746,70.69483548211234,23167344,61.029101020917544,63.487759092064366,NaN,NaN,NaN,NaN,NaN,NaN,0.03503323088428978,0.7082280564804506,0.6731948255961608,77.08310391933361,70.28817425056043,4383585170,9542682276.998236,27.32380353663597,22.537874075222604,17.204940882466495,57.142857142857146,0
2013-07-26,74.67,75.38,74.55,75.37,69.62149779896686,71.65798162827417,73.05817462520193,74.15167413226278,68.76390810000005,71.42551419999998,73.21129900000004,73.9560499999999,73.9560499999999,76.84287282694383,71.06922717305598,20885520,63.60421414252979,64.07625655842803,NaN,NaN,NaN,NaN,NaN,NaN,0.043486799199691006,0.7275533245957746,0.6840665253960836,88.02564384696558,77.71660317204669,4404470690,9563064531.456068,28.20421472057869,20.771011555243884,18.086529812205516,50,0
2013-07-29,75.22,75.53999,75.02991,75.23,69.67730379101694,71.72871466533805,73.14334424774303,74.25437183395205,68.79830805000005,71.49271429999997,73.24409900000005,74.1540499999999,74.1540499999999,76.81084258395653,71.49725741604327,20970304,62.05856698941361,64.3414388925279,NaN,NaN,NaN,NaN,NaN,NaN,0.03133470530466975,0.7232349070269208,0.6919002017222511,81.5214437628851,82.21006384306142,4383500386,9558546345.270372,28.360153299436146,19.746482136843653,19.27394452082023,42.857142857142854,0
2013-07-30,75.5,75.95,75.35001,75.63,69.73653459906652,71.80596784028185,73.24086015959624,74.38538404024233,68.84016205000006,71.56211429999998,73.27069900000004,74.3500494999999,74.3500494999999,76.82914267984351,71.87095632015628,24104512,64.69816836251167,64.60404234716644,NaN,NaN,NaN,NaN,NaN,NaN,0.04129453470630773,0.7435183701051358,0.702223835398828,81.7142857142853,83.75379110804532,4407604898,9556938949.271906,30.35400933815312,18.369161653116304,20.531771540937402,100,0
2013-07-31,75.77,76.2099,75.63,75.77,69.79656908066785,71.8844635266129,73.34004211412187,74.51725222688592,68.88441205000005,71.63211429999997,73.30229900000003,74.5515489999999,74.5515489999999,76.79304079042177,72.31005720957802,25007600,65.6002232575307,64.3913348678646,NaN,NaN,NaN,NaN,NaN,NaN,0.04790486734587873,0.7621049195811764,0.7142000522352977,78.11333897208776,80.44968948308605,4432612498,9544006065.602308,31.17915470217609,17.32123833806145,20.799597426581744,100,57.142857142857146
2013-08-01,76.3,76.64999,76.21001,76.53999,69.8636677962831,71.97665216965028,73.46553026650925,74.70989391956344,68.93356195000005,71.70781419999997,73.34769880000003,74.7769979999999,74.7769979999999,76.86053647867216,72.69345952132765,16879936,70.12217967289723,64.40048619547144,NaN,NaN,NaN,NaN,NaN,NaN,0.09216458089114288,0.8294057783492264,0.7372411974580835,95.51018575586025,85.11260348074443,4449492434,9552445649.94996,32.78508477289629,15.844112808014565,21.27447305166341,100,50
2013-08-02,76.56,76.99001,76.3801,76.97,69.93437756945441,72.07553034450869,73.60296045213633,74.92514211770026,68.98501200000004,71.79031419999997,73.41471880000003,74.99649799999989,74.99649799999989,77.03240151051293,72.96059448948685,18105232,72.31121514294601,64.51372317891884,NaN,NaN,NaN,NaN,NaN,NaN,0.1357952386110748,0.906985245721927,0.7711900071108522,99.28279826954028,90.96877433249608,4467597666,9569362884.72965,34.15932148065852,14.895957271905495,21.93780997227236,100,42.857142857142854
2013-08-05,76.89,77.08,76.78,77.02,70.00488127523099,72.17344063471644,73.73696200303294,75.124652392205,69.03426200000004,71.87421419999997,73.48611880000003,75.2149984999999,75.2149984999999,77.13114706942314,73.29884993057665,15462781,72.56293511228765,64.72180613784766,NaN,NaN,NaN,NaN,72.56293511228765,NaN,0.15218356990790838,0.9614194694957376,0.8092358995878293,97.91666666666659,97.56988356402236,4483060447,9578640553.32965,34.031421923880885,14.438271872085284,22.62885767329365,100,35.714285714285715
2013-08-06,76.92,76.99001,76.25,76.56,70.07010633716898,72.26030319640523,73.84766937546303,75.26135216437595,69.07646200000005,71.95121419999997,73.54911880000003,75.38849849999988,75.38849849999988,77.1234043827818,73.65359261721797,23680560,66.56714761713116,64.43616380821106,NaN,NaN,NaN,NaN,NaN,NaN,0.11774396968088752,0.9564158616889387,0.8386718920080511,81.94444444444456,93.04796979355046,4459379887,9574800194.408014,31.367436625451926,18.69615678098117,22.118447153967193,92.85714285714286,28.571428571428573
2013-08-07,76.36,76.56799,75.87,76.42,70.13328935868968,72.34267343013978,73.94854508622919,75.37169957729253,69.11816200000004,72.03031429999997,73.59971880000003,75.5339989999999,75.5339989999999,77.09356851499015,73.97442948500964,20281120,64.81188961442334,64.1838776093944,NaN,NaN,NaN,NaN,NaN,NaN,0.07340507752562642,0.9304282389150842,0.8570231613894578,77.08333333333341,85.64814814814817,4439098767,9586481182.747675,29.140576082334498,21.23385533334546,21.085843042102596,85.71428571428571,21.428571428571427
2013-08-08,76.84,76.98,76.3,76.8,70.19962478795645,72.43093732261227,74.06036684755354,75.50772818897896,69.16571205000005,72.11471429999997,73.66491900000003,75.6254989999999,75.6254989999999,77.25513110697374,73.99586689302608,19993952,67.32997646670083,64.70805408404694,NaN,NaN,NaN,NaN,NaN,NaN,0.05820369912939216,0.9297777853011979,0.8715740861718058,90.27777777777773,83.10185185185189,4459092719,9595890101.33591,31.320630758134243,19.761923807765157,21.86375035212035,78.57142857142857,14.285714285714286
2013-08-09,76.7,76.94,76.27,76.49001,70.26221568558873,72.51131499939223,74.1556469711789,75.60127883764763,69.21976215000005,72.19731439999997,73.71611940000003,75.6849994999999,75.6849994999999,77.34927877347087,74.02072022652894,18569824,63.34750178880532,64.84548155902633,NaN,NaN,NaN,NaN,NaN,NaN,0.017895823383229592,0.8939438654008427,0.8760480420176131,79.51423611111107,82.29178240740738,4440522895,9589515939.957523,29.174699905546696,18.71472023609225,22.334011860074238,71.42857142857143,7.142857142857143
2013-08-12,76.2,76.80991,76.19,76.67,70.32597473349333,72.59366519742406,74.25424905074051,75.7030618054907,69.27301215000006,72.27692439999997,73.78451940000002,75.7449994999999,75.7449994999999,77.45970814583606,74.03029085416375,20515856,64.65475852874631,65.4619205913943,NaN,NaN,NaN,NaN,NaN,NaN,-0.004806722340025105,0.8700396390925818,0.8748463614326069,85.09090909090922,84.96097432659933,4461038751,9600771182.600874,27.310255209902838,18.343449330305035,23.171478199362465,64.28571428571429,0
2013-08-13,76.77,77.27,76.22,77.10001,70.39337806947847,72.68289974797011,74.36584751933893,75.83610449068206,69.33156220000005,72.36862459999998,73.85891960000002,75.83149999999992,75.83149999999992,77.63410427163384,74.028895728366,23916976,67.62556504214895,66.16596019707072,NaN,NaN,NaN,NaN,67.62556504214895,NaN,0.0006821644843479913,0.8756990670380418,0.8750169025536938,93.95051227940318,86.18521916047449,4484955727,9616944069.552797,29.033680939660726,16.428385185367326,24.51605840627288,100,0
2013-08-14,77.07001,77.17999,76.7,76.81,70.45722505386178,72.76462450543605,74.4616966362276,75.92885644395044,69.38979220000004,72.45082459999998,73.93511960000002,75.89399999999992,75.89399999999992,77.74075584745654,74.0472441525433,29920960,63.73476506176565,66.35922191427416,NaN,NaN,NaN,NaN,NaN,NaN,-0.02239839053936321,0.8470189143794897,0.8694173049188529,83.08823529411787,87.37655222147674,4455034767,9600737168.595694,27.61440890339205,15.625305901583102,25.810962024538494,92.85714285714286,0
2013-08-15,75.98,75.99001,75.28999,75.50999,70.50750132198256,72.81898817859573,74.50280617990495,75.88896440166944,69.44154215000005,72.52252449999997,74.00431940000003,75.90099949999993,75.90099949999993,77.7408062083607,74.06119279163916,39406560,49.88065711080109,65.37896784057925,NaN,NaN,NaN,NaN,NaN,NaN,-0.12658058739130928,0.7111915706797163,0.8377721580710256,21.43128177885719,66.15667645079273,4415628207,9586099738.62055,23.66860773423266,26.647479706113465,25.149736402034147,85.71428571428571,0
2013-08-16,75.53999,75.87,75.35001,75.485,70.55702867201258,72.87178049189086,74.54132358461456,75.85049160151044,69.49221710000005,72.59027439999998,74.06601960000003,75.9457494999999,75.9457494999999,77.6972476167973,74.19425138320251,23824928,49.657202831127215,64.49315611498736,NaN,NaN,NaN,NaN,NaN,NaN,-0.1944770187453001,0.5946758846394005,0.7891529033847006,9.848940156867746,38.12281907661424,4391803279,9574644767.853266,22.48495398302292,25.31485424421072,24.293661187174955,78.57142857142857,0
2013-08-19,75.5,76.13,75.33,75.35001,70.60472002850996,72.92085434353659,74.57303677737477,75.80282668708088,69.54421715000005,72.65576459999997,74.10521980000003,75.97274999999992,75.97274999999992,77.66916541792075,74.27633458207909,29586816,48.39599698176649,63.328715302076986,NaN,NaN,48.39599698176649,NaN,NaN,NaN,-0.24264768268774095,0.4858433000250244,0.7284909827127654,3.0312978217279016,11.437173252484257,4362216463,9546538032.323666,23.25127952217924,23.377826766306427,22.55605768815428,71.42857142857143,85.71428571428571
2013-08-20,75.49001,76.03,75.42999,75.67999,70.65522022723125,72.97549069316953,74.6164467076738,75.79112795497794,69.59325265000005,72.72286449999997,74.15041960000003,76.04374999999992,76.04374999999992,77.55639456834894,74.5311054316509,18842752,51.63007046096131,62.330847245179164,NaN,NaN,NaN,NaN,NaN,NaN,-0.2457030896694008,0.4213621206260143,0.6670652102954151,19.696870217827282,10.859036065474285,4381059215,9543397311.956472,21.72931801473621,21.847581842277624,20.53452906099539,64.28571428571429,78.57142857142857
2013-08-21,75.46001,76.09,75.14,75.42,70.7026309712389,73.02389681805727,74.64795860149052,75.75578243545623,69.64450265000006,72.79206449999998,74.20501960000003,76.08974999999991,76.08974999999991,77.46117611545864,74.71832388454118,30705088,49.02318628865573,60.82377628916192,NaN,NaN,NaN,NaN,NaN,NaN,-0.25741145821353606,0.3453008875284951,0.6027123457420311,13.145539906103368,11.957902648552826,4350354127,9530792065.30384,19.781200221717672,22.62556969084397,18.525265472950398,57.142857142857146,100
2013-08-22,75.73,76.21001,75.71001,76.16,70.75693315062956,73.08599787116505,74.70725434260854,75.79427934636516,69.69730260000006,72.86326459999998,74.29121940000003,76.14924999999991,76.14924999999991,77.4208110839296,74.87768891607021,17269472,55.855330793554025,59.64835597849106,NaN,NaN,NaN,NaN,NaN,NaN,-0.20952584497980253,0.3408050395172779,0.5503308844970805,47.88732394366189,26.909911355864153,4367623599,9544606952.12496,19.440039536469932,20.943972967745513,15.98636501182722,50,92.85714285714286
2013-08-23,76.73,76.77,76.39999,76.67,70.81576963669295,73.1569682103499,74.78422476054546,75.877681313378,69.75205260000006,72.9458646,74.36941960000003,76.21424999999991,76.21424999999991,77.45229587563148,74.97620412436834,20697264,59.84926575449576,58.74023673864878,NaN,NaN,NaN,NaN,NaN,NaN,-0.14099863236253452,0.3740825940439123,0.5150812264064468,71.83098591549316,44.28794992175281,4388320863,9554116808.217066,23.65184961196466,19.724928106925002,13.745618106494215,42.857142857142854,85.71428571428571
2013-08-26,76.72,77.28,76.55,76.71001,70.8744187945368,73.22732547351129,74.85974575032799,75.9569507121039,69.81475265000006,73.02866479999997,74.45801980000002,76.28825049999992,76.28825049999992,77.45712144119906,75.11937955880077,27525408,60.15383935804724,58.28214329157136,NaN,NaN,NaN,NaN,60.15383935804724,NaN,-0.09279827428058168,0.3990833835557197,0.4918816578363014,73.36495327102784,64.36108771006097,4415846271,9538658086.611805,26.876416538731213,18.34854315615525,13.284632075851361,100,78.57142857142857
2013-08-27,75.82001,76.17999,74.96001,75.14,70.916862388621,73.26520021661007,74.87073611306022,75.87914588237972,69.87465265000006,73.10145489999998,74.50121980000003,76.26375049999993,76.26375049999993,77.50507856911466,75.0224224308852,40068864,45.551561969980824,56.90640560268262,NaN,NaN,45.551561969980824,NaN,NaN,NaN,-0.16240134630417002,0.28887997495608886,0.4512813212602589,7.758223095789349,50.984720760770124,4375777407,9510412358.780201,22.773808530432305,29.416686002791653,13.072648928532661,92.85714285714286,100
2013-08-28,75.08,75.75,75.05,75.42999,70.96176913102278,73.30806734103363,74.89266763803825,75.83636913167689,69.93465265000005,73.17355479999998,74.53821960000003,76.24674999999993,76.24674999999993,77.52346951116496,74.97003048883491,20490384,48.059565302151185,55.529947662357635,NaN,NaN,NaN,NaN,NaN,NaN,-0.18312161781764597,0.2223792989882014,0.4055009168058474,20.25784593899137,33.7936741019362,4396267791,9512168091.96923,21.368695244799625,27.60171613218026,12.365551279829736,85.71428571428571,92.85714285714286
2013-08-29,75.39999,76.34,75.3,75.96001,71.0115028710126,73.36058105705277,74.93452420125243,75.84814445246957,69.99735270000005,73.24635499999998,74.60222000000003,76.21775099999994,76.21775099999994,77.49285686547921,74.94264513452066,27287904,52.37725135457299,54.74635834562675,NaN,NaN,NaN,NaN,NaN,NaN,-0.15638138106236155,0.21002419047789544,0.366405571540257,43.10363406738814,23.706567700722953,4423555695,9519515360.121231,24.545914667382483,25.121751053588532,10.8882252924389,78.57142857142857,85.71428571428571
2013-08-30,76.03999,76.03999,75.2,75.47,71.05586602652491,73.40235172919034,74.95552325218371,75.81213069509151,70.05980270000005,73.30090499999997,74.69112020000003,76.14275099999993,76.14275099999993,77.40847038761571,74.87703161238416,26228464,48.37364250826126,53.58342148702068,NaN,NaN,NaN,NaN,NaN,NaN,-0.16603509140771971,0.15886170728060733,0.32489679868832705,21.982422338027362,28.447967448135625,4397327231,9510148252.280233,22.76667463620807,24.163712034021255,9.697933350820708,71.42857142857143,78.57142857142857
2013-09-03,76.10001,76.44,75.53999,75.89999,71.10406626506695,73.45180991277073,74.99256116386277,75.82049824793994,70.12810260000005,73.36000479999998,74.80052020000002,76.08675049999992,76.08675049999992,77.28981939379388,74.88368160620597,27241424,51.85163452375178,52.456712164278024,NaN,NaN,NaN,NaN,NaN,NaN,-0.13890308100851467,0.15126794742768368,0.29017102843619835,40.51655395066375,35.20087011869308,4424568655,9504699725.336933,24.294082913684303,22.165611482881705,8.044666627086988,64.28571428571429,71.42857142857143
2013-09-04,76.14,76.84,75.92999,76.71001,71.1598467997429,73.51632872637923,75.05991209861325,75.90521365289804,70.20150310000004,73.42770489999998,74.94012040000003,76.09425099999993,76.09425099999993,77.31082290343292,74.87767909656694,27142880,57.64092843815587,52.02143811973447,NaN,NaN,NaN,NaN,NaN,NaN,-0.06556758332365586,0.20821154928162855,0.2737791326052844,75.43135961792925,45.97677863554012,4451711535,9524088178.525799,25.744587356734417,20.404730608742895,6.890649609786353,57.142857142857146,64.28571428571429
2013-09-05,76.75,77.05499,76.73,76.84,71.21636573705888,73.5821439991242,75.12971946729509,75.99424092405062,70.27420310000004,73.51050489999997,75.07212020000001,76.11525099999993,76.11525099999993,77.3675644704307,74.86293752956917,17815360,58.50322621919688,52.63733591319131,NaN,NaN,NaN,NaN,NaN,NaN,-0.010365487028821119,0.26082227381925804,0.27118776084807916,81.03440101034931,65.6607715263141,4469526895,9518332817.910395,26.85799505659252,19.7835739601312,7.551172027454143,50,57.142857142857146
2013-09-06,77.09,77.34,76.05,76.92999,71.2732177197747,73.64843797933956,75.2003183117149,76.08335988366484,70.33995010000004,73.58510479999998,75.19332000000001,76.12175049999993,76.12175049999993,77.38946645527085,74.85403454472902,27724528,59.12359863938286,53.31350704235242,NaN,NaN,NaN,NaN,NaN,NaN,0.028048077961159268,0.3062478582995283,0.278199780338369,82.77261669166683,79.74612577331513,4497251423,9528433572.692907,23.925051953823434,23.379548108838634,7.210661723843697,100,50
2013-09-09,77.23,77.96001,77.23,77.83,71.33845933450331,73.73124118766947,75.30344308380451,76.24970656141105,70.41010010000005,73.68225469999997,75.32652000000002,76.18874999999994,76.18874999999994,77.65355315067355,74.72394684932634,25161872,64.79263719893859,54.48469562929329,NaN,NaN,NaN,NaN,NaN,NaN,0.10555487102732275,0.41014336912252247,0.3045884980951997,95.66633333333338,86.49111701178317,4522413295,9544633115.468048,27.038397333033448,21.37263424664661,8.027237685832114,100,42.857142857142854
2013-09-10,78.27,78.32001,77.92,78.21001,71.40683297296597,73.81992967900274,75.41742610012591,76.43640212699094,70.48150020000004,73.79266469999997,75.46532020000001,76.26575049999992,76.26575049999992,77.96654738594785,74.564953614052,27619376,66.88118273644335,55.57406079182772,NaN,NaN,NaN,NaN,66.88118273644335,NaN,0.17007574183572832,0.5171831753898601,0.3471074335541318,96.7261904761905,91.7217135003969,4550032671,9557062214.424974,28.99426342973996,20.472301080154814,9.238404197928856,100,35.714285714285715
2013-09-11,77.69,78.11,77.59,78.06,71.47303363990163,73.90389146753733,75.52105644914057,76.59103049584894,70.54730025000005,73.89236469999997,75.59232000000002,76.31374999999993,76.31374999999993,78.15444625691767,74.47305374308219,28138592,65.23602400678666,56.73212062883707,NaN,NaN,NaN,NaN,NaN,NaN,0.18886272229355872,0.5831858364210802,0.3943231141275215,92.26160714285732,94.8847103174604,4521894079,9579789538.732668,27.420295906681336,22.250294256180776,9.502777729520533,92.85714285714286,28.571428571428573
2013-09-12,78.06,78.25,77.85001,78.00999,71.53807798179315,73.98520034936828,75.61866168642918,76.72616949624428,70.61144520000005,73.98456469999998,75.71771960000002,76.37374949999993,76.37374949999993,78.34858016748741,74.39891883251245,18332688,64.66494773002728,57.36137898144231,NaN,NaN,NaN,NaN,NaN,NaN,0.1839510517673788,0.624261928836745,0.4403108770693662,90.77321428571445,93.25367063492075,4503561391,9576121534.480963,27.69580943533564,21.44161499949579,10.145912320835961,85.71428571428571,21.428571428571427
2013-09-13,78.11,78.145,77.64,78.06,71.60297272824297,74.06588945136099,75.71440044382412,76.85320097279245,70.67694515000005,74.07066469999997,75.83829940000001,76.50124999999993,76.50124999999993,78.56387035048384,74.43862964951602,16932448,64.99495383455698,57.728928130018105,NaN,NaN,NaN,NaN,NaN,NaN,0.17040678488732403,0.6533193581785213,0.48291257329119724,92.26160714285732,91.76547619047636,4520493839,9587353950.480963,26.391640478580975,22.39020118932376,10.085174648256356,78.57142857142857,14.285714285714286
2013-09-16,78.69,78.72,77.67,77.85001,71.66513230308632,74.14082253153205,75.79814983818396,76.94813516585984,70.73859520000003,74.15496479999997,75.94369960000002,76.61950049999993,76.61950049999993,78.70654335587224,74.53245764412762,25909888,62.36130496371896,57.88660424470894,NaN,NaN,62.36130496371896,NaN,NaN,NaN,0.13518080257943355,0.6518885765154891,0.5167077739360556,76.86190654762378,86.63224265873185,4494583951,9570327946.174067,29.097659795207566,20.25457367748987,10.018156509204669,100,7.142857142857143
2013-09-17,77.99001,78.47,77.98,78.37,71.73184740454815,74.22456862001657,75.89900670727478,77.08355086434938,70.80089520000004,74.24076489999997,76.05809980000001,76.77049999999993,76.77049999999993,78.9047616897261,74.63623831027375,27182208,66.03185482065464,59.34948230547135,NaN,NaN,NaN,NaN,NaN,NaN,0.13448925912703613,0.6848193478448508,0.5503300887178146,90.46321525885574,86.52890964977894,4521766159,9586415375.398558,27.43373924204091,19.096336153413986,10.388883165893173,92.85714285714286,0
2013-09-18,78.49001,79.47,78.33,79.31,71.80725190798547,74.32527023150139,76.03277115012675,77.29559363917325,70.86844520000004,74.33816479999997,76.1824998,76.95200049999993,76.95200049999993,79.29193059985599,74.61207040014386,31714656,71.45177851727186,61.020354677979974,NaN,NaN,NaN,NaN,NaN,NaN,0.1819770135106179,0.777801355606087,0.5958243420954691,96.25292740046847,87.85934973564933,4553480815,9609227671.81961,33.56579292086296,17.153918096800723,11.79101495589596,100,0
2013-09-19,79.53999,79.685,79.36,79.5,71.88379666511995,74.4277401279073,76.16874090894531,77.50553710210913,70.93759520000003,74.43106469999996,76.3023,77.15600049999992,77.15600049999992,79.63347180280331,74.67852919719653,26435616,72.41003746021639,62.45126797124021,NaN,NaN,NaN,NaN,72.41003746021639,NaN,0.2088952215479023,0.856943369030347,0.6480481474824447,95.87513935340017,94.19709400424146,4579916431,9605567355.758072,34.39242887649379,16.5573041757691,14.208583250962253,100,7.142857142857143
2013-09-20,79.47,79.53999,78.95,78.985,71.9544554047705,74.5179828976517,76.27918244192784,77.64643833047968,71.00437020000003,74.51371469999998,76.3826,77.29725049999993,77.29725049999993,79.85238302908817,74.74211797091169,26328832,65.9483483604378,63.70660410353854,NaN,NaN,NaN,NaN,NaN,NaN,0.1760421720315979,0.868100862521942,0.6920586904903441,83.1122240959611,91.74676361660993,4553587599,9582362336.432863,32.478507136000765,19.50313308260774,15.778913718051994,92.85714285714286,0
2013-09-23,79.34,79.41,78.455,78.83,72.0228687838275,74.60336937492593,76.3792145030287,77.75915848948162,71.07400420000003,74.59811469999997,76.45320000000001,77.40525049999994,77.40525049999994,80.02693351081588,74.783567489184,30319392,64.09448757276616,64.58109360703956,NaN,NaN,NaN,NaN,NaN,NaN,0.13002099063976202,0.8545849287900467,0.7245639381502846,77.23042015866791,85.40592786934307,4523268207,9575853985.27056,29.606462101295595,22.361986310215034,16.447400403766792,85.71428571428571,0
2013-09-24,79,79.25,78.57001,78.83,72.09060143274465,74.687065030868,76.47532373820405,77.86114339524528,71.14155415000003,74.67361469999997,76.5204,77.51124999999993,77.51124999999993,80.1828765813527,74.83962341864716,21875696,64.09448757276616,65.04206211665458,NaN,NaN,NaN,NaN,NaN,NaN,0.08775417942591568,0.8342566624326793,0.7465024830067636,76.47867950481422,78.94044125314774,4523268207,9570706365.280619,27.726398727293567,20.941960125123153,16.616637383048502,78.57142857142857,0
2013-09-25,78.88,79,78.39999,78.56,72.15497355779196,74.76375681243496,76.55707574847057,77.92770116712668,71.20970420000003,74.73801469999997,76.5842,77.68224999999993,77.68224999999993,80.15531178454792,75.20918821545193,22746400,60.650144011760325,65.19541338755197,NaN,NaN,60.650144011760325,NaN,NaN,NaN,0.03262545203530276,0.7872842980508921,0.7546588460155893,69.05089408528202,74.25333124958804,4500521807,9560091934.627796,26.148519611802744,21.362757933991706,16.252727753221414,71.42857142857143,7.142857142857143
2013-09-26,78.87,79.36,78.85001,79.17,72.22477481592338,74.85100915278278,76.6595433661776,78.04601534168604,71.27995420000003,74.80571479999998,76.6564,77.86925049999994,77.86925049999994,80.19396614565754,75.54453485434233,22421664,65.20016799787375,65.62945405601563,NaN,NaN,NaN,NaN,NaN,NaN,0.028410247902443952,0.7901716558936442,0.7617614079912003,79.02240325865577,74.850658949584,4522943471,9565806933.163767,27.572583446301778,19.748989128969804,17.351274561165663,64.28571428571429,0
2013-09-27,78.74001,79.21001,78.59,79.07001,72.29288660879976,74.9345537240148,76.75407146946475,78.14353864247785,71.34545425000003,74.87281489999997,76.7304002,78.02475049999994,78.02475049999994,80.23085717266133,75.81864382733855,25151520,63.895934996233116,65.56540389867952,NaN,NaN,NaN,NaN,NaN,NaN,0.010952965918944457,0.7754526153898809,0.7644996494709364,70.64486873508324,72.90605535967369,4497791951,9579599885.398731,25.937267724437557,21.064914247984163,17.255758397287185,57.142857142857146,0
2013-09-30,78.27,79.09,78,78.88,72.35843002562763,75.01268137304422,76.83744121576025,78.21367781938473,71.41070425000002,74.93451479999997,76.8162002,78.19525049999993,78.19525049999993,80.09039323055373,76.30010776944613,28031856,61.38312285008957,65.17268533536854,NaN,NaN,NaN,NaN,NaN,NaN,-0.01965888447302999,0.7399260438796489,0.7595849283526789,61.575178997613015,70.41415033045068,4469760095,9596830475.784052,23.318823785801786,24.40277506185168,16.187450094860733,50,7.142857142857143
2013-10-01,78.87,79.72,78.8456,79.67999,72.4312813686562,75.10510332605324,76.94891371710298,78.35332659849094,71.48254870000004,75.00524959999997,76.9136,78.38425049999992,78.38425049999992,80.06827190520019,76.70022909479965,33129744,67.22693944260052,65.31489358078382,NaN,NaN,NaN,NaN,67.22693944260052,NaN,0.006313254037901284,0.7674764959000555,0.7611632418621542,98.07644230769253,76.7654966801296,4502889839,9626928378.39009,27.227897431035974,22.445231320569775,16.131714330626906,100,0
2013-10-02,79.13,79.75999,79.06,79.64999,72.50310931523674,75.19510108197298,77.05483827721659,78.47681835101561,71.55734865000004,75.07124949999996,77.02140000000001,78.53124949999993,78.53124949999993,80.11532535524462,76.94717364475524,25503760,66.81858425594987,65.46872476120687,NaN,NaN,NaN,NaN,NaN,NaN,0.013407226186480825,0.7779222745952552,0.7645150484087744,94.81129627969946,84.820972528335,4477386079,9644416556.453207,25.8362234729531,20.993383590617277,15.961245807388233,100,7.142857142857143
2013-10-03,79.55,79.72,78.3,78.72,72.56496892404036,75.26490106054777,77.12013873693358,78.49997850806174,71.62319865000003,75.12704949999997,77.1058,78.62524949999992,78.62524949999992,80.00691975414018,77.24357924585966,42998192,55.55321048401375,64.79431452188234,NaN,NaN,NaN,NaN,NaN,NaN,-0.04916896539200999,0.703053841668762,0.7522228070607719,50.23947483002297,81.04240447247166,4434387887,9626853914.65039,22.637306764026235,25.02081202801845,15.73256971212933,92.85714285714286,0
2013-10-04,78.72,79.50999,78.64999,79.39999,72.63297908400016,75.34678400984386,77.20954466881854,78.58569388824634,71.68746260000003,75.18584939999997,77.19439980000001,78.74874949999993,78.74874949999993,79.92911694498108,77.56838205501879,22854272,60.76228928877483,64.68009911652919,NaN,NaN,NaN,NaN,NaN,NaN,-0.04927549008332066,0.6906284444566211,0.7399039345399417,79.77516727622066,74.94197946198103,4457242159,9643861744.975971,20.945829176760597,23.151237029466262,14.80992311833471,85.71428571428571,0
2013-10-07,78.72,79.35001,78.67,78.74001,72.69374556077628,75.41397660370833,77.26956291710016,78.6003906607943,71.74986015000003,75.23654949999997,77.26180000000001,78.79424999999993,78.79424999999993,79.8970560891148,77.69144391088507,20234688,54.13125111085552,63.83005599440069,NaN,NaN,NaN,NaN,NaN,NaN,-0.09562309978440697,0.6203750598094331,0.7159981595938401,42.046261626486356,57.353634577576656,4437007471,9627793556.01828,19.606623031974934,21.67102449514226,13.887276524540097,78.57142857142857,0
2013-10-08,78.75999,78.81,77.19,77.22,72.7387829183805,75.44973944323887,77.26761927329231,78.4689248835758,71.80466020000003,75.27284949999998,77.30160000000002,78.74474949999993,78.74474949999993,80.02293783087167,77.46656116912818,43660688,42.60039861212816,61.769243144033275,NaN,NaN,NaN,NaN,NaN,NaN,-0.2231912684707501,0.43700907400540245,0.6602003424761526,1.1673197171973855,40.99624953996813,4393346783,9585749930.536798,17.00777873679751,30.90798807691828,13.64811192420898,71.42857142857143,100
2013-10-09,77.39999,77.44,76.35001,76.98,72.78098408337173,75.48004163248166,77.25634008610437,78.32712251371143,71.86356020000002,75.29964949999997,77.32860000000002,78.69074949999994,78.69074949999994,80.15744414891881,77.22405485108106,64526688,41.11129807091314,59.53361890194019,NaN,NaN,41.11129807091314,NaN,NaN,NaN,-0.31278362991536757,0.2692208050819431,0.5820044349973107,18.474888415768,20.56282325315058,4328820095,9595813226.248796,15.51742519415945,34.952536838771096,13.898321911197487,64.28571428571429,100
2013-10-10,77.8,78.78999,77.78999,78.61,72.83898424174615,75.54202100609588,77.30942478861009,78.3540632266913,71.93126015000003,75.34384949999998,77.38540000000002,78.72074999999994,78.72074999999994,80.15469925647513,77.28680074352475,48062720,53.10158487083371,58.615992938397035,NaN,NaN,NaN,NaN,NaN,NaN,-0.2538249829619944,0.2647232062948177,0.5185481892568121,66.27575528302216,28.639321138662513,4376882815,9626574328.303196,23.519647239099857,30.217356529242657,13.005637090985301,57.142857142857146,92.85714285714286
2013-10-11,78.41,79.28999,78.39999,79.23,72.90257643834569,75.61505029310388,77.38474146356656,78.43748577653022,72.00491015000003,75.39344949999996,77.43920020000002,78.77924999999993,78.77924999999993,80.19596114563049,77.36253885436938,25214128,56.71197497666247,58.08867061010392,NaN,NaN,NaN,NaN,NaN,NaN,-0.16872547353000877,0.30764134734430115,0.4763668208743099,84.45768010369571,56.40277460082863,4402096943,9648389365.204948,25.70582319658482,28.19469273997532,12.339735803401817,50,85.71428571428571
2013-10-14,78.74001,79.78999,78.67999,79.78999,72.9711079165711,75.69772236650776,77.47906493558355,78.56629570257496,72.08186015000003,75.45515939999997,77.49560000000002,78.87624899999994,78.87624899999994,80.29083619071815,77.46166180928174,31471888,59.72759614180988,57.77674979360704,NaN,NaN,NaN,NaN,NaN,NaN,-0.07514757335568911,0.38243235417969856,0.4575799275353877,100,83.57781179557263,4433568831,9679861253.204948,27.30109669651533,25.868940105292815,11.536407100936483,100,78.57142857142857
2013-10-15,79.73,80.11,79.38,79.48,73.0358730119286,75.77261895330959,77.55753297732538,78.65331515947258,72.16036015000003,75.51545939999997,77.54480000000002,78.93174899999994,78.93174899999994,80.34962817826005,77.51386982173983,38684000,57.34602043473024,57.54074096667632,NaN,NaN,NaN,NaN,NaN,NaN,-0.03650990492268108,0.4119425463820363,0.4484524513047174,83.24463628892643,89.23410546420739,4394884831,9651775609.369333,28.21384112102586,24.44103199672804,11.328712093460428,100,71.42857142857143
2013-10-16,79.83,80.42,79.78999,80.38,73.10894890235717,75.86385422156089,77.66821795860673,78.8177613347609,72.23660965000003,75.58515939999997,77.62120000000003,78.98524899999992,78.98524899999992,80.53114802391887,77.43934997608098,46735856,62.07429344554911,57.31746421293884,NaN,NaN,NaN,NaN,NaN,NaN,0.0429687887002958,0.5021634371800872,0.45919464847979136,99.01719660244851,94.0872776304583,4441620687,9692576847.696596,28.552631978366826,22.70323498679713,10.962949440971995,100,64.28571428571429
2013-10-17,80,80.87,79.95,80.84,73.18587478392575,75.962391761728,77.79260156807314,79.0103554933551,72.30480965000004,75.65465939999996,77.70960000000002,79.05224899999993,79.05224899999993,80.78628311966082,77.31821488033904,32193536,64.25528901704027,57.34313235728221,NaN,NaN,NaN,NaN,NaN,NaN,0.11570173459726008,0.6038218167263665,0.4881200821291064,99.3362817174374,93.86603820293745,4473814223,9722670805.261814,29.972100481216863,21.12043166395031,11.459988853789337,100,57.142857142857146
2013-10-18,81.56,82.17999,81.35001,82.14999,73.2750699602051,76.08491845951556,77.96347954579576,79.30936830351176,72.38129910000002,75.74075939999996,77.81659980000002,79.21049849999993,79.21049849999993,81.40708632801164,77.01391067198821,39628224,69.61430560177126,57.93107398240233,NaN,NaN,NaN,NaN,NaN,NaN,0.23437446370816784,0.7810881617643162,0.5467136980561483,99.48541847484896,99.27963226491163,4513442447,9759434269.339888,36.65441476763249,19.038483231840726,13.557065639045726,100,50
2013-10-21,82.31,82.53999,82.07001,82.33,73.36516876657122,76.20858344051526,78.13471564203907,79.59704751270111,72.45979910000003,75.82475949999997,77.93339960000002,79.38549849999993,79.38549849999993,81.9583957358355,76.81260126416436,31176944,70.27382218084726,58.14870846370567,NaN,NaN,NaN,NaN,NaN,NaN,0.30297346780613743,0.9254305328138202,0.6224570650076827,96.60758193079775,98.47642737436136,4544619391,9762751106.652113,38.08828965282632,18.355066445302075,15.366553679890801,100,42.857142857142854
2013-10-22,82.62,82.89999,81.92999,82.45,73.4555650972521,76.33217584763376,78.30394247960616,79.86875727339624,72.53879705000003,75.91675949999996,78.04899960000003,79.56649849999992,79.56649849999992,82.44838579102503,76.68461120897481,43944816,70.72991148234459,58.428088979876726,NaN,NaN,NaN,NaN,NaN,NaN,0.3320709221819107,1.037545717735071,0.7054747955531604,93.12990268672576,96.40763436412415,4588564207,9765923288.112236,38.016254095968335,16.998789634725096,17.356676262152604,100,35.714285714285715
2013-10-23,82.03999,82.2,81.55,81.95,73.54008683757796,76.44341989025487,78.44692512746475,80.06697086640612,72.61594705000003,76.00245949999997,78.14599940000002,79.73599849999992,79.73599849999992,82.7565880769156,76.71540892308424,38021280,66.17403567623133,59.1867193507494,NaN,NaN,NaN,NaN,NaN,NaN,0.29456042545470884,1.0736753273715465,0.7791149019168376,85.49629159173006,91.74459206975116,4550542927,9774697429.650698,35.402404501932125,18.73297824218958,19.198879963267917,92.85714285714286,28.571428571428573
2013-10-24,81.99001,82.48,81.88,82.31,73.6273496551145,76.55958979341814,78.59841825972103,80.28059268865316,72.69364705000002,76.09555949999996,78.25599940000002,79.89299849999993,79.89299849999993,83.10023894564227,76.68575805435759,23155088,67.78308689133459,59.68820489378938,NaN,NaN,NaN,NaN,NaN,NaN,0.271479545698347,1.1184643340397713,0.8469847883414243,90.99249158012697,89.87289528619425,4573698015,9784731301.117365,35.93228941051778,17.851755635841098,21.242855106049387,85.71428571428571,21.428571428571427
2013-10-25,83.10001,83.28,82.5,82.89999,73.71961473317306,76.6851422727564,78.7671073475751,80.53005909925761,72.77229700000002,76.20405939999996,78.40379940000001,80.08449749999993,80.08449749999993,83.52144983748641,76.64754516251344,35832384,70.27836634841906,60.84157026790107,NaN,NaN,NaN,NaN,NaN,NaN,0.2727114758694531,1.1878741331782408,0.9151626573087877,94.51644230366857,90.33507515850852,4609530399,9785649161.41521,39.45552188334521,16.50037473776494,23.815882622697785,100,14.285714285714286
2013-10-28,82.9,83.05,82.55,82.92,73.81116085523104,76.80860480200874,78.92996588296431,80.75767251837594,72.85059705000002,76.30925949999997,78.55249940000002,80.28649749999991,80.28649749999991,83.88750810956041,76.6854868904394,28618375,70.36220961857583,62.82455676836161,NaN,NaN,NaN,NaN,NaN,NaN,0.2521212678302929,1.2303142420966537,0.9781929742663609,94.80518730907262,93.43804039762271,4638148774,9799385981.41521,37.86437388867904,15.834953602217436,24.6740230125684,92.85714285714286,7.142857142857143
2013-10-29,83.1601,83.26,82.7,83.06,73.90318910542774,76.93239480592936,79.091928005201,80.97694180234014,72.93109700000002,76.40595949999997,78.70669920000002,80.45549799999992,80.45549799999992,84.23940149878952,76.67159450121032,36878062,70.9790499866566,64.95796761948614,NaN,NaN,NaN,NaN,70.9790499866566,NaN,0.22601558516834297,1.2607124557267895,1.0346968705584465,95.9927213247335,95.1047836458249,4675026836,9809922570.558067,37.84747236865106,15.10044766266914,24.99208409515504,85.71428571428571,0
2013-10-30,83.36,83.485,82.58,82.98,73.9935056317419,77.05214936422779,79.24440141676175,81.16770924973632,73.01284700000002,76.50155949999997,78.85269940000002,80.62199849999993,80.62199849999993,84.54014722919987,76.70384977079999,33535470,70.08146256695514,66.17081602635196,NaN,NaN,NaN,NaN,NaN,NaN,0.18326639161132507,1.263779860072603,1.0805134684612778,90.06884942212511,93.6222526853104,4641491366,9806031714.922709,36.87747803036765,13.972478558327836,27.31925674285671,100,0
2013-10-31,82.77,83.3,82.48,82.79,74.08103293888874,77.16577016889654,79.38344449845737,81.32221313071382,73.09229705000001,76.60255949999996,79.00009940000001,80.82549849999992,80.82549849999992,84.75013439472139,76.90086260527846,31309909,67.88575977034981,66.96894351161534,NaN,NaN,NaN,NaN,NaN,NaN,0.12488870703220889,1.236624352251539,1.11173564521933,85.53593020618077,90.53250031767978,4610181457,9798395151.751978,34.372153014697574,13.851731256522392,30.028890946305328,92.85714285714286,0
2013-11-01,83.04,83.169,82.4,82.81,74.16788833253163,77.27753709624513,79.51781922400805,81.46390711826488,73.17024705000001,76.71215939999996,79.13309940000002,80.99599899999993,80.99599899999993,84.954246032225,77.03775196777485,30873163,67.99941499222695,67.55978771521657,NaN,NaN,NaN,NaN,NaN,NaN,0.07289270452081076,1.2028515258703436,1.1299588213495328,83.5566382460415,86.3871392914491,4641054620,9800442656.710365,32.16523232915577,13.630307552023584,32.72743871320436,85.71428571428571,0
2013-11-04,83.05,83.07,82.64,82.93,74.2550735232527,77.38946705473532,79.65163023483126,81.60353501176347,73.249547,76.81385949999996,79.25829940000003,81.20549849999993,81.20549849999993,85.10707947520588,77.30391752479399,16843634,68.71484312376714,68.3718464787192,NaN,NaN,NaN,NaN,NaN,NaN,0.03383796223019986,1.1722562741372826,1.1384183119070828,84.9797429506282,84.6907704676168,4657898254,9806318342.989435,30.96788982088703,13.12292285584587,35.10658466636025,78.57142857142857,0
2013-11-05,82.59,83.22,82.37,83.02,74.34228672202632,77.50096275662175,79.78372316679867,81.73843643921457,73.32874705,76.92125949999996,79.38449920000002,81.49549849999993,81.49549849999993,85.01225518565468,77.97874181434517,27975601,69.2697500364245,68.88580766378172,NaN,NaN,NaN,NaN,NaN,NaN,0.0029502117826880614,1.142106076635443,1.1391558648527549,86.84582743988673,85.12740287885212,4685873855,9821128955.283552,28.694055603587742,14.491705952217856,36.64047734465305,71.42857142857143,0
2013-11-06,83.35,83.4,82.73,83,74.42843312280218,77.6098545832233,79.90985167006146,81.85858534976556,73.40579705,77.02145949999996,79.54169920000002,81.79649849999993,81.79649849999993,84.69130992703481,78.90168707296505,25576806,68.97695884278436,69.22306979419201,NaN,NaN,NaN,NaN,NaN,NaN,-0.028226106629791747,1.1038732315655153,1.132099338195307,77.28326596377505,83.0362787847633,4660297049,9816166291.432806,28.58678116452221,13.641452581148098,37.930978186365415,64.28571428571429,0
2013-11-07,82.99,83.13,81.37,81.44,74.49819995740116,77.68569904692184,79.9698574869218,81.81872007835932,73.47969705,77.10005949999996,79.66189940000002,81.93799849999992,81.93799849999992,84.44688428777472,79.42911271222512,52173216,50.903498595783226,67.88658357947858,NaN,NaN,50.903498595783226,NaN,NaN,NaN,-0.15616384899725833,0.9368945269487341,1.0930583759459924,3.3096926713944845,55.81292869168541,4608123833,9768143217.614624,24.51742057508058,22.699436409254144,35.946678561418324,57.142857142857146,0
2013-11-08,81.73,82.56,81.51,82.54,74.57821786827279,77.78182381826993,80.07064738939545,81.88741340422986,73.55739705,77.19785959999996,79.79349920000001,82.10349849999992,82.10349849999992,84.29228283887443,79.9147141611254,31480519,59.0511391381891,67.08496336214586,NaN,NaN,NaN,NaN,NaN,NaN,-0.16793215470187794,0.8831431825686451,1.051075337270523,55.31914893617043,45.30403585711331,4639604352,9798424478.747957,22.338209416943357,20.68181530776066,33.724476943701156,50,92.85714285714286
2013-11-11,82.39,82.64,82.14,82.41,74.65614604868799,77.8734708713735,80.16238670745837,81.93718355620797,73.6336971,77.31170969999995,79.93229920000002,82.23449899999993,82.23449899999993,84.15034259384525,80.3186554061546,24822945,57.8297116423948,66.16352051643516,NaN,NaN,NaN,NaN,NaN,NaN,-0.18438376919694233,0.8205956257743452,1.0049793949712875,49.172576832151044,35.93380614657198,4614781407,9800410314.347958,22.07845989465663,19.834242863743263,31.37814700870246,42.857142857142854,85.71428571428571
2013-11-12,82.16,82.66,82.1199,82.54,74.73459235666124,77.96587738877204,80.25562644442078,81.99459464609292,73.71059710000002,77.43280979999996,80.06509940000002,82.38749899999993,82.38749899999993,83.82903772652584,80.94596027347403,20108526,58.74860008085714,65.63313225962271,NaN,NaN,NaN,NaN,NaN,NaN,-0.18589552959465527,0.7726099829779685,0.9585055125726237,55.31914893617043,53.27029156816396,4634889933,9811583372.39758,21.07379819450424,19.101047590461423,29.52945436744366,35.714285714285715,78.57142857142857
2013-11-13,82.01,83.55,82,83.54,74.82220835311237,78.07625605434092,80.38442540738467,82.14177610836978,73.79319710000001,77.57090979999995,80.20169920000002,82.54549899999994,82.54549899999994,83.74458997406126,81.34640802593862,31345887,65.05624354881297,65.43835773515688,NaN,NaN,NaN,NaN,NaN,NaN,-0.1220189688630019,0.8059818014938713,0.9280007703568732,99.54128440367015,68.01100339066387,4666235820,9842524796.339516,25.55503530324344,16.7459777777718,28.61572485300186,100,71.42857142857143
2013-11-14,83.29,83.86,83.14,83.8,74.91153961328041,78.1895975186114,80.51836950905586,82.29970219328695,73.87784710000001,77.70650969999996,80.34089920000002,82.69349899999993,82.69349899999993,83.73427387867424,81.65272412132562,31101157,66.4909041980663,65.1678247244174,NaN,NaN,NaN,NaN,NaN,NaN,-0.06745375540744969,0.8436835760975612,0.9111373315050109,97.59036144578303,84.1502649285412,4697336977,9868442427.17285,26.571728968761395,15.773119297903737,27.507006810566093,100,64.28571428571429
2013-11-15,83.83,83.96,83.61,83.96,75.00157404498907,78.30386291428245,80.65333541066151,82.45782579392629,73.95934710000002,77.83740969999997,80.48149940000002,82.78399949999994,82.78399949999994,83.92950180731431,81.63849719268556,20515761,67.378499208208,64.95470255224828,NaN,NaN,NaN,NaN,67.378499208208,NaN,-0.027813138316554964,0.8763709086093172,0.9041840469258722,100,99.04388194981773,4717852738,9888958188.17285,26.63075081859197,15.307570033744506,26.505289793927123,100,57.142857142857146
2013-11-18,83.94,84.105,82.98,83.14,75.0825534077255,78.39962800508873,80.75085166906695,82.52279476593331,74.04264710000001,77.95710969999996,80.58769940000002,82.82449949999993,82.82449949999993,83.9601661315718,81.68883286842807,31679608,58.78453081209733,64.08366546835119,NaN,NaN,NaN,NaN,NaN,NaN,-0.062082914513537646,0.8265804037839501,0.8886633182974878,64.71663619744045,87.4356658810745,4686173130,9866289668.670628,24.162140070153214,19.079666835636324,24.276181211841447,100,50
2013-11-19,83.09,83.49,82.76,82.9,75.16033894595708,78.48874428221569,80.8351319957702,82.55871907393967,74.11984705000002,78.07340969999996,80.68149920000002,82.84699949999994,82.84699949999994,83.96985469460876,81.72414430539112,25545292,56.51257647002373,63.11445931857036,NaN,NaN,NaN,NaN,NaN,NaN,-0.1037260705102303,0.7590057301597,0.8627318006699303,55.94149908592327,73.55271176112124,4660627838,9850542570.862408,22.69219618716274,19.75235721255391,21.553468298082123,92.85714285714286,42.857142857142854
2013-11-20,83.14,83.4301,82.455,82.7,75.23536044898238,78.57213548454806,80.90826407436745,82.57217440023113,74.19714700000002,78.18330959999996,80.77429920000003,82.88449949999993,82.88449949999993,83.93263066453093,81.83636833546893,32177418,54.61815331773004,62.16677314338324,NaN,NaN,54.61815331773004,NaN,NaN,NaN,-0.1450185958208492,0.6814585558938688,0.826477151714718,48.62888482632536,56.429006703229696,4628450420,9834534709.646328,20.86612330611402,20.67990971975821,18.54602593336409,85.71428571428571,35.714285714285715
2013-11-21,83.03,83.61,82.98,83.54,75.31799367834573,78.67050903930948,81.01146940478442,82.66434826687579,74.27834700000001,78.30130949999995,80.88489940000001,82.94599949999994,82.94599949999994,83.99641664764131,81.89558235235857,28125025,60.593148937711774,61.637754139489296,NaN,NaN,NaN,NaN,NaN,NaN,-0.11722583311634927,0.6799448603192815,0.7971706934356307,79.34186471663628,61.30408287629498,4656575445,9856409729.090773,20.784049080909572,19.132549782046784,15.950609171668507,78.57142857142857,28.571428571428573
2013-11-22,83.69,84.02,83.62,83.99,75.4042822984617,78.77584549397662,81.12827452616543,82.79060081288762,74.35834695000001,78.42089939999995,81.00349940000001,83.00049999999995,83.00049999999995,84.14464116263647,81.85635883736342,25361273,63.37510178408396,61.25634404379764,NaN,NaN,NaN,NaN,NaN,NaN,-0.07221040033760928,0.7069076930136191,0.7791180933512284,95.79524680073092,74.58866544789753,4681936718,9877966811.140772,23.41917491022385,18.352499739289087,13.92605505829219,71.42857142857143,21.428571428571427
2013-11-25,84.29,84.38,83.98,84.19,75.49170237509392,78.88305647429391,81.248342191806,82.92387692594593,74.43924700000001,78.53699939999996,81.13029920000002,83.06399999999994,83.06399999999994,84.31883704122949,81.80916295877039,21699975,64.57218559664098,60.92080372667027,NaN,NaN,NaN,NaN,NaN,NaN,-0.03454974883103357,0.7359309073124365,0.77048065614347,93.68770764119607,89.60827305285443,4703636693,9879051809.890772,25.7693246733876,17.704698771704276,12.902040694509866,100,14.285714285714286
2013-11-26,84.22,84.84,84.025,84.63,75.5826307096701,78.99685733618908,81.38095622349988,83.08636483776061,74.52374700000001,78.65679949999995,81.25549920000002,83.14249999999994,83.14249999999994,84.57093795806428,81.7140620419356,26629288,67.11847328340366,60.788054758143076,NaN,NaN,NaN,NaN,NaN,NaN,0.01192181985922447,0.7853829309675007,0.7734611111082762,93.94812680115251,94.47702708102649,4730265981,9891958029.228195,27.974172810914734,16.43201776627821,12.230642753852935,100,7.142857142857143
2013-11-27,84.79,85.24,84.73,85.22,75.67852493146442,79.12008788398731,81.53150695983322,83.28956818654531,74.609997,78.77809949999995,81.37369920000002,83.25449999999994,83.25449999999994,84.94215488179209,81.56684511820778,21638074,70.21028782017282,62.16711113131377,NaN,NaN,NaN,NaN,NaN,NaN,0.0710252616566659,0.8622426881791085,0.7912174265224426,99.4638069705095,95.69988047095269,4751904055,9911898999.385057,30.033425174559714,15.532070067054155,14.228857949158016,100,0
2013-11-29,85.54,85.84,85.4737,85.73,75.77853960876328,79.25097723281924,81.69615374572211,83.52199026401719,74.698897,78.90029959999995,81.49829920000002,83.40149999999994,83.40149999999994,85.3875037764401,81.41549622355978,16708898,72.60795432248506,63.13545507304919,NaN,NaN,NaN,NaN,72.60795432248506,NaN,0.12968052267114638,0.9533180798613756,0.8236375571902292,97.13541666666669,96.84911681277623,4768612953,9918572523.210884,33.80810097274688,14.653618553738234,16.777049984682545,100,0
2013-12-02,85.83,85.96,85.35,85.48,75.8750715529547,79.37432421830796,81.84453987334085,83.70846738172985,74.78754700000002,79.00539959999996,81.62819920000001,83.53499999999994,83.53499999999994,85.6953194208344,81.37468057916549,26354619,69.64864961447512,63.979664928197785,NaN,NaN,NaN,NaN,NaN,NaN,0.13618307430370646,0.9938664000698623,0.8576833257661558,87.87878787878812,94.82600383865476,4742258334,9903451020.505966,31.896678265683736,14.971645481064687,18.974005460071332,100,14.285714285714286
2013-12-03,85.42,85.64,85.08,85.41,75.96994646287554,79.4938425506187,81.98436183909219,83.87051810727938,74.87339695,79.10649959999996,81.7597992,83.65899999999993,83.65899999999993,85.94709877410119,81.37090122589868,37154262,68.8030670929702,64.69784114334871,NaN,NaN,NaN,NaN,NaN,NaN,0.12083323427384962,1.0087248686084678,0.8878916343346182,86.11111111111116,90.37510521885531,4705104072,9910085710.148823,30.208169759712,16.731404924578243,20.674038841952648,92.85714285714286,7.142857142857143
2013-12-04,85.06,85.77,84.78,85.49,76.06467336374246,79.61257834169555,82.1218378454023,84.02475447801467,74.96489695000001,79.20669959999995,81.89299920000002,83.78249999999994,83.78249999999994,86.18317386373798,81.3818261362619,37193220,69.26236073822787,64.99827808544977,NaN,NaN,NaN,NaN,NaN,NaN,0.10188864866964042,1.0152524451716687,0.9133637965020283,86.59058487874466,86.86016128954797,4742297292,9926240341.057913,27.442424805095655,17.973971247363448,20.675710200027364,85.71428571428571,0
2013-12-05,85.57,85.66,85.17,85.38,76.15736318101865,79.72678471116693,82.24960891028849,84.15382548010851,75.05944695000001,79.30679959999995,82.0293992,83.90149999999993,83.90149999999993,86.37021039209733,81.43278960790252,39829338,67.78462386654758,65.09068663319843,NaN,NaN,NaN,NaN,NaN,NaN,0.0693264716973978,1.0000218861237755,0.9306954144263777,83.45221112696152,85.38463570560577,4702467954,9920550435.629341,26.16550841291414,17.137629026099678,20.343317712229123,78.57142857142857,28.571428571428573
2013-12-06,86.105,86.18,85.59,86,76.25529986578464,79.85100679609431,82.39668307066933,84.32965162486008,75.15375190000002,79.41119959999996,82.1659992,84.12949999999992,84.12949999999992,86.48651909200055,81.7724809079993,36842888,71.47830076632988,65.38352960163571,NaN,NaN,NaN,NaN,NaN,NaN,0.07636490093019854,1.026151540589126,0.9497866396589274,95.16778523489916,88.40352708020178,4739310842,9934912917.392052,29.102375423791038,15.841592042622462,20.522284984438723,100,21.428571428571427
2013-12-09,86.35,86.53,86.2,86.35,76.35574464323952,79.97969973082512,82.55171510711367,84.52206575582578,75.25395190000002,79.52099959999995,82.31159900000003,84.31999999999994,84.31999999999994,86.74717943301305,81.89282056698683,22599903,73.3368264802383,66.4229792922172,NaN,NaN,NaN,NaN,73.3368264802383,NaN,0.09045043656321694,1.0628496853629485,0.9723992487997316,95.5828220858894,91.40093948258335,4761910745,9932858380.755688,30.99322601223794,15.030605408382405,22.160125756870382,100,14.285714285714286
2013-12-10,86.19,86.45,86.12,86.29,76.45459295524708,80.10465617179888,82.69831451467783,84.69044044574713,75.35260190000001,79.63799959999994,82.45979900000002,84.51399999999992,84.51399999999992,86.91966331809985,82.1083366819,26965928,72.46508071161654,67.5624438809024,NaN,NaN,NaN,NaN,NaN,NaN,0.08184317790322715,1.0747032211787655,0.9928600432755383,94.1104294478529,94.95367892288048,4734944817,9933675530.089022,29.964626087766792,15.336326282782364,23.97191641801774,92.85714285714286,7.142857142857143
2013-12-11,86.27,86.401,85.06,85.18,76.54141292584164,80.20515802978306,82.79563551410223,84.73706516519978,75.4423069,79.74169959999995,82.56979920000002,84.64599999999993,84.64599999999993,86.8880740398234,82.40392596017647,36830565,58.58968674162281,67.8461248397519,NaN,NaN,NaN,NaN,NaN,NaN,-0.007731362031526801,0.9831958407361299,0.9909272027676567,61.971830985915624,83.88836083988598,4698114252,9903436565.089022,26.16454844533746,23.415845180431557,24.335896535464986,85.71428571428571,0
2013-12-12,85.24,85.4201,84.9,84.96,76.62517996140541,80.29931331632201,82.88051255276488,84.75829705422838,75.53160685,79.84869969999994,82.67599940000002,84.71699999999993,84.71699999999993,86.90373363719704,82.53026636280282,33662597,56.28916809147283,67.5386976364491,NaN,NaN,NaN,NaN,NaN,NaN,-0.08654363773842322,0.8827476555946276,0.9692912933330509,46.04810996563542,67.37679013313465,4664451655,9877540766.089405,24.848342663874494,23.78545912362877,24.19647570350605,78.57142857142857,0
2013-12-13,85.36,85.4,84.709,84.85,76.70701896676456,80.3894259239196,82.95774735461724,84.76703066811139,75.61895685000002,79.95219969999995,82.79859940000001,84.76949999999992,84.76949999999992,86.91569174354252,82.62330825645732,34075415,55.12370724587488,66.94931231229131,NaN,NaN,55.12370724587488,NaN,NaN,NaN,-0.14726167152702518,0.7852142039242693,0.9324758754512945,34.11764705882319,47.37919600345808,4630376240,9857371670.959158,23.179947669094084,24.044338831840246,23.46082881219399,71.42857142857143,0
2013-12-16,85.27,85.81,85.21,85.32,76.79272027057786,80.48706105413902,83.0503847132597,84.81969441400554,75.70715690000002,80.05569969999995,82.91699960000001,84.83749999999992,84.83749999999992,86.96286937967285,82.71213062032699,24908324,59.02724086691157,66.55324483159636,NaN,NaN,NaN,NaN,NaN,NaN,-0.1561057612103175,0.7373436739383976,0.8934494351487151,51.69660678642674,43.95412127029511,4655284564,9841596399.092491,24.962624691194467,21.849416471943844,22.61082850567414,64.28571428571429,0
2013-12-17,85.32,85.53,84.99,85.15,76.87587728281092,80.57939647880953,83.13272256764168,84.85115208886215,75.78950695000002,80.15349969999994,83.0451994,84.93799999999992,84.93799999999992,86.91790504824272,82.95809495175712,24454893,57.092788873070944,65.83712451657259,NaN,NaN,NaN,NaN,NaN,NaN,-0.172460154134914,0.6778742424800726,0.8503343966149866,24.21746293245486,36.6772389259016,4630829671,9831633294.536936,23.654562326764083,22.83933762791025,20.879484273258722,57.142857142857146,0
2013-12-18,85.22,86.22,84.05,86.14,76.96805760835508,80.68950743962517,83.25065501596946,84.97389950897052,75.87765700000001,80.26259969999995,83.22359940000003,85.09999999999992,85.09999999999992,86.90923188122775,83.29076811877209,68387235,64.40802735226971,65.4226773402938,NaN,NaN,NaN,NaN,NaN,NaN,-0.11824297372607206,0.7025306794573964,0.8207736531834685,84.2741935483871,53.39608775575624,4699216906,9894978152.762743,19.2819595360376,26.62486255541097,19.74876525098913,50,100
2013-12-19,85.99,86.01,85.52,85.9,77.05693265702817,80.79268551012764,83.35455089769614,85.06209955573523,75.96370700000001,80.36529969999995,83.40199940000002,85.25999999999992,85.25999999999992,86.72523718218491,83.79476281781493,46489555,61.66338177510966,64.64092215833841,NaN,NaN,NaN,NaN,NaN,NaN,-0.10086127937759337,0.6946970539614767,0.7955583333390701,74.59677419354861,61.02947689146353,4652727351,9920594846.334171,18.24426818403336,25.192000424857564,18.06806938850009,42.857142857142854,92.85714285714286
2013-12-20,85.75,86.68,85.73,86.5,77.15089352611247,80.90570163863997,83.47790184288453,85.19904245518902,76.05235700000001,80.47259969999995,83.55979940000002,85.40799999999993,85.40799999999993,86.74034530060717,84.07565469939269,40475437,65.60900577092363,64.3523761695133,NaN,NaN,NaN,NaN,NaN,NaN,-0.05364181034474047,0.7285060704081445,0.782147880752885,93.15589353612144,84.0089537593524,4693202788,9945732222.997328,22.508456934644215,23.137309575184656,15.587055116577885,100,85.71428571428571
2013-12-23,87.19,87.41,86.95,87.41,77.25297418754418,81.03449962599363,83.63210177061455,85.4096098404091,76.14455700000002,80.58129979999994,83.72339940000002,85.57899999999992,85.57899999999992,87.01344623463528,84.14455376536456,28181764,70.55826421231116,64.47774739232338,NaN,NaN,NaN,NaN,NaN,NaN,0.02970981153321406,0.8192851451694025,0.7895753336361885,100,89.25088924322336,4721384552,9973913986.997328,26.98727296799497,21.34168703189377,14.370676536167549,100,78.57142857142857
2013-12-24,87.43,87.51,87.27,87.45,77.35443713095171,81.16153923736009,83.78182326980614,85.60393271275109,76.23820700000002,80.68609979999995,83.8765996,85.74199999999993,85.74199999999993,87.24719899018261,84.23680100981726,13852475,70.75747531926221,64.58454129096869,NaN,NaN,NaN,NaN,NaN,NaN,0.07574985487595254,0.8842626522311292,0.8085127973551767,98.26589595375717,97.1405964966262,4735237027,9980840224.497328,27.303862081047342,20.881412860687433,13.833573677466616,100,71.42857142857143
2013-12-26,87.6,87.81,87.44,87.74,77.4577760649721,81.29180578711534,83.93704588667649,85.80736769248908,76.333757,80.79329979999994,84.04179960000002,85.89749999999992,85.89749999999992,87.54674073441612,84.24825926558373,15241096,72.22481219453397,64.90169760011057,NaN,NaN,NaN,NaN,72.22481219453397,NaN,0.11177199520117342,0.9482277913566435,0.83645579615547,98.13829787234023,98.80139794203247,4750478123,9990314419.308138,29.162876213561766,20.159567396442377,13.648279697899543,100,64.28571428571429
2013-12-27,87.83,87.9,87.412,87.52,77.5578976961664,81.4151363655883,84.07755389112054,85.97047553129964,76.427057,80.90289979999996,84.1845996,86.01249999999992,86.01249999999992,87.77369135816079,84.25130864183905,15831962,69.38059754552627,64.75186165576746,NaN,NaN,NaN,NaN,NaN,NaN,0.10682500834118924,0.9699870565819566,0.8631620482407674,90.1298701298699,95.51135465198911,4734646161,9981490047.045841,28.661140485771853,19.216047222834344,12.949894447189248,100,57.142857142857146
2013-12-30,87.4,87.51,87.14,87.39,77.65572955988614,81.53345049696279,84.20745373852758,86.10566833784253,76.52145705,81.01259979999995,84.3155996,86.09549999999993,86.09549999999993,87.94962486096556,84.2413751390343,18985622,67.68442493539787,64.34811868827886,NaN,NaN,NaN,NaN,NaN,NaN,0.08195880943222811,0.9656105600310525,0.8836517505988244,86.75324675324664,91.6738049184856,4715660539,9988160670.991787,27.578728291963966,21.193576402068054,11.407635661291014,92.85714285714286,50
2013-12-31,87.54,87.96,87.52,87.96,77.75825961401662,81.66070890296352,84.35461241544806,86.28227135328609,76.61945705,81.12419979999996,84.43179980000001,86.21949999999991,86.21949999999991,88.21844447148045,84.22055552851937,24896065,71.02879795845146,64.24552706305278,NaN,NaN,NaN,NaN,NaN,NaN,0.09039672551358957,0.9966476574908114,0.9062509319772218,100,92.2943722943722,4740556604,10013056735.991787,30.532352441137796,19.97497573615199,10.594156342846503,100,42.857142857142854
2014-01-02,87.55,87.58,87.02,87.27,77.85290379696173,81.77178397419196,84.46894134033245,86.37634074821122,76.71465704999999,81.23199969999996,84.5305998,86.31249999999991,86.31249999999991,88.32516862649064,84.29983137350919,29190009,62.58509996321685,64.53091372173807,NaN,NaN,NaN,NaN,NaN,NaN,0.038650397325901586,0.9545639286345988,0.9159135313086972,82.35294117647064,89.7020626432391,4711366595,10009929235.027502,27.703386589843436,23.052641727558758,10.852656982562207,92.85714285714286,35.714285714285715
2014-01-03,87.27,87.35,86.62,86.64,77.94033759002679,81.86818429153469,84.55408089561352,86.40145115314348,76.80431205,81.33169969999996,84.61439980000002,86.36999999999992,86.36999999999992,88.3508483031417,84.38915169685814,35727317,56.03519152127398,64.51277253815245,NaN,NaN,NaN,NaN,NaN,NaN,-0.04436465342130946,0.8604577145320604,0.9048223679533699,66.24040920716126,82.8644501278773,4675639278,9976159579.23298,25.71103199010349,25.335434052139384,10.749107912433411,85.71428571428571,28.571428571428573
2014-01-06,86.65,86.76,86,86.32,78.02371731549916,81.95633905803895,84.6233326251973,86.39369390046315,76.8962621,81.42389959999996,84.7017998,86.41699999999992,86.41699999999992,88.34557564022475,84.48842435977508,32092437,53.001003538233284,64.36115084474947,NaN,NaN,NaN,NaN,NaN,NaN,-0.12274195575432545,0.7513949232604631,0.8741368790147885,58.05626598465468,68.88320545609552,4643546841,9971092352.338243,23.79258084695481,29.532092998301113,11.387174875814186,78.57142857142857,21.428571428571427
2014-01-07,86.7,87.25,86.56,87.12,78.11422759096682,82.05858976976096,84.72124114969937,86.46286590994285,76.9889121,81.52699959999995,84.79799980000001,86.47299999999993,86.47299999999993,88.41488671143769,84.53111328856217,25913225,58.98088531687228,64.35783973403238,NaN,NaN,NaN,NaN,NaN,NaN,-0.12234820230768584,0.7212016261301812,0.8435498284378671,78.51662404092097,67.60443307757897,4669460066,9987241173.715055,26.379507296678195,26.888182653133086,10.98035333474338,71.42857142857143,14.285714285714286
2014-01-08,87.11,87.55,86.945,87.31,78.20572781394227,82.16257809115183,84.82276110461312,86.54354534709115,77.0837621,81.64499969999996,84.8862,86.52099999999992,86.52099999999992,88.49553690774988,84.54646309224995,27209991,60.2736831421103,64.5850464675352,NaN,NaN,NaN,NaN,NaN,NaN,-0.11125283698084587,0.7044837822118097,0.8157366191926556,83.37595907928409,73.31628303495326,4696670057,9992863072.681997,27.749173025749524,25.301273766790004,11.184702222985694,64.28571428571429,7.142857142857143
2014-01-09,87.62,87.64,86.72,87.02,78.29343201479857,82.25876466360427,84.90892733580476,86.58892198070151,77.17531204999999,81.76034969999995,84.96820000000001,86.55749999999992,86.55749999999992,88.5405771543405,84.57442284565934,23695690,57.30498647568969,64.07768640492233,NaN,NaN,NaN,NaN,NaN,NaN,-0.12441045694968689,0.660223548005547,0.7846340049552338,61.47540983606563,74.45599765209023,4672974367,9984621093.551563,25.303551954863117,25.226823138780198,10.053031809718615,57.142857142857146,0
2014-01-10,87.24,87.4,86.58,87.3,78.38304960669112,82.35859110590913,85.0026948912634,86.65664369682518,77.26780709999998,81.87984959999996,85.05300000000001,86.66349999999991,86.66349999999991,88.56571213330048,84.76128786669935,38012069,59.385014168170486,63.914945861569535,NaN,NaN,NaN,NaN,NaN,NaN,-0.11542000908965289,0.6403589935931677,0.7557790026828206,70.40358744394621,71.75165211976531,4710986436,10013361926.210098,23.329932936887364,24.590856951690395,9.098462843611944,50,0
2014-01-13,87.18,87.48,85.675,86.01,78.45893966035588,82.43089623252479,85.04219705239032,86.59505858284183,77.3530071,81.98314969999996,85.1136,86.71599999999992,86.71599999999992,88.48020406984816,84.95179593015169,48855231,47.82489418543711,62.64465217689192,NaN,NaN,47.82489418543711,NaN,NaN,NaN,-0.19294954217264648,0.5145920749670125,0.707541617139659,14.660831509847197,48.84660959661968,4662131205,9982641323.891539,19.68941848567715,28.577434156611027,10.315366133529187,42.857142857142854,100
2014-01-14,86.3,87.72,86.3,87.65,78.55039299706876,82.53424482197974,85.14446383464953,86.69552919399975,77.4487571,82.10544969999995,85.2108,86.85599999999992,86.85599999999992,88.4409593054937,85.27104069450614,37194076,58.80424705642611,61.80507952290014,NaN,NaN,NaN,NaN,NaN,NaN,-0.1332183708824044,0.5410186535366535,0.6742370244190579,86.43326039387358,57.165893115889,4699325281,10016168378.314074,18.912859678972914,24.65264463080516,10.422043897863787,35.714285714285715,92.85714285714286
2014-01-15,88,88.54,87.94,88.37,78.64810052943623,82.6498043304554,85.27095544897699,86.855002604095,77.54540714999999,82.22754969999994,85.322,87.00849999999993,87.00849999999993,88.55951611857073,85.45748388142913,39859705,62.5320009859733,61.217545641950935,NaN,NaN,NaN,NaN,NaN,NaN,-0.04899467507058353,0.6129936805808285,0.661988355651412,94.06631762652701,65.05346984341594,4739184986,10033440917.147408,24.146524941962593,22.89055482762785,9.66072353506436,100,85.71428571428571
2014-01-16,88.28,88.51,88.16,88.38,78.74493535003886,82.7632735516345,85.39287876470338,87.00024045132405,77.64525714999999,82.34464969999995,85.431,87.16999999999993,87.16999999999993,88.57951055336908,85.76048944663079,34260219,62.582644061689905,60.528819346747774,NaN,NaN,NaN,NaN,NaN,NaN,0.0009664427693375499,0.663196409113084,0.6622299663437464,94.41535776614275,91.63831192884778,4773445205,10042250687.747406,23.437060894589802,22.21799321830099,8.547594293131068,92.85714285714286,78.57142857142857
2014-01-17,88.12,88.3701,87.67,87.88,78.83583151571011,82.86459486744371,85.49041293079344,87.08402707500747,77.7425072,82.45634959999995,85.5282,87.25699999999992,87.25699999999992,88.61533869122152,85.89866130877832,36908236,58.336865390742496,59.7399813356918,NaN,NaN,NaN,NaN,NaN,NaN,-0.005715815106647537,0.655085197460437,0.6608010125670846,76.96335078534001,88.48167539266994,4736536969,10027484230.236193,22.023431002309344,25.040546514773425,7.596373971896235,85.71428571428571,71.42857142857143
2014-01-21,88.43,88.59,87.81,88.55,78.93248990858862,82.97717714729632,85.61039673742899,87.22364354405438,77.84595225,82.59044959999996,85.6392,87.38949999999991,87.38949999999991,88.70894647488086,86.07005352511896,26432336,62.05205658968807,59.33766931099824,NaN,NaN,NaN,NaN,NaN,NaN,0.027128945648422498,0.6947121946276127,0.6675832489791902,98.62778730703238,90.00216528617172,4762969305,10051205557.41568,22.434319760563394,23.372677374166777,6.8075700592126855,100,64.28571428571429
2014-01-22,88.75,89,88.52,88.78,79.03047508362754,83.09208453051818,85.73469490458864,87.37186796843015,77.94875224999998,82.72394969999996,85.786,87.50349999999993,87.50349999999993,88.88820610602534,86.11879389397453,29425432,63.26312629187691,58.782978477671485,NaN,NaN,NaN,NaN,63.26312629187691,NaN,0.054885094849141725,0.7361896175406173,0.6813045226914756,93.38345864661657,89.65819891299633,4792394737,10053657676.749014,25.09693779325193,22.384582847593354,5.722554351556836,100,57.142857142857146
2014-01-23,88.5,88.52,87.86,88.48,79.12450020717353,83.19877592595346,85.8423539279381,87.47740435238919,78.0477523,82.84914959999995,85.90480000000001,87.55699999999993,87.55699999999993,89.00438522863215,86.10961477136772,35077428,60.548785140436834,58.637527418901485,NaN,NaN,NaN,NaN,NaN,NaN,0.044048321647768285,0.7363649247511859,0.6923166031034176,84.36090225563923,92.12404940309607,4757317309,10084483295.29447,23.082712074469786,26.345671642884643,5.53958631506326,92.85714285714286,50
2014-01-24,88.06,88.18,86.71,86.74,79.20027632451509,83.26889917494448,85.87755573468563,87.40717536644736,78.1313773,82.96184959999995,85.99140000000001,87.52149999999992,87.52149999999992,89.01183251325735,86.03116748674249,64334902,47.751601556040974,58.04584242138485,NaN,NaN,NaN,NaN,NaN,NaN,-0.0824074970204689,0.5893072318278314,0.6717147288483003,32.03007518796983,69.92481203007522,4692982407,10022774307.661818,19.791627560592207,31.852896814312796,7.155200937590474,85.71428571428571,42.857142857142854
2014-01-27,86.77,86.89,85.25,85.9,79.2669402416841,83.32100018138122,85.87843590195286,87.26363485535714,78.21092725,83.06184969999995,86.05860000000001,87.42949999999993,87.42949999999993,89.07374420329106,85.78525579670881,63676475,43.0240627163772,57.33320379125227,NaN,NaN,NaN,NaN,NaN,NaN,-0.21707834971034556,0.4003667917103684,0.6174451414207139,17.333333333333485,44.574770258980855,4629305932,10009573087.23499,17.326604791325472,38.97353571202172,9.132759994783175,78.57142857142857,100
2014-01-28,85.42,85.94,85.31,85.85,79.3324433238564,83.3710793857103,85.87732076854294,87.12900296437074,78.29047725,83.15324959999994,86.1048,87.34599999999993,87.34599999999993,89.1272849294978,85.56471507050206,44439554,42.75273977506703,56.17405053826617,NaN,NaN,NaN,NaN,NaN,NaN,-0.29892783805692935,0.2437853438495523,0.5427131819064817,15.999999999999849,21.787802840434395,4584866378,10041315625.806417,16.47759140159494,37.063810519858656,11.810918425423637,71.42857142857143,92.85714285714286
2014-01-29,85.1,85.74,84.76,84.93,79.38814040521106,83.40194910084475,85.84017093448243,86.91957411062114,78.37232725,83.23414959999995,86.1274,87.22299999999993,87.22299999999993,89.29169137380711,85.15430862619274,52064566,38.003722560840906,54.583339068175505,NaN,NaN,38.003722560840906,NaN,NaN,NaN,-0.39821928363556064,0.044939077362030844,0.4431583609975915,4.009433962264196,12.447589098532525,4532801812,10007314276.581928,15.099045603966893,38.184453073297,14.576013897525387,64.28571428571429,100
2014-01-30,85.99,86.8,85.88,86.5,79.45890517729852,83.46329664340227,85.86604658411056,86.87961467151436,78.45747725,83.32984969999994,86.1782,87.14999999999993,87.14999999999993,89.21254212079666,85.08745787920321,66863622,48.51422656719943,53.955427646140485,NaN,NaN,NaN,NaN,NaN,NaN,-0.34342438324694496,0.013877881938910264,0.35730226518585523,41.03773584905653,20.349056603773526,4599665434,10030571188.581928,20.66638996724204,33.07242427199045,16.214153287522056,57.142857142857146,92.85714285714286
2014-01-31,85.54,86.68,85.45,86.27,79.52667726508659,83.51887492769134,85.8818878945376,86.82155613137013,78.54825220000001,83.41424969999994,86.2408,87.09999999999994,87.09999999999994,89.19668309480869,85.00331690519118,45196915,47.25043172962866,53.08867175767322,NaN,NaN,NaN,NaN,NaN,NaN,-0.3090126468120651,-0.028963543329226127,0.28004910348283896,35.61320754716964,26.88679245283012,4554468519,10045636826.91526,18.876311602264728,33.23586569546633,17.9944258992488,50,85.71428571428571
2014-02-03,86.14,86.5,84.07,84.29,79.57407351120513,83.5341447311034,85.81946091828122,86.58045554743012,78.63385715,83.47504959999995,86.2686,86.98249999999993,86.98249999999993,89.4069081752178,84.55809182478207,65617206,38.05893675896213,52.39110337006786,NaN,NaN,NaN,NaN,NaN,NaN,-0.40015721209448485,-0.22014741163526708,0.18000980045921774,4.462474645030685,27.037806013752284,4488851313,9991900925.705385,15.93897533428605,36.901135534482684,19.512754313402088,42.857142857142854,100
2014-02-04,84.7,85.25,84.46,84.91,79.62716730711354,83.56138938989342,85.78379578423097,86.42136454291297,78.71795715,83.54354959999995,86.31280000000001,86.91199999999992,86.91199999999992,89.48671241113857,84.33728758886127,37801215,41.872024122838816,51.18165887481162,NaN,NaN,NaN,NaN,NaN,NaN,-0.39838212098641224,-0.3179678507737975,0.08041427021261469,17.03853955375258,19.038073915317636,4526652528,9997164386.021841,14.949269471304309,34.609816963294406,21.405315430957447,35.714285714285715,92.85714285714286
2014-02-05,84.64,84.9901,83.74,84.69,79.67754375181887,83.58373811484603,85.74090183190819,86.25647268168316,78.79745720000001,83.61034969999996,86.3358,86.79049999999992,86.79049999999992,89.53802597805122,84.04297402194862,41969204,40.90965952237929,49.63720591312633,NaN,NaN,NaN,NaN,NaN,NaN,-0.391158686783422,-0.4085340882666628,-0.01737540148324082,18.06083650190118,13.187283566894815,4484683324,10018983269.054878,13.7518024163449,36.451008557304085,24.4442325751403,28.571428571428573,100
2014-02-06,84.94,85.88,84.92,85.77,79.73816520702465,83.62703042940353,85.74204293653924,86.2101419500943,78.8790572,83.68744969999995,86.3714,86.71349999999993,86.71349999999993,89.4846894558229,83.94231054417695,32338053,47.311663362258855,48.54642157745269,NaN,NaN,NaN,NaN,NaN,NaN,-0.2970445083041753,-0.3886810368634599,-0.09163652855928464,38.59315589353611,24.56417731639662,4517021377,10043910518.242378,18.38304763226889,33.68492039344641,26.352667960162112,21.428571428571427,92.85714285714286
2014-02-07,86.27,87.359,86,87.3,79.81340734426819,83.69976250010842,85.80313929196907,86.31393795484722,78.96845720000002,83.78194959999995,86.43360000000001,86.72749999999992,86.72749999999992,89.50755665411153,83.94744334588832,38467242,54.78529219195908,48.292737777539585,NaN,NaN,NaN,NaN,NaN,NaN,-0.12400754217989626,-0.24664595628415498,-0.12263841410425871,67.68060836501898,41.44486692015209,4555488619,10079037705.38145,25.73200974564356,30.370758450279826,26.485356383328753,14.285714285714286,85.71428571428571
2014-02-10,87.23,87.84,87.21,87.8,79.89287592790731,83.78095532188846,85.88144755502911,86.4554676734332,79.05850725,83.87624959999995,86.49700000000001,86.75249999999991,86.75249999999991,89.56154165153706,83.94345834846277,30225157,56.93511933597588,47.92724225941729,NaN,NaN,NaN,NaN,NaN,NaN,0.023976259098128616,-0.09266809023159794,-0.11664434932972656,77.18631178707221,61.15335868187577,4585713776,10105424747.206846,27.772649146405076,29.14635705148151,26.511423558154195,7.142857142857143,78.57142857142857
2014-02-11,87.94,88.97,87.89,88.8,79.98150402812713,83.8803423452174,85.9959005920868,86.67875646643957,79.15465720000002,83.97114959999995,86.5686,86.89199999999991,86.89199999999991,89.81450988023533,83.96949011976449,38682035,60.93566246037332,47.76099484288132,NaN,NaN,NaN,NaN,NaN,NaN,0.18035385178079197,0.10879796539626341,-0.07155588638452856,96.74952198852769,80.53881404687296,4624395811,10131929104.521662,32.906738605561905,26.971627165595685,26.811388055536863,0,71.42857142857143
2014-02-12,88.97,89.1695,88.7,88.97,80.07094179899154,83.9811276453121,86.11253194141673,86.89697013630247,79.24845715000001,84.06584959999995,86.6334,86.95799999999991,86.95799999999991,90.00305238051446,83.91294761948537,32533008,61.58892207128681,47.83529033794203,NaN,NaN,NaN,NaN,NaN,NaN,0.2804152146122633,0.2789631318808006,-0.001452082731462731,96.32562851091261,90.08715409550416,4656928819,10136814252.687796,33.20615627677987,26.129107520534856,27.191804758537252,100,64.28571428571429
2014-02-13,88.31,89.7,88.3,89.63,80.16605680596675,84.09298650382077,86.25047186528275,87.15725869474986,79.34300715,84.17229959999993,86.71640000000001,87.02099999999992,87.02099999999992,90.22812269800772,83.81387730199211,40492842,64.09902367360067,49.00296334633915,NaN,NaN,NaN,NaN,NaN,NaN,0.37056480589090035,0.4617539246321627,0.09118911874126236,98.82550335570457,97.30021795171496,4697421661,10173257810.487795,33.63342554706462,23.747012946439547,26.75431805667207,100,57.142857142857146
2014-02-14,89.56,90.01,89.33,89.81,80.26201643973822,84.20619469186393,86.39006120389911,87.4099007238213,79.44010715000002,84.28209959999995,86.8044,87.09249999999992,87.09249999999992,90.47650871749363,83.7084912825062,34086390,64.7751032059306,50.55660909559297,NaN,NaN,NaN,NaN,NaN,NaN,0.41829902946051883,0.6140629055669109,0.19576387610639207,96.81020733652308,97.32044640104675,4731508051,10187293382.840736,34.177566106751755,22.66613310067213,25.454451453422255,100,50
2014-02-18,89.93,90.4172,89.74,90.25,80.36139936073585,84.32587400489632,86.54143135276581,87.68038636917164,79.53495715000001,84.39629959999995,86.8996,87.21099999999991,87.21099999999991,90.85315266018245,83.56884733981738,29614391,66.43887184853405,52.24847567226918,NaN,NaN,NaN,NaN,66.43887184853405,NaN,0.45258501988702604,0.7614951509651746,0.3089101310781486,97.49595638890561,97.7105556937111,4761122442,10202284247.03861,35.385488682963114,21.611164997005478,24.434289971173648,100,42.857142857142854
2014-02-19,90.07,90.285,89.45,89.63,80.45362424271858,84.43090620281916,86.66255169187303,87.86606385782196,79.62250715,84.50699959999994,86.98460000000001,87.2649999999999,87.2649999999999,91.01537864756133,83.51462135243847,41775267,61.99536242934485,53.96216423430518,NaN,NaN,NaN,NaN,NaN,NaN,0.4079663335863314,0.8188680480610628,0.41090171447473145,88.21062720900977,94.17226364481284,4719347175,10178519873.595495,33.32582186465229,22.37479834379186,22.743924476897337,92.85714285714286,35.714285714285715
2014-02-20,89.7,90.22,89.31,90.05,80.54911056866167,84.54217538692176,86.79539280199566,88.07405777612463,79.7107572,84.61579959999993,87.06560000000002,87.32849999999992,87.32849999999992,91.21969660259785,83.43730339740199,41833212,63.763408122446194,55.05139148825136,NaN,NaN,NaN,NaN,NaN,NaN,0.3816712423884392,0.8879907674602805,0.5063195250718413,94.50068891151984,93.40242416981175,4761180387,10204723094.298792,31.19477393464869,21.927805168769837,22.340974653989868,85.71428571428571,28.571428571428573
2014-02-21,90.33,90.465,89.82,89.93,80.64245275205808,84.64886498322034,86.91831857446643,88.25081417839847,79.7986072,84.72439949999995,87.1372,87.40099999999991,87.40099999999991,91.42700993541646,83.37499006458336,31221745,62.863553288929374,56.16661445677284,NaN,NaN,NaN,NaN,NaN,NaN,0.3329080133180271,0.9224545417193752,0.5895465284013481,92.04460966542756,91.58530859531908,4729958642,10184150626.663134,31.51076167660454,20.90730426342164,21.81765663884646,100,21.428571428571427
2014-02-24,90.1,90.82,90.04,90.41,80.73964227691322,84.76294686474073,87.05524725782068,88.4564509233129,79.88710715,84.83969949999995,87.21960000000001,87.5844999999999,87.5844999999999,91.8032082146173,83.36579178538251,31517522,64.9917695899264,58.090388230413154,NaN,NaN,NaN,NaN,NaN,NaN,0.3101502733424537,0.9772343700794153,0.6670840967369616,94.20903954802266,93.58477937499003,4761476164,10182534343.483646,32.05260551969238,19.554951627325444,20.713784412833444,100,14.285714285714286
2014-02-25,90.52,90.72,90.02,90.31,80.83486971694393,84.8727895010825,87.18288462025909,88.63297940680691,79.9756246,84.94599959999994,87.32220000000001,87.80499999999992,87.80499999999992,92.10862405422041,83.50137594577943,27464711,64.16674128547362,59.68286802774421,NaN,NaN,NaN,NaN,NaN,NaN,0.2671641282322377,1.0010392570272586,0.7338751287950209,92.79661016949164,93.0167531276473,4734011453,10177826107.312218,30.38772592737946,18.687632399853012,19.58308099500528,92.85714285714286,7.142857142857143
2014-02-26,90.57,90.84,89.87,90.23,80.92835360035743,84.97887287729868,87.30237934103324,88.78507660615864,80.0615246,85.05179969999993,87.4276,88.02399999999992,88.02399999999992,92.35309413157891,83.69490586842092,42968334,63.472562735217885,61.294503971518395,NaN,NaN,NaN,NaN,NaN,NaN,0.2144200476172381,1.0019001883165686,0.7874801406993305,89.69594594594597,92.23386522115345,4691043119,10166751794.42562,28.201710049584594,18.455726533745594,17.845464678944403,100,0
2014-02-27,89.87,90.53,89.73,90.44,81.02299684811506,85.08701400844129,87.42542328844371,88.94268835795306,80.14802460000001,85.16899969999993,87.5394,88.29949999999992,88.29949999999992,92.50548371371822,84.09351628628163,28750313,64.55651852975265,62.526279340625095,NaN,NaN,NaN,NaN,NaN,NaN,0.1763432297776485,1.0079091779213911,0.8315659481437426,91.73553719008254,91.40936443517342,4719793432,10189033287.000618,26.508014864709363,18.39832897078164,17.0362392537992,92.85714285714286,0
2014-02-28,90.41,90.96,89.54,90.34,81.11570334713879,85.19103353302661,87.53972041438709,89.07576565719563,80.2321246,85.27839979999993,87.63980000000001,88.49149999999993,88.49149999999993,92.70195496354759,84.28104503645227,48623159,63.58882342126468,63.15510299986121,NaN,NaN,NaN,NaN,NaN,NaN,0.12927022012900546,0.9931537233049994,0.8638835031759939,83.46666666666692,88.29938326756518,4671170273,10195196786.028788,26.896621594919512,16.503700011082685,18.156120696445246,100,0
2014-03-03,89.48,89.91,88.87,89.67,81.20082072676925,85.27972593831322,87.62326079029349,89.13235940412937,80.3121246,85.38769969999994,87.73020000000001,88.66149999999993,88.66149999999993,92.77283688720122,84.55016311279864,38946845,57.38246141127727,63.18705600523988,NaN,NaN,57.38246141127727,NaN,NaN,NaN,0.04235551533344384,0.9168278973427988,0.874472382009355,57.980456026058796,77.72755329426944,4632223428,10216168164.105711,24.12675770895491,19.49784906856154,18.741644356313113,92.85714285714286,0
2014-03-04,90.63,90.98,90.56,90.81,81.296434450881,85.38923631577237,87.74823095538001,89.2921346989742,80.3982246,85.52359969999993,87.8236,88.98749999999993,88.98749999999993,92.67249592944856,85.3025040705513,33213909,63.847983163106115,63.395078912577944,NaN,NaN,NaN,NaN,NaN,NaN,0.05043845504972333,0.9375204508215091,0.8870819957717858,93.6567164179104,78.36794637021207,4665437337,10222494622.962854,29.303220177585555,17.744151954989775,19.788576669253057,100,0
2014-03-05,90.9698,91.22,90.77,91.06,81.39358435684238,85.50152866595509,87.87810425124746,89.46050282288141,80.48202460000002,85.66439969999993,87.9268,89.29499999999993,89.29499999999993,92.57140351606024,86.01859648393962,27220604,65.09847110092623,63.64576098612361,NaN,NaN,NaN,NaN,65.09847110092623,NaN,0.0607276766400171,0.9629915915718072,0.9022639149317901,94.52054794520559,82.0525734630583,4692657941,10230358353.0073,30.077030395906522,17.172760301141995,20.88739976332942,100,7.142857142857143
2014-03-06,91.25,91.335,90.65,90.98,81.48897157717231,85.61001324682726,87.99974722178678,89.60521683974984,80.5659746,85.78809969999993,88.01640000000002,89.60949999999994,89.60949999999994,92.19132474231722,87.02767525768266,24086220,64.33162858410861,63.66237562258847,NaN,NaN,NaN,NaN,NaN,NaN,0.05066213524944785,0.9655915839936,0.9149294487441522,85.59837728194762,91.25854721502124,4668571721,10229479293.883213,28.568913156330566,17.19008369417797,21.432919849394104,100,0
2014-03-07,91.27,91.36,90.071,90.53,81.57893205899148,85.70743872708812,88.09897282093239,89.69329142644034,80.6472746,85.90109969999995,88.07880000000002,89.84749999999994,89.84749999999994,91.76070542546884,87.93429457453104,31174837,60.04680901845807,63.32464032348329,NaN,NaN,NaN,NaN,NaN,NaN,0.0046382702052893965,0.9207272865007639,0.9160890162954745,66.66666666666667,82.26186396460666,4637396884,10220506551.814167,25.93372251934158,19.747750904039773,20.95367023275828,100,71.42857142857143
2014-03-10,90.48,90.655,90.03,90.61,81.66879343153883,85.8045191483339,88.19744447501347,89.7805970048746,80.73222960000001,86.00929979999994,88.14200000000001,90.01299999999993,90.01299999999993,91.55219589397859,88.47380410602128,18138198,60.54986765983845,62.90399716714789,NaN,NaN,NaN,NaN,NaN,NaN,-0.027698138152642438,0.8814663436046715,0.9091644817573139,69.8795180722891,74.04818734030117,4655535082,10236032849.302166,24.742026808171367,19.141752818704937,20.13900627908637,92.85714285714286,64.28571428571429
2014-03-11,90.83,91.055,89.95,90.22,81.75388006406084,85.89195441272332,88.27676037795412,89.82244490917225,80.81607960000001,86.11669979999994,88.19160000000002,90.13399999999993,90.13399999999993,91.29143509539135,88.97656490460851,27505046,56.79547102963866,62.53257635288316,NaN,NaN,NaN,NaN,NaN,NaN,-0.07969155820495522,0.8095500340011199,0.8892415922060751,54.2168674698794,63.587684069611754,4628030036,10221969183.247868,25.663780657187218,17.601744152675277,20.0656743200812,85.71428571428571,57.142857142857146
2014-03-12,89.82,90.61,89.48,90.56,81.84150314800053,85.98439095900603,88.3662991866618,89.89268825115585,80.90182960000001,86.21849979999993,88.25240000000002,90.22199999999992,90.22199999999992,91.2165169682017,89.22748303179814,27997215,59.17221171505561,62.20463375235527,NaN,NaN,NaN,NaN,NaN,NaN,-0.09451150360551897,0.7711022126991764,0.8656137163046954,67.87148594377514,63.98929049531457,4656027251,10247488768.60185,23.574994812847947,19.554396020602827,19.485508436388844,78.57142857142857,50
2014-03-13,90.9,90.93,88.87,89.28,81.91551804205027,86.04965054397621,88.40213059110644,89.83433698914101,80.97877960000002,86.30289979999993,88.29020000000003,90.23749999999993,90.23749999999993,91.16057908655692,89.31442091344293,48541951,48.38155077423055,61.170205001305355,NaN,NaN,NaN,NaN,NaN,NaN,-0.18842415378773159,0.6300835240700309,0.8185076778577625,16.465863453815157,46.18473895582326,4607485300,10218269341.786316,20.326969684232,20.940025815476137,18.14671937030425,71.42857142857143,42.857142857142854
2014-03-14,88.99,89.38,88.63,88.67,81.98272681775126,86.10153865201629,88.41263527380815,89.72344775207996,81.05442965000002,86.36809989999992,88.30440000000003,90.18949999999992,90.18949999999992,91.31220165228383,89.06679834771602,38738769,44.24098593632023,59.68800616890491,NaN,NaN,44.24098593632023,NaN,NaN,NaN,-0.28380023122230913,0.46375738882987605,0.7475576200521852,1.465201465201692,28.600850287597353,4568746531,10183662708.146317,19.285202428256277,21.506854965928053,16.805974674287782,64.28571428571429,100
2014-03-17,89.24,89.91,89.19,89.45,82.05702804344527,86.1678448173229,88.45331624346274,89.69740510902473,81.13202970000002,86.43929989999994,88.34800000000001,90.17149999999992,90.17149999999992,91.3289674941628,89.01403250583705,28476800,50.11940909707561,58.68462529830505,NaN,NaN,NaN,NaN,NaN,NaN,-0.285740394086367,0.3903821274442265,0.6761225215305935,30.036630036630264,15.98923165188237,4597223331,10175752485.924095,21.24669007098104,19.708419090415394,15.371325871896214,57.142857142857146,92.85714285714286
2014-03-18,89.55,90.64,89.53,90.53,82.14133622211746,86.25422412787097,88.53475482215048,89.77669986054619,81.21842970000003,86.52009989999993,88.42580000000002,90.18549999999992,90.18549999999992,91.35315534300506,89.01784465699478,31250235,56.895540236227426,58.21483797694858,NaN,NaN,NaN,NaN,NaN,NaN,-0.20921847000602667,0.4145994340230601,0.6238179040290868,69.5970695970697,33.699633699633885,4628473566,10200808980.653826,24.43639292788155,18.140654130091082,14.935491215757732,50,85.71428571428571
2014-03-19,90.56,90.66,89.45,90.04,82.21992989154913,86.32918998672501,88.59378404481124,89.8017760643037,81.30172970000002,86.60099989999993,88.50020000000002,90.20599999999993,90.20599999999993,91.34804027951382,89.06395972048604,40869371,53.35413745567518,57.41466790022877,NaN,NaN,NaN,NaN,NaN,NaN,-0.18724631657898227,0.38976000830535895,0.5770063248843412,51.64835164835197,50.42735042735065,4587604195,10199795690.463743,22.478372903879535,17.216860787665897,14.592324128668636,42.857142857142854,78.57142857142857
2014-03-20,89.78,90.56,89.58,90.29,82.30022909660835,86.40762186817601,88.66030231756375,89.84827358198906,81.38817970000002,86.68079989999993,88.56360000000002,90.21799999999993,90.21799999999993,91.35827365138151,89.07772634861836,31634538,54.89666993865943,56.79379979432839,NaN,NaN,NaN,NaN,NaN,NaN,-0.1529648757260621,0.3858002302267636,0.5387651059528257,60.805860805861116,60.68376068376093,4619238733,10213998952.422928,21.010015458252482,16.092201728222562,13.8286187002836,35.714285714285715,71.42857142857143
2014-03-21,90.61,90.65,88.825,89,82.36689348370678,86.45895608860816,88.67362379530634,89.76748562179962,81.47292970000002,86.74179999999993,88.59740000000004,90.17149999999992,90.17149999999992,91.42517100949206,88.91782899050779,62812715,46.37475486168655,56.007535040786195,NaN,NaN,NaN,NaN,NaN,NaN,-0.21069586614785785,0.2753952732680034,0.48609113941586124,13.5531135531137,42.002442002442265,4556426018,10163232511.532516,18.576409942430654,19.02013179346423,13.155007656187095,28.571428571428573,64.28571428571429
2014-03-24,89.32,89.39,87.41,88.22,82.42513334954054,86.49382824526938,88.65583462686295,89.62010603877108,81.55202975000003,86.79479999999992,88.62140000000004,90.06199999999993,90.06199999999993,91.5699867373549,88.55401326264496,77735313,42.117377927707615,54.45534895254344,NaN,NaN,NaN,NaN,NaN,NaN,-0.2900448849564207,0.12353503322033532,0.41357991817675605,20.506329113924092,31.621767824299642,4478690705,10149098818.259789,16.362048594711304,25.271668368489426,12.928651355204428,21.428571428571427,100
2014-03-25,88.69,89.25,87.7701,88.51,82.48567928636103,86.53375243843237,88.65011562188793,89.51438165412623,81.62762975000003,86.84929999999993,88.64560000000003,89.97199999999994,89.97199999999994,91.61853089859721,88.32546910140266,41723335,44.1695769355675,52.96042794073211,NaN,NaN,NaN,NaN,NaN,NaN,-0.30983808721525014,0.026282309157693362,0.3361203963729435,27.84810126582298,20.635847977620262,4520414040,10149095998.925037,14.929576840165435,23.059173342664078,12.506455992035873,14.285714285714286,92.85714285714286
2014-03-26,88.96,89.15,87.36,87.37,82.5342794924669,86.55031179608717,88.59991500926488,89.31015482992373,81.69737975000002,86.89319999999992,88.67280000000004,89.82899999999992,89.82899999999992,91.82149491845009,87.83650508154976,40930442,38.40519454056989,51.10853979476506,NaN,NaN,NaN,NaN,NaN,NaN,-0.3818183406641843,-0.14115252945728685,0.24066581120689742,0.2500000000001279,16.201476793249075,4479483598,10108622880.29934,13.401304324615237,23.043966055800155,12.620102790183207,7.142857142857143,100
2014-03-27,87.27,87.64,86.4,86.879,82.5775105422931,86.55682047339238,88.53242814615645,89.0786162746929,81.76832475000002,86.93408999999993,88.65738000000003,89.65094999999994,89.65094999999994,91.99808966138316,87.30381033861671,64784488,36.213112892047555,49.40613292859287,NaN,NaN,36.213112892047555,NaN,NaN,NaN,-0.4404471978904115,-0.30989318615611694,0.13055401173429454,10.290010741138541,12.79603733565389,4414699110,10093889633.834824,12.450495349823083,26.901844842094143,14.275920003203709,0,100
2014-03-28,87.15,88.01,86.81,87.05,82.62201292495685,86.56658640461234,88.47429370905228,88.88541472472215,81.84432470000003,86.97648999999993,88.63098000000004,89.48644999999993,89.48644999999993,92.06692549688854,86.90597450311132,39895065,37.550011349998066,47.76328604931856,NaN,NaN,NaN,NaN,NaN,NaN,-0.44438307534380006,-0.42492483244545554,0.019458242898344524,13.963480128893476,8.167830290010722,4454594175,10069952594.834824,13.71617043445294,25.049628400989725,15.45264215604019,7.142857142857143,92.85714285714286
2014-03-31,87.73,88.26,87.62,87.67,82.6722416520717,86.58843617877842,88.44275277928551,88.76966094141528,81.91887475000003,87.02388999999992,88.61678000000003,89.38644999999994,89.38644999999994,92.08311716337698,86.6897828366229,33924297,42.274099499966134,46.72604522577053,NaN,NaN,NaN,NaN,NaN,NaN,-0.38416515748252156,-0.4607482039548074,-0.07658304647228587,28.035320088300125,17.429603652777388,4488518472,10041328969.241074,14.199291935096781,23.307074415285946,15.856173532871994,0,85.71428571428571
2014-04-01,88.1,89.27,87.7106,89.21,82.73729397394163,86.6403483336541,88.47284090558804,88.81159799461382,82.00352475000001,87.08578999999992,88.64338000000004,89.30644999999993,89.30644999999993,91.9231925914748,86.68970740852505,38683837,51.98903234662805,46.21296098516855,NaN,NaN,NaN,NaN,NaN,NaN,-0.2273057655284738,-0.36071525338287813,-0.13340948785440432,62.03090507726242,34.67656843148534,4527202309,10077035981.539265,18.60909741805315,21.20634519514146,15.656247722669653,7.142857142857143,78.57142857142857
2014-04-02,89.59,89.68,89.035,89.44,82.80398756624072,86.69578698051244,88.51076871321204,88.8714458046506,82.08582475000003,87.15018999999991,88.66118000000004,89.22544999999992,89.22544999999992,91.71737242857614,86.7335275714237,34631615,53.254357150904426,46.5610185835024,NaN,NaN,NaN,NaN,53.254357150904426,NaN,-0.10117926217591561,-0.2598835655742988,-0.1587043033983832,71.36150234741781,53.80924250432679,4561833924,10085895231.888102,20.30200128297694,20.40779395285337,15.568696701533456,0,71.42857142857143
2014-04-03,89.55,89.679,88.22,88.73,82.86295286408907,86.73606842644288,88.51936601857628,88.85797477563627,82.16157475000001,87.22308999999991,88.66018000000004,89.11294999999993,89.11294999999993,91.477787709028,86.74811229097186,30319074,48.96436147959778,46.89840255087937,NaN,NaN,NaN,NaN,NaN,NaN,-0.06068529370732906,-0.23456092053254451,-0.17387562682521546,54.694835680751254,62.6957477018105,4531514850,10076772494.748966,18.596153245606978,23.38663230737747,15.994717580882465,21.428571428571427,64.28571428571429
2014-04-04,89.29,89.41,86.14,86.37,82.89784885549116,86.72881954671134,88.4350771551027,88.62102479700424,82.22962480000002,87.26138999999992,88.61798000000005,88.90494999999991,88.90494999999991,91.45887838389126,86.35102161610857,131213229,38.00508754983459,46.033093868933584,NaN,NaN,NaN,NaN,NaN,NaN,-0.18114773110576654,-0.40031029070742363,-0.2191625596016571,5.088495575221332,43.71494453446348,4400301621,9964017395.822361,15.460655237597901,30.168453307176634,18.028815741304197,14.285714285714286,100
2014-04-07,85.84,86.63,84.951,85.55,82.92423841911811,86.70547658539031,88.32193687451044,88.3285462449086,82.30224985000002,87.29278999999991,88.59418000000004,88.65194999999993,88.65194999999993,91.46907850080355,85.83482149919631,83995771,35.068110292961975,44.47399173012891,NaN,NaN,35.068110292961975,NaN,NaN,NaN,-0.29748761083393394,-0.5910220731440745,-0.2935344623101406,10.492205289893212,23.425178848621936,4316305850,9939954283.3441,14.142137170953994,33.63496061856991,19.88687408435997,7.142857142857143,100
2014-04-08,85.65,86.46,85.35,86.34,82.95822609653982,86.69823942528357,88.24421385982376,88.13916088825063,82.38179990000002,87.33078999999991,88.60298000000004,88.45794999999994,88.45794999999994,91.3498240273449,85.56607597265499,51495650,39.88780320510179,43.512110712230815,NaN,NaN,NaN,NaN,NaN,NaN,-0.3017203493566122,-0.6706848990059058,-0.3689645496492936,24.372696964379838,13.317799276498127,4367801500,9980315738.749508,13.332611931788618,31.709625769252437,21.854355726611733,0,92.85714285714286
2014-04-09,86.67,87.87,86.43,87.82,83.00660195627574,86.72045250597102,88.22757802218361,88.10876461317913,82.47224990000002,87.37358999999991,88.64238000000005,88.32094999999994,88.32094999999994,91.05692013690415,85.58497986309573,45685231,47.71737510623383,42.99930393848613,NaN,NaN,NaN,NaN,NaN,NaN,-0.19074274675818803,-0.6073929830970286,-0.4166502363388406,50.34216529215641,28.40235584880982,4413486731,10022828384.263395,19.505812408770264,29.226254536365246,22.33235112202262,7.142857142857143,85.71428571428571
2014-04-10,87.87,87.88,84.86,85.1,83.02743178755658,86.68836433753596,88.1049279036666,87.82221560240016,82.54654985000003,87.3865899999999,88.64578000000004,88.11194999999994,88.11194999999994,91.14538979502441,85.07851020497546,73659615,37.93745185777807,42.396639438206954,NaN,NaN,NaN,NaN,NaN,NaN,-0.28097061038130144,-0.7678634993154674,-0.48689288893416593,4.979253112033081,26.56470512285644,4339827116,9960876257.740217,16.72200561803173,32.47455993022864,24.5351655588867,0,100
2014-04-11,84.34,85.44,83.91,84.11,83.03820361056597,86.6373076179808,87.94826406430712,87.46867125931443,82.61274985000001,87.38808999999992,88.59798000000005,87.88394999999994,87.88394999999994,91.36743357108591,84.40046642891397,93657425,35.11634713204248,41.89656580994516,NaN,NaN,NaN,NaN,NaN,NaN,-0.38153532126869893,-0.9638120405200397,-0.5822767192513407,3.466204506065901,19.595874303418462,4246169691,9891704434.047407,15.51400244899616,34.61409762841979,25.728205635931097,50,100
2014-04-14,84.85,85.22,83.99,84.77,83.05543541543597,86.60033122950593,87.82362625786371,87.21165494890353,82.68074985000003,87.4043899999999,88.56798000000005,87.64994999999993,87.64994999999993,91.30569454660557,83.9942054533943,46500747,38.4047980124173,41.484795886863004,NaN,NaN,NaN,NaN,NaN,NaN,-0.37713845797033996,-1.0536997917142656,-0.6765613337439257,14.904679376083152,7.7833789980607095,4292670438,9904180244.21814,14.600824425553938,32.57665865292177,26.921245712975495,42.857142857142854,92.85714285714286
2014-04-15,85.06,85.54,83.28,85.0501,83.0752828242376,86.5696335813969,87.7148605222612,87.00579257281748,82.74965035000002,87.42589099999992,88.58318200000005,87.37595499999993,87.37595499999993,90.9476606925144,83.80424930748546,84631517,39.799275921162554,41.5843731283339,NaN,NaN,NaN,NaN,NaN,NaN,-0.3305689599068903,-1.0897725336275386,-0.7592035737206483,27.657812499999967,15.342898794049674,4377301955,9952120628.316988,13.077651013130692,32.45557013183652,28.071234061909422,35.714285714285715,100
2014-04-16,85.83,86.18,85.091,86.18,83.10617553245415,86.5619180649336,87.65466991354508,86.92714566112058,82.82200030000004,87.46069099999991,88.60858200000004,87.18295499999994,87.18295499999994,90.5703906191574,83.79551938084248,46970899,45.18987610540947,42.2255705007169,NaN,NaN,NaN,NaN,NaN,NaN,-0.20502203719420808,-1.0154811202134084,-0.8104590830192003,45.31250000000005,29.29166395869439,4424272854,9999091527.316988,15.394449648818043,30.729555387708412,27.822990155694594,28.571428571428573,92.85714285714286
2014-04-17,85.89,86.63,85.63,86.2,83.1369598555143,86.55475137057847,87.59762403458252,86.85789369339481,82.89430025000003,87.48729099999991,88.63878200000003,86.97845499999994,86.97845499999994,90.07198590398835,83.88492409601153,53719454,45.28327251742557,42.7779462983903,NaN,NaN,NaN,NaN,NaN,NaN,-0.10691891028017997,-0.9441077208694253,-0.8371888105892453,45.624999999999986,39.53177083333333,4477992308,10006612250.87699,16.822684255414416,29.247096391694694,27.6610592407435,21.428571428571427,85.71428571428571
2014-04-21,86.41,86.84,86,86.84,83.1738060261062,86.56039985828978,87.56791328812831,86.85618953211912,82.96834520000002,87.51579099999992,88.66018200000003,86.87045499999994,86.87045499999994,89.82168907643924,83.91922092356063,25947923,48.31815632435618,43.20966464298959,NaN,NaN,NaN,NaN,NaN,NaN,0.008650890472317818,-0.826375197498848,-0.8350260879711658,55.624999999999986,48.85416666666668,4503940231,10032560173.87699,17.164624484077258,28.02410841614527,27.643066376383707,14.285714285714286,78.57142857142857
2014-04-22,87.1,87.745,86.9898,87.53,83.2171512397768,86.57959986109593,87.56642649251543,86.92036195763158,83.04309520000002,87.54919099999992,88.66478200000003,86.83595499999993,86.83595499999993,89.73901668620958,83.93289331379027,38593408,51.445023961638825,43.170806901204635,NaN,NaN,NaN,NaN,NaN,NaN,0.1322812701371905,-0.6696745002996778,-0.8019557704368683,66.40624999999994,55.885416666666636,4542533639,10049179051.368515,20.99758019294854,26.727377814386312,28.034684618207525,7.142857142857143,71.42857142857143
2014-04-23,87.55,87.56,86.71,86.76,83.25240346624668,86.58317214107423,87.5348019241815,86.9050893902381,83.11364525000003,87.5704909999999,88.64398200000004,86.74845499999994,86.74845499999994,89.54806401804714,83.94884598195273,34376729,47.957970442109854,42.79249356486218,NaN,NaN,NaN,NaN,NaN,NaN,0.161007670767224,-0.6006961819778383,-0.7617038527450622,54.38349742147216,58.804915807157364,4508156910,10018846643.42734,20.05877105770894,27.004146911723666,29.070239572992453,0,64.28571428571429
2014-04-24,88.2,88.21,86.65,87.59,83.29556363076163,86.60310932639949,87.53696655460575,86.97031897212018,83.18614525000002,87.59419099999992,88.61978200000003,86.75945499999995,86.75945499999995,89.57045172961917,83.94845827038073,48926264,51.754154098546856,42.99176446621568,NaN,NaN,NaN,NaN,NaN,NaN,0.23048550360276,-0.4735969732416123,-0.7040824768443723,70.30995106035898,63.69989949394369,4557083174,10028882800.145288,21.813196222373882,24.81158009496261,28.71454683184941,0,57.142857142857146
2014-04-25,87.08,87.17,85.98,86.19,83.3243639926446,86.5949289436985,87.48414433677807,86.8960028795373,83.24954530000002,87.5987909999999,88.56418200000003,86.72500499999994,86.72500499999994,89.54616664051778,83.9038433594821,44341588,45.698887800460746,43.54132162697469,NaN,NaN,NaN,NaN,NaN,NaN,0.17902468845583908,-0.48030161627457346,-0.6593263047304125,59.026369168357014,61.239939216729375,4512741586,10000191184.380583,20.007665990461422,26.202431491139194,27.36971013721588,0,50
2014-04-28,86.58,87.11,85.11,86.47,83.35566385341431,86.59245510322923,87.44437397062991,86.85543117672422,83.30704530000003,87.60869099999992,88.50098200000004,86.69600499999994,86.69600499999994,89.5151307797277,83.87687922027219,58623796,47.03364657875606,44.396002790245696,NaN,NaN,NaN,NaN,NaN,NaN,0.1612651744251472,-0.4577448366989785,-0.6190100111241257,64.70588235294123,64.68073419388574,4571365382,10021295750.940582,18.013040821670494,27.926878786646252,25.99688826178237,85.71428571428571,42.857142857142854
2014-04-29,86.75,87.32,86.31,87.16,83.39351794442511,86.60369361603657,87.43322205021305,86.88443773132191,83.36634530000003,87.6261909999999,88.44798200000002,86.67050499999995,86.67050499999995,89.46302969674299,83.8779803032569,36742661,50.27723032484524,45.13810472737023,NaN,NaN,NaN,NaN,NaN,NaN,0.19135765231523627,-0.3798129457300803,-0.5711705980453166,78.70182555780936,67.47802569303587,4608108043,10046397172.811869,18.15596482686118,26.490618896026856,24.41607064192325,78.57142857142857,35.714285714285715
2014-04-30,86.79,87.48,86.54,87.39,83.43328393502784,86.61926403948138,87.43152706785175,86.93258651881506,83.42594530000004,87.6451909999999,88.39078200000003,86.57950499999995,86.57950499999995,89.14442172806586,84.01458827193404,38689408,51.346777826950444,45.39734777884998,NaN,NaN,NaN,NaN,NaN,NaN,0.22007306612426003,-0.2960792653899915,-0.5161523315142516,83.36713995943217,75.59161595672758,4646797451,10077677970.769316,18.10034242535184,25.19204912147523,24.161374061538673,71.42857142857143,28.571428571428573
2014-05-01,87.53,88.15,87.31,87.65,83.47524130880866,86.63967465256096,87.44009463381835,87.00091161226125,83.48734530000003,87.66789099999991,88.35118200000002,86.49000499999994,86.49000499999994,88.75704324447652,84.22296675552336,37127219,52.588316738860236,46.4438381274987,NaN,NaN,NaN,NaN,NaN,NaN,0.24783299228421568,-0.20636109115898194,-0.4541940834431976,88.64097363083187,83.56997971602446,4683924670,10070606119.531221,20.87816611638068,24.0571594394194,22.379586584033035,64.28571428571429,21.428571428571427
2014-05-02,87.94,88.11,87.28,87.49,83.51518915648221,86.65651277825282,87.44205170700194,87.04749145871256,83.54699530000003,87.68279099999991,88.29998200000004,86.42800499999994,86.42800499999994,88.50660281629774,84.34940718370214,40074150,51.71376362196767,47.62936787677908,NaN,NaN,NaN,NaN,NaN,NaN,0.2461705357718978,-0.1464809137283254,-0.3926514495002232,85.39553752535497,85.80121703853966,4643850520,10050810455.07339,19.9231060434738,23.122019447745444,20.188798234824237,57.142857142857146,14.285714285714286
2014-05-05,86.98,87.97,86.76,87.95,83.55931662756198,86.68212638660425,87.46197124790382,87.13344465312089,83.60989530000005,87.69879099999991,88.26038200000002,86.50700499999995,86.50700499999995,88.68834076551406,84.32566923448584,27924376,54.078255529368526,48.7489005565613,NaN,NaN,NaN,NaN,NaN,NaN,0.26515972764508616,-0.06120178994386549,-0.32636151758895166,94.72616632860058,89.58755916159579,4671774896,10077811711.20562,18.5881514206257,24.452289131839102,18.440379970847605,50,7.142857142857143
2014-05-06,87.83,87.86,86.77,86.81,83.59166173574545,86.68465853736457,87.43640374798602,87.10264040044271,83.67099530000003,87.70399099999992,88.18838200000003,86.57000499999994,86.57000499999994,88.7095234509426,84.43048654905728,33698549,47.82761016378503,49.32235300246292,NaN,NaN,NaN,NaN,NaN,NaN,0.19338491305739047,-0.08463037626721359,-0.27801528932460406,55.113818531580904,78.41184079517882,4638076347,10046586450.20562,17.36609054991495,22.84469593598378,16.373733935181694,42.857142857142854,0
2014-05-07,87,87.08,85.53,86.56,83.62119743986739,86.68219005147616,87.40203497355519,87.0509603623053,83.72974530000003,87.7177909999999,88.11338200000002,86.58100499999993,86.58100499999993,88.71794083477126,84.44406916522861,67489143,46.55673029966867,49.419985444910004,NaN,NaN,NaN,NaN,NaN,NaN,0.12484048945707746,-0.12196467750325724,-0.2468051669603347,46.774193548387274,65.53805946952292,4570587204,10068792555.321749,15.888438350959289,27.70794713748039,15.935423490646794,35.714285714285715,0
2014-05-08,86.26,87.53,86.05,86.48,83.64964323648562,86.67818628808058,87.36587673929812,86.99658318494289,83.79084535000004,87.73299099999991,88.03838200000001,86.51400499999993,86.51400499999993,88.57399467034595,84.4540153296539,46556871,46.13427170616202,49.48077110124831,NaN,NaN,46.13427170616202,NaN,NaN,NaN,0.07247849041488558,-0.15620705394172774,-0.2286855443566133,44.193548387097,48.69385348902173,4524030333,10049289001.25418,17.056412835100158,25.478681537914998,15.4234285945734,28.571428571428573,42.857142857142854
2014-05-09,86.41,86.86,85.85,86.8,83.68099006995342,86.68059844079185,87.34368549461976,86.9778609768531,83.85234535000005,87.7524909999999,87.96558200000003,86.59900499999993,86.59900499999993,88.55633329181101,84.64167670818885,35081529,48.16058432538839,49.469515958464896,NaN,NaN,NaN,NaN,NaN,NaN,0.05836609648048757,-0.15572792375600386,-0.21409402023649143,54.51612903225809,48.49462365591412,4559111862,10080202427.798735,16.104185653676627,25.161762067863975,15.274705585768146,21.428571428571427,35.714285714285715
2014-05-12,87.31,88.26,87.24,88.23,83.7262538503519,86.71127965978607,87.3784429262033,87.09711231239089,83.91864535000005,87.78159099999989,87.92338200000003,86.80500499999992,86.80500499999992,88.52383884942705,85.0861711505728,38951060,56.106824028031326,49.80250167749294,NaN,NaN,NaN,NaN,NaN,NaN,0.13967218771681797,-0.039503785590468965,-0.17917597330728693,99.04761904761901,65.9190988223247,4598062922,10116862248.975204,22.483932293000066,23.149814938170728,14.521371052156045,100,28.571428571428573
2014-05-13,88.32,88.61,88.12,88.29,83.77166425980113,86.7425414487012,87.41419026243062,87.21072066359176,83.98324535000005,87.81299099999991,87.89578200000001,86.98100499999993,86.98100499999993,88.54410408896821,85.41790591103164,30311862,56.40875021408327,50.40612880406247,NaN,NaN,NaN,NaN,56.40875021408327,NaN,0.18877399664156005,0.05679152249466313,-0.13198247414689693,90.85714285714305,81.47363031234003,4628374784,10107583107.546633,23.85871869325018,22.49956904183978,13.676670894901154,100,21.428571428571427
2014-05-14,88.03,88.35,87.62,87.83,83.81204570995236,86.7640752814002,87.43049652664902,87.2696996480116,84.04624535000005,87.8298909999999,87.83618200000002,87.11999999999992,87.11999999999992,88.44833730657457,85.79166269342527,26483571,53.37729206520243,50.522067230252155,NaN,NaN,NaN,NaN,NaN,NaN,0.1815013480447208,0.09489421090900407,-0.08660713713571672,77.71428571428568,89.20634920634923,4601891213,10096336659.587729,22.829884761341933,24.482900923689456,13.466879706672893,92.85714285714286,14.285714285714286
2014-05-15,87.81,87.96,86.58,87.135,83.84510993174388,86.77142032533287,87.41890842756474,87.25687111010573,84.10377035000005,87.8422409999999,87.75768200000002,87.16774999999993,87.16774999999993,88.42420722172456,85.9112927782753,59680284,49.08521552777705,50.76394778220332,NaN,NaN,NaN,NaN,NaN,NaN,0.12386469660172125,0.06822373361643486,-0.055640962985286396,57.85714285714302,75.47619047619058,4542210929,10084660082.28338,20.98742415122467,28.58906809700355,13.604558903798676,85.71428571428571,7.142857142857143
2014-05-16,87.24,87.76,86.64,87.71,83.88356654933847,86.7900060614649,87.43032378334652,87.30002624247662,84.16347035000007,87.85434099999989,87.69228200000003,87.2432499999999,87.2432499999999,88.43798124594761,86.0485187540522,66807315,52.48907871353837,51.15362150611633,NaN,NaN,NaN,NaN,NaN,NaN,0.1184483927459438,0.09241952794714337,-0.02602886479880044,70.77922077922058,68.78354978354976,4609018244,10145502458.444094,19.604572809184678,26.70534807015561,13.158355685190575,78.57142857142857,0
2014-05-19,87.47,88.46,87.3,88.32,83.92771016576296,86.82030297113886,87.4652130467447,87.39716660033599,84.22237040000006,87.8634409999999,87.64808200000004,87.31724999999992,87.31724999999992,88.58407072529182,86.05042927470801,32017036,55.86042243138994,51.5524209422981,NaN,NaN,NaN,NaN,NaN,NaN,0.14801037306661774,0.15898410153447173,0.010973728467854,90.58441558441538,73.07359307359299,4641035280,10169791244.375128,22.39368426739449,24.877077905778453,12.200175991825905,71.42857142857143,42.857142857142854
2014-05-20,88.28,88.6,87.64,88,83.96823046262104,86.84366330834403,87.48618508412726,87.45457930506589,84.27752040000004,87.8689409999999,87.59588200000006,87.34074999999993,87.34074999999993,88.63951970630819,86.04198029369167,33715953,53.70740009065528,51.721036818277014,NaN,NaN,NaN,NaN,NaN,NaN,0.13825860347979452,0.18379698281759715,0.04553837933780264,80.1948051948052,80.51948051948038,4607319327,10161362256.125128,21.944536874839848,23.446479617674456,11.266457762283105,64.28571428571429,35.714285714285715
2014-05-21,88.16,88.89,88.11,88.84,84.01670578140093,86.88319472798078,87.53927586514187,87.58652413315485,84.33662040000004,87.87994099999989,87.56828200000005,87.44474999999991,87.44474999999991,88.8679979580298,86.02150204197002,36837678,58.2557604490469,52.125854226147496,NaN,NaN,NaN,NaN,NaN,NaN,0.17809031166494543,0.26815126891898444,0.09006095725403901,98.51190476190484,89.76370851370847,4644157005,10193477154.89436,22.52224335650706,22.17340410749051,10.816877741814654,100,28.571428571428573
2014-05-22,88.94,89.48,88.8,89.23,84.06857935571534,86.92966611950591,87.60557877239121,87.74304564428296,84.39997040000006,87.8970409999999,87.54168200000005,87.52674999999991,87.52674999999991,89.14907633894606,85.90442366105376,30617089,60.21046944991762,52.73276178528677,NaN,NaN,NaN,NaN,NaN,NaN,0.21778808660194496,0.3622960655064702,0.14450797890452524,93.67088607594937,90.79253201088646,4674774094,10201581678.453184,25.269634043957666,21.225137158204593,10.907398191883834,100,21.428571428571427
2014-05-23,89.33,89.9,89.12,89.88,84.126404436753,86.988088572585,87.6947717617092,87.9465651067322,84.46727040000005,87.92194099999989,87.55368200000004,87.71124999999991,87.71124999999991,89.51290444801195,85.90959555198786,22691254,63.29536131364164,53.391126484163415,NaN,NaN,NaN,NaN,NaN,NaN,0.2714171013032819,0.4837793555336276,0.21236225423034572,99.54233409610961,97.24170831132126,4697465348,10223109278.401901,26.70353879180866,20.16010806594266,10.93153996596361,100,14.285714285714286
2014-05-27,90.28,91.02,90.2,91.001,84.19480837270571,87.06755216520708,87.82442777105395,88.2374636679958,84.53827540000003,87.95235099999991,87.60030200000004,87.9377999999999,87.9377999999999,90.15071885076003,85.72488114923976,29725231,67.91539150351088,54.82596800842955,NaN,NaN,NaN,NaN,NaN,NaN,0.36040613080977846,0.6628699177425688,0.3024637869327903,99.65391621129342,97.62237879445077,4727190579,10251456998.697023,31.940204597643202,18.684448488108842,11.828659481318464,100,7.142857142857143
2014-05-28,90.97,91.1,90.645,90.72,84.25973565257928,87.13987786490594,87.93797962316948,88.47389569961524,84.60942535000005,87.9868509999999,87.62570200000003,88.1157999999999,88.1157999999999,90.60525910592118,85.62634089407861,30478074,65.68353748306816,56.19216852152952,NaN,NaN,NaN,NaN,NaN,NaN,0.37659937743752614,0.773213008729698,0.39661363129217186,92.76190476190484,97.31938502310261,4696712505,10231026641.40032,31.50226029396726,18.114531426794564,11.819448161864486,100,0
2014-05-29,91.05,91.31,90.86,91.3,84.32978803414565,87.22225652104642,88.06982355951578,88.74304849012807,84.68257535000004,88.03345099999991,87.64110200000005,88.31129999999989,88.31129999999989,91.13388648052788,85.4887135194719,33036099,68.01961686337935,57.755407461330755,NaN,NaN,NaN,NaN,NaN,NaN,0.4004054232868703,0.8971204104007597,0.49671498711388945,99.81684981684971,97.4108902633493,4729748604,10262594469.333652,31.669394888938925,17.374469231172146,12.487053384526956,100,7.142857142857143
2014-05-30,91.33,91.45,90.83,91.31,84.39924287957703,87.30320193647124,88.19688930227987,88.98752006249683,84.75362530000004,88.08335099999991,87.66650200000004,88.4942999999999,88.4942999999999,91.58363896490083,85.40496103509896,29916899,68.05998854510928,59.17679347702511,NaN,NaN,NaN,NaN,NaN,NaN,0.3904463986134038,0.9847729853806442,0.5943265867672404,97.12525667351129,96.56800375075527,4759665503,10279000510.720749,31.26775150757131,16.60666939284599,13.10667949029902,100,0
2014-06-02,91.43,91.44,90.64,91.22,84.46711110963099,87.38076229416488,88.31544266297477,89.2001371994019,84.82567530000006,88.12435099999992,87.68510200000004,88.68079999999989,88.68079999999989,91.95021135987182,85.41138864012797,30415405,67.23730900834454,59.97182811847605,NaN,NaN,NaN,NaN,NaN,NaN,0.3525744777008508,1.0350446838933038,0.682470206192453,95.27720739219704,97.40643796085266,4729250098,10292687442.970749,29.458770261792633,17.019943468457374,14.914052854763638,92.85714285714286,21.428571428571427
2014-06-03,90.91,91.33,90.8,91.18,84.53390602396303,87.4559947239834,88.4277782448189,89.38869556136362,84.90402535000004,88.16305099999991,87.72870200000003,88.8422999999999,88.8422999999999,92.2667865367019,85.41781346329789,21783686,66.85054509905832,60.71767061025998,NaN,NaN,NaN,NaN,NaN,NaN,0.3015798975006495,1.059445078068265,0.7578651805676154,94.45585215605759,95.61943874058862,4707466412,10302140740.668863,28.291002928683874,16.345260383685154,16.616237046581478,85.71428571428571,14.285714285714286
2014-06-04,90.96,91.67,90.81,91.52,84.60341939685891,87.53647007598373,88.54904184306129,89.59167693647184,84.98420035000005,88.2080509999999,87.79470200000003,89.07779999999988,89.07779999999988,92.5582071371119,85.59739286288786,20128261,68.50871710917998,61.798486684829804,NaN,NaN,NaN,NaN,NaN,NaN,0.26859685950670764,1.093611254951,0.8250143954442923,97.05304518664036,95.59536824496497,4727594673,10315247515.273514,29.019415745431104,15.286364671738706,18.58068465160187,100,7.142857142857143
2014-06-05,91.61,92.46,91.29,92.29,84.67990278594489,87.6305993814098,88.69574608450986,89.84866008537928,85.06890030000004,88.2579509999999,87.87030200000002,89.36429999999989,89.36429999999989,92.91122644976745,85.81737355023232,35583055,71.93283162023916,63.43045926286281,NaN,NaN,NaN,NaN,NaN,NaN,0.2754615414468443,1.1693413222528477,0.8938797808060034,97.0790378006875,96.19597838112846,4763177728,10340490195.31625,32.357028164307195,13.961238068682935,20.322320163980553,100,0
2014-06-06,92.66,92.82,92.45,92.82,84.76089877812454,87.73335978969871,88.85748153217614,90.13164483915268,85.15460035000005,88.32605099999992,87.97930200000005,89.68129999999988,89.68129999999988,93.27341169649063,86.08918830350913,22680643,74.02627845044108,64.96883067264157,NaN,NaN,NaN,NaN,74.02627845044108,NaN,0.29099807240305586,1.2576273713098232,0.9666292989067673,99.99999999999999,98.0440276624426,4785858371,10363170838.31625,33.80011683825002,13.394785423622066,22.315401724567383,100,0
2014-06-09,92.85,92.98,92.495,92.75,84.84039232262081,87.83269919980368,89.01012931522806,90.38101199732861,85.24125035000004,88.37705099999992,88.09672200000003,89.9787999999999,89.9787999999999,93.5526281212248,86.40497187877499,23402469,73.24918546549175,66.21088517507742,NaN,NaN,NaN,NaN,NaN,NaN,0.27220165793480633,1.3068813713252752,1.0346797133904688,95.69288389513102,97.5906405652728,4762455902,10364377151.1513,33.76895831648522,12.879794970317485,25.13869678502727,100,0
2014-06-10,92.67,92.96,92.56,92.91,84.92068692637584,87.93323980970857,89.16306542051323,90.62186799758302,85.32500035000004,88.42245099999991,88.21392200000004,90.21279999999989,90.21279999999989,93.90873693669957,86.5168630633002,20635286,73.92301656182076,67.65485778016067,NaN,NaN,NaN,NaN,NaN,NaN,0.24692901755912988,1.3433409853393812,1.0964119677802513,98.5626283367555,98.08517074396214,4783091188,10379853615.6513,32.653890489036584,12.454497723629109,28.100895589031627,92.85714285714286,0
2014-06-11,92.59,93.02,92.5,92.89,84.99998357387459,88.03139347684305,89.30921971774801,90.83788056924179,85.40610035000005,88.46755099999992,88.31832200000004,90.44279999999989,90.44279999999989,94.20343795652582,86.68216204347397,22884331,73.67320169570027,68.75610358349306,NaN,NaN,NaN,NaN,NaN,NaN,0.2068720571527627,1.3550020392212048,1.148129982068442,96.91943127962097,97.0583145038358,4760206857,10391295781.1513,31.21104455221218,11.904182855581139,31.243695941089296,100,0
2014-06-12,92.69,92.79,91.73,92.05,85.07013299104996,88.11096984363823,89.41670129744416,90.95332051502828,85.48280030000005,88.5092509999999,88.37512200000003,90.65379999999989,90.65379999999989,94.2753448968726,87.03225510312718,35275853,63.90514061054732,69.02000866639517,NaN,NaN,63.90514061054732,NaN,NaN,NaN,0.1068464358318788,1.2816880268582906,1.1748415910264118,75.12820512820511,90.20342158152717,4724931004,10377318556.377714,28.215897019380193,17.13185293330558,32.368231893372176,92.85714285714286,0
2014-06-13,92.47,92.55,91.92,92.32,85.14227097123852,88.19431697544738,89.53055614852478,91.08348046597797,85.56870030000003,88.54695099999992,88.43272200000003,90.9130499999999,90.9130499999999,94.2184393855422,87.6076606144576,39449997,65.48903105012519,69.17669936185828,NaN,NaN,NaN,NaN,NaN,NaN,0.04507121018748039,1.2311806037607624,1.186109393573282,75.17730496453885,82.40831379078828,4764381001,10387963793.663427,26.716368975666427,16.2213841328054,33.11677643641229,85.71428571428571,0
2014-06-16,92.16,92.67,91.96,92.4,85.21448718047992,88.27759782741872,89.64308335838655,91.20886327874197,85.65355035000005,88.5831509999999,88.50612200000003,91.1475499999999,91.1475499999999,94.1634969806447,88.1316030193551,25218557,65.9655816517329,69.03742722958843,NaN,NaN,NaN,NaN,NaN,NaN,-0.0017191316035503057,1.183960479068844,1.1856796106723944,73.94957983193314,74.75169664155901,4789599558,10394002039.70568,26.121658083467036,15.238493391085653,33.12597468375938,78.57142857142857,0
2014-06-17,92.34,92.7,92.18,92.45,85.28648233291295,88.36021965261834,89.75315852080276,91.32706677600464,85.73600030000006,88.6228509999999,88.62772200000005,91.35404999999989,91.35404999999989,94.12273824356629,88.58536175643349,19984787,66.27899470710696,69.07995988844836,NaN,NaN,NaN,NaN,NaN,NaN,-0.03857502313253436,1.1374608317567265,1.1760358548892609,76.05042016806746,75.05910165484646,4809584345,10394770685.359528,25.19335771773407,14.543446123761944,33.113037086172476,71.42857142857143,21.428571428571427
2014-06-18,92.55,93.1,91.98,92.97,85.36293524502327,88.45150243177441,89.87930916704579,91.48353660686135,85.82350030000005,88.68515099999989,88.77612200000003,91.6025499999999,91.6025499999999,93.98812208863198,89.2169779113678,34514013,69.43173082462266,69.1808251713943,NaN,NaN,NaN,NaN,NaN,NaN,-0.037189924689184695,1.12954844902778,1.1667383737169648,94.71544715447172,81.57181571815742,4844098358,10421272516.770243,26.199942762053453,13.15200847055851,33.399450971755115,100,14.285714285714286
2014-06-19,93.1,93.17,92.49,92.91,85.43803041671458,88.53978951233334,89.99815978794595,91.61939026335074,85.90855035000004,88.75525099999992,88.90752200000004,91.80604999999989,91.80604999999989,93.88952157169666,89.72257842830311,38427402,68.63435828286376,69.2218515812339,NaN,NaN,NaN,NaN,NaN,NaN,-0.04883820538454797,1.10569061698628,1.1545288223708279,89.72332015810257,86.8297291602139,4805670956,10430314258.417301,25.26351087160489,12.377703455493872,33.65725095925199,100,7.142857142857143
2014-06-20,92.7,92.87,92.53,92.77,85.5109853379413,88.62355605664358,90.10685940410494,91.72897214303163,85.98885030000005,88.8244509999999,89.00652200000005,91.9830499999999,91.9830499999999,93.73638139766949,90.22971860233032,25897494,66.7092687472227,69.18413441972521,NaN,NaN,NaN,NaN,NaN,NaN,-0.07303903446002624,1.063230029295795,1.1362690637558213,83.1223628691981,89.18704339392411,4779773462,10440977932.4173,24.399036666075773,11.954159577711248,34.19088126719873,92.85714285714286,0
2014-06-23,92.735,92.82,92.51,92.79,85.58341334452895,88.70605989710609,90.21208060394396,91.83002241512385,86.06860030000006,88.9030509999999,89.16032200000004,92.12854999999989,92.12854999999989,93.62359507960898,90.6335049203908,20837926,66.85230605243433,69.1842602021092,NaN,NaN,NaN,NaN,NaN,NaN,-0.09346161328213798,1.0194420471531487,1.1129036604352867,83.89830508474596,85.58132937068217,4800611388,10457782711.449558,23.686954130489386,11.793568508408965,34.673629128380476,85.71428571428571,0
2014-06-24,92.79,93.57,92.43,92.7,85.65422515204608,88.78514781993567,90.30964607045595,91.91287742320729,86.14745035000004,88.96505099999992,89.33212200000004,92.2134999999999,92.2134999999999,93.63382777909209,90.7931722209077,31945762,65.48869805890797,68.96854455566121,NaN,NaN,65.48869805890797,NaN,NaN,NaN,-0.11725239781166619,0.966338163170704,1.0835905609823702,61.842105263158096,76.28759107236736,4768665626,10440969152.50219,28.049023537393964,10.571685235529722,35.69203835491732,100,0
2014-06-25,92.49,93.45,92.48,93.29,85.7302030112297,88.87435281360031,90.42652269514396,92.0440319543304,86.22475035000005,89.0352509999999,89.50252200000004,92.3419999999999,92.3419999999999,93.6599317129737,91.0240682870261,32818591,69.8328203351642,68.81854374958444,NaN,NaN,NaN,NaN,NaN,NaN,-0.09824390285982454,0.9607856824075895,1.059029585267414,84.7826086956528,76.84100634785226,4801484217,10462960991.832087,25.617017664356347,9.65506150542243,36.08759125934986,92.85714285714286,0
2014-06-26,93.35,93.36,92.62,93.34,85.8059223842523,88.96278147075674,90.5407767070991,92.16745748248941,86.30040030000005,89.1257509999999,89.66832000000004,92.44399999999989,92.44399999999989,93.73913551417299,91.14886448582679,22572172,70.17544400359341,68.54348414623817,NaN,NaN,NaN,NaN,NaN,NaN,-0.08764372613855209,0.949474927594224,1.0371186537327761,87.50000000000048,78.04157131960376,4824056389,10484313046.426682,23.913543776245902,9.013021695086815,36.23169811557425,85.71428571428571,28.571428571428573
2014-06-27,93.21,93.765,93.19,93.75,85.88496793266769,89.0575778772764,90.66662860093835,92.31817581749041,86.37885030000005,89.21415099999989,89.81972000000003,92.56599999999989,92.56599999999989,93.87052136819099,91.26147863180879,22881506,72.89404743454703,68.51811714402784,NaN,NaN,NaN,NaN,NaN,NaN,-0.059695282412951745,0.9624995507165863,1.022194833129538,99.26289926289924,90.51516931951748,4846937895,10506000734.722334,26.36577272259682,8.537927023287919,36.68152353057984,100,21.428571428571427
2014-06-30,93.71,94.14,93.67,93.91,85.96481899801428,89.15366544406301,90.79381963619568,92.46977812058657,86.45835035000003,89.3063509999999,89.97392000000004,92.70049999999989,92.70049999999989,93.97656386989857,91.42443613010121,19764915,73.89411890604146,68.51605302575788,NaN,NaN,NaN,NaN,NaN,NaN,-0.03815674295421334,0.9744989044367713,1.0126556473909847,90.45643153526953,92.40644359938973,4866702810,10506421264.828716,28.73464795023335,8.159328547673406,37.46645887781289,100,14.285714285714286
2014-07-01,94.21,95.19,94.2,94.94,86.05412428161613,89.26824632635879,90.95641494458016,92.70503734719738,86.54275035000005,89.39805099999991,90.13592000000004,92.8884999999999,92.8884999999999,94.31245610889587,91.46454389110392,31862487,79.21143815427101,68.91164134422722,NaN,NaN,NaN,NaN,NaN,NaN,0.03384344131823225,1.0549599490387749,1.0211165077205426,92.77456647398843,94.16463242405239,4898565297,10522191586.6772,34.86836303963285,7.2203006414384,38.96005628852255,100,7.142857142857143
2014-07-02,94.98,95.24,94.91,95.1,86.14413299523189,89.38372659712397,91.11890847616525,92.93312902841667,86.62900030000004,89.4760509999999,90.28732000000004,93.0674999999999,93.0674999999999,94.64961093165378,91.48538906834601,18784391,79.89644465268171,70.05387734723682,NaN,NaN,NaN,NaN,NaN,NaN,0.07809913475120389,1.1187404261595475,1.0406412914083436,95.78313253012045,93.00471017979278,4917349688,10525037706.525684,34.25785657684749,6.996733455148557,41.934191572173745,100,0
2014-07-03,95.41,95.7,95.15,95.7,86.23921624901067,89.508801317973,91.29855912415877,93.19664054951984,86.71565030000004,89.55505099999989,90.46612000000005,93.2379999999999,93.2379999999999,95.14899555207653,91.32700444792327,15291700,82.2574752558192,71.25162336192925,NaN,NaN,NaN,NaN,82.2574752558192,NaN,0.13054693060113753,1.2038249546597655,1.073278024058628,100,96.18589966803627,4932641388,10540329406.525684,36.68205232501292,6.596782325722981,45.153666445699464,100,0
2014-07-07,95.59,95.71,95.23,95.41,86.3304678286225,89.62565673741908,91.45979209968196,93.4074366876608,86.79615030000005,89.6211509999999,90.62252000000004,93.3674999999999,93.3674999999999,95.48726295845914,91.24773704154065,23266428,77.51869438380439,72.07684569993435,NaN,NaN,NaN,NaN,NaN,NaN,0.12828471375481398,1.2336339162521455,1.1053492024973315,91.9571045576408,95.91341236258707,4909374960,10534512799.525684,35.05811880185033,6.287154215898346,48.24465978414731,100,0
2014-07-08,95.24,95.3,93.87,94.26,86.40936864624815,89.71742591093553,91.56960417420424,93.48863319359788,86.86995030000004,89.6740509999999,90.78392000000004,93.4429999999999,93.4429999999999,95.57692689660574,91.30907310339406,40612448,62.21289014580782,71.78640965984155,NaN,NaN,62.21289014580782,NaN,NaN,NaN,0.036674332309591495,1.151192117884321,1.1145177855747295,61.126005361930495,84.36103663985709,4868762512,10516052595.88932,30.166066625129993,17.732956622917516,48.18435905425016,92.85714285714286,7.142857142857143
2014-07-09,94.51,95.065,94.24,94.96,86.4944495552407,89.82123925923383,91.70256087325505,93.62876336563617,86.94982530000003,89.72735099999991,90.95372000000005,93.5454999999999,93.5454999999999,95.76249323410099,91.32850676589882,29928322,66.54320013121404,71.5800860388838,NaN,NaN,NaN,NaN,NaN,NaN,0.011843709670600777,1.1293224226629803,1.1174787129923796,77.13414634146332,76.73908542034486,4898690834,10538362799.562048,27.91850052929099,16.411737234923095,47.67006603556069,85.71428571428571,0
2014-07-10,93.78,95.05,93.63,94.66,86.57569881339751,89.91705630360545,91.81853887822544,93.72697637843272,87.02897530000004,89.77585099999992,91.10372000000005,93.6339999999999,93.6339999999999,95.88037841871154,91.38762158128826,44250020,63.200453915591545,71.19195001265007,NaN,NaN,NaN,NaN,NaN,NaN,-0.03367364964590225,1.0753866509350019,1.109060300580904,67.98780487804873,68.74931886048084,4854440814,10558306470.547964,24.530665898923246,19.63302375496244,46.016959471675555,78.57142857142857,21.428571428571427
2014-07-11,94.87,95.27,94.61,95.27,86.6622092729657,90.02305518868256,91.95389029476561,93.87393100905818,87.11117530000003,89.82605099999992,91.26132000000005,93.7949999999999,93.7949999999999,96.02569944189091,91.5643005581089,19570393,66.84725806143649,71.20180639223678,NaN,NaN,NaN,NaN,NaN,NaN,-0.03162013642083572,1.0695351300548595,1.1011552664756952,86.58536585365856,77.23577235772352,4874011207,10577876863.547964,25.034718649097133,18.508810021834947,44.642234568767414,71.42857142857143,14.285714285714286
2014-07-14,95.7,96.055,95.535,95.84,86.7535305737322,90.13824221464924,92.10628675379441,94.06117567486217,87.19757530000004,89.88815099999992,91.42512000000005,93.9709999999999,93.9709999999999,96.26302879564166,91.67897120435815,19579041,69.85357963145864,71.4161830764528,NaN,NaN,NaN,NaN,NaN,NaN,-0.00233840830992027,1.098232256088295,1.1005706643982152,94.06896551724128,82.88071208298284,4893590248,10581265543.72104,30.157346756552062,17.24404120159156,44.193775764566674,100,7.142857142857143
2014-07-15,95.98,96.13,94.83,95.51,86.8406596227498,90.24461365594331,92.239765704626,94.19915894392291,87.27927530000005,89.94275099999992,91.58552000000005,94.1264999999999,94.1264999999999,96.39294457246646,91.86005542753333,39480119,66.11554492692521,71.46095785273974,NaN,NaN,NaN,NaN,NaN,NaN,-0.014956126910405043,1.081875505760209,1.096831632670614,83.01369863013721,87.889343333679,4854110129,10583087703.059504,26.88135911644409,21.261903411081047,41.79510159656802,100,0
2014-07-16,96.19,96.3,95.785,95.89,86.93070281058313,90.35640348453849,92.38291214758183,94.36019142545406,87.36337525000005,90.00235099999992,91.74432000000004,94.2984999999999,94.2984999999999,96.55200637896779,92.04499362103202,22061998,68.224199777558,71.34605638433929,NaN,NaN,NaN,NaN,NaN,NaN,-0.007829535974507973,1.087044712702479,1.094874248676987,88.85869565217398,88.64711993318416,4876172127,10570021859.583776,26.525442795497707,19.850688606070086,39.59073372695635,100,0
2014-07-17,95.63,95.97,94.32,94.619,87.00720328012956,90.4408113363298,92.4706018672845,94.3848398611251,87.44207025000003,90.04444099999992,91.90050000000005,94.3809499999999,94.3809499999999,96.55319781966895,92.20870218033085,43111514,55.73159258823925,70.314352711814,NaN,NaN,55.73159258823925,NaN,NaN,NaN,-0.09404629987176305,0.977316373837283,1.071362673709046,45.948553054662455,72.60698244565788,4833060613,10542535003.384989,23.079839295623366,28.805495716858832,37.146548830188955,92.85714285714286,0
2014-07-18,95.14,96.17,95,96.12,87.09787787435712,90.55327051778862,92.61371551954785,94.55009320768461,87.52427030000004,90.10254099999993,92.09170000000006,94.5414499999999,94.5414499999999,96.72954044375491,92.35335955624488,36690832,64.09353402716943,69.68574461128703,NaN,NaN,NaN,NaN,NaN,NaN,-0.0571323303436313,0.999947260779507,1.0570795911231383,93.25842696629242,76.02189189104294,4869751445,10576089866.83798,21.896198213399376,25.457867524468313,34.03541463836079,85.71428571428571,0
2014-07-21,95.92,96.16,95.55,96,87.1864562039655,90.66112654713933,92.74651098936951,94.6881795688575,87.60602035000004,90.16024099999993,92.28210000000007,94.70294999999989,94.70294999999989,96.81985278238339,92.58604721761638,29754810,63.06786651283518,68.91244086891516,NaN,NaN,NaN,NaN,NaN,NaN,-0.04829571073417793,0.996709952705416,1.045005663439594,88.76404494382034,75.99034165492506,4839996635,10590235596.182243,20.86897302193208,24.263552301921234,30.58917051430518,78.57142857142857,50
2014-07-22,96.44,96.76,96.345,96.61,87.28022280890117,90.7789260214534,92.89802036233542,94.87121008610917,87.69547035000005,90.22194099999992,92.47830000000005,94.89394999999988,94.89394999999988,96.97501842512942,92.81288157487033,25770404,66.0426757149126,67.97181498038955,NaN,NaN,NaN,NaN,NaN,NaN,-0.010823690025970611,1.0314760509071306,1.0422997409331012,95.20766773162923,92.41004654724732,4865767039,10597376792.4714,24.308264283468066,22.826711238521575,26.121539664175287,100,42.857142857142854
2014-07-23,96.94,97.34,96.77,97.227,87.37919571627529,90.90661065469195,93.06778426969481,95.09557103028925,87.78460540000006,90.29081099999992,92.65824000000006,95.12029999999989,95.12029999999989,97.182301367618,93.05829863238178,28947464,68.78174695889301,67.17790800226179,NaN,NaN,NaN,NaN,68.78174695889301,NaN,0.04310349311163164,1.0961791073226408,1.0530756142110091,96.95417789757414,93.64196352434124,4894714503,10614846840.920523,27.49117733290547,21.509147893610276,22.27353424202747,100,35.714285714285715
2014-07-24,97.4,97.51,96.98,97.12,87.476119141984,91.02964806747032,93.2266946904911,95.28837378930932,87.87650535000004,90.3653109999999,92.83484000000006,95.31179999999988,95.31179999999988,97.36969237815389,93.25390762184587,24707180,67.76096555593354,66.14244302369853,NaN,NaN,NaN,NaN,NaN,NaN,0.058215271036262006,1.1258447030063365,1.0676294319700745,89.94845360824743,94.0367664124836,4870007323,10603192510.731844,27.689133033177693,20.580355347945442,18.360126892625527,100,28.571428571428573
2014-07-25,96.65,96.87,96.23,96.74,87.56829706096923,91.14272434336199,93.36447136929537,95.4266239046132,87.97410535000006,90.42461099999991,93.01304000000006,95.48179999999988,95.48179999999988,97.41820725056982,93.54539274942994,29903633,64.12141983217037,65.18549484143897,NaN,NaN,NaN,NaN,NaN,NaN,0.030651213982254122,1.1059434494478921,1.075292235465638,80.15463917525751,89.01909022702637,4840103690,10620947792.825594,25.683512557300087,25.193594022143966,13.458403587696509,92.85714285714286,21.428571428571427
2014-07-28,96.8,97.02,96.02,96.77,87.65985629419342,91.25415554448354,93.49802151167594,95.55456448512622,88.07305535000005,90.48171099999992,93.20574000000006,95.63279999999989,95.63279999999989,97.47414044653598,93.7914595534638,25603360,64.28451701628119,65.33346818932992,NaN,NaN,NaN,NaN,NaN,NaN,0.0038791055986515666,1.0801411174639526,1.076262011865301,80.92783505154621,83.67697594501705,4865707050,10633749472.825594,23.61384416816659,24.855659366005124,11.787341951670554,85.71428571428571,14.285714285714286
2014-07-29,96.97,97.2,96.52,96.6,87.74881294798254,91.36001385053336,93.61966772690434,95.65412977225705,88.16300535000006,90.53791099999991,93.38354000000005,95.76729999999989,95.76729999999989,97.47365894232655,94.06094105767323,27022232,62.549330243143956,65.04819176875348,NaN,NaN,NaN,NaN,NaN,NaN,-0.03376556057051339,1.0340550611521593,1.0678206217226727,76.5463917525771,79.20962199312693,4838684818,10613085413.060888,23.773032201850487,23.470612806910083,9.978999775183862,78.57142857142857,7.142857142857143
2014-07-30,97.13,97.32,96.6,96.98,87.8406655554653,91.47130070497825,93.75144546310418,95.7804031272802,88.25175535000005,90.60241099999992,93.55674000000005,95.8692999999999,95.8692999999999,97.60921035402727,94.12938964597252,35348519,64.83429018040253,65.16489435909713,NaN,NaN,NaN,NaN,NaN,NaN,-0.041074866075437866,1.0164770391283753,1.0575519052038131,83.3855799373041,80.28660224714247,4874033337,10615049219.672,23.348470263661397,22.06838703982142,9.388197736860166,71.42857142857143,0
2014-07-31,96.2,96.34,94.88,95.02,87.91210171909252,91.54157197814699,93.80119269984519,95.70798378182494,88.32790540000005,90.6465109999999,93.69714000000005,95.8652999999999,95.8652999999999,97.61261841404144,94.11798158595838,50047926,48.42341976793556,63.84890590956134,NaN,NaN,NaN,NaN,NaN,NaN,-0.17822710474196457,0.8347680242763573,1.012995129018322,21.943573667711604,60.62518178586427,4823985411,10574599526.055563,19.65926891009705,31.522900875260323,9.97335033941965,64.28571428571429,28.571428571428573
2014-08-01,94.83,95.34,94.04,94.67,87.97934448805677,91.60352104788666,93.83526357436106,95.6091281835559,88.40385540000005,90.69101099999993,93.81374000000005,95.8137999999999,95.8137999999999,97.63665387237936,93.99094612762045,60707990,46.175725491852646,62.1576306138752,NaN,NaN,NaN,NaN,NaN,NaN,-0.2864199770845406,0.6549701576626461,0.9413901347471867,18.155619596541662,41.16159106718579,4763277421,10572731587.901716,17.785762602506484,34.67657751015884,10.327179844439302,57.142857142857146,100
2014-08-04,94.9,95.69,94.52,95.32,88.05238583643431,91.67711469050276,93.89348853222926,95.58159216607439,88.47855540000006,90.73861099999993,93.93554000000006,95.8092999999999,95.8092999999999,97.63655806607989,93.9820419339199,33230537,50.74803229794993,61.059951140376974,NaN,NaN,NaN,NaN,NaN,NaN,-0.3063195576207184,0.5584906877212887,0.8648102453420071,36.8876080691639,25.66226711113906,4796507958,10584944520.303425,18.811327713456937,31.744450349442726,11.32071745806437,50,92.85714285714286
2014-08-05,94.94,95.21,94.15,94.59,88.11743672363397,91.73479558772053,93.92080270743595,95.48715481692444,88.54730540000006,90.79171099999992,94.02974000000006,95.82579999999989,95.82579999999989,97.60204757285118,94.0495524271486,50331066,46.01982677463696,59.47392449731118,NaN,NaN,NaN,NaN,NaN,NaN,-0.3572056563182462,0.41830317494419944,0.7755088312624456,15.850144092218944,23.63112391930817,4746176892,10576397735.510973,17.241320054801207,31.734391765330706,12.406411444823565,42.857142857142854,85.71428571428571
2014-08-06,93.99,95.11,93.92,94.52,88.18114382091125,91.78994815033992,93.94430064047768,95.3950448343602,88.60915545000006,90.8502109999999,94.10012000000006,95.8037999999999,95.8037999999999,97.63252093006206,93.97507906993773,34431913,45.58127240152602,58.74890162683166,NaN,NaN,NaN,NaN,NaN,NaN,-0.3819121688459999,0.29811862020494573,0.6800307890509456,16.713091922005397,23.150281361129416,4711744979,10576687079.317696,15.797185004157674,30.6952083685712,13.907039327457678,35.714285714285715,100
2014-08-07,94.95,95.139,93.885,94.22,88.2412319420962,91.83806798894706,93.9551123800668,95.28313580251638,88.66860545000004,90.89791099999991,94.17012000000005,95.78179999999989,95.78179999999989,97.67449993397263,93.88910006602715,33274669,43.66092713967754,57.289429706296524,NaN,NaN,43.66092713967754,NaN,NaN,NaN,-0.4027222753254931,0.1766279448940793,0.5793502202195724,9.241379310344655,13.934871774856333,4678470310,10561190742.239546,14.425935338368756,28.273033636276068,15.686198300167343,28.571428571428573,100
2014-08-08,94.38,95.01,93.97,94.9,88.30748834068231,91.89870030599761,93.99216679653476,95.2466466784672,88.73085545000005,90.94161099999991,94.24212000000006,95.7632999999999,95.7632999999999,97.68269324788987,93.84390675210993,40238383,48.91458889025435,56.27848130468361,NaN,NaN,NaN,NaN,NaN,NaN,-0.35654009374202805,0.13367510304203734,0.4902151967840654,28.000000000000014,17.984823744116692,4718708693,10592917159.60493,13.387993963159447,26.238798023440317,17.465357272877007,21.428571428571427,92.85714285714286
2014-08-11,95.25,95.76,95.2,95.46,88.37865761092428,91.96922109201746,94.04972888294516,95.26696604242271,88.79840545000006,90.9958109999999,94.32512000000006,95.7442999999999,95.7442999999999,97.66779890565353,93.82080109434627,28283279,52.81674058501856,55.333771652548315,NaN,NaN,NaN,NaN,NaN,NaN,-0.2776348827918595,0.143171593294241,0.4208064760861005,43.448275862068655,26.896551724137776,4746991972,10590896925.390644,17.83316767839469,24.658820400711868,18.38822682791837,14.285714285714286,85.71428571428571
2014-08-12,95.38,95.67,94.93,95.42,88.4487207192733,92.03755334762108,94.1034650051826,95.28154070504912,88.86395545000005,91.0471109999999,94.40912000000006,95.73979999999989,95.73979999999989,97.66588977985361,93.81371022014616,28158723,52.50821501853238,54.17137651395113,NaN,NaN,NaN,NaN,NaN,NaN,-0.220013664760712,0.1457893951352105,0.3658030598959225,42.344827586206804,37.93103448275849,4718833249,10600029484.201454,16.890687390619348,25.28391081298543,18.937726254176514,7.142857142857143,78.57142857142857
2014-08-13,95.81,96.47,95.76,96.43,88.52813643350939,92.12453248925235,94.19470167164603,95.39091778075873,88.93160550000005,91.1214109999999,94.51412000000006,95.7667999999999,95.7667999999999,97.7155608986362,93.81803910136361,27996489,59.017898237529174,53.54687170549367,NaN,NaN,NaN,NaN,NaN,NaN,-0.11124343796077335,0.2267487624449558,0.33799220040572914,74.09024745269318,53.294450300322886,4746829738,10624871439.229624,21.32177866724236,23.39460700752897,18.216885614034165,0,71.42857142857143
2014-08-14,96.54,96.95,96.43,96.93,88.61173706601178,92.2196902617424,94.30196827275795,95.53749703973409,89.00165550000006,91.2085109999999,94.62232000000006,95.88234999999989,95.88234999999989,97.8191978799505,93.94550212004928,25006602,61.80876065836886,53.381681764507846,NaN,NaN,NaN,NaN,NaN,NaN,-0.008409380658298438,0.3274804745828561,0.33588985524115456,88.64628820960735,68.3604544161691,4771836340,10647954456.460394,24.042328507546312,22.498003849320998,18.385121700347945,21.428571428571427,64.28571428571429
2014-08-15,97.46,97.63,96.48,97.4,88.69918246834003,92.32227065259899,94.42345971304195,95.71487827404513,89.07335550000005,91.2974109999999,94.72452000000004,95.94634999999988,95.94634999999988,97.99191899420914,93.90078100579062,55205490,64.27178156599712,53.380772089487564,NaN,NaN,NaN,NaN,NaN,NaN,0.08341790616188521,0.44016223794351106,0.35674433178162585,93.85847797062776,85.53167121097609,4827041830,10681077750.460394,26.977195493106564,20.616208114299884,19.156780008115028,100,57.142857142857146
2014-08-18,97.89,98.24,97.77,98.15,88.79322045372967,92.43767123373564,94.56959854782463,95.94679462889798,89.14920550000005,91.4052109999999,94.83112000000004,96.05384999999988,96.05384999999988,98.31410806271558,93.79359193728419,38938349,67.83642984487375,53.758422061039695,NaN,NaN,NaN,NaN,NaN,NaN,0.18121144395494276,0.5832586367253043,0.40204719277036155,97.93340987370863,93.47939201798124,4865980179,10705103540.268906,29.794826360987454,19.343497616022557,20.630285261864596,100,50
2014-08-19,98.38,98.76,98.32,98.7,88.89179537458809,92.5616777439587,94.73157507536091,96.20900466424102,89.22875550000005,91.52342099999989,94.95012000000004,96.15834999999988,96.15834999999988,98.68889280937267,93.6278071906271,21363394,70.18561520490721,54.14065956279002,NaN,NaN,NaN,NaN,NaN,NaN,0.26444146312541605,0.7325990216771316,0.4681575585517156,98.76923076923072,96.85370620452237,4887343573,10720640554.087088,32.348640322063375,18.452627709174838,22.382796170237004,100,42.857142857142854
2014-08-20,98.61,98.9,98.53,98.7,88.98938945046282,92.68322867972189,94.8871995822095,96.44624231526569,89.30820550000004,91.6399209999999,95.06592000000002,96.23199999999989,96.23199999999989,98.96065241466678,93.50334758533299,23435596,70.18561520490721,55.69510209400228,NaN,NaN,NaN,NaN,NaN,NaN,0.2984778651443045,0.8412548899820962,0.5427770248377917,96.01196410767692,97.5715349168721,4887343573,10718740370.627628,32.508954549192666,17.91371127536097,22.79469404788941,100,35.714285714285715
2014-08-21,98.76,98.95,98.6,98.9,89.08800249075672,92.80633306230166,95.0445643044758,96.67993352333562,89.38805550000005,91.7522209999999,95.18612000000003,96.32099999999988,96.32099999999988,99.26714935128237,93.3748506487174,19339477,71.07653782680151,57.473731546498634,NaN,NaN,NaN,NaN,NaN,NaN,0.31197965786801496,0.9327515971728104,0.6207719393047955,99.01283316880559,97.93134268190441,4906683050,10732554282.770487,31.982443821171902,17.39614354158939,22.60495488616633,100,28.571428571428573
2014-08-22,98.94,99.25,98.72,99.05,89.18712684408253,92.92997003136499,95.2016402141042,96.9056541401608,89.46820550000004,91.8506209999999,95.32612000000003,96.43649999999988,96.43649999999988,99.61152929121363,93.26147070878613,24699453,71.7581743437522,58.97445597834165,NaN,NaN,NaN,NaN,NaN,NaN,0.30800102108359495,1.0057732156592891,0.6977721945756942,96.27213420316863,97.0989771598837,4931382503,10738612639.166714,33.09031836625779,16.61337734669541,23.145558138525335,100,21.428571428571427
2014-08-25,99.52,99.68,99.16,99.4,89.28874747249962,93.0580894366845,95.3662817743354,97.14321088871692,89.55020550000005,91.95022099999991,95.46772000000003,96.56799999999988,96.56799999999988,99.99522394950618,93.14077605049359,24124718,73.33713343862713,60.92569216862666,NaN,NaN,NaN,NaN,NaN,NaN,0.30533609258457983,1.079442310306419,0.7741062177218392,95.16824849007763,96.81773862068394,4955507221,10736756891.628252,35.005458788741855,15.708552318228804,23.749706604134172,100,14.285714285714286
2014-08-26,99.53,99.61,99.27,99.5,89.39035197526081,93.18565202209669,95.52838837142029,97.3676669945534,89.64050550000006,92.05792099999991,95.60972000000004,96.71299999999988,96.71299999999988,100.37098906505713,93.05501093494263,20100350,73.78804785126438,62.94046184360797,NaN,NaN,NaN,NaN,NaN,NaN,0.28698393227104846,1.1328361330606498,0.8458522007896013,96.89387402933552,96.11141890752725,4975607571,10743851132.804724,33.93139172396191,15.226569242897463,24.178738201023823,92.85714285714286,7.142857142857143
2014-08-27,99.53,99.64,99.31,99.52,89.49114449291991,93.3110846553225,95.68492216077635,97.57265109031022,89.72540550000005,92.18942099999991,95.75112000000003,96.83999999999989,96.83999999999989,100.69719587265965,92.98280412734013,15595925,73.88317889704456,65.09919411199134,NaN,NaN,NaN,NaN,NaN,NaN,0.25400186199955743,1.163354528289048,0.9093526662894906,97.19789842381769,96.42000698107694,4991203496,10748104566.895632,33.159483445837715,14.753409561596232,24.60631796345961,85.71428571428571,0
2014-08-28,99.2,99.53,99.08,99.41,89.58983957259235,93.4318552562072,95.83100364466748,97.74763670075686,89.81040550000006,92.32802099999992,95.87992000000004,97.05949999999989,97.05949999999989,100.97660849991013,93.14239150008964,23563850,72.32836320716191,66.77160656319901,NaN,NaN,NaN,NaN,NaN,NaN,0.20470380429972201,1.1652324216641432,0.9605286173644212,94.31578947368399,96.13585397561239,4967639646,10759101030.228964,31.712322048535203,16.34014906141521,24.57494692648626,78.57142857142857,0
2014-08-29,99.65,99.9141,99.2701,99.78,89.69123420371083,93.55756109271795,95.98586624683738,97.94119511020858,89.89660550000004,92.4624209999999,96.01732000000004,97.31499999999988,97.31499999999988,101.24194537778018,93.38805462221958,17912339,74.2883662132362,68.3052941080717,NaN,NaN,NaN,NaN,NaN,NaN,0.17792940467395213,1.1829403732068613,1.0050109685329092,97.30944403202176,96.27437730984114,4985551985,10769553603.20443,33.472577177356,15.310350273317535,26.08689804042148,100,7.142857142857143
2014-09-02,100.04,100.1,99.6601,100.07,89.79450550516644,93.68652027900076,96.14602835480454,98.14393843304586,89.97925550000005,92.58492099999991,96.16332000000004,97.55249999999988,97.55249999999988,101.54214597427787,93.56285402572189,18331922,75.73885425520865,69.96462548212001,NaN,NaN,NaN,NaN,75.73885425520865,NaN,0.16116500563413627,1.2064672255755795,1.0453022199414432,99.30875576036864,96.97799642202479,5003883907,10785385149.391745,33.86189988279172,14.632001748741505,27.497835635279582,100,0
2014-09-03,100.32,100.34,99.3,99.48,89.89087858471703,93.80124264971361,96.27677234089064,98.27118239180339,90.05765550000004,92.72872099999991,96.29712000000005,97.79699999999988,97.79699999999988,101.62661146855301,93.96738853144676,25950656,67.40723031924114,70.56386348795658,NaN,NaN,NaN,NaN,NaN,NaN,0.09502662672746642,1.1640855033507762,1.0690588766233098,78.00511508951406,91.54110496063481,4977933251,10768417412.77636,30.429295757446205,16.65870575864178,29.255612111258813,100,0
2014-09-04,99.73,100.22,99.14,99.39,89.98539720576463,93.91191111209552,96.3988597000714,98.37773644972688,90.13480550000004,92.88152099999992,96.43092000000004,98.04049999999988,98.04049999999988,101.61660668186408,94.46439331813568,24663511,66.2107254902026,70.87828954737327,NaN,NaN,NaN,NaN,NaN,NaN,0.03310092388858776,1.1104350314840445,1.0773341075954568,75.38860103626935,84.23415729538401,4953269740,10755172193.905989,27.330870894300823,16.470953876678333,30.78954411087028,92.85714285714286,0
2014-09-05,99.58,99.95,99.03,99.89,90.08395046739881,94.03028910987581,96.5357671628137,98.5217615497529,90.21855550000004,93.03272099999991,96.56292000000005,98.32399999999988,98.32399999999988,101.52273975185048,95.12526024814929,30805767,69.45461298308587,71.24849179145106,NaN,NaN,NaN,NaN,NaN,NaN,0.014638870417335914,1.0956326956171267,1.0809938251997908,82.49027237354079,78.62799616644139,4984075507,10781959817.384249,24.995973116916055,16.08528239167954,31.384196542737374,85.71428571428571,0
2014-09-08,99.89,100.33,99.62,100.08,90.18341364682767,94.15008536512579,96.6747566858406,98.6701652116812,90.30445550000005,93.1830199999999,96.69772000000005,98.58299999999988,98.58299999999988,101.45276723796103,95.71323276203874,25581202,70.6093021571391,71.44655409947,NaN,NaN,NaN,NaN,NaN,NaN,0.004569960958661801,1.0867062763981181,1.0821363154394563,87.12871287128694,81.66919542703236,5009656709,10789526088.398333,26.887042141716055,15.018911999215748,31.887887096225207,78.57142857142857,0
2014-09-09,100.06,100.46,99.0645,99.25,90.27362843641149,94.25107377373716,96.7757466197292,98.72538757247347,90.38720550000004,93.31371999999992,96.80772000000005,98.7724999999999,98.7724999999999,101.26855188248696,96.27644811751283,36449189,59.94814415704132,70.71530616747958,NaN,NaN,NaN,NaN,NaN,NaN,-0.06481489252269079,1.0011176997860929,1.0659325923087837,37.30569948186537,68.9748949088977,4973207520,10762767081.497223,23.578399343113617,18.069204532368243,30.878919006757084,100,0
2014-09-10,99.38,100.11,99.1,100.07,90.37110477037754,94.36630003564336,96.90493302679864,98.85344589890457,90.46985550000005,93.4524199999999,96.93092000000004,99.0049999999999,99.0049999999999,101.03056165052143,96.97943834947836,31080115,65.4916784661212,70.38002497185201,NaN,NaN,NaN,NaN,NaN,NaN,-0.0622936903542155,0.9880654793660142,1.0503591697202297,79.03225806451609,67.82222347255612,5004287635,10791385405.210094,21.5148216613802,16.487790685861246,29.756227646148794,92.85714285714286,0
2014-09-11,99.65,100.04,99.24,99.99,90.46681517067229,94.47766043097715,97.02591604535556,98.96168914662795,90.54985550000005,93.5839199999999,97.03192000000003,99.1829999999999,99.1829999999999,100.86944122342555,97.49655877657423,28761940,64.55294782786255,69.91405425764208,NaN,NaN,NaN,NaN,NaN,NaN,-0.07212924865486237,0.9601976089016517,1.032326857556514,72.98850574712642,63.10882109783595,4975525695,10816552102.710094,19.96819096149796,15.302536926878913,28.591112770513423,85.71428571428571,0
2014-09-12,99.9,99.93,99.17,99.48,90.55649860180988,94.57671666006671,97.12215463181221,99.01105208504433,90.62630550000006,93.70341999999991,97.11952000000002,99.3104999999999,99.3104999999999,100.64522806221153,97.97577193778828,30445999,58.76968285163045,68.98630486534766,NaN,NaN,NaN,NaN,NaN,NaN,-0.11647138710235505,0.8867376236785702,1.0032090107809253,31.46853146853183,61.163098426724765,4945079696,10810943629.210094,18.54945834931275,14.821818560823536,27.02110351916124,78.57142857142857,0
2014-09-15,99.59,99.6,98.215,98.52,90.63573742169237,94.65480147867925,97.17697209723134,98.96428521980201,90.69575550000005,93.8210199999999,97.17592000000002,99.3664999999999,99.3664999999999,100.44535633893187,98.28764366106793,32972159,49.73690184082425,67.30057403693317,NaN,NaN,49.73690184082425,NaN,NaN,NaN,-0.20856958018004312,0.7424970355558713,0.9510666157359144,13.585746102449617,39.34759443936928,4912107537,10792493504.137892,16.426560606131506,21.016884010330035,25.178882599644414,71.42857142857143,100
2014-09-16,98.16,99.57,98.05,99.38,90.72274500953623,94.74836976623016,97.2633653483203,99.00387710363039,90.76655550000005,93.93891999999991,97.25532000000001,99.42799999999991,99.42799999999991,100.35150636167337,98.50449363832645,38166920,56.22745659473643,66.04624609003832,NaN,NaN,NaN,NaN,NaN,NaN,-0.20914888323453895,0.6896305116927408,0.8987793949272798,55.186721991701255,33.41366652089423,4950274457,10821118694.137892,14.469398421296948,19.806165555878387,23.57314947288327,64.28571428571429,100
2014-09-17,99.37,100,98.93,99.53,90.8103793875508,94.84305551343351,97.35225298171952,99.05398404614178,90.83555550000004,94.0723199999999,97.36072000000001,99.4694999999999,99.4694999999999,100.33092846485464,98.60807153514516,37206375,57.26403829171041,64.85916461822875,NaN,NaN,NaN,NaN,NaN,NaN,-0.19716939971386171,0.6523176452849526,0.8494870449988143,61.41078838174299,43.394418825297954,4987480832,10825639094.838827,16.599882848702048,18.165387928788874,21.15081878595351,57.142857142857146,92.85714285714286
2014-09-18,99.83,100.29,99.73,100.28,90.90460446827169,94.95071778049423,97.46706659027953,99.17074747031876,90.90955550000004,94.2104199999999,97.46712000000004,99.5484999999999,99.5484999999999,100.40293021953194,98.69406978046787,30196722,62.09716456301218,64.1283647150752,NaN,NaN,NaN,NaN,NaN,NaN,-0.13920630915749044,0.6754791585519513,0.8146854677094417,92.5311203319505,69.70954356846492,5017677554,10854757362.481684,17.88454611816795,17.08289447954127,19.029545628851714,50,85.71428571428571
2014-09-19,100.46,100.5646,99.58,99.98,90.99490691137346,95.05030752741514,97.56561299850387,99.24781913981221,90.98240550000004,94.3386199999999,97.57352000000003,99.60249999999989,99.60249999999989,100.42196018821363,98.78303981178615,46923054,59.212516383690655,63.05151829867908,NaN,NaN,NaN,NaN,NaN,NaN,-0.12215137321951774,0.6619962511850446,0.7841476244045623,76.75176966515572,76.89789279294975,4970754500,10845959885.568827,18.65251182797234,15.77163611658936,16.967978549408354,100,78.57142857142857
2014-09-22,99.74,99.75,98.62,99.05,91.0750570913598,95.12950935855544,97.6238242534645,99.22897922173486,91.05020550000005,94.4552199999999,97.64912000000004,99.60249999999989,99.60249999999989,100.42196018821363,98.78303981178615,48658049,51.26251238560618,61.30320816513604,NaN,NaN,NaN,NaN,NaN,NaN,-0.17155764451438926,0.5697005687615757,0.741258213275965,39.76775630318935,69.6835487667652,4922096451,10834333626.073252,16.741019831446483,21.389190018765383,15.006263932976472,92.85714285714286,71.42857142857143
2014-09-23,98.67,99.22,98.58,98.78,91.15172318995323,95.20179630195038,97.66916447881884,99.18621929585535,91.11720550000004,94.56651999999991,97.70792000000003,99.5714999999999,99.5714999999999,100.46299929896708,98.68000070103272,33989583,49.19731882054409,60.0025002009434,NaN,NaN,NaN,NaN,NaN,NaN,-0.21751988185994464,0.4693583609510341,0.6868782428109788,29.030462101328386,48.516662689891156,4888106868,10821587532.448252,15.914498862064818,20.641752996651704,13.841055406520654,85.71428571428571,64.28571428571429
2014-09-24,98.87,99.8868,98.54,99.84,91.23817370547609,95.29364191973355,97.75429528357104,99.24848412482152,91.18640550000003,94.69001999999989,97.79452000000003,99.5884999999999,99.5884999999999,100.48683790973244,98.69016209026735,35958950,56.59109778583191,59.31538393634549,NaN,NaN,NaN,NaN,NaN,NaN,-0.17354078432944264,0.4699522623991754,0.6434930467286181,71.18428378270919,46.66083406240897,4924065818,10855047404.842075,19.29514399920647,18.56461336778939,12.207931987069239,78.57142857142857,57.142857142857146
2014-09-25,99.53,99.65,97.7,97.74,91.30286849447633,95.34208465399625,97.75373468421532,99.10481897007661,91.24335550000004,94.78791999999989,97.83152000000004,99.4994999999999,99.4994999999999,100.70688519125501,98.29211480874478,68642547,43.18244437802341,57.43880046455532,NaN,NaN,NaN,NaN,NaN,NaN,-0.27676194062904313,0.29754062094231415,0.5743025615713573,1.3963555121131084,33.87036713205022,4855423271,10789220962.334383,16.460728492749183,21.603595771649683,11.623688097823516,71.42857142857143,100
2014-09-26,98.05,98.96,97.89,98.78,91.37726781293925,95.41016218560029,97.79398038287354,99.0738838300693,91.30580550000005,94.90761999999988,97.91474000000004,99.46799999999989,99.46799999999989,100.71529467250635,98.22070532749343,56109106,49.556827558611324,55.935052278946195,NaN,NaN,NaN,NaN,NaN,NaN,-0.26581607987510514,0.24203246172747583,0.507848541602581,37.70159882706137,36.760746040627886,4911532377,10826452238.278309,15.098988805255761,19.81640428934202,10.565839681435298,64.28571428571429,92.85714285714286
2014-09-29,97.8,98.92,97.75,98.65,91.44963330733786,95.47431738984582,97.8275497796236,99.03351394149128,91.37315550000005,95.02851999999989,97.96534000000003,99.4114999999999,99.4114999999999,100.69887368314726,98.12412631685255,33342673,48.81952813479353,55.140151134499924,NaN,NaN,NaN,NaN,NaN,NaN,-0.25794716277413016,0.1854145881349183,0.44336175090904845,33.16344341269302,24.08713258395583,4878189704,10844405985.278309,13.910491420081462,19.1984550631437,10.76178858273225,57.142857142857146,85.71428571428571
2014-09-30,98.92,99.3,98.32,98.79,91.52267178189172,95.53997447123501,97.8652929255207,99.01032213753973,91.44230550000003,95.1516199999999,98.02114000000005,99.3474999999999,99.3474999999999,100.62479205746656,98.07020794253323,41834324,49.687657216820845,54.01129247383561,NaN,NaN,NaN,NaN,NaN,NaN,-0.234600632989657,0.15011095967197718,0.3847115926616342,38.05068770508989,36.30524331494809,4920024028,10842698461.84974,15.558932634134411,17.92568206236099,10.32179217636367,50,78.57142857142857
2014-10-01,98.54,98.61,96.9,97.21,91.57926211242015,95.5730442836858,97.83959516373558,98.83886288634547,91.50410550000004,95.2557199999999,98.03314000000006,99.2339999999999,99.2339999999999,100.8120418245609,97.6559581754389,58164861,41.195086476513005,52.34287380588207,NaN,NaN,NaN,NaN,NaN,NaN,-0.31200857856494185,-0.005299130544543118,0.30670944802039873,8.45931343120637,26.557814849663092,4861859167,10805622614.779562,13.67588797906192,24.849201293935867,11.448547415968068,42.857142857142854,100
2014-10-02,97.19,97.51,95.97,97.21,91.63528935508263,95.60545924836529,97.81490515731458,98.6837330876459,91.56355550000004,95.34551999999991,98.03280000000007,99.1249999999999,99.1249999999999,100.92975483101353,97.32024516898628,54501347,41.195086476513005,51.08754549337368,NaN,NaN,NaN,NaN,NaN,NaN,-0.346966585444238,-0.1269987837848987,0.21996780165933924,26.98820354328984,24.499401559862036,4861859167,10838889670.7406,12.362943658812233,28.261234087196385,13.446036074464413,35.714285714285715,100
2014-10-03,97.76,98.57,97.44,98.17,91.70031135154947,95.65624223354618,97.82883044526304,98.63480612691772,91.62865550000004,95.44431999999989,98.05380000000005,99.0389999999999,99.0389999999999,100.85363935812903,97.22436064187077,41627772,47.51627596207419,50.928929359177246,NaN,NaN,NaN,NaN,NaN,NaN,-0.2914294723575742,-0.14431903878762853,0.1471104335699457,47.88229660906288,27.776604527853035,4903486939,10851046453.714052,17.849594023199028,25.896737459975682,13.88429763839004,28.571428571428573,92.85714285714286
2014-10-06,98.47,98.72,97.6587,97.96,91.76259681073803,95.70186119921853,97.83397434937037,98.57053887673509,91.68775550000004,95.54561999999991,98.07820000000005,98.93299999999991,98.93299999999991,100.7396776137596,97.12632238624022,36038687,46.34273145208611,50.222877563273656,NaN,NaN,NaN,NaN,NaN,NaN,-0.2560855584458266,-0.17299651448733755,0.08308904395848904,43.31171375092489,39.39407130109254,4867448252,10835470324.695961,17.605478804098183,24.195495681243628,13.898229260414483,21.428571428571427,85.71428571428571
2014-10-07,97.485,97.7799,96.56,96.57,91.81043166834263,95.71905206656074,97.78440672782642,98.38001136466508,91.74110550000003,95.6399699999999,98.07420000000003,98.7989999999999,98.7989999999999,100.86996982113936,96.72803017886042,45153968,39.40539110810054,48.94725990730152,NaN,NaN,NaN,NaN,NaN,NaN,-0.3099723094563114,-0.3043763428619002,0.005595966594411195,13.058808166107918,34.750939508698565,4822294284,10791056646.359047,16.10270259100872,28.829014366769464,15.59970065117994,14.285714285714286,78.57142857142857
2014-10-08,96.66,98.76,96.06,98.45,91.87649702487653,95.77313024346053,97.81050842477441,98.3866769489827,91.80085550000004,95.74736999999992,98.11120000000004,98.7179999999999,98.7179999999999,100.70896559489627,96.72703440510354,64931636,50.2524255013275,48.10120711718118,NaN,NaN,NaN,NaN,50.2524255013275,NaN,-0.20757202974524347,-0.25386907058714314,-0.04629704084189967,53.97640708657999,36.782309667870926,4887225920,10841078054.83312,19.1441429350191,24.487753969518835,16.310733720447512,7.142857142857143,71.42857142857143
2014-10-09,98.33,98.57,96.71,96.86,91.92608411915636,95.79465241685735,97.77323358458717,98.24127914431767,91.84810550000003,95.83276999999991,98.10880000000004,98.5614999999999,98.5614999999999,100.61887964412665,96.50412035587314,62497086,43.20772702361802,46.958007877176,NaN,NaN,NaN,NaN,NaN,NaN,-0.23355625363571447,-0.3382423578865428,-0.1046861042508283,22.722630718954292,29.919281990547393,4824728834,10788661143.994411,17.22033583897902,22.026964002971454,16.587752641414053,0,64.28571428571429
2014-10-10,96.29,96.83,94.42,94.44,91.95109820752296,95.76782761652353,97.64251854205435,97.87925255914456,91.88305550000004,95.8971699999999,98.09720000000007,98.3094999999999,98.3094999999999,100.99416366609874,95.62483633390106,77579425,35.13457681441862,45.806012479234035,NaN,NaN,NaN,NaN,NaN,NaN,-0.3910836002323117,-0.5935406045412179,-0.20245700430890623,0.365844735494184,25.68829418034282,4747149409,10712369344.305614,15.079539994391641,30.956158108008225,18.180421730655393,14.285714285714286,100
2014-10-13,94.29,94.99,92.88,92.96,91.9611370313287,95.71222706966168,97.45889036393457,97.4107523154165,91.90915550000004,95.9383699999999,98.06300000000005,98.03149999999991,98.03149999999991,101.58295758809754,94.48004241190228,80835922,31.28471731342917,44.52654094301154,NaN,NaN,NaN,NaN,NaN,NaN,-0.5619218212955202,-0.9048592809283065,-0.3429374596327863,1.1417480162127978,8.07674115688709,4666313487,10637663160.466751,13.514869784374325,35.31719965514159,20.44585836819965,7.142857142857143,100
2014-10-14,93.6,94.1699,92.71,92.97,91.97117546882792,95.65792554352977,97.28285544770185,96.98782352347207,91.93640550000003,95.9757699999999,98.01600000000006,97.7109999999999,97.7109999999999,101.82949924123692,93.59250075876288,71814456,31.339461792158346,42.72285265774914,NaN,NaN,NaN,NaN,NaN,NaN,-0.6357783661708536,-1.1376604173463534,-0.5018820511754998,3.746397694524563,1.7513301487438477,4738127943,10591428207.939592,12.54496415093867,33.618318649640926,23.56871771855892,0,100
2014-10-15,91.55,92.76,90.24,92.37,91.97514387212317,95.59281810702423,97.09019444975276,96.54803080695092,91.96130550000004,96.0006699999999,97.97160000000005,97.35299999999991,97.35299999999991,101.98904184623737,92.71695815376245,108847755,29.805147950241576,41.76733148433616,NaN,NaN,NaN,NaN,NaN,NaN,-0.6824567005619313,-1.354952926877914,-0.6724962263159826,23.509933774834536,9.466026495190631,4629280188,10666584991.153877,10.960851278223819,40.798035195014116,26.721253748006177,0,100
2014-10-16,90.43,92.58,90.39,91.79,91.97330164453986,95.51751477817227,96.88234368701735,96.09488501581274,91.98045550000005,96.0085599999999,97.91700000000004,96.9284999999999,96.9284999999999,101.95323989377239,91.90376010622741,93165782,28.359752978740048,40.25325472863107,NaN,NaN,28.359752978740048,NaN,NaN,NaN,-0.7068214935861213,-1.5560230932986343,-0.849201599712513,17.10816777041955,14.788166413259548,4536114406,10692535277.46438,9.882747542229625,36.785161281438405,29.873789777453432,14.285714285714286,92.85714285714286
2014-10-17,92.99,93.89,92.46,93,91.98351754857428,95.46766300038668,96.73009491497746,95.8001340619258,92.00910550000005,96.0313599999999,97.89260000000004,96.57949999999991,96.57949999999991,101.67705814091953,91.4819418590803,69546720,35.39827439544226,39.29459374724883,NaN,NaN,NaN,NaN,NaN,NaN,-0.6000787410626361,-1.5993000260408081,-0.999221284978172,30.463576158940445,23.693892568064843,4605661126,10675513352.988855,14.723440070315915,33.393318533547614,31.504489293646298,7.142857142857143,85.71428571428571
2014-10-20,92.96,94.47,92.8,94.39,92.00746264759344,95.44632313899288,96.63832648693912,95.66583557983763,92.04785550000004,96.06225999999991,97.88240000000005,96.3464999999999,96.3464999999999,101.39685157192658,91.29614842807324,41479253,42.39936569203107,38.774001495478124,NaN,NaN,NaN,NaN,NaN,NaN,-0.4039010701149133,-1.5040976226218135,-1.1001965525069002,48.70892018779344,32.093554705717814,4647140379,10713018545.82119,16.187709226110872,30.94934568668912,33.23650691685888,0,78.57142857142857
2014-10-21,95.54,96.87,95.32,96.87,92.05584610383629,95.47451476000292,96.64741172274543,95.78051790556738,92.10060550000004,96.11785999999991,97.91060000000004,96.25099999999992,96.25099999999992,101.18455814803528,91.31744185196456,53609758,52.32643048997534,39.569097496439724,NaN,NaN,NaN,NaN,NaN,NaN,-0.09146945681965302,-1.2145333735314665,-1.1230639167118135,77.81690140845072,52.3297992517282,4700750137,10766628303.82119,24.631701541192214,27.70641929111538,31.584508814370583,35.714285714285715,71.42857142857143
2014-10-22,97.16,97.3,96.305,96.37,92.09877300827573,95.49224714099296,96.63653283165738,95.8366590574181,92.14685550000004,96.16935999999991,97.92960000000005,96.07749999999992,96.07749999999992,100.7300514505538,91.42494854944603,39178048,50.43903309930472,40.22937939806771,NaN,NaN,NaN,NaN,NaN,NaN,0.0874815331060399,-1.0137120003292637,-1.1011935334353036,71.94835680751176,66.15805946791863,4661572089,10732568995.76089,25.43663488071643,26.506388836867817,28.936253832226384,28.571428571428573,64.28571428571429
2014-10-23,97.32,98.36,97.17,97.82,92.15570064003418,95.5383412570129,96.68294330884729,96.02554867099732,92.19940550000003,96.2357599999999,97.95740000000004,96.08149999999992,96.08149999999992,100.73989575391029,91.42310424608955,48123778,55.456756937869706,40.796556610624535,NaN,NaN,NaN,NaN,NaN,NaN,0.2976336039934808,-0.7291515284434524,-1.0267851324369333,88.96713615023461,79.57746478873236,4709695867,10737017412.21467,27.811289061485965,24.24464996232536,28.111720804926755,21.428571428571427,57.142857142857146
2014-10-24,97.965,98.69,97.64,98.62,92.2200220267005,95.59936420241858,96.75890631634347,96.27263927375948,92.25740550000005,96.30675999999988,97.99120000000002,96.07349999999992,96.07349999999992,100.71384600003573,91.43315399996412,43161724,57.9842269494989,41.62809200329688,NaN,NaN,NaN,NaN,NaN,NaN,0.474165540476547,-0.4340782068412494,-0.9082437473177964,98.35680751173707,86.42410015649448,4752857591,10774424239.681337,27.97856471833764,23.123493432083386,27.664257393276106,14.285714285714286,50
2014-10-27,98.4,98.87,98.02,98.69,92.2843999169821,95.66056491128158,96.83463548040844,96.50286410483001,92.31435550000003,96.3707599999999,98.01700000000002,96.07549999999992,96.07549999999992,100.72031851099148,91.43068148900836,29545673,58.20768363727316,42.97111289823778,NaN,NaN,NaN,NaN,NaN,NaN,0.5727033184620828,-0.192364599240193,-0.7650679177022758,97.91425260718415,95.07939875638527,4782403264,10791456451.175455,27.714966483323998,22.227399973295054,26.42598076004895,100,42.857142857142854
2014-10-28,99.1,100.2,99.08,100.18,92.36296310188774,95.75005867541462,96.96582624588261,96.85306752341764,92.38520550000003,96.4443599999999,98.05760000000004,96.14499999999992,96.14499999999992,100.98759228100448,91.30240771899537,34495077,62.74909403358208,43.863732079113106,NaN,NaN,NaN,NaN,NaN,NaN,0.7065061316636905,0.11806474687733726,-0.5884413847863532,99.79919678714863,98.69008563535662,4816898341,10824719561.139742,31.881395638040754,20.693238643666895,27.071230316971615,100,35.714285714285715
2014-10-29,99.84,100.12,99.1,99.81,92.4370629715207,95.83045355312919,97.07736247153427,97.134680140235,92.44600550000004,96.51495999999992,98.07980000000005,96.27499999999992,96.27499999999992,101.35857157912143,91.19142842087841,40552803,60.97710413645685,45.13297330145873,NaN,NaN,NaN,NaN,NaN,NaN,0.7350870960883553,0.3304174853240909,-0.4046696107642644,96.08433734939759,97.93259558124346,4776345538,10840622621.139742,30.27202760935691,19.64864708747713,27.716479873894283,92.85714285714286,28.571428571428573
2014-10-30,99.37,100.26,99.14,100.02,92.51251508125682,95.9134148689088,97.19276002167018,97.40947250783167,92.50425550000004,96.58605999999992,98.10620000000004,96.41549999999992,96.41549999999992,101.74409259092354,91.0869074090763,35935794,61.63923419535305,47.02616311438262,NaN,NaN,NaN,NaN,NaN,NaN,0.7315576156320774,0.5097774087758324,-0.221780206856245,97.60479041916159,97.82944151856928,4812281332,10861157360.568314,29.323575727375022,18.600044377750077,26.851385110532597,100,21.428571428571427
2014-10-31,101.67,101.75,101.07,101.4,92.60094776701546,96.02206011902942,97.35774982474194,97.78952274518103,92.56935550000004,96.67115999999992,98.15620000000004,96.57699999999991,96.57699999999991,102.29040213883601,90.86359786116381,54254141,65.75174230021548,49.488093470581646,NaN,NaN,NaN,NaN,NaN,NaN,0.7810862504865725,0.7545776062519707,-0.026508644234601864,96.95916594265861,96.88276457040593,4866535473,10859561650.538904,33.95515084929985,17.08345889572148,26.023467850499692,100,14.285714285714286
2014-11-03,101.53,101.9701,101.43,101.7,92.69148560017948,96.13449457211794,97.5280341453403,98.16194915040188,92.63845550000003,96.7676599999999,98.20920000000005,96.76399999999992,96.76399999999992,102.87706600651812,90.65093399348173,33480951,66.59027358312835,52.00600859850807,NaN,NaN,NaN,NaN,66.59027358312835,NaN,0.7905709807446601,0.9617050816962234,0.1711341009515632,97.69737683395711,97.42044439859245,4900016424,10859555451.510761,34.08597988213037,16.603029175082074,25.22639737191466,100,7.142857142857143
2014-11-04,101.36,101.6244,100.67,101.36,92.77773947480456,96.2379699271255,97.67830731611127,98.46652542179218,92.70250550000004,96.8580599999999,98.24840000000006,97.00349999999992,97.00349999999992,103.43446034819459,90.57253965180524,22773298,64.65810029859898,54.495505194819316,NaN,NaN,NaN,NaN,NaN,NaN,0.7318145861236636,1.0859023336061426,0.35408774748247906,94.73147900277198,96.46267392646257,4877243126,10869710853.468851,32.317644543250225,19.569626864522302,22.8636962993637,92.85714285714286,0
2014-11-05,102.01,102.03,101.015,101.37,92.8632346044085,96.33959428500421,97.82307957822455,98.74304681019292,92.76545550000004,96.9477599999999,98.28580000000007,97.14949999999992,97.14949999999992,103.83282095593623,90.46617904406361,25818604,64.69055158918793,57.09056223842274,NaN,NaN,NaN,NaN,NaN,NaN,0.6540343126386476,1.1716306382807886,0.517596325642141,93.10344827586212,95.17743470419708,4903061730,10861952553.744713,32.71647450543267,18.548429941235693,20.720155774171854,100,0
2014-11-06,101.32,101.72,100.921,101.69,92.95106311580743,96.44554291302393,97.9747235163334,99.02370901874598,92.83150550000003,97.04015999999989,98.32920000000006,97.39099999999992,97.39099999999992,104.35806222162903,90.42393777837081,24671900,65.77357606201406,59.260226643177866,NaN,NaN,NaN,NaN,NaN,NaN,0.5867004101847819,1.2509718383731183,0.6642714281883364,96.31635969664134,94.71709565842515,4927733630,10884771745.35923,31.33048637800317,18.26104686749378,19.831082757081823,92.85714285714286,0
2014-11-07,101.87,101.91,101.07,101.6,93.03712218928199,96.54761137019177,98.11689122157523,99.2690700645797,92.90580550000004,97.1264599999999,98.37300000000005,97.74899999999992,97.74899999999992,104.80794864693357,90.69005135306628,20931734,65.16815161363854,60.88656849472126,NaN,NaN,NaN,NaN,NaN,NaN,0.501941394066676,1.2916981707716815,0.7897567767050054,93.59165424739186,94.33715407329845,4906801896,10890253866.168755,30.931779283494993,17.425271154586312,19.58925257376114,85.71428571428571,0
2014-11-10,101.65,102.09,101.38,101.96,93.12590704311998,96.65478738266323,98.26760136974875,99.5253491060483,92.98610550000004,97.21695999999991,98.41660000000006,98.19899999999993,98.19899999999993,105.12564103300073,91.27235896699912,20360007,66.49659226643146,61.89872290732527,NaN,NaN,NaN,NaN,NaN,NaN,0.4382777847155007,1.3376040075993814,0.8993262228838806,97.75280898876386,95.88694097759902,4927161903,10903158095.957487,30.708622680372343,16.728354189302966,21.274718809490114,100,0
2014-11-11,101.98,102.28,101.7,102.28,93.21699254517848,96.76617773152138,98.42495033564096,99.78769681023417,93.06825550000003,97.31205999999992,98.46080000000008,98.66449999999992,98.66449999999992,105.37076714350472,91.95823285649512,15454012,67.67667859114553,63.12998329959961,NaN,NaN,NaN,NaN,NaN,NaN,0.38762208896264805,1.3838538340871906,0.9962317451245426,100,97.11482107871859,4942615915,10918612107.957487,30.778299985939945,16.159774785219003,23.352204794853833,100,0
2014-11-12,101.87,102.57,101.87,102.46,93.30896276860955,96.87892668733284,98.58318757738053,100.04220187592615,93.15590550000005,97.40875999999989,98.52040000000007,99.16899999999991,99.16899999999991,105.40702500796985,92.93097499202997,22050317,68.35195091213777,64.0510685834759,NaN,NaN,NaN,NaN,NaN,NaN,0.337957014640873,1.4186780134256338,1.0807209987847608,97.7687626774848,98.50719055541624,4964666232,10933732325.328917,31.22888769811742,15.476093060391879,25.271972383689132,100,0
2014-11-13,102.65,103.28,102.42,102.9,93.40439597489204,96.9981558618411,98.75247433905189,100.31437312583795,93.23790550000004,97.5107599999999,98.59060000000007,99.72449999999992,99.72449999999992,105.16258596843088,94.28641403156897,28027776,70.0017236557739,64.90946120535268,NaN,NaN,NaN,NaN,NaN,NaN,0.3073386880987259,1.4648943589081682,1.1575556708094423,92.77566539923964,96.84814269224152,4992694008,10936991369.049847,33.9498000207825,14.655720839720452,27.428722868434313,100,0
2014-11-14,102.87,103.22,102.53,103.22,93.5020636766344,97.12136069626008,98.92767142379495,100.59109949480576,93.32265550000004,97.6100599999999,98.65720000000006,100.23549999999992,100.23549999999992,104.91825762772794,95.5527423722719,19251346,71.1784526620294,65.83594470712099,NaN,NaN,NaN,NaN,NaN,NaN,0.2819049506432305,1.5099368591134805,1.22803190847025,98.57142857142851,96.37195221605101,5011945354,10956242715.049847,32.46293115721168,14.013857412647926,29.479254566150594,92.85714285714286,0
2014-11-17,102.98,103.21,102.42,102.91,93.59567498333456,97.23598721712622,99.08384117188142,100.81194716196711,93.41575550000005,97.7057599999999,98.71380000000008,100.66149999999992,100.66149999999992,104.63628691253354,96.6867130874663,23361634,68.38007621542187,66.23815772010956,NaN,NaN,NaN,NaN,NaN,NaN,0.22020644511858878,1.503289964868486,1.2830835197498973,91.14832535885158,94.16513977650662,4988583720,10961861335.88529,30.779767441618578,14.000176724945742,30.63573283501906,85.71428571428571,0
2014-11-18,103,103.82,102.991,103.68,93.69601652578895,97.36359143064847,99.26408269455274,101.08509505130358,93.50960550000005,97.80505999999988,98.80240000000009,101.00199999999992,101.00199999999992,104.78119885690636,97.22280114309349,26336812,71.38895711299529,66.981861504148,NaN,NaN,NaN,NaN,NaN,NaN,0.20743340503653118,1.5423752760455613,1.3349418710090302,97.0085470085473,95.5761003129425,5014920532,10979302722.843071,32.9448653242854,13.164064234853287,32.17999210369935,100,0
2014-11-19,103.57,103.57,102.73,103.21,93.7906830280199,97.4793618973683,99.41882454966832,101.28746695117943,93.60220550000005,97.8980599999999,98.86520000000007,101.34399999999991,101.34399999999991,104.5841320960817,98.10386790391811,23760243,67.18636592604713,67.37808519919759,NaN,NaN,67.18636592604713,NaN,NaN,NaN,0.14638879689420525,1.5179278671267866,1.3715390702325814,80.6349206349206,89.59726433410653,4991160289,10982697043.271643,30.87203681570012,14.064398412596315,33.253338163933,92.85714285714286,0
2014-11-20,102.77,103.76,102.69,103.67,93.88898468943263,97.60194879048973,99.58553731242642,101.5143748605909,93.69170550000004,97.98535999999989,98.93880000000009,101.63649999999991,101.63649999999991,104.5953124306984,98.67768756930143,22874018,69.10344830899797,67.61749277125348,NaN,NaN,NaN,NaN,NaN,NaN,0.11730534196854414,1.5181707476932615,1.4008654057247174,95.2380952380955,90.96052096052115,5014034307,11001723095.626783,29.942108325020534,13.067154234636764,33.694688477342595,85.71428571428571,14.285714285714286
2014-11-21,104.59,104.69,103.54,103.87,93.9882982746124,97.72606861642062,99.75355545703715,101.7387201119632,93.77455550000005,98.07305999999988,99.02660000000007,101.89899999999992,101.89899999999992,104.66609161396102,99.13190838603882,34049128,69.92613143621642,67.85576833218833,NaN,NaN,NaN,NaN,NaN,NaN,0.09291916625861485,1.517014363547986,1.4240951972893712,79.6019900497514,85.1583353075892,5048083435,10987215206.305044,33.804676281064815,12.076082339370824,34.61384726672305,100,7.142857142857143
2014-11-24,104.15,104.73,104.06,104.68,94.09468336640731,97.86377022797664,99.94674936068276,102.01884200606194,93.85895550000005,98.1628599999999,99.14980000000007,102.19849999999991,102.19849999999991,104.80335143531568,99.59364856468414,17928289,73.0553431197409,68.45557139084133,NaN,NaN,NaN,NaN,NaN,NaN,0.11147251113989443,1.5634358362142393,1.451963325074345,98.6873195064322,91.17580159809307,5066011724,11002467631.275194,32.12644577270015,11.380919136823975,36.26485531868569,100,0
2014-11-25,104.84,105.15,104.57,104.84,94.2016019398759,98.00191339177908,100.13864154261677,102.28752371977033,93.93915550000006,98.25715999999987,99.25900000000007,102.43149999999991,102.43149999999991,105.10521109135816,99.75778890864167,17525991,73.63882852705613,69.09473402926048,NaN,NaN,NaN,NaN,NaN,NaN,0.11423136877143669,1.5947525360386408,1.480521167267204,92.66966185859536,90.31965713825969,5083537715,11001258942.240711,33.74324203463112,10.924184485949791,37.93982999952663,100,7.142857142857143
2014-11-26,104.94,105.58,104.834,105.52,94.31422281609603,98.15078639392208,100.3496752076122,102.59537860360173,94.02190550000005,98.3697599999999,99.37880000000007,102.71699999999991,102.71699999999991,105.42919542069868,100.00480457930115,18973804,76.01596046120531,69.826332914917,NaN,NaN,NaN,NaN,NaN,NaN,0.1398707526981824,1.655359608139932,1.5154888554417496,98.66962305986691,96.6755348082982,5102511519,11017180659.806395,35.001704497817684,10.348907944527921,39.94027813548111,100,0
2014-11-28,105.795,106.245,105.73,106.01,94.43059870847318,98.30641438612165,100.57164872888231,102.92058064135395,94.10380550000004,98.48025999999989,99.49340000000005,103.01649999999991,103.01649999999991,105.79340673233125,100.23959326766857,17360420,77.58454520186814,70.71321817121911,NaN,NaN,NaN,NaN,77.58454520186814,NaN,0.16606299850110084,1.7230676035681256,1.5570046050670248,95.16957862281605,95.50295451375949,5119871939,11018697589.709307,37.96466914743693,9.808320269672569,42.15506426852291,100,0
2014-12-01,105.72,105.9199,104.42,104.81,94.5338763332645,98.43519825966379,100.73785858265163,103.10052534217738,94.17880550000004,98.5817599999999,99.59000000000006,103.18699999999993,103.18699999999993,105.96470480793889,100.40929519206097,35969494,66.17094085813267,70.68995735634063,NaN,NaN,NaN,NaN,NaN,NaN,0.08299838359514267,1.660752584560953,1.5777542009658103,68.4268426842684,87.42201478898382,5083902445,11001433479.6149,33.79528825184286,17.77942639040038,42.26809729647929,92.85714285714286,0
2014-12-02,104.92,105.4168,104.7,105.23,94.6403054244758,98.5697487891754,100.9140209911751,103.3033324524462,94.25370550000004,98.6813599999999,99.71360000000006,103.3634999999999,103.3634999999999,106.18902136782965,100.53797863217015,26031291,67.94820771535394,70.7093522937841,NaN,NaN,NaN,NaN,NaN,NaN,0.03900351470469121,1.6265085943466744,1.5875050796419832,76.79999999999998,80.13214043569485,5109933736,11013897122.292356,32.08458779099971,16.879440786107562,42.26162798288719,85.71428571428571,0
2014-12-03,105.39,105.565,104.7626,105.42,94.74756606701833,98.70539732800361,101.0907260503447,103.50491983792752,94.33265550000004,98.7771599999999,99.84640000000007,103.56649999999993,103.56649999999993,106.37038498338279,100.76261501661708,32974322,68.74809395687296,70.73764822555088,NaN,NaN,NaN,NaN,NaN,NaN,0.007036129857626472,1.5963002419640162,1.5892641121063897,78.43137254901956,74.55273841109603,5142908058,11034954004.885576,31.301540386569698,15.908643457367713,42.18139497524219,78.57142857142857,0
2014-12-04,105.32,105.78,104.93,105.37,94.853261927048,98.83736965814215,101.25854071503706,103.68254652002966,94.40925550000003,98.8757599999999,99.95700000000006,103.76649999999992,103.76649999999992,106.48447185416767,101.04852814583218,31008791,68.26528325222637,70.61361676815464,NaN,NaN,NaN,NaN,NaN,NaN,-0.031049153944296304,1.5504526696760195,1.5815018236203158,77.12418300653596,77.45185185185188,5111899267,11036048432.803223,30.931650631104375,14.929114548984227,41.83843052655944,71.42857142857143,0
2014-12-05,105.54,105.7,105.145,105.38,94.95800558946543,98.96692669461459,101.42016656934933,103.84420875621731,94.48650550000004,98.97065999999991,100.10980000000006,103.95099999999991,103.95099999999991,106.57959582288048,101.32240417711934,25622236,68.31321343732985,70.40895682353325,NaN,NaN,NaN,NaN,NaN,NaN,-0.06707269764639356,1.4976609515623238,1.5647336492087174,77.38562091503246,77.64705882352938,5137521503,11032124306.568989,29.648024326780448,14.309574248213119,41.4954660778767,64.28571428571429,7.142857142857143
2014-12-08,105.11,105.57,104.075,104.63,95.05424433981901,99.07906676006776,101.54604239015916,103.91904601752995,94.55760550000002,99.0707699999999,100.22680000000008,104.10249999999992,104.10249999999992,106.51174780793669,101.69325219206316,32685756,60.885817614673726,69.87365263776552,NaN,NaN,NaN,NaN,NaN,NaN,-0.14826412116558307,1.3794034977517384,1.5276676189173215,54.57102672292529,69.6936102148313,5104835747,11023706904.522165,26.462379864327424,20.462342782500006,39.73227302984613,57.142857142857146,0
2014-12-09,103.41,105.04,103.0401,104.96,95.15280907275613,99.19552088363078,101.67992308074115,104.0181844920509,94.63085550000004,99.1591699999999,100.35300000000008,104.25249999999991,104.25249999999991,106.47589267788167,102.02910732211815,46035139,62.80221803933413,69.260314132504,NaN,NaN,NaN,NaN,NaN,NaN,-0.1842487072775736,1.2973567348203545,1.481605442097928,63.85372714486615,65.27012492760802,5150870886,11066059048.252401,22.915244144381514,24.655956855979312,36.92934594922178,50,14.285714285714286
2014-12-10,104.77,105.03,103.12,103.31,95.23397515163417,99.27699571761829,101.74384766581012,103.95073834995083,94.69625550000002,99.2322699999999,100.4434000000001,104.3039999999999,104.3039999999999,106.38543604275115,102.22256395724865,39330116,49.69240004265082,68.01074514083284,NaN,NaN,NaN,NaN,NaN,NaN,-0.315951186324422,1.0866664591924007,1.4026176455168227,17.440225035161838,45.28832630098447,5111540770,11034553772.084862,20.138781321299632,21.66858534264015,34.51906251829407,42.857142857142854,7.142857142857143
2014-12-11,103.61,105.04,103.59,103.8,95.31920922972736,99.36656015885357,101.82448109068031,103.93638231662217,94.76305550000002,99.3041699999999,100.5752000000001,104.37099999999991,104.37099999999991,106.29067601434654,102.45132398565327,47576022,52.8407662293879,66.84912499228925,NaN,NaN,NaN,NaN,NaN,NaN,-0.3634538074856517,0.9483003861597581,1.3117541936454098,23.71056819245529,35.00150679082781,5159116792,11000758390.940033,18.071325196429807,19.37834303695606,31.96580806170318,35.714285714285715,0
2014-12-12,102.81,103.99,102.66,102.67,95.3923514264465,99.43197480917331,101.85763869496735,103.81577447694387,94.82470550000002,99.35859999999991,100.6844000000001,104.35949999999991,104.35949999999991,106.31667628231598,102.40232371768384,46889391,45.73278408266613,65.12102875274995,NaN,NaN,NaN,NaN,NaN,NaN,-0.4582476536890767,0.7389446265340638,1.1971922802231405,0.27894002789414485,13.809911085170476,5112227401,10954574103.564093,16.61720879837026,23.44558484838806,29.800475627009927,28.571428571428573,100
2014-12-15,103.2,103.58,101.315,101.61,95.4542185764321,99.47510402087285,101.84792737359608,103.60570071723494,94.88440550000003,99.40349999999991,100.75320000000009,104.27899999999991,104.27899999999991,106.52774987494551,102.03025012505431,52968448,40.26161076403214,62.77861929877076,NaN,NaN,NaN,NaN,NaN,NaN,-0.5722017979443126,0.48194003279274966,1.0541418307370622,5.983772819472643,9.991093679940745,5059258953,10915403176.235174,14.480291459100675,28.066874295168514,28.675489826305242,21.428571428571427,100
2014-12-16,100.97,102.47,99.96,99.98,95.49925122741287,99.48510196105359,101.77467531972957,103.26039588702209,94.93025550000004,99.4358999999999,100.7936000000001,104.13249999999991,104.13249999999991,107.01216577922976,101.25283422077005,65348626,33.6041045339517,59.91899615640615,NaN,NaN,33.6041045339517,NaN,NaN,NaN,-0.7272634860136431,0.14506247322000831,0.8723259592336514,0.3182179793159936,2.1936436088943116,4993910327,10851095962.60171,12.553692462291735,31.51514958266692,28.09979896771242,14.285714285714286,100
2014-12-17,100.05,102.09,99.92,101.8,95.56194524505055,99.53094152618124,101.77566844444605,103.12131056444855,94.98395550000004,99.48619999999991,100.89820000000009,104.03849999999991,104.03849999999991,107.08879359243751,100.98820640756232,79715318,44.61623564211218,57.676158669328075,NaN,NaN,NaN,NaN,NaN,NaN,-0.6781334754784571,0.024659114885579925,0.7027925903640371,29.72332015810268,12.00843698563044,5073625645,10909504882.242262,11.170004762247004,28.24467369994809,27.311237189515168,7.142857142857143,100
2014-12-18,103.26,104.26,102.98,104.25,95.64839355106994,99.6243882286331,101.87270105446778,103.22880479640583,95.05030550000004,99.56269999999991,101.01420000000009,104.0904999999999,104.0904999999999,107.11789805775012,101.06310194224969,49840942,55.35157273852786,56.088089207660914,NaN,NaN,NaN,NaN,NaN,NaN,-0.461844808876239,0.1254865792687383,0.5873313881449773,72.16786946449109,34.06980253396992,5123466587,10958567059.523512,20.307390442566483,24.894753359953945,23.826290891655464,0,92.85714285714286
2014-12-19,103.97,104.74,103.71,104.32,95.73467819235283,99.71737063994729,101.9686735621357,103.33272814912908,95.11925550000004,99.6360999999999,101.1634000000001,104.1229999999999,104.1229999999999,107.1455955733558,101.100404426644,51419912,55.6162846647585,55.33418519384848,NaN,NaN,NaN,NaN,NaN,NaN,-0.30295594650088087,0.20863645501887618,0.511592401519757,75.08532423208177,58.992171284891846,5174886499,10968052286.00895,21.64221604272004,23.63098758167844,21.921941857835513,0,85.71428571428571
2014-12-22,104.15,104.61,104.0999,104.58,95.82269134466773,99.81366033024537,102.07107852048333,103.45151594445012,95.18910550000003,99.7316999999999,101.3662000000001,104.15849999999989,104.15849999999989,107.18505100734922,101.13194899265056,33869167,56.644470990747436,54.526775427805156,NaN,NaN,NaN,NaN,NaN,NaN,-0.17555753210393216,0.29214548638984184,0.467703018493774,79.52218430034125,75.59179266563804,5208755666,10997937626.269094,21.071708622487577,23.008054433975033,20.01759282401556,14.285714285714286,78.57142857142857
2014-12-23,104.96,104.97,104.09,104.21,95.90614715218348,99.90071656132962,102.15495779418985,103.52375252116916,95.25905550000003,99.82709999999992,101.59120000000009,104.1349999999999,104.1349999999999,107.15227360378091,101.1177263962189,30156929,54.70238916456753,53.523510799783345,NaN,NaN,NaN,NaN,NaN,NaN,-0.11438015290489872,0.3247278273626506,0.4391079802675493,73.20819112627973,75.93856655290092,5178598737,10976005314.269094,21.997879154474216,21.933851108797253,17.69907207388459,7.142857142857143,71.42857142857143
2014-12-24,104.34,104.7,104.2699,104.3,95.98966807604235,99.98783108486765,102.2390770963785,103.59768085248638,95.32775550000004,99.91689999999993,101.81780000000008,104.1079999999999,104.1079999999999,107.10917710241662,101.10682289758319,14291333,55.10559580876458,52.583533125250355,NaN,NaN,NaN,NaN,NaN,NaN,-0.06829903410039051,0.3537341876420612,0.4220332217424517,75.77854671280268,76.16964071314122,5192890070,10963714302.698063,21.398786716752372,21.336502417265567,15.217072402377998,0,64.28571428571429
2014-12-26,104.6,105.26,104.57,105.04,96.07972113001208,100.08787403368216,102.348917210246,103.73504458082101,95.40655550000002,100.02139999999991,102.07120000000008,104.0839999999999,104.0839999999999,107.04706192984031,101.1209380701595,13924332,58.385568608881904,51.874415637504065,NaN,NaN,NaN,NaN,58.385568608881904,NaN,0.007541541554497488,0.4314601486855736,0.4239186071310761,90.61946902654888,79.8687356218771,5206814402,10968759350.52415,23.405758618986532,20.177106546295825,13.253810749721197,0,57.142857142857146
2014-12-29,104.94,105.25,104.875,105.02,96.16867912871842,100.18553989440132,102.45366555494223,103.85742128740948,95.48830550000002,100.12639999999992,102.33580000000008,104.0344999999999,104.0344999999999,106.8986332022226,101.17036679777719,17073772,58.26167640856622,51.68697697992496,NaN,NaN,NaN,NaN,NaN,NaN,0.049540466730134736,0.4858441905437445,0.43630372381360977,95.50561797752792,87.30121123895982,5189740630,10964889295.537483,22.88268805769486,19.726189717740162,12.869636526189272,0,50
2014-12-30,104.72,104.96,104.175,104.32,96.24978679907943,100.26741039154189,102.52685514102293,103.90147640289429,95.56265550000003,100.22739999999993,102.56220000000006,104.0099999999999,104.0099999999999,106.85550171324185,101.16449828675796,18603989,53.946905725439265,51.05445467178961,NaN,NaN,NaN,NaN,NaN,NaN,0.024617523808773578,0.46707562857457674,0.44245810476580316,82.39700374531814,89.50736358313164,5171136641,10953158117.760412,21.70557294603239,22.97285803999575,12.810871169915236,85.71428571428571,42.857142857142854
2014-12-31,104.5,104.91,103.1,103.25,96.31944066177516,100.32647157190739,102.55521376294361,103.83943103119007,95.62625550000003,100.31089999999993,102.73940000000007,103.9109999999999,103.9109999999999,106.71733497645457,101.10466502354524,24367121,48.084808052679016,50.939626672505916,NaN,NaN,NaN,NaN,NaN,NaN,-0.06461289162151457,0.36169199023890997,0.42630488186042453,62.35955056179768,80.08739076154791,5146769520,10932829746.09743,19.403123552930165,26.836098236691768,13.697718985986663,78.57142857142857,35.714285714285715
2015-01-02,103.76,104.2,102.44,102.94,96.3853168740958,100.37822461008744,102.57030341929877,103.7537709329815,95.69075550000004,100.38569999999993,102.86080000000007,103.78699999999989,103.78699999999989,106.53421022131096,101.03978977868883,31314599,46.508007217125495,50.48728674305859,NaN,NaN,NaN,NaN,NaN,NaN,-0.1408236888032262,0.2502752708563918,0.391098959659618,56.55430711610476,67.10362047440685,5115454921,10919307532.892883,17.463293156960514,27.90222352954314,15.092051211729794,71.42857142857143,28.571428571428573
2015-01-05,102.49,102.61,101.14,101.43,96.43551272609486,100.39905184553126,102.52558563814979,103.53245941555468,95.74645550000002,100.44579999999992,102.96200000000006,103.58999999999989,103.58999999999989,106.41875237517954,100.76124762482024,36521270,39.68205765008833,50.05509199787446,NaN,NaN,NaN,NaN,NaN,NaN,-0.28113917648672887,0.03967498905120692,0.3208141655379358,28.27715355805251,49.06367041198498,5078933651,10897196015.682,15.731102138044825,32.29834189071343,16.338461224985263,64.28571428571429,21.428571428571427
2015-01-06,101.58,101.75,99.62,100.07,96.47167677857152,100.39253596740193,102.42928816214392,103.20270137597805,95.80180550000003,100.48219999999992,103.00700000000006,103.3244999999999,103.3244999999999,106.41596227537653,100.23303772462327,66205451,34.736970714526706,49.66047485148122,NaN,NaN,34.736970714526706,NaN,NaN,NaN,-0.4440652499133279,-0.2342673968537241,0.2097978530596038,7.978723404255117,30.93672802613746,5012728200,10858964698.90735,13.965770442274955,36.68197850345844,17.26120237298348,57.142857142857146,100
2015-01-07,100.73,101.6,100.485,101.36,96.52031681062553,100.41169367101773,102.38735529304023,103.02720600683729,95.86750550000002,100.52649999999993,103.06180000000006,103.1609999999999,103.1609999999999,106.30443697249792,100.01756302750188,37577361,42.10657962290621,50.26779450069226,NaN,NaN,NaN,NaN,NaN,NaN,-0.4424934228057441,-0.34331892544757636,0.09917449735816775,30.85106382978714,22.36898026403158,5050305561,10880365258.759369,12.850255382939979,33.752007715527874,17.391521402632403,50,92.85714285714286
2015-01-08,102.22,103.5,102.111,103.3,96.58777634484817,100.46888785575005,102.42314528154846,103.0531863871385,95.94145550000002,100.58549999999993,103.15400000000005,103.07799999999989,103.07799999999989,106.1128350861425,100.04316491385728,40212640,51.05736708416637,50.72787531798184,NaN,NaN,NaN,NaN,51.05736708416637,NaN,-0.29540988277226826,-0.27008785610716757,0.02532202666510068,65.24822695035448,34.692671394798914,5090518201,10908997584.864481,21.00515190952926,30.12726435868509,15.571492166736146,42.857142857142854,85.71428571428571
2015-01-09,103.62,103.65,102.02,102.62,96.64779847077007,100.51148413583421,102.43086507442891,103.01193054074436,96.0177055,100.63019999999992,103.20280000000004,103.04349999999988,103.04349999999988,106.08268591074746,100.0043140892523,41410071,48.24191315712368,50.220042490738685,NaN,NaN,NaN,NaN,NaN,NaN,-0.23136176264392197,-0.2638801766398018,-0.03251841399587982,53.191489361702125,49.76359338061459,5049108130,10898073455.704971,20.049605324501194,27.68816062452873,15.989529483064473,35.714285714285715,78.57142857142857
2015-01-12,102.82,102.93,101.285,101.55,96.69657659543903,100.53204880641175,102.39632134601993,102.87269906067347,96.09106050000003,100.65869999999994,103.23760000000004,102.9309999999999,102.9309999999999,106.01607309477025,99.84592690522955,34129751,44.119251504821534,49.39882583645747,NaN,NaN,NaN,NaN,NaN,NaN,-0.24707771197250356,-0.34136555396150925,-0.0942878419890057,34.21985815602824,50.886524822694945,5014978379,10874939916.273361,18.428114635299814,29.062426545770393,17.27521959143952,28.571428571428573,71.42857142857143
2015-01-13,102.54,103.62,100.7,101.52,96.74457085817097,100.5516121963838,102.36195580303875,102.74387057870457,96.16341050000001,100.68689999999994,103.26760000000004,102.8734999999999,102.8734999999999,106.01817979293261,99.72882020706717,56162334,44.005702250272925,48.496056640709284,NaN,NaN,NaN,NaN,NaN,NaN,-0.24503086826204767,-0.4005764273165653,-0.1555455590545176,33.687943262411196,40.36643026004719,4958816045,10850320810.958292,19.12466226842425,25.17098528362126,17.936441244342813,21.428571428571427,64.28571428571429
2015-01-14,100.5,101.4829,100.07,100.96,96.78651542674639,100.55969908358412,102.30697714409605,102.57397814263747,96.22986050000002,100.70749999999992,103.25880000000005,102.8409999999999,102.8409999999999,106.0500179183168,99.63198208168299,51354217,41.84094552586171,47.577382095087444,NaN,NaN,NaN,NaN,NaN,NaN,-0.2652228358366974,-0.4870741038503894,-0.22185126801369198,23.758865248226755,30.555555555555397,4907461828,10863663675.32286,17.846732037384392,26.392293238965532,19.305801899748154,14.285714285714286,57.142857142857146
2015-01-15,101.43,101.59,99.525,99.65,96.81500781055986,100.54168524034483,102.20278196197464,102.29550403381485,96.2820605,100.71349999999991,103.21780000000004,102.8244999999999,102.8244999999999,106.09499522244943,99.55400477755038,51005416,37.22743791418803,46.30037081690341,NaN,NaN,37.22743791418803,NaN,NaN,NaN,-0.3455539145528989,-0.6537936612048156,-0.3082397466519167,2.1795989537925022,19.87546915481015,4856456412,10818833249.15337,16.18776763054057,26.392289388442176,21.007212709447767,7.142857142857143,100
2015-01-16,99.52,100.95,99.36,100.82,96.8548584791115,100.54719642370434,102.14855521836779,102.1549798401182,96.33896050000001,100.72769999999993,103.20700000000005,102.7754999999999,102.7754999999999,106.13410372775239,99.4168962722474,35362210,43.24641012483423,45.21900235375714,NaN,NaN,NaN,NaN,NaN,NaN,-0.3003125416198521,-0.6836304236767319,-0.3833178820568798,24.78777589134115,16.9087466977868,4891818622,10848412959.404942,15.029312464055304,25.24620304330917,22.290028515655568,0,100
2015-01-20,101.43,101.88,100.29,101.62,96.90227282260292,100.56844005887851,102.12782756274552,102.10402937915457,96.4034105,100.74889999999994,103.21200000000006,102.64399999999989,102.64399999999989,105.96713947948187,99.32086052051791,30964056,46.98928214267863,44.41383133476517,NaN,NaN,NaN,NaN,NaN,NaN,-0.2016644788459126,-0.6353984806142705,-0.4337340017683579,40.35714285714299,22.44150590075888,4922782678,10869250405.895508,18.139136910607924,23.439737445771513,22.67147319205417,0,92.85714285714286
2015-01-21,101.32,102.619,100.9648,102.14,96.95438951093523,100.5995600577126,102.12830491322609,102.10745515256842,96.48226050000001,100.77509999999992,103.22100000000006,102.5349999999999,102.5349999999999,105.77301482394259,99.2969851760572,40128772,49.328514260773375,44.083946230146175,NaN,NaN,NaN,NaN,NaN,NaN,-0.09212274372713358,-0.5488874314272749,-0.45676468770014134,50.090090090090136,38.41166961285809,4962911450,10886139325.65515,20.108549920948,21.70005480192552,22.740772189381808,0,85.71428571428571
2015-01-22,102.54,104.14,101.64,104.03,97.02479359540354,100.66748956152027,102.20288119113879,102.29055466184762,96.57466050000001,100.82129999999994,103.26960000000007,102.5074999999999,102.5074999999999,105.68434041149081,99.33065958850898,40887168,56.79163708116307,44.70586258932361,NaN,NaN,NaN,NaN,NaN,NaN,0.10614474120548989,-0.324083761193279,-0.43022850239876886,96.48760330578509,62.3116120843394,5003798618,10923428422.87115,24.498475025148945,19.36128181072034,22.42918140253346,0,78.57142857142857
2015-01-23,104.02,104.58,103.72,104.26,97.09678569893185,100.73862838208423,102.28355251697648,102.4781208845288,96.66426050000001,100.86609999999993,103.31560000000007,102.5099999999999,102.5099999999999,105.69226963032195,99.32773036967787,34782992,57.60986161987824,45.498852189520235,NaN,NaN,NaN,NaN,57.60986161987824,NaN,0.24345105076295648,-0.1259146889450733,-0.36936573970802977,93.86973180076642,80.14914173221388,5038581610,10932326397.568825,25.522234211443184,18.617917894856546,21.90283055791246,100,71.42857142857143
2015-01-26,104.14,104.33,103.61,104.14,97.16686743327084,100.8059822755083,102.35635437905584,102.63639508600225,96.74586050000002,100.90679999999995,103.35280000000006,102.50199999999991,102.50199999999991,105.66698720377548,99.33701279622434,19960870,57.00334442451087,46.73608695912185,NaN,NaN,NaN,NaN,NaN,NaN,0.31245919644862824,0.021208255852755542,-0.2912509405958727,91.57088122605369,93.9760721108684,5018620740,10941752363.957714,24.66829827754414,18.506161782652526,20.458453359269306,92.85714285714286,64.28571428571429
2015-01-27,102.5,102.56,101.1,101.44,97.20938616527809,100.81853708193388,102.32041891321052,102.52245269685918,96.8275605,100.92639999999994,103.33240000000005,102.3219999999999,102.3219999999999,105.29266053261907,99.35133946738074,45253205,45.41730827870584,47.49896821370607,NaN,NaN,NaN,NaN,NaN,NaN,0.1696801247850997,-0.0791507846144981,-0.2488309093995978,39.84674329501913,75.09578544061307,4973367535,10917575994.163193,21.410923236255957,26.965044111999546,18.07486690464844,85.71428571428571,57.142857142857146
2015-01-28,103.07,103.18,100.9,100.92,97.24630769597184,100.82054624862826,102.26550052445717,102.36983815430116,96.91161050000001,100.94169999999993,103.29280000000006,102.1169999999999,102.1169999999999,104.87272204695314,99.36127795304667,43591675,43.58014613693426,47.60422296470808,NaN,NaN,43.58014613693426,NaN,NaN,NaN,0.04037741495049868,-0.19835914071147442,-0.2387365556619731,29.885057471264417,53.7675606641124,4929775860,10874749085.391262,21.9681672999444,24.366296816774067,15.24089013217919,78.57142857142857,50
2015-01-29,100.84,102.0779,99.96,101.89,97.29251358954426,100.84172355063562,102.25077501369414,102.32413928246295,96.9972105,100.96169999999995,103.26620000000007,101.99549999999991,101.99549999999991,104.5596019870623,99.43139801293752,46539734,47.82029215763802,47.37300332709891,NaN,NaN,NaN,NaN,NaN,NaN,0.021295980134027864,-0.21211658049443827,-0.23341256062846613,48.4674329501916,39.39974457215837,4976315594,10913030812.85781,20.03646862200761,26.126451564846537,14.908904028967362,71.42857142857143,42.857142857142854
2015-01-30,101.8,102.58,100.96,101.1,97.33039902646422,100.84683793577155,102.20564658178456,102.20755458889505,97.07745999999999,100.97189999999993,103.23000000000006,101.8879999999999,101.8879999999999,104.41268295040283,99.36331704959699,42927638,44.863108750066466,47.131660155166244,NaN,NaN,NaN,NaN,NaN,NaN,-0.04006824066391321,-0.28349786145835765,-0.24342962079444444,33.33333333333324,37.22860791826307,4933387956,10877522766.610895,20.776542850713238,24.361837089308874,14.33331982625074,64.28571428571429,35.714285714285715
2015-02-02,101.33,102.07,99.75,101.98,97.37666371276806,100.86927678852855,102.19679769622438,102.185882723286,97.15646000000001,100.99919999999995,103.19600000000004,101.83999999999992,101.83999999999992,104.31894332328324,99.3610566767166,43624654,48.67087402595609,47.456776049533005,NaN,NaN,NaN,NaN,NaN,NaN,-0.0180508565066132,-0.26599319142771094,-0.24794233492109774,50.19157088122615,43.99744572158365,4977012610,10917762749.179861,18.81649860562354,26.983840535504598,14.007606118865981,57.142857142857146,28.571428571428573
2015-02-03,102.35,103.03,101.68,102.96,97.43221929771565,100.91067724816165,102.22672719833322,102.25960817821114,97.24025999999999,101.02809999999994,103.19100000000005,101.91649999999991,101.91649999999991,104.43423926371395,99.39876073628588,30750360,52.596979776050006,48.07043872994565,NaN,NaN,NaN,NaN,NaN,NaN,0.06149722254203213,-0.17107080674355757,-0.2325680292855897,68.96551724137922,50.83014048531286,5007762970,10945324182.957638,21.735507864989,25.477641778068303,13.598757253569607,50,21.428571428571427
2015-02-04,102.54,103.55,102.31,102.87,97.48632656838514,100.94947571849508,102.25195358271232,102.31774073266722,97.32041,101.05689999999996,103.17500000000005,102.05649999999993,102.05649999999993,104.45661062245956,99.6563893775403,34073211,52.20207985422426,48.81051975340012,NaN,NaN,NaN,NaN,NaN,NaN,0.10450931994842144,-0.10193137935006291,-0.20644069929848435,67.24137931034494,62.13282247765009,4973689759,10942026775.44151,22.792474631540305,24.144520360421716,12.424740176410824,42.857142857142854,14.285714285714286
2015-02-05,103.13,103.83,102.87,103.76,97.54875117964498,101.0051296646635,102.31109265790008,102.45509875812748,97.40155999999999,101.09969999999994,103.17280000000007,102.17649999999992,102.17649999999992,104.66372556276184,99.689274437238,23605516,55.74091893054882,50.13291125456875,NaN,NaN,NaN,NaN,NaN,NaN,0.1846697193219496,0.024396449853952618,-0.16027326946799697,84.29118773946372,73.49936143039595,4997295275,10962189820.358175,23.058930317218607,23.135224642226117,10.72471620289308,35.714285714285715,7.142857142857143
2015-02-06,103.92,104.17,102.76,103.13,97.60428599377786,101.04720630496719,102.34320667131576,102.51937506687725,97.48341,101.14579999999995,103.14180000000005,102.16799999999992,102.16799999999992,104.64093024568983,99.69506975431001,34169256,52.76297630187389,50.81266598150015,NaN,NaN,NaN,NaN,NaN,NaN,0.18648806544431734,0.07283681233739969,-0.11365125310691764,69.97929606625252,73.83728770535372,4963126019,10945953365.379452,23.124332374085316,21.700395897671168,9.139657505213794,28.571428571428573,0
2015-02-09,102.73,103.285,102.55,102.8,97.65598464060595,101.08191509100745,102.36112013518573,102.54610125098418,97.55946,101.17999999999995,103.10100000000006,102.17699999999992,102.17699999999992,104.65774263075639,99.69625736924345,22604655,51.21937701889733,51.114815615515774,NaN,NaN,NaN,NaN,NaN,NaN,0.15782806473972216,0.0836338278177351,-0.07419423692198708,63.14699792960659,72.47249391177427,4940521364,10938726026.705982,22.346322135111325,21.931569437561116,8.295971909249651,21.428571428571427,64.28571428571429
2015-02-10,103.37,104.54,103.21,104.4,97.72308927104768,101.14761974267067,102.4410762083157,102.72266303660473,97.65051,101.22869999999995,103.07860000000007,102.31949999999992,102.31949999999992,104.96195700060501,99.67704299939483,23686531,57.6834501383922,51.711596749631404,NaN,NaN,NaN,NaN,NaN,NaN,0.23437560038624158,0.2187752635608149,-0.015600336825426685,96.27329192546598,76.4665286404417,4964207895,10957425919.60072,26.278911503062602,20.198992937785906,8.958447998419828,14.285714285714286,57.142857142857146
2015-02-11,104.52,105.02,104.32,104.78,97.79330728825119,101.21954806459799,102.53279870995038,102.91859989026142,97.74206,101.27369999999995,103.05400000000004,102.48249999999992,102.48249999999992,105.30371870829944,99.66128129170039,20303617,59.070659349150446,51.87438405448764,NaN,NaN,NaN,NaN,NaN,NaN,0.29446069404142283,0.35247553072635185,0.05801483668492902,95.4459203036054,84.95540338622598,4984511512,10963807056.372149,27.678512566592357,19.530540597806784,9.354631590969618,100,50
2015-02-12,105.46,106.04,105.3,106,97.87496592219894,101.31421047916041,102.66876738799155,103.21206656737938,97.83626,101.33389999999996,103.07780000000007,102.73449999999991,102.73449999999991,105.85158501649411,99.61741498350571,22520295,63.23742049852472,52.276352545819535,NaN,NaN,NaN,NaN,NaN,NaN,0.39401339021345927,0.5505315744517532,0.15651818423829386,99.36406995230514,97.0277607271255,5007031807,10983892724.885662,30.890022186509604,18.353180647937396,10.055861945500721,100,42.857142857142854
2015-02-13,106.3,106.93,106.101,106.91,97.96486675879397,101.42501819244436,102.83509023552129,103.56425070381944,97.93386000000001,101.41249999999997,103.11140000000006,103.09749999999993,103.09749999999993,106.37976674724081,99.81523325275904,29030249,66.01648365712168,52.92014820529174,NaN,NaN,NaN,NaN,NaN,NaN,0.49240338619168844,0.7720224169779044,0.27961903078621597,99.72144846796643,98.1771462412923,5036062056,11011522238.107616,33.853486826256855,17.51395949557232,11.30846671639409,100,35.714285714285715
2015-02-17,106.91,107.08,106.6432,107.01,98.05486808457712,101.53561189160388,102.99881218706948,103.89241730345569,98.03065999999998,101.49479999999996,103.14320000000006,103.40699999999993,103.40699999999993,106.93038530394317,99.88361469605668,17675344,66.31780927926786,54.41304113390331,NaN,NaN,NaN,NaN,NaN,NaN,0.5320922634303362,0.9447343600741362,0.4126420966438,99.0450204638473,99.37684629470628,5053737400,11023532407.748642,33.86449973391269,17.1180430328994,12.834629288328752,100,28.571428571428573
2015-02-18,106.88,107.2199,106.74,107.16,98.14546641209377,101.64698591355231,103.16199602287067,104.20361565550752,98.12900999999998,101.56799999999996,103.17900000000004,103.6839999999999,103.6839999999999,107.46363701961772,99.90436298038207,15149619,66.79343749517216,56.07113337377745,NaN,NaN,NaN,NaN,NaN,NaN,0.5348859974363964,1.0812495934392956,0.5463635960028992,99.19811510194248,99.32152801125206,5068887019,11034900146.448162,33.741736420390026,16.672117054338834,14.883435914714994,100,21.428571428571427
2015-02-19,107.09,107.76,107.06,107.69,98.24043689555552,101.7666495588285,103.3395648062875,104.5356522597449,98.22770999999999,101.66749999999996,103.22520000000006,103.96149999999992,103.96149999999992,108.04934185115438,99.87365814884545,19828113,68.48672281517129,57.547306992172686,NaN,NaN,NaN,NaN,NaN,NaN,0.5374397171551826,1.2181632424468773,0.6807235252916948,99.12609238451925,99.12307598343635,5088715132,11050762636.848162,35.44847480060311,16.016705890619853,16.63806080404695,100,14.285714285714286
2015-02-20,107.62,108.47,107.28,108.41,98.3416265781868,101.89820105271309,103.53840540211937,104.9046377588168,98.33571,101.76379999999997,103.30080000000005,104.18049999999991,104.18049999999991,108.705486077333,99.65551392266681,28336710,70.67445251126848,59.39097440368711,NaN,NaN,NaN,NaN,NaN,NaN,0.5506095526581605,1.3689854661143954,0.818375913456235,99.31192660550457,99.2120446973221,5117051842,11076241863.486816,37.074267579271485,14.941363144819213,19.1100316766262,100,7.142857142857143
2015-02-23,108.35,108.55,108.11,108.52,98.44290392566754,102.02932578434253,103.73376205301665,105.24895797226283,98.44551,101.86249999999997,103.37200000000006,104.39349999999993,104.39349999999993,109.298498572888,99.48850142711187,17867968,71.00562836590804,60.986313999397964,NaN,NaN,NaN,NaN,NaN,NaN,0.5295592538509949,1.4803249807699785,0.9507657269189836,99.56331877729255,99.33377925577213,5134919810,11091673290.395906,36.58234763941248,14.55232124215297,20.913594254198085,100,0
2015-02-24,108.38,108.73,108.05,108.6,98.54396955824797,102.15943814504863,103.92459491368267,105.56810483204733,98.55611,101.96059999999996,103.47780000000006,104.61649999999993,104.61649999999993,109.8496798172852,99.38332018271466,19745011,71.2598332007826,62.319374958307435,NaN,NaN,NaN,NaN,71.2598332007826,NaN,0.48504242668696285,1.5570687602776871,1.0720263335907243,97.97507788161978,98.95010775480563,5154664821,11103868738.366495,36.16234725677084,13.94787841022212,23.51396334594441,100,0
2015-02-25,108.44,108.86,108.09,108.33,98.64134299547933,102.28162748871102,104.09735589745982,105.83114246709043,98.66376,102.07179999999997,103.56840000000007,104.96099999999993,104.96099999999993,110.2194632736231,99.70253672637675,19472341,69.05918797863873,63.523454110051325,NaN,NaN,NaN,NaN,NaN,NaN,0.40470918767096276,1.5779128181794277,1.173203630508465,91.60063391442154,96.37967685777795,5135192480,11096534999.548313,35.23290888134722,13.275460829283913,26.541443543163002,100,0
2015-02-26,108.44,108.94,108.135,108.88,98.74322017960392,102.41228833051872,104.28491056814767,106.12150985117705,98.76700999999998,102.18849999999995,103.69260000000007,105.35899999999992,105.35899999999992,110.53815012333538,100.17984987666446,22255476,71.02233247040606,64.61498364861255,NaN,NaN,NaN,NaN,NaN,NaN,0.35754618694646956,1.620136364191552,1.2625901772450825,99.06103286384972,96.21224821996367,5157447956,11115472889.06384,33.93063958994833,12.591997266075811,29.805876717850985,100,14.285714285714286
2015-02-27,108.84,108.91,108.23,108.4,98.8393075410009,102.53085687842925,104.44628662429874,106.33850891296971,98.86756,102.29079999999996,103.82840000000007,105.68449999999993,105.68449999999993,110.76805574377302,100.60094425622684,27757584,67.02543132362177,65.63373043588027,NaN,NaN,NaN,NaN,NaN,NaN,0.26709889758355243,1.596463799224523,1.3293649016409705,91.54929577464802,94.07032085097308,5129690372,11101594097.06384,32.41261920523068,12.028644828125465,32.85520160134253,92.85714285714286,7.142857142857143
2015-03-02,108.61,109.42,108.59,109.38,98.94419005303075,102.666483474896,104.63976558020859,106.62817473078212,98.97531000000001,102.40499999999994,104.01640000000006,106.09849999999992,106.09849999999992,110.9652002167845,101.23179978321534,22988645,70.65631733827229,67.02208331583562,NaN,NaN,NaN,NaN,NaN,NaN,0.24682826778117795,1.637900236367443,1.3910719685862651,99.3558776167471,96.6554020850816,5152679017,11122366969.051792,33.59800107095923,11.21791936451411,36.35527942104987,100,0
2015-03-03,109.05,109.16,108.18,108.87,99.04295433111005,102.78932538628419,104.80565712608276,106.84168189927907,99.08398500000001,102.52799999999996,104.15780000000007,106.44299999999994,106.44299999999994,111.06402629293886,101.82197370706102,20788924,66.54948498758363,67.65537151934929,NaN,NaN,NaN,NaN,NaN,NaN,0.1759547379146018,1.6110153909795173,1.4350606530649155,89.21568627450988,93.37361988863499,5131890093,11130852244.153833,30.954684089809508,13.023408128913449,38.33327166947209,92.85714285714286,0
2015-03-04,108.51,108.67,107.86,108.45,99.13655677557662,102.90141795289243,104.94857253290304,106.99485505172868,99.187685,102.62799999999996,104.24180000000005,106.71749999999993,106.71749999999993,111.12565550996545,102.3093444900344,21007420,63.2871017166315,67.95654597416936,NaN,NaN,NaN,NaN,NaN,NaN,0.08242215148130216,1.5380883424165432,1.455666190935241,76.4563106796117,88.34262485695622,5110882673,11140448226.129143,28.894191024962513,14.26549176147012,39.52148740296294,85.71428571428571,0
2015-03-05,108.73,108.965,108.19,108.64,99.23111839970024,103.01505324095396,105.09333439435783,107.15153552299262,99.28928500000002,102.74579999999995,104.32820000000005,107.00599999999993,107.00599999999993,111.1142181052185,102.89778189478136,15381039,64.14344488853237,68.02126200202706,NaN,NaN,NaN,NaN,NaN,NaN,0.018331358280231802,1.4785803887855309,1.460249030505299,76.49894546550163,80.72364747320773,5126263712,11142929038.871078,29.37231399664757,13.521716678674434,40.34247966077031,78.57142857142857,0
2015-03-06,108.5,108.71,107.14,107.41,99.31250030617088,103.10208188964795,105.18418402595164,107.17615118746951,99.38633500000002,102.87549999999996,104.38480000000007,107.18849999999993,107.18849999999993,111.01858759691399,103.35841240308588,30990366,55.17161449416006,67.24662849038694,NaN,NaN,NaN,NaN,NaN,NaN,-0.11460900751522174,1.3169877711112719,1.4315967786264936,27.614520311149565,60.189925485420964,5095273346,11122597779.648148,26.372534204362413,18.971067484885413,39.236333793498765,71.42857142857143,0
2015-03-09,107.63,107.9857,107.19,107.72,99.39615701954231,103.19352581262521,105.28362778963981,107.22794631247241,99.48073500000001,103.02309999999996,104.45500000000007,107.41799999999992,107.41799999999992,110.76779163531808,104.06820836468177,26237101,56.81122585060411,66.56758681691096,NaN,NaN,NaN,NaN,NaN,NaN,-0.18519357853609342,1.2001048054563768,1.3852983839924702,36.56716417910453,46.893543318585245,5121510447,11131312704.612707,24.98008453705355,17.96940960843253,38.05602195608674,64.28571428571429,0
2015-03-10,106.95,106.98,105.72,105.72,99.45908083029313,103.24355500445442,105.30074042534021,107.08433237795123,99.56318500000002,103.15059999999995,104.48340000000006,107.56399999999992,107.56399999999992,110.29297343337178,104.83502656662806,34234496,45.299631570704605,65.03231496516328,NaN,NaN,NaN,NaN,NaN,NaN,-0.35999129536886,0.9353092647813952,1.2953005601502552,0,21.3938948300847,5087275951,11097078208.612707,21.856372153158247,24.91340503942705,36.10440460451077,57.142857142857146,100
2015-03-11,105.875,106.01,105.07,105.11,99.515308881733,103.28051431129691,105.2932604086602,106.89630072290825,99.63933500000002,103.27799999999996,104.48480000000006,107.59949999999992,107.59949999999992,110.17719257283429,105.02180742716556,25459733,42.47281954946875,63.17417901761309,NaN,NaN,42.47281954946875,NaN,NaN,NaN,-0.5014175622090442,0.66852860738895,1.1699461695979942,0.9195402298851995,12.495568136329906,5061816218,11073785261.399942,20.555350390770496,27.546567957254503,34.445623059941084,50,100
2015-03-12,105.03,105.92,104.96,105.8,99.57784312171576,103.33040511701381,105.31313254949706,106.79189113025032,99.71333,103.41809999999995,104.50040000000007,107.65049999999992,107.65049999999992,110.0362533401528,105.26474665984705,21473171,46.53688295068656,61.45006690614296,NaN,NaN,NaN,NaN,NaN,NaN,-0.5304076570891216,0.5069365982365923,1.037344255325714,18.83408071748883,6.584540315791339,5083289389,11089890139.649942,19.292305797095263,26.5580098749439,32.53820064975013,42.857142857142854,100
2015-03-13,105.7,106.12,104.68,105.34,99.63517801602704,103.37019907509274,105.31418617500698,106.6536157845122,99.78643,103.54149999999996,104.52080000000007,107.61749999999992,107.61749999999992,110.1095503606563,105.12544963934354,42021103,44.29046259162933,59.54184077940876,NaN,NaN,NaN,NaN,NaN,NaN,-0.5595866360071173,0.3378609603168172,0.8974475963239346,13.924050632911335,11.225890526761782,5041268286,11086388381.066608,17.550282882571082,25.91568157503874,30.835592915300452,35.714285714285715,100
2015-03-16,105.73,106.74,105.62,106.7,99.70547475218598,103.4361357270711,105.36853181520279,106.65803332884437,99.86343000000001,103.66459999999998,104.58980000000007,107.60699999999993,107.60699999999993,110.11261848653129,105.10138151346857,25674085,51.71207158653729,58.14557209267695,NaN,NaN,NaN,NaN,NaN,NaN,-0.46993083420559767,0.3100340535669375,0.7799648877725351,42.61603375527422,25.12472170189146,5066942371,11110228602.852324,19.859555127222116,23.67721520208109,28.29542212018194,28.571428571428573,92.85714285714286
2015-03-17,106.405,107.04,106.16,106.87,99.77676356062194,103.50413303940633,105.42741292048895,106.67822063085919,99.94123000000002,103.76459999999997,104.66840000000006,107.59999999999994,107.59999999999994,110.11302208506781,105.08697791493206,19603813,52.562783301961645,56.9672574729143,NaN,NaN,NaN,NaN,NaN,NaN,-0.3853635518556182,0.29826044795301243,0.6836239998086306,46.20253164556962,34.24753867791839,5086546184,11122258215.375051,20.64568671806091,22.369299813219452,25.348402743910352,21.428571428571427,85.71428571428571
2015-03-18,106.58,108.41,106.03,107.92,99.85779078887447,103.5915759495171,105.52516143341094,106.79648533268212,100.02473000000002,103.88009999999997,104.79820000000005,107.63799999999992,107.63799999999992,110.14623922305071,105.12976077694913,40622188,57.538588067912166,56.00413287273617,NaN,NaN,NaN,NaN,NaN,NaN,-0.2513809459531894,0.36939781736714394,0.6207787633203333,68.3544303797468,52.39099859353021,5127168372,11146153620.080935,25.762121659233937,19.269101590677973,23.10209591099817,14.285714285714286,78.57142857142857
2015-03-19,108.03,108.38,107.87,108.08,99.93960381585084,103.68045563368507,105.62535118112032,106.91872482480764,100.10923000000001,103.98269999999997,104.95840000000005,107.65749999999994,107.65749999999994,110.17310628875599,105.1418937112439,31314035,58.257113226132006,55.377824437201184,NaN,NaN,NaN,NaN,NaN,NaN,-0.1496741349519216,0.4336860946304313,0.5833602295823529,71.72995780590708,62.09563994374116,5158482407,11140627613.904463,24.963714928422487,18.67192327554597,20.855789078085984,7.142857142857143,71.42857142857143
2015-03-20,108.72,109.07,108.51,108.53,100.0250803947976,103.77648621519626,105.73925897793913,107.07217960339739,100.19428000000002,104.08179999999997,105.10180000000004,107.66349999999993,107.66349999999993,110.18681745922751,105.14018254077234,31761404,60.29227870389971,54.63753596331743,NaN,NaN,NaN,NaN,60.29227870389971,NaN,-0.05468054586721027,0.51500954724834,0.5696900931155503,85.93750000000007,75.34062939521799,5190243811,11111134881.618748,27.685537149648958,17.535818694125027,18.891984190668932,0,64.28571428571429
2015-03-23,108.47,108.77,108.28,108.32,100.1076169082822,103.86645678519237,105.84046450821603,107.19101964116906,100.27443000000001,104.17809999999997,105.20220000000005,107.65349999999994,107.65349999999994,110.16471703562866,105.14228296437122,17268507,58.850304711518795,54.08759451502709,NaN,NaN,NaN,NaN,NaN,NaN,-0.010869425227255536,0.5561033115814809,0.5669727368087364,82.91571753986327,80.19439178192347,5172975304,11096685722.70038,26.81584352086578,18.459462113868337,17.297956931614028,0,57.142857142857146
2015-03-24,108.31,108.81,107.91,107.93,100.18545156591122,103.94692298746578,105.92240707652128,107.26139872296248,100.34998000000003,104.25559999999997,105.30840000000003,107.61999999999993,107.61999999999993,110.09746644781151,105.14253355218835,22445280,56.16383186292979,53.578789525476964,NaN,NaN,NaN,NaN,NaN,NaN,-0.012897541446113658,0.5508508100010943,0.5637483514472079,74.03189066059248,80.96170273348527,5150530024,11075238010.70038,25.247086388481993,19.78460916348581,15.743380648025164,85.71428571428571,50
2015-03-25,108.1,108.2,105.42,105.46,100.23793463490713,103.97688490850607,105.9042734656773,107.0898369398232,100.41353000000001,104.31209999999997,105.38660000000006,107.47649999999994,107.47649999999994,110.10095632465527,104.85204367534462,41581435,42.82897284830995,52.05632723688965,NaN,NaN,NaN,NaN,NaN,NaN,-0.17626183070586188,0.3434210630648806,0.5196828937707425,17.767653758541897,58.23842065299922,5108948589,11034853163.757935,21.134276734145686,31.152543640332624,14.472473028275232,78.57142857142857,42.857142857142854
2015-03-26,104.59,105.7,104.24,105.1,100.2863133947588,103.99912481130792,105.8727333297684,106.90032865984004,100.47448000000003,104.36289999999997,105.45820000000005,107.28749999999994,107.28749999999994,110.02254570346324,104.55245429653664,47846276,41.2902191263972,51.06479899633516,NaN,NaN,41.2902191263972,NaN,NaN,NaN,-0.29712767461532524,0.14827330050158594,0.4454009751169112,17.805383022774322,36.53497581396956,5061102313,11043373733.456564,19.351358050584793,35.34272513169283,15.39495658762783,71.42857142857143,100
2015-03-27,105.08,105.77,104.92,105.52,100.33838987839304,104.02924115167806,105.85890065016963,106.76886878747432,100.53763000000002,104.40409999999996,105.54940000000006,107.14349999999993,107.14349999999993,109.93183480773722,104.35516519226265,33878385,43.825924908130084,50.137277500444156,NaN,NaN,NaN,NaN,NaN,NaN,-0.33456533720088844,0.027194303615800663,0.3617596408166891,26.501035196687404,20.691357326001203,5094980698,11057323656.691858,18.792936895133774,33.5672652635333,16.244502747822896,64.28571428571429,92.85714285714286
2015-03-30,106.16,106.82,106.16,106.73,100.4019879890558,104.08272152491216,105.89306140898651,106.76516699819105,100.61103000000001,104.45439999999996,105.69100000000006,107.01099999999992,107.01099999999992,109.60684205991889,104.41515794008096,30570196,50.463837429537364,50.50614934750364,NaN,NaN,NaN,NaN,NaN,NaN,-0.26657079137451334,0.028546151598547453,0.2951169429730608,51.55279503105611,31.953071083505943,5125550894,11079556526.51004,23.52903860064216,31.002123459687603,16.75649587995763,57.142857142857146,85.71428571428571
2015-03-31,106.43,106.65,105.57,105.6,100.4537095016025,104.11276664323073,105.88156880471253,106.65419871264905,100.67743,104.49679999999996,105.78660000000005,106.84749999999993,106.84749999999993,109.36513281676407,104.32986718323578,30488101,45.10359414490127,50.69406181860597,NaN,NaN,NaN,NaN,NaN,NaN,-0.2847835309027752,-0.060862470655408174,0.223921060247367,28.15734989648033,35.40372670807461,5095062793,11050762208.89893,21.919417188378418,32.360742231799335,17.092339592196208,50,78.57142857142857
2015-04-01,105.6,105.62,104.37,105.05,100.4994437354174,104.1313257196024,105.84895826335125,106.50141788287294,100.74068000000001,104.53359999999995,105.85520000000008,106.67749999999992,106.67749999999992,109.19850674335615,104.1564932566437,32970452,42.72481901176747,50.42177153725459,NaN,NaN,NaN,NaN,NaN,NaN,-0.31841126059051994,-0.17409301549078293,0.144318245099737,16.77018633540378,32.16011042098007,5062092341,11053663608.674929,20.30725927497406,37.04136544967301,18.044699467803955,42.857142857142854,71.42857142857143
2015-04-02,105.15,105.46,104.78,105.12,100.5454194196421,104.15090342812512,105.82037166478845,106.36985427498028,100.80403000000003,104.56789999999995,105.91480000000007,106.50149999999992,106.50149999999992,108.94003460095335,104.06296539904649,19164241,43.13587467541896,50.339300971811,NaN,NaN,NaN,NaN,NaN,NaN,-0.31964531107700855,-0.2552383937465237,0.06440691733048487,18.219461697722775,21.048999309868957,5081256582,11053663608.674929,19.468393870929145,35.51123676152412,18.754253177023156,35.714285714285715,64.28571428571429
2015-04-06,104.5,106.27,104.34,105.98,100.59949484830238,104.18712316222165,105.82663159950263,106.33272529641073,100.86908000000001,104.61169999999997,105.95380000000006,106.42999999999992,106.42999999999992,108.84149746009503,104.01850253990482,24451142,48.06717246796456,50.07895103477009,NaN,NaN,NaN,NaN,NaN,NaN,-0.24936644930684046,-0.2473011443030657,0.002065305003774748,36.02484472049709,23.671497584541214,5105707724,11070766739.089437,21.990869508686814,31.530162662972945,19.401012451057273,28.571428571428573,57.142857142857146
2015-04-07,105.92,106.7,105.8,105.8,100.65124116821977,104.21906131742519,105.82558722305156,106.28198955389541,100.93353,104.65009999999997,105.98460000000006,106.33399999999992,106.33399999999992,108.68453525820188,103.98346474179796,19379381,47.14561398833154,49.6920103695108,NaN,NaN,NaN,NaN,NaN,NaN,-0.20375082742457917,-0.25262322927694925,-0.04887240185237006,32.29813664596279,28.847481021394216,5086328343,11051387358.089437,23.365280305983262,29.84964340287825,19.985171609372067,21.428571428571427,50
2015-04-08,105.84,106.79,105.83,106.64,100.71083080833698,104.26700069727815,105.85752497901032,106.31608578685776,101.00288,104.69369999999995,106.03460000000007,106.37999999999995,106.37999999999995,108.71663861134247,104.04336138865743,25866907,51.790727839978054,49.28144892465836,NaN,NaN,NaN,NaN,NaN,NaN,-0.1104264863287492,-0.18690550976330655,-0.07647902343455736,49.689440993788956,39.337474120082945,5112195250,11069170856.651937,22.51754207520607,28.07690795229924,19.740111993885282,14.285714285714286,42.857142857142854
2015-04-09,106.59,107.35,106.23,107.31,100.7764941833784,104.32725810921323,105.91448478375501,106.4107442833475,101.07548000000001,104.74219999999995,106.15200000000006,106.48999999999994,106.48999999999994,108.78387881110294,104.19612118889694,23114727,55.17464170938688,49.06127238774799,NaN,NaN,NaN,NaN,NaN,NaN,-0.002688779022424384,-0.07983999721258783,-0.07715121819016345,63.56107660455504,48.516218081435596,5135309977,11090634531.723366,24.371880645705584,26.182459737412923,18.966006451712342,7.142857142857143,35.714285714285715
2015-04-10,107.27,107.76,107.03,107.75,100.84588230095673,104.39503517635752,105.98646577262737,106.53829244683821,101.15073000000002,104.79069999999996,106.28860000000006,106.58749999999993,106.58749999999993,108.92119985217334,104.25380014782652,17164343,57.29463143977311,48.84715472602467,NaN,NaN,NaN,NaN,57.29463143977311,NaN,0.09376322393944461,0.040052811734142324,-0.05371041220530229,76.80525164113784,63.35192307982728,5152474320,11107328618.750763,25.80952415074552,24.998500006812733,17.476844110316268,0,28.571428571428573
2015-04-13,107.83,108.38,107.36,107.48,100.91189342234024,104.45612358870687,106.04503574232825,106.62797888047267,101.22168000000002,104.83329999999997,106.40040000000006,106.69449999999995,106.69449999999995,108.9854428190212,104.4035571809787,17783465,55.55821440392895,48.61200541833968,NaN,NaN,NaN,NaN,NaN,NaN,0.1325611460197342,0.11199102031936548,-0.020570125700368737,70.89715536105041,70.42116120224776,5134690855,11093729498.456646,28.037726017626312,23.40587557470971,16.80162447167928,7.142857142857143,21.428571428571427
2015-04-14,107.37,107.68,106.56,107.17,100.97416313953089,104.50986371566317,106.08915198772715,106.67959993947527,101.29083000000003,104.87589999999996,106.52180000000006,106.71799999999993,106.71799999999993,109.01830954439589,104.41769045560397,23755747,53.551460837464006,48.425407487949265,NaN,NaN,NaN,NaN,NaN,NaN,0.13033391574378628,0.14234726897936412,0.012013353235577832,70.77294685990354,72.8251179540306,5110935108,11095850547.29593,26.073458648847158,26.77025021647788,16.029359835038708,0,14.285714285714286
2015-04-15,107.45,108.07,107.321,107.84,101.04247992421217,104.57580700842232,106.1578126940908,106.79011423095382,101.36128000000002,104.91749999999998,106.63900000000007,106.76649999999995,106.76649999999995,109.11791893333016,104.41508106666974,21128576,57.15358016239736,49.4485937246698,NaN,NaN,NaN,NaN,NaN,NaN,0.1647539230351039,0.2179557570294577,0.053201833994353805,86.95652173913062,76.20887465336152,5132063684,11104002961.800604,27.060060423757037,25.240020312659382,14.90934414953961,85.71428571428571,7.142857142857143
2015-04-16,107.55,107.88,107.4,107.69,101.10862440257822,104.63747419637436,106.21789847079312,106.87581763752965,101.43018000000002,104.96229999999997,106.73360000000007,106.75499999999995,106.75499999999995,109.08590111330868,104.42409888669123,16195279,56.104556441924295,50.50676067577887,NaN,NaN,NaN,NaN,NaN,NaN,0.1676333633526584,0.2627435381851768,0.09511017483251841,82.92079207920794,80.21675355941403,5115868405,11107376978.258938,26.199884960639437,24.437699629647206,13.069498255963166,78.57142857142857,0
2015-04-17,106.66,106.95,105.55,106.01,101.15739430902022,104.66465292515902,106.20974558958554,106.79335881490778,101.48553000000004,104.98569999999998,106.79640000000006,106.65149999999994,106.65149999999994,108.92089000615546,104.38210999384442,46513964,45.935262957833935,50.65742767932915,NaN,NaN,45.935262957833935,NaN,NaN,NaN,0.052569746329034106,0.16082235774381104,0.10825261141477693,41.33663366336646,70.40464916056833,5069354441,11091429333.458939,22.730694022808745,32.64871458067742,12.333248757806501,71.42857142857143,35.714285714285715
2015-04-20,106.54,107.79,106.5,107.6,101.2214998382837,104.72277860980934,106.2642653703861,106.87018178491655,101.54803000000001,105.02299999999997,106.87320000000007,106.60499999999995,106.60499999999995,108.75340871345095,104.45659128654894,28945909,54.3658061350329,50.93613972972169,NaN,NaN,NaN,NaN,NaN,NaN,0.0781774744367964,0.20597445446077245,0.12779698002397605,80.69306930693062,68.31683168316835,5098300350,11111848540.58297,25.324295743170378,29.186872219183847,11.860505743141164,64.28571428571429,28.571428571428573
2015-04-21,108.22,108.41,107.93,108.06,101.28954461601222,104.7888622016943,106.33468633625331,106.98349780540069,101.60983000000002,105.05679999999998,106.97180000000007,106.59199999999994,106.59199999999994,108.70153644197748,104.4824635580224,22759772,56.480143604763555,51.748750405426144,NaN,NaN,NaN,NaN,NaN,NaN,0.11832073460202303,0.2756978982765048,0.1573771636744818,91.40049140049153,71.14339812359621,5121060122,11101416978.416304,27.854298337213635,27.74516140441996,10.500527399370275,100,21.428571428571427
2015-04-22,108.34,108.83,107.64,108.65,101.36278297804195,104.86532037591817,106.42548295051789,107.14221230012443,101.67603000000003,105.09489999999998,107.08880000000008,106.62799999999996,106.62799999999996,108.8492573016255,104.40674269837442,21429190,59.097781962906,52.918247759078895,NaN,NaN,NaN,NaN,NaN,NaN,0.1734968280376624,0.3742481987215598,0.2007513706838974,95.99109131403134,89.36155067381783,5142489312,11116363388.248238,28.393585184845527,25.734010325652886,8.767235725325099,100,14.285714285714286
2015-04-23,108.28,109.55,108.26,109.06,101.43937220214103,104.94838333877128,106.52879734461523,107.32485874773162,101.75003000000001,105.13029999999999,107.18200000000007,106.80799999999995,106.80799999999995,109.19849450951594,104.41750549048396,29473221,60.859611369147125,54.184228951488045,NaN,NaN,NaN,NaN,NaN,NaN,0.22332017428769207,0.4799015885435125,0.25658141425582043,90.59500959692907,92.66219743715065,5171962533,11123446100.271494,30.532924260056998,23.726241019195985,7.5790321670988465,100,7.142857142857143
2015-04-24,110.21,110.69,110.03,110.54,101.52992571256749,105.05910842117184,106.68609940953228,107.6310626765191,101.82793000000001,105.17559999999997,107.29720000000009,107.07999999999996,107.07999999999996,109.84055066970751,104.3194493302924,32508127,66.47354386685663,55.49896976569459,NaN,NaN,NaN,NaN,66.47354386685663,NaN,0.33495260859679027,0.6752721750018083,0.340319566405018,97.08171206225697,94.55593765773911,5204470660,11141177805.907858,34.31497728328218,21.449061771944095,7.953933428200516,100,0
2015-04-27,110.95,111.16,110.02,110.26,101.61679212338771,105.16209637322784,106.82625237386435,107.88143765970776,101.90593000000001,105.23009999999998,107.38240000000009,107.31699999999996,107.31699999999996,110.30559900288014,104.32840099711979,31121321,64.58615038183459,56.74472236523052,NaN,NaN,NaN,NaN,NaN,NaN,0.3663913121219452,0.7983087065574495,0.43191739443550425,83.95721925133705,90.54464697017436,5173349339,11123160199.01312,34.7810255389866,20.00306676200391,9.01033873432828,100,57.142857142857146
2015-04-28,110.34,110.55,109.11,110.04,101.70060513708535,105.25868852425303,106.95228169253633,108.08701502544987,101.97978,105.27819999999998,107.44500000000009,107.48249999999996,107.48249999999996,110.68190541351346,104.28309458648646,36849221,63.070874180800054,57.55044710386066,NaN,NaN,NaN,NaN,NaN,NaN,0.34891204992905844,0.8680574568468273,0.5191454069177689,80.03565062388608,87.0248606458267,5136500118,11133907888.471455,31.859314598311805,23.63127262316094,9.284604545246646,92.85714285714286,50
2015-04-29,109.43,110.07,108.75,109.35,101.7767185188059,105.3397045930797,107.04630986145648,108.20729930874036,102.04733000000002,105.31749999999998,107.4918000000001,107.66999999999996,107.66999999999996,110.84558183645507,104.49441816354485,34043905,58.439894066649764,57.78367941509373,NaN,NaN,NaN,NaN,NaN,NaN,0.27089870319610143,0.8577687859128957,0.5868700827167943,67.73618538324416,77.24301841948909,5102456213,11130812988.016909,29.41965848921558,23.910120338305514,9.766720348555415,85.71428571428571,42.857142857142854
2015-04-30,108.73,109.17,107.06,107.63,101.83496012558395,105.38505697737516,107.06919967081113,108.15231842219366,102.10793000000001,105.34009999999998,107.50120000000008,107.79899999999995,107.79899999999995,110.73927141604882,104.85872858395108,44080546,48.8174907188022,57.178169363595806,NaN,NaN,NaN,NaN,NaN,NaN,0.09268372688625726,0.7027247413246158,0.6100410144383586,37.0766488413547,61.61616161616164,5058375667,11110548471.609325,25.73748293219127,30.15424719065041,10.217156440981245,78.57142857142857,35.714285714285715
2015-05-01,108.05,109.12,108.03,109.05,101.90675156712042,105.45763010653604,107.14687811509305,108.23781190579426,102.17373000000002,105.37679999999999,107.52840000000009,107.99549999999995,107.99549999999995,110.70996845626112,105.28103154373878,32874307,55.35341436435667,57.163540789340644,NaN,NaN,NaN,NaN,NaN,NaN,0.06118285335613238,0.6865195811335241,0.6253367277773917,62.388591800356515,55.73380867498511,5091249974,11139200390.55428,23.66228724885796,27.72293081954031,10.138485933031673,71.42857142857143,28.571428571428573
2015-05-04,109.4,109.91,109.17,109.23,101.97961971073117,105.53233050046602,107.22856916940312,108.33230601000433,102.24678500000002,105.4228,107.54480000000008,108.15799999999994,108.15799999999994,110.75705059589855,105.55894940410134,23507259,56.118371286161526,57.34689153567617,NaN,NaN,NaN,NaN,NaN,NaN,0.04401751373428864,0.6803586199452525,0.6363411062109638,65.59714795008925,55.020796197266804,5114757233,11119505119.500225,26.9170902193883,26.399835681153146,10.113597452345163,64.28571428571429,21.428571428571427
2015-05-05,108.8,109,107.4,107.45,102.0340513554005,105.57030415392214,107.2372527313873,108.24827686619439,102.30343500000001,105.44769999999998,107.5234000000001,108.24049999999993,108.24049999999993,110.63132809922762,105.84967190077224,47843265,47.45877860473911,56.654405710129154,NaN,NaN,NaN,NaN,NaN,NaN,-0.08844570139218644,0.5257839794707309,0.6142296808629173,33.86809269162221,53.951277480689306,5066913968,11074652058.562725,24.26345128699088,33.332524334730905,10.989742008283036,57.142857142857146,14.285714285714286
2015-05-06,107.64,107.95,105.995,106.71,102.08057820758557,105.59287238849794,107.21657615368584,108.1017743075092,102.35698500000001,105.48169999999999,107.4856000000001,108.24399999999994,108.24399999999994,110.6256330531877,105.86236694681219,42687150,44.39192671786973,55.81778930126812,NaN,NaN,44.39192671786973,NaN,NaN,NaN,-0.21965949455734324,0.3396553126662383,0.5593148072235815,20.677361853832384,40.04753416518127,5024226818,11063188757.411829,21.791800094259887,37.25792639632745,12.612006552329692,50,7.142857142857143
2015-05-07,106.68,107.65,106.6,107.35,102.13301026522154,105.6276669946663,107.22180846138443,108.03017675441309,102.41068500000002,105.51719999999999,107.46600000000011,108.24599999999995,108.24599999999995,110.62455754608285,105.86744245391705,29335806,47.54885116185875,55.933045601555605,NaN,NaN,NaN,NaN,NaN,NaN,-0.2546427058952152,0.2410114248545625,0.4956541307497777,26.23426911907051,26.926574554841682,5053562624,11075761245.697542,20.57927193706591,35.18483997672013,13.203612100114102,42.857142857142854,0
2015-05-08,108.46,108.92,108.3,108.69,102.19825394417457,105.68830725219766,107.27938460015366,108.09301706351661,102.46799999999999,105.5774,107.46220000000011,108.29299999999996,108.29299999999996,110.66764186773935,105.91835813226058,33023337,53.50106899273015,55.87127866281969,NaN,NaN,NaN,NaN,NaN,NaN,-0.18222382818656263,0.2678743455165744,0.45009817370313704,52.17812197483054,33.02991764924446,5086585961,11084283397.181414,25.538736538286937,32.29160690948966,13.531554408928821,35.714285714285715,85.71428571428571
2015-05-11,108.76,108.98,108.19,108.27,102.25866932781462,105.73942988086701,107.31823226289274,108.10987258127693,102.52375,105.64399999999999,107.4596000000001,108.33249999999995,108.33249999999995,110.67783473091296,105.98716526908694,19679255,51.527326038543045,55.51750597951822,NaN,NaN,NaN,NaN,NaN,NaN,-0.15818748237833036,0.2523638207302241,0.4105513031085545,44.04646660212962,40.819619232010204,5066906706,11068589814.080147,24.449289301691127,31.508072320825203,14.418574627078709,28.571428571428573,78.57142857142857
2015-05-12,107.63,108.33,106.8,107.78,102.3136079414682,105.77983720995876,107.33634080160283,108.07845614496485,102.57895,105.722,107.42760000000011,108.36299999999997,108.36299999999997,110.66248776905164,106.0635122309483,33665017,49.24477868553183,54.81372003113436,NaN,NaN,NaN,NaN,NaN,NaN,-0.16984309040220136,0.19824744010580275,0.3680905305080041,34.55953533397869,43.59470797031293,5033241689,11078051224.086683,22.451704883841682,36.35646917150601,15.756484831651818,21.428571428571427,71.42857142857143
2015-05-13,108.25,108.81,107.84,108,102.37018895697598,105.82380082956354,107.36236665252036,108.07098413115867,102.63510000000001,105.78399999999999,107.41020000000009,108.37099999999995,108.37099999999995,110.6642588166258,106.0777411833741,20738434,50.30909418801935,54.060111661053796,NaN,NaN,NaN,NaN,NaN,NaN,-0.15756106931808478,0.1711391938603981,0.3287002631784829,38.818973862536275,39.14165859954818,5053980123,11064154335.323797,23.802218463712325,34.32336673821249,16.15333882073985,14.285714285714286,64.28571428571429
2015-05-14,108.88,109.67,108.48,109.58,102.4419283703394,105.89818101115634,107.44933266614701,108.21469992819118,102.70000000000002,105.8373,107.4328000000001,108.46549999999995,108.46549999999995,110.79421187570158,106.13678812429832,23904233,57.2435226026166,53.400824427893795,NaN,NaN,NaN,NaN,NaN,NaN,-0.04376811355800203,0.2739901212309803,0.31775823478898235,69.40948693126813,47.59599870926103,5077884356,11084442801.987663,26.265864907535647,31.270061478859613,15.126585319337348,7.142857142857143,57.142857142857146
2015-05-15,109.86,110.01,109.31,109.58,102.51295395869423,105.97108831786612,107.53288824786674,108.3447285064587,102.763,105.88989999999998,107.45160000000008,108.64399999999996,108.64399999999996,110.72678083340925,106.56121916659067,23937442,57.2435226026166,52.87635101509251,NaN,NaN,NaN,NaN,NaN,NaN,0.026952562240751488,0.3514489375899217,0.3244963753491702,78.70472008781557,62.31106029387333,5077884356,11078971386.673378,27.126980532718083,30.062867661854696,13.566490490637559,0,50
2015-05-18,109.4,110.28,109.32,110.06,102.58804894417986,106.05205686602719,107.63199066951903,108.50808769631978,102.83820000000001,105.9447,107.5046000000001,108.76699999999997,108.76699999999997,110.87898579541088,106.65501420458905,17631135,59.247274435997255,52.603236747606594,NaN,NaN,NaN,NaN,NaN,NaN,0.09754012101390125,0.44642152661654677,0.3488814056026455,94.86581096849477,80.99333932919284,5095515491,11088521584.798378,27.180815330765423,28.441227541237772,12.669220091372514,0,42.857142857142854
2015-05-19,110.18,110.35,109.76,109.94,102.66120268602882,106.12904583897715,107.7225008393418,108.64446029667027,102.91455000000002,106.002,107.5490000000001,108.86099999999996,108.86099999999996,111.00584405028066,106.71615594971927,14212896,58.50904775539641,52.608176296802775,NaN,NaN,NaN,NaN,NaN,NaN,0.12583101618628922,0.506170175835507,0.38033915964921783,90.58553386911602,88.05202164180879,5081302595,11082980964.323801,26.65284226413397,27.46082785591947,12.037938235077059,100,35.714285714285715
2015-05-20,110.02,110.67,109.425,110.01,102.73432504736186,106.20589641642314,107.81220668877938,108.77451169698739,102.98800000000001,106.0591,107.6348000000001,108.92899999999997,108.92899999999997,111.12831716676168,106.72968283323827,21131892,58.83129561241428,53.32344807491792,NaN,NaN,NaN,NaN,NaN,NaN,0.1379666883493142,0.5527975200858606,0.4148308317365464,85.88235294117653,90.44456592626244,5102434487,11081707958.781633,24.71665836529678,27.420641081089688,11.843932212492726,100,28.571428571428573
2015-05-21,109.82,110.73,109.66,110.58,102.81239146480105,106.29251232896922,107.9207476029449,108.94646296394097,103.06795000000002,106.1145,107.74420000000009,109.00499999999997,109.00499999999997,111.31922125131193,106.690778748688,16771801,61.45642168829054,53.75937716948464,NaN,NaN,NaN,NaN,61.45642168829054,NaN,0.17093478563900122,0.6284993137852979,0.45756452814629667,96.83210137275596,91.09999606101617,5119206288,11093777385.669483,23.51277673133195,25.693136122694956,11.595984703476216,100,21.428571428571427
2015-05-22,110.45,110.87,110.38,110.47,102.88858657460403,106.37523485710845,108.02071828518235,109.09156172927993,103.1477,106.16900000000001,107.8376000000001,109.00149999999996,109.00149999999996,111.3066184351396,106.69638156486033,13543774,60.65264533314607,54.08325388712638,NaN,NaN,NaN,NaN,NaN,NaN,0.17144639492077784,0.671872521797269,0.5004261268764911,91.79487179487168,91.50310870293474,5105662514,11085208875.58785,23.665211979105564,24.918910163932452,11.711007434244157,100,14.285714285714286
2015-05-26,110.23,110.38,108.76,109.2,102.95138670819006,106.43117080053204,108.0669646269399,109.10188918363423,103.2226,106.21780000000001,107.9148000000001,108.94849999999997,108.94849999999997,111.18310309675427,106.71389690324567,25488437,52.16910612735928,54.41970585302782,NaN,NaN,52.16910612735928,NaN,NaN,NaN,0.07716883585937884,0.5968871717007147,0.5197183358413359,65.74358974358971,84.79018763707245,5080174077,11073566009.3039,21.257783946370605,32.02138812574166,12.029311369930017,92.85714285714286,7.142857142857143
2015-05-27,109.53,111.08,109.29,110.96,103.03107440263592,106.52085058666012,108.18041699451089,109.2788521185262,103.30290000000001,106.29490000000001,108.00000000000011,108.99449999999995,108.99449999999995,111.35160394340897,106.63739605659092,30572695,60.42936996846973,55.565237513784965,NaN,NaN,NaN,NaN,NaN,NaN,0.12161308586504194,0.6717346931726382,0.5501216073075963,97.32142857142847,84.95329670329663,5110746772,11100039572.013397,22.97519326556382,28.5791660301897,10.934906264407545,100,0
2015-05-28,110.75,111.01,110.37,110.71,103.10748162251019,106.60380404038962,108.27961632805949,109.4151519167618,103.37915000000001,106.37260000000002,108.0768000000001,109.06249999999996,109.06249999999996,111.53247064760461,106.5925293523953,17302408,58.874044379276356,56.37417988645765,NaN,NaN,NaN,NaN,NaN,NaN,0.12212495218396291,0.70277779753755,0.5806528453535871,91.35514018691579,84.80671950064466,5093444364,11101120972.513397,22.10407352016118,27.4955679273022,9.840501158885074,92.85714285714286,0
2015-05-29,110.64,110.79,109.79,110.05,103.17656140736084,106.67204554454032,108.34904313872383,109.47561363897496,103.45230000000001,106.45880000000002,108.1194000000001,109.18349999999995,109.18349999999995,111.59737882878059,106.76962117121931,30382987,54.859694290197986,56.471224550562496,NaN,NaN,NaN,NaN,NaN,NaN,0.06863042900689309,0.6664408816122034,0.5978104526053103,75.93457943925232,88.20371606586554,5063061377,11086537138.753397,20.778403113451745,29.325041704403453,10.224854685692204,85.71428571428571,14.285714285714286
2015-06-01,110.64,110.72,109.52,110.42,103.24863542320799,106.74626246445041,108.43025713328367,109.56555519716782,103.52225,106.56230000000001,108.1662000000001,109.25199999999995,109.25199999999995,111.72389481977521,106.7801051802247,24570186,56.64444907365006,56.83673333878443,NaN,NaN,NaN,NaN,NaN,NaN,0.049665789573775654,0.6598926895725299,0.6102268999987542,84.57943925233653,83.95638629283489,5087631563,11098822231.753397,19.283813061407248,28.834116613553462,10.741506695331077,78.57142857142857,7.142857142857143
2015-06-02,110.01,110.61,109.47,110.07,103.31650969760392,106.81207904931277,108.49456077511569,109.61359755934232,103.58795,106.64940000000003,108.1970000000001,109.29399999999995,109.29399999999995,111.79138583323389,106.79661416676602,19449634,54.45127493975366,57.208625928371696,NaN,NaN,NaN,NaN,NaN,NaN,0.007276053723532128,0.6193219671531693,0.6120459134296372,68.82716049382695,76.44705972847193,5068181929,11099845896.700766,17.961991888027395,27.158302578961962,10.508470254581308,71.42857142857143,0
2015-06-03,110.57,110.81,110.13,110.4,103.38699218817503,106.88312698893034,108.5692838819739,109.68849302988114,103.65295,106.72040000000003,108.23860000000009,109.44149999999998,109.44149999999998,111.83200015687524,107.05099984312471,20507208,56.174237413788,57.62756473021232,NaN,NaN,NaN,NaN,NaN,NaN,-0.004194510944680929,0.6068027747487861,0.610997285693467,73.84615384615407,75.75091786410586,5088689137,11095623824.465471,18.376500798279853,25.91645869929728,10.431485139777985,64.28571428571429,0
2015-06-04,109.78,110.48,109.21,109.56,103.44841515147677,106.93613437528816,108.60813549444552,109.6762555984639,103.71000000000002,106.78980000000001,108.27120000000009,109.58399999999997,109.58399999999997,111.61964633471145,107.5483536652885,31374588,50.89661272147558,57.17421402441653,NaN,NaN,NaN,NaN,NaN,NaN,-0.07034133869352288,0.5230706123265634,0.5934119510200863,34.48275862068964,59.05202432022355,5057314549,11081542316.465471,16.94448005107566,29.541960104479,11.745895215764838,57.142857142857146,0
2015-06-05,109.43,109.69,108.63,109.3,103.50663987633769,106.98294359557948,108.63526743583981,109.64042173194352,103.763,106.86730000000001,108.3480000000001,109.68149999999996,109.68149999999996,111.44893062099588,107.91406937900403,22641732,49.35108510747312,56.61046848904914,NaN,NaN,NaN,NaN,NaN,NaN,-0.13011609571931249,0.4307668313709456,0.5608829270902581,27.346938775510242,45.22528374745132,5034672817,11087523151.333395,15.835305810804421,31.18990000808931,13.711485034387234,50,100
2015-06-08,109.25,109.33,107.97,108.19,103.55324047458308,107.00684570259772,108.61780596776765,109.50228632890128,103.81045000000002,106.93400000000001,108.40980000000009,109.65649999999997,109.65649999999997,111.49215002111612,107.82084997888381,24549204,43.305171146625284,55.47174682552257,NaN,NaN,NaN,NaN,NaN,NaN,-0.2367119240700929,0.26499302200264196,0.5017049460727349,7.073954983922794,22.967884126707556,5010123613,11070916336.862806,14.52186182948259,32.62810888311133,16.292582614746816,42.857142857142854,100
2015-06-09,107.93,108.4,107.2,108.01,103.59758634050762,107.02671014413043,108.5939704396199,109.36016382138688,103.85600000000001,107.00450000000002,108.45960000000008,109.64349999999995,109.64349999999995,111.5214379649082,107.76556203509169,27554599,42.39809078109685,54.32096418450117,NaN,NaN,42.39809078109685,NaN,NaN,NaN,-0.3071764216818109,0.11773441897047121,0.42491084065228213,20.876288659793897,18.43239413974231,4982569014,11080560446.512806,13.460930661883088,34.93223760480041,19.355106937904566,35.714285714285715,100
2015-06-10,108.38,109.81,108.26,109.49,103.65621732219411,107.07548816107834,108.62910885375244,109.37252917173099,103.90820000000002,107.10290000000003,108.5148000000001,109.72899999999996,109.72899999999996,111.40458825492273,108.05341174507718,30297862,51.41017489609971,53.790884133335844,NaN,NaN,NaN,NaN,NaN,NaN,-0.2446631966268864,0.11908184486867412,0.36374504149556053,59.020618556700896,28.990287400139195,5012866876,11098348223.557966,20.30875827452978,31.24484618115947,20.49987616737687,28.571428571428573,92.85714285714286
2015-06-11,109.86,110.15,109.46,109.65,103.715856950829,107.12646859353224,108.66914380066412,109.39895496489946,103.95945,107.19120000000002,108.5958000000001,109.81149999999995,109.81149999999995,111.28924524192554,108.33375475807436,17593463,52.27940971778727,53.1353832782999,NaN,NaN,NaN,NaN,NaN,NaN,-0.18576083709060498,0.1315439951323043,0.3173048322229093,63.144329896907365,47.680412371134054,5030460339,11090443914.094198,21.518318015489463,29.940153784515505,21.352389326869694,21.428571428571427,85.71428571428571
2015-06-12,109.07,109.3,108.6,108.75,103.76594792644264,107.15861773029397,108.67231463201063,109.33714973014713,104.00569999999999,107.26250000000003,108.66980000000011,109.76999999999995,109.76999999999995,111.31644107551327,108.22355892448664,27201768,47.16793885964959,52.172189958764434,NaN,NaN,NaN,NaN,NaN,NaN,-0.19943279424920207,0.0680138394114067,0.2674466336606088,39.9484536082474,54.03780068728522,5003258571,11074900046.665627,20.140104953567523,33.26840191326909,22.923849396024472,14.285714285714286,78.57142857142857
2015-06-15,107.94,108.38,107.31,108.21,103.81016735006013,107.17943718117924,108.65418464644158,109.22980213679979,104.04915000000001,107.32320000000003,108.73160000000009,109.70149999999994,109.70149999999994,111.39034901635651,108.01265098364337,31238798,44.36513349447822,51.614763342130075,NaN,NaN,NaN,NaN,NaN,NaN,-0.2344473138743274,-0.025612508682300472,0.20883480519202693,26.030927835051344,43.04123711340204,4972019773,11096212497.637589,18.399603535076306,38.1351202469039,23.9743058372346,7.142857142857143,71.42857142857143
2015-06-16,108.1,108.9799,108.05,108.8,103.85981742617894,107.21152753402717,108.65990289560074,109.18886859996171,104.0961,107.37090000000003,108.7880000000001,109.63849999999995,109.63849999999995,111.36278854895035,107.91421145104955,16456867,48.000812514394774,50.72700923826757,NaN,NaN,NaN,NaN,NaN,NaN,-0.2083551062357292,-0.05160907760263456,0.15674602863309464,41.9947506561678,35.99137736648885,4988476640,11106301818.937405,21.013841339826982,35.97315071905635,25.07290341073127,0,64.28571428571429
2015-06-17,108.98,109.45,108.43,109.1,103.91195854631646,107.24892302840287,108.67716160557718,109.18040492377487,104.1427,107.41930000000002,108.85400000000008,109.59649999999995,109.59649999999995,111.33026209441871,107.86273790558118,23296738,49.797281185767005,50.078669010159764,NaN,NaN,NaN,NaN,NaN,NaN,-0.1633624214961291,-0.04745699823706673,0.11590542325906236,52.63157894736819,40.21908581286245,5011773378,11113610599.486423,22.587649333273777,33.71527632120161,25.70817663787776,0,57.142857142857146
2015-06-18,109.5,110.88,109.44,110.69,103.97940174486057,107.3170631664543,108.75609644457415,109.32417588341536,104.1958,107.48480000000004,108.93500000000009,109.63049999999994,109.63049999999994,111.42110297108451,107.83989702891537,43032384,58.06618624107207,50.30770414950791,NaN,NaN,NaN,NaN,58.06618624107207,NaN,-0.026184752425442936,0.08317448272725869,0.10935923515270163,94.83695652173918,63.15442870842506,5054805762,11145287215.486423,28.6808880331159,30.15792122902374,24.669056522585688,100,50
2015-06-19,110.49,110.575,109.81,109.89,104.03821366779728,107.36801241068294,108.80056325066928,109.37806389451866,104.24785,107.56930000000004,108.9866000000001,109.59599999999993,109.59599999999993,111.33802640624688,107.85397359375298,27877574,53.308510276388134,50.069422806846354,NaN,NaN,NaN,NaN,NaN,NaN,0.009117062639206086,0.12075556345170924,0.11163850081250315,73.0978260869566,73.52212051868798,5026928188,11123240245.198841,27.1554158060969,28.553888912925874,23.430670938222477,92.85714285714286,42.857142857142854
2015-06-22,110.7,111.03,110.45,110.7,104.10450009896347,107.43399236294664,108.87505096632931,109.50396257123117,104.30439999999999,107.66710000000005,109.04560000000009,109.60749999999993,109.60749999999993,111.37529947959618,107.83970052040368,19120898,57.13786074316976,50.261321792804644,NaN,NaN,NaN,NaN,NaN,NaN,0.0814401457134526,0.2134386829543189,0.1319985372408663,91.3838120104439,86.43953153971323,5046049086,11120602879.957462,28.036619620742766,26.581476722403245,22.16513184007111,100,35.714285714285715
2015-06-23,110.82,110.89,110.33,110.79,104.17102248603847,107.50044795971998,108.95014700686542,109.626442326352,104.35889999999999,107.75610000000005,109.11180000000009,109.68699999999993,109.68699999999993,111.51628510628183,107.85771489371803,18127916,57.55440598169955,50.35990526194117,NaN,NaN,NaN,NaN,NaN,NaN,0.12704181031753733,0.290800800137788,0.16375898982025064,93.73368146214112,86.07177318651388,5064177002,11132256540.243177,27.04820596634976,26.399814238797397,21.03586036842643,92.85714285714286,28.571428571428573
2015-06-24,110.66,111.13,110.19,110.22,104.23121131702315,107.55430047536909,108.99994516345893,109.6829716286042,104.4096,107.84730000000003,109.17280000000008,109.64999999999993,109.64999999999993,111.40314574410004,107.89685425589983,15815914,53.976645583182915,50.57990760920599,NaN,NaN,NaN,NaN,NaN,NaN,0.11109528078942615,0.30262809080703335,0.1915328100176072,76.84478371501277,87.3207590625326,5048361088,11117450152.668709,26.957363452057763,24.818174970836107,19.39531759948796,100,21.428571428571427
2015-06-25,110.65,110.76,109.815,110,104.28861219944083,107.60273016892614,109.03916300018604,109.71316480683237,104.46334999999999,107.92750000000004,109.21600000000008,109.61449999999994,109.61449999999994,111.30809351677233,107.92090648322754,18326654,52.61710512631534,50.813194753409,NaN,NaN,NaN,NaN,NaN,NaN,0.07949045271317207,0.2908958759090723,0.21140542319590022,71.24681933842245,80.60842817185878,5030034434,11106299013.99146,25.315341366543713,25.723590486977372,17.12017756367587,92.85714285714286,14.285714285714286
2015-06-26,109.98,110.23,108.86,109.27,104.3381782472076,107.63574541310582,109.04821543155128,109.67095863475309,104.50935,107.99060000000003,109.24760000000008,109.57549999999995,109.57549999999995,111.26309562693253,107.88790437306737,32311679,48.27231104535967,51.16799046046146,NaN,NaN,NaN,NaN,NaN,NaN,0.006999900402842096,0.22015529869945283,0.21315539829661073,52.67175572519076,66.92111959287531,4997722755,11093327172.057154,23.11694747630836,29.543215904057917,15.248883719050454,85.71428571428571,7.142857142857143
2015-06-29,108.06,108.66,106.64,106.69,104.36157945867816,107.61701778116313,108.95573639501985,109.38705781239565,104.54284999999999,108.02880000000003,109.26120000000009,109.38899999999992,109.38899999999992,111.44604545405777,107.33195454594208,50874901,36.728949789745776,50.763051818222095,NaN,NaN,36.728949789745776,NaN,NaN,NaN,-0.20539558948385409,-0.04358908855820687,0.16180650092564722,1.113585746102388,41.677386936571864,4946847854,11044970830.5126,19.598408331952474,37.89437048903241,14.352783293283467,78.57142857142857,100
2015-06-30,107.49,107.72,106.74,107.07,104.38852891680077,107.60618574589257,108.88178594815633,109.16638563978654,104.58079999999998,108.06190000000002,109.25060000000006,109.23899999999995,109.23899999999995,111.50267753888212,106.97532246111777,34809920,39.041119731946836,49.87954787792547,NaN,NaN,NaN,NaN,NaN,NaN,-0.3049782382916399,-0.21941629693890263,0.08556194135273724,9.576837416480915,21.120726295924687,4981657774,11033604326.022804,18.41618959623025,35.60849941155852,15.110641783980018,71.42857142857143,92.85714285714286
2015-07-01,108.13,108.3464,107.42,107.92,104.423667932554,107.61239988953827,108.8440688521502,109.04768224552116,104.6278,108.1098,109.24780000000005,109.11499999999994,109.11499999999994,111.38239939138462,106.84760060861525,21292958,43.97320420265429,49.286247483987395,NaN,NaN,NaN,NaN,NaN,NaN,-0.29794228776593235,-0.28686591835467823,0.011076369411254144,28.507795100222776,13.066072754268697,5002950732,11035295994.53403,20.700463119744693,32.95548845827681,15.573051405068195,64.28571428571429,85.71428571428571
2015-07-02,108.23,108.32,107.62,107.95,104.45875581382212,107.61908504024048,108.80900732853647,108.94314107928105,104.67064999999998,108.16130000000003,109.23380000000006,109.03449999999994,109.03449999999994,111.34686221212078,106.72213778787909,20499447,44.14497241982675,49.07032130971434,NaN,NaN,NaN,NaN,NaN,NaN,-0.27610011446555344,-0.33404877367068764,-0.057948659205134215,29.17594654788427,22.420193021529325,5023450179,11034124597.562603,19.82797473227639,31.566472144155483,15.448701495366711,57.142857142857146,78.57142857142857
2015-07-06,107.27,108.32,107.04,107.7,104.49100699975425,107.62068731667136,108.76551684506445,108.82474669077808,104.71149999999997,108.19430000000003,109.20660000000007,108.95449999999994,108.95449999999994,111.33431070676754,106.57468929323234,24311020,42.962900095807484,48.970161781237856,NaN,NaN,NaN,NaN,NaN,NaN,-0.2633623482498624,-0.38715159451746217,-0.12378924626759981,23.608017817372016,27.09725315515969,4999139159,11034884316.937603,18.308385346907215,32.61994927950448,14.962466803671324,50,71.42857142857143
2015-07-07,107.82,108.07,105.83,107.97,104.52562384552783,107.62760439950955,108.73432010604232,108.74334224403731,104.74994999999997,108.22620000000002,109.15520000000008,108.94349999999993,108.94349999999993,111.3393236579626,106.54767634203726,44230772,44.685599287043026,48.73336083642702,NaN,NaN,NaN,NaN,NaN,NaN,-0.22321334151680983,-0.4028059231636121,-0.17959258164680225,40.37735849056607,31.05377428527412,5043369931,11075165912.866175,15.997758742094065,35.320491913907595,15.776920950752315,42.857142857142854,100
2015-07-08,107.2,107.33,105.8942,106.09,104.54118977741312,107.59715678763807,108.63062127835438,108.49064298270042,104.78049999999998,108.22710000000002,109.07180000000008,108.84749999999994,108.84749999999994,111.52281586920873,106.17218413079115,39691475,36.43400763323603,47.77884129696052,NaN,NaN,NaN,NaN,NaN,NaN,-0.3046874063987154,-0.5604518396451965,-0.2557644332464811,4.90566037735859,22.963678895098894,5003678456,11046299888.214413,14.208218295884734,31.369472906874265,17.05469944418348,35.714285714285715,92.85714285714286
2015-07-09,107.5,107.5955,106.02,106.03,104.55600380947867,107.56612397996207,108.52863613018363,108.25629603196705,104.81539999999997,108.21830000000004,108.99160000000008,108.67449999999994,108.67449999999994,111.5972895921604,105.75171040783948,28381041,36.20423011085668,46.21727300194514,NaN,NaN,36.20423011085668,NaN,NaN,NaN,-0.3412788588485472,-0.6823630068071651,-0.3410841479586179,3.773584905660433,16.352201257861697,4975297415,11018279127.011303,14.429678008078858,28.741563729014892,19.24335156269766,28.571428571428573,85.71428571428571
2015-07-10,107.44,108.05,107.05,107.65,104.58678984122515,107.56778489124996,108.4941798113529,108.1985535527321,104.85974999999996,108.22470000000003,108.95760000000007,108.57449999999994,108.57449999999994,111.49379768951928,105.6552023104806,26415825,46.090151566422335,45.70167595123329,NaN,NaN,NaN,NaN,NaN,NaN,-0.23982905617812683,-0.6408704681812765,-0.40104141200314963,34.33962264150959,14.339622641509541,5001713240,11023562292.011303,15.266389779312192,25.76170682618077,20.891244405991166,21.428571428571427,78.57142857142857
2015-07-13,108.58,109.63,108.57,109.54,104.6360755144468,107.60683865577965,108.53519236777042,108.3263103572338,104.90824999999997,108.24850000000004,108.99580000000006,108.61399999999995,108.61399999999995,111.56295506917907,105.66504493082083,25780733,54.875671999084005,45.54009104094145,NaN,NaN,NaN,NaN,NaN,NaN,-0.03939844723346614,-0.4502894710449823,-0.41089102381151615,70.00000000000018,36.03773584905674,5027493973,11044965164.690548,21.63216549133017,23.220420495458267,20.95387595753985,14.285714285714286,71.42857142857143
2015-07-14,109.69,110.56,109.63,110.26,104.69203496206424,107.65937650418006,108.60283188275982,108.51047127559248,104.97084999999997,108.27420000000004,109.02000000000005,108.71649999999993,108.71649999999993,111.74363247150646,105.68936752849339,21977167,57.703537833080425,45.55074331604008,NaN,NaN,NaN,NaN,NaN,NaN,0.13798764015433596,-0.23840647361859624,-0.3763941137729322,83.58490566037753,62.64150943396245,5049471140,11052763514.271193,25.240612203126954,22.01558208537395,21.35469310639263,7.142857142857143,64.28571428571429
2015-07-15,110.47,110.81,110.07,110.38,104.74863162910837,107.71325023677055,108.67252475010257,108.68852163029796,105.02884999999998,108.29390000000004,109.04300000000005,108.79549999999992,108.79549999999992,111.90847590740209,105.68252409259775,28631537,58.17400333687954,45.850554584161266,NaN,NaN,NaN,NaN,NaN,NaN,0.25302589602484915,-0.06011174374187078,-0.31313763976671993,91.36546184738943,81.65012250258906,5078102677,11048120562.325247,25.573452305557076,21.157859806572226,21.734495689525897,0,57.142857142857146
2015-07-16,111.29,111.96,111.07,111.94,104.82018753329635,107.796948251884,108.80066103441227,108.99818623693625,105.09529999999997,108.32810000000003,109.13280000000006,108.93749999999993,108.93749999999993,112.3388225369052,105.53617746309466,29838948,63.80965903306328,46.65002272035754,NaN,NaN,NaN,NaN,NaN,NaN,0.4142759822126302,0.20470733799906782,-0.20956864421356236,99.67373572593809,91.54136774456835,5107941625,11076618434.010641,29.455069131969978,19.418305842727065,23.144237260621747,100,50
2015-07-17,112.84,113.59,112.65,113.59,104.90744934888544,107.9116621478863,108.98847824874905,109.43550183341851,105.16929999999996,108.37800000000003,109.27040000000007,109.08249999999994,109.08249999999994,112.98119144714526,105.18380855285461,35926804,68.62498917161534,48.10378544366152,NaN,NaN,NaN,NaN,NaN,NaN,0.6008371233809618,0.5414777600126399,-0.0593593633683219,99.99999999999999,97.01306585777583,5143868429,11112545238.010641,35.32332376961641,17.774761265746143,24.633240819208627,100,42.857142857142854
2015-07-20,113.83,114.39,113.48,113.98,104.99772348471743,108.03182725386876,109.1842241997785,109.86831118261675,105.25314999999996,108.43450000000004,109.40300000000006,109.28699999999995,109.28699999999995,113.7253785327564,104.8486214672435,26539045,69.65280956169252,50.45548971308627,NaN,NaN,NaN,NaN,69.65280956169252,NaN,0.7117032144054684,0.8302696546385135,0.11856644023304522,95.21028037383182,98.29467203325663,5170407474,11115169978.724926,37.84044494944788,16.923985842934414,25.08827297893797,100,35.714285714285715
2015-07-21,114.02,114.2,113.58,113.91,105.0864028530287,108.14822671418818,109.36954874096365,110.25323392712944,105.33664999999998,108.48480000000004,109.50740000000008,109.44749999999995,109.44749999999995,114.29221619396142,104.60278380603847,35468865,69.21453249046608,52.61073348155195,NaN,NaN,NaN,NaN,NaN,NaN,0.738335089823085,1.0414853025119015,0.3031502126888165,94.39252336448592,96.53426791277258,5134938609,11117458292.595894,36.556601829280716,16.349792203845748,25.543305138667307,92.85714285714286,28.571428571428573
2015-07-22,112.17,113.169,112.165,112.62,105.16136401867021,108.23677668024386,109.49701741778861,110.47864021978378,105.40889999999997,108.52700000000003,109.59440000000008,109.53899999999994,109.53899999999994,114.54801946492908,104.5299805350708,35574962,61.530693194907684,53.864839838141464,NaN,NaN,NaN,NaN,NaN,NaN,0.6312341389926842,1.0921928864296717,0.4609587474369875,79.32242990654211,89.64174454828662,5099363647,11114127569.062029,33.14782060798006,22.38649115753473,25.296004544061496,85.71428571428571,21.428571428571427
2015-07-23,112.73,113.1,111.91,112.2,105.23140019758891,108.315256349942,109.60301673473808,110.64257924647104,105.48009999999998,108.55520000000003,109.68280000000009,109.63799999999995,109.63799999999995,114.7736113560155,104.5023886439844,25698255,59.22536382022876,54.9420106524559,NaN,NaN,NaN,NaN,NaN,NaN,0.5000091095569155,1.0859701343831318,0.5859610248262164,74.41588785046733,82.7102803738318,5073665392,11100954513.977995,31.02331571228397,22.325096317194166,24.829186006459885,78.57142857142857,14.285714285714286
2015-07-24,112.8,113.003,110.93,111.1,105.2897942254736,108.37039978855701,109.66172196082678,110.68614312775952,105.55274999999997,108.57750000000001,109.74480000000007,109.69299999999994,109.69299999999994,114.86636292947325,104.51963707052663,30844714,53.56492906869428,55.69929843623352,NaN,NaN,NaN,NaN,NaN,NaN,0.3160069745963501,0.980969743071654,0.6649627684753039,61.5654205607476,71.76791277258569,5042820678,11075168749.693382,27.69351759624254,25.002966610248155,23.186641166893928,71.42857142857143,7.142857142857143
2015-07-27,110.47,110.946,109.94,110.18,105.33845298939923,108.40623345611034,109.68204658981396,110.63793902035385,105.61139999999997,108.59480000000002,109.75680000000007,109.73849999999996,109.73849999999996,114.91218833618956,104.56481166381036,35994837,49.31932940920147,56.03027915924484,NaN,NaN,49.31932940920147,NaN,NaN,NaN,0.11933780398944838,0.8141350234621143,0.6947972194726659,50.446102780197364,62.14247039713744,5006825841,11056348387.60392,26.01110735703735,28.668797951674605,20.844334096305566,64.28571428571429,0
2015-07-28,110.67,111.35,109.785,111.13,105.39608032283805,108.46016942727647,109.73882907648793,110.68480197079634,105.68274999999996,108.61970000000002,109.78780000000008,109.96049999999995,109.96049999999995,114.97034021701575,104.95065978298416,33553494,53.42454590001542,57.243889035443374,NaN,NaN,NaN,NaN,NaN,NaN,0.044105940088498996,0.7499296445832897,0.7058237044947907,61.05137395459972,57.687632431848236,5040379335,11080468311.405836,25.995177012584946,26.34355076389297,18.202395714100884,57.142857142857146,0
2015-07-29,111.37,111.79,110.94,111.55,105.4573133544516,108.52135419109278,109.8098553872139,110.76720178310146,105.76829999999997,108.66110000000002,109.81760000000007,110.18449999999996,110.18449999999996,115.05606022235479,105.31293977764513,26714068,55.15407190667885,58.597449163716384,NaN,NaN,NaN,NaN,NaN,NaN,0.015008517837156399,0.7245843517912363,0.7095758339540799,61.30790190735692,57.601792880718,5067093403,11092096788.06466,27.162325316574957,25.150403976051518,16.10914684559815,50,0
2015-07-30,111.29,112.2663,110.621,112.08,105.5232107340093,108.59182242493253,109.8988806661467,110.89223018471084,105.86389999999996,108.70470000000003,109.86040000000008,110.39249999999996,110.39249999999996,115.21453639555182,105.5704636044481,25438057,57.30845595117268,59.39875661976998,NaN,NaN,NaN,NaN,NaN,NaN,0.0233383403666354,0.7387487594123741,0.7154104190457387,60.30927835051548,60.889518070824046,5092531460,11111774059.774317,27.316469040786203,22.980731094008135,14.897677775000975,42.857142857142854,0
2015-07-31,112.43,112.49,111.72,111.95,105.5871588859097,108.65832099077545,109.97931671845467,110.99297016711934,105.95879999999995,108.76700000000002,109.89920000000008,110.59249999999994,110.59249999999994,115.32367691489458,105.86132308510531,22081731,56.59033999435647,59.52123290514658,NaN,NaN,NaN,NaN,NaN,NaN,0.012517320858933312,0.7310570701194052,0.7185397492604719,48.73949579831943,56.78555868539729,5070449729,11102884012.228863,27.388781853834317,22.023184906112707,15.42038107556309,35.714285714285715,0
2015-08-03,111.97,112.28,110.861,111.6,105.64698815072651,108.71657206026505,110.04287292557409,111.0507825321556,106.05494999999998,108.83190000000002,109.91960000000006,110.78749999999994,110.78749999999994,115.34399371776571,106.23100628223416,25001780,54.60639886060644,59.300008692827014,NaN,NaN,NaN,NaN,NaN,NaN,-0.02380823524686071,0.688779455201896,0.7125876904487567,39.41368078175888,49.48748497686461,5045447949,11103923550.650286,25.296889341864855,24.964674199276438,14.980124408826965,28.571428571428573,0
2015-08-04,111.55,111.745,110.93,111.39,105.7041325472367,108.76951122738852,110.09570143829667,111.08308895766459,106.15294999999996,108.88780000000003,109.93800000000006,110.95849999999993,110.95849999999993,115.332241076018,106.58475892398187,22132319,53.396810146354284,58.9587806077895,NaN,NaN,NaN,NaN,NaN,NaN,-0.06522655839263491,0.6310544924579631,0.696281050850598,34.853420195439796,41.002198925172706,5023315630,11106774953.711636,24.155728941612367,23.838500256843442,14.352415680539412,21.428571428571427,64.28571428571429
2015-08-05,112.01,113,111.88,112.25,105.76926555671693,108.8384317971432,110.18018373483406,111.19422334264891,106.24919999999996,108.95690000000002,109.99900000000007,111.26649999999992,111.26649999999992,115.05375375437863,107.47924624562121,28989897,57.54437571355812,58.51126037068199,NaN,NaN,NaN,NaN,57.54437571355812,NaN,-0.03923214751050397,0.647240866462468,0.686473013972972,53.52877307274704,42.59862468331524,5052305527,11096939095.800922,28.866290140329117,21.75106485035303,13.889603459607594,14.285714285714286,57.142857142857146
2015-08-06,112.35,112.5,109.95,110.45,105.8158400287894,108.87034403878393,110.19076476484057,111.12334492906331,106.32949999999997,108.99440000000003,109.98880000000007,111.48749999999993,111.48749999999993,114.45348634522358,108.52151365477627,42125401,47.92958155206948,57.033016969285846,NaN,NaN,NaN,NaN,NaN,NaN,-0.1420129786684814,0.5089567906373702,0.6509697693058516,14.440825190010981,34.27433948606595,5010180126,11071333459.898962,25.11510798449878,28.759959829997005,12.012178142579026,7.142857142857143,50
2015-08-07,110.18,110.57,109.4,110.31,105.86055803845318,108.89885207761989,110.19544065641544,111.04588350724775,106.39669999999998,109.0288,109.98080000000007,111.62049999999995,111.62049999999995,114.08186933434197,109.15913066565793,30006846,47.268058343954834,55.434106168018864,NaN,NaN,NaN,NaN,NaN,NaN,-0.21385869749763542,0.38364639743380735,0.5975050949314428,18.95833333333327,28.975977198697098,4980173280,11088003929.898962,23.599750961459957,29.86101520903897,10.120633507226886,0,100
2015-08-10,111.01,111.81,111,111.57,105.91736840622977,108.95174609588484,110.24934494439916,111.09579936370035,106.47269999999999,109.06530000000002,110.01120000000006,111.72199999999994,111.72199999999994,113.99178941755575,109.45221058244412,21500780,53.489861580454146,54.310915388732305,NaN,NaN,NaN,NaN,NaN,NaN,-0.17271645935586022,0.38160952073661747,0.5543259800924777,57.574953568585634,30.3247040306433,5001674060,11096763506.935999,28.141923483293013,27.564740193877174,7.466533533898734,0,92.85714285714286
2015-08-11,110.98,111.4101,109.53,110.14,105.95938464099365,108.97527587616435,110.24505690736389,111.00477085287174,106.53429999999997,109.08590000000002,110.00560000000007,111.71599999999994,111.71599999999994,114.00179439146467,109.4302056085352,36123270,46.748327108638456,53.25503209685593,NaN,NaN,46.748327108638456,NaN,NaN,NaN,-0.23418816275459936,0.2615907766492285,0.49577893940382783,19.999999999999922,32.17776230063961,4965550790,11084080686.592932,25.293221188481525,32.06871084032995,6.9261063729570065,0,85.71428571428571
2015-08-12,109.38,110.735,108.22,110.52,106.0047638982972,109.00586447267594,110.25583898942806,110.95860220021729,106.59379999999997,109.10580000000003,110.01460000000006,111.72299999999993,111.72299999999993,113.99319030040662,109.45280969959323,41888960,48.60213450906808,52.496230003201596,NaN,NaN,NaN,NaN,NaN,NaN,-0.24071011477491927,0.19489129593517873,0.435601410710098,48.08697470206976,41.88730942355178,5007439750,11118807717.050188,22.296645073520175,34.440403656033304,7.290322553581639,0,100
2015-08-13,110.63,111.16,110.1,110.34,106.04790057592608,109.03228299796949,110.2591394212152,110.8996877049585,106.65204999999997,109.12600000000003,110.01340000000006,111.64299999999994,111.64299999999994,113.9884816136652,109.29751838633469,22510520,47.75409599596031,52.08117049800631,NaN,NaN,NaN,NaN,NaN,NaN,-0.24763800037857703,0.12605391023687673,0.37369191061545376,44.351464435146525,37.4794797124054,4984929230,11106490640.069056,23.20486270779228,32.68290737776371,8.13698805843587,0,92.85714285714286
2015-08-14,110.08,110.67,109.86,110.51,106.0922995751706,109.06154472078198,110.26897709097146,110.86257459020054,106.70369999999998,109.15180000000004,110.03240000000005,111.48899999999992,111.48899999999992,113.70372255600333,109.27427744399651,17924931,48.665128375606535,52.034441852749524,NaN,NaN,NaN,NaN,NaN,NaN,-0.23155654664583775,0.08424622730815656,0.3158027739539943,47.9079497907951,46.78212964267046,5002854161,11117334116.846834,22.269664445252584,32.559854719316064,9.130356475126472,50,85.71428571428571
2015-08-17,110.24,111.46,109.96,111.43,106.14541102218382,109.10844482532096,110.31450740112945,110.91661510541954,106.76179999999998,109.21150000000003,110.07500000000006,111.36149999999994,111.36149999999994,113.25877462431109,109.46422537568878,21224913,53.40082013884983,52.03274715552341,NaN,NaN,NaN,NaN,NaN,NaN,-0.15350528908790328,0.12392116259411523,0.2774264516820185,67.15481171548132,53.138075313807654,5024079074,11137710033.326834,24.531037643637248,30.13757694767153,9.815348291688936,42.857142857142854,78.57142857142857
2015-08-18,111.275,111.37,110.71,110.86,106.19232235529643,109.14312908620569,110.33589926775183,110.91122319061768,106.81599999999999,109.26910000000004,110.12840000000006,111.20899999999995,111.20899999999995,112.71164965978502,109.70635034021487,13984363,50.304475567310156,51.68634741699707,NaN,NaN,NaN,NaN,NaN,NaN,-0.13544258442528898,0.10812322115040729,0.24356580557569626,55.23012552301255,56.76429567642966,5010094711,11130082198.963198,23.622600039923558,29.021517016501814,10.27317324067484,35.714285714285715,71.42857142857143
2015-08-19,110.52,111.105,109.49,110.13,106.23150322738303,109.16267108449864,110.32782478666353,110.83682098198742,106.85965,109.31520000000005,110.17080000000007,111.08449999999996,111.08449999999996,112.50949789474454,109.65950210525538,42511384,46.57945680285119,50.91999033497411,NaN,NaN,NaN,NaN,NaN,NaN,-0.1658285445353706,0.036280124906483024,0.20210866944185363,39.95815899581582,54.11436541143657,4967583327,11121264048.102516,21.6829545653074,32.841284857771335,11.119220482580005,28.571428571428573,64.28571428571429
2015-08-20,109.11,109.46,107.07,107.08,106.23994598133942,109.12143007292441,110.20045910875515,110.47902850751242,106.88654999999999,109.31870000000005,110.12260000000006,110.82849999999996,110.82849999999996,113.00262304160307,108.65437695839685,57747349,34.93851850415564,49.37343165710262,NaN,NaN,NaN,NaN,NaN,NaN,-0.3726673301393118,-0.2637254932322861,0.10894183690702568,0.16863406408103043,31.785639527636476,4909835978,11063999940.516743,18.57142781870854,39.477301845672216,12.916038377920506,21.428571428571427,100
2015-08-21,105.57,106.47,102.4,102.4,106.20173756361464,108.988332447718,109.89455875154907,109.70959722108267,106.89174999999999,109.28670000000005,109.97760000000005,110.39349999999995,110.39349999999995,114.6553178046516,106.13168219534829,97763445,24.726910722331255,47.23918250436868,NaN,NaN,NaN,NaN,NaN,NaN,-0.7824339051718002,-0.8691005445577247,-0.08666663938592441,0,13.375597686632291,4812072533,10966236495.516743,15.021116724204859,51.006614256922504,16.761724752153466,14.285714285714286,100
2015-08-24,94.23,102.53,84.74,98.46,106.12470534905131,108.77985061707011,109.44614468286088,108.638207009551,106.87719999999999,109.22080000000005,109.77180000000006,109.80749999999996,109.80749999999996,116.5352094913525,103.07979050864742,150829863,19.547164711950202,44.82135068762553,NaN,NaN,NaN,NaN,NaN,NaN,-1.2489026499181026,-1.6477949517835526,-0.39889230186545005,48.54918612880395,16.239273397628335,4661242670,11048052581.966995,8.426554867992154,72.1948493495253,22.364225702379166,7.142857142857143,100
2015-08-25,102.07,102.74,98.01,98.09,106.04475803214532,108.5681704068311,109.00080567568986,107.63361586578424,106.85919999999999,109.15050000000006,109.56940000000006,109.15549999999996,109.15549999999996,117.5621532579879,100.74884674201202,75088278,19.141648586862615,42.07829875000443,NaN,NaN,19.141648586862615,NaN,NaN,NaN,-1.4957825921395353,-2.2686205420398693,-0.7728379499003339,48.090778097982735,32.2133214089289,4586154392,10975504288.000822,7.9813557737845,64.13299210445645,26.92192805933845,0,92.85714285714286
2015-08-26,100.96,103.23,98.93,103.03,106.01476043978568,108.45850366610178,108.76665643350594,107.19517625951907,106.86634999999998,109.12100000000005,109.45400000000005,108.72949999999994,108.72949999999994,117.4646896945659,99.99431030543398,104103817,37.71919916409723,41.34898572229212,NaN,NaN,NaN,NaN,NaN,NaN,-1.249805686594426,-2.3350950581433665,-1.0852893715489405,67.5655707425194,54.735178323102026,4690258209,11069924029.000822,8.160700223021,56.720630458059404,31.784702986584485,0,85.71428571428571
2015-08-27,104.52,105.71,103.2799,105.64,106.01103148018582,108.40269171231758,108.64404245572139,107.04706423480297,106.88474999999998,109.11940000000004,109.38480000000006,108.40749999999996,108.40749999999996,117.09960187469308,99.71539812530683,69377690,44.919632603100894,41.181241026516844,NaN,NaN,NaN,NaN,44.919632603100894,NaN,-0.8536567696650295,-2.1523603336302273,-1.2987035639651978,77.20724048762467,64.2878631093756,4759635899,11135304814.9228,13.302859510145005,53.2639082030885,35.23610604796537,7.142857142857143,78.57142857142857
2015-08-28,105.08,106,104.85,105.62,106.00714061968645,108.34758890613307,108.52545255549703,106.91115335529793,106.90144999999998,109.10920000000006,109.28340000000006,108.09099999999994,108.09099999999994,116.7047167355362,99.47728326446368,49919628,44.87681713753872,40.5660235663086,NaN,NaN,NaN,NaN,NaN,NaN,-0.550044525531149,-1.986259220879134,-1.436214695347985,78.14371257485034,74.30550793499815,4709716271,11152234080.070627,13.629211592152805,51.80495138982894,39.329399109468326,0,71.42857142857143
2015-08-31,105.03,105.61,104.05,104.31,105.99025364834628,108.26763665056608,108.36014069057558,106.66342446431717,106.91069999999996,109.07920000000006,109.17180000000006,107.72649999999994,107.72649999999994,116.33238467271373,99.12061532728616,39549380,42.049641705138704,40.23040318034433,NaN,NaN,NaN,NaN,NaN,NaN,-0.40141945429371617,-1.9379890132151303,-1.5365695589214141,73.24101796407189,76.19732367551563,4670166891,11125867826.737293,13.101593098329644,51.77206382121822,42.74347578503216,28.571428571428573,64.28571428571429
2015-09-01,101.71,103.29,100.63,101.05,105.94109689562642,108.12471315253507,108.07346850663144,106.12881261057268,106.90144999999997,109.01220000000006,108.97880000000005,107.20949999999996,107.20949999999996,116.1102291274382,98.30877087256172,73155538,35.97569602338122,39.32851471708098,NaN,NaN,NaN,NaN,NaN,NaN,-0.48125804056212473,-2.13814210962407,-1.6568840690619453,61.04041916167666,70.80838323353296,4597011353,11075814037.5794,11.935281016698731,55.43639501165424,45.826709227443494,21.428571428571427,57.142857142857146
2015-09-02,102.88,103.92,101.7,103.9,105.92078747377938,108.04105546634625,107.90980307499883,105.91654474289909,106.90484999999998,108.97640000000007,108.84100000000007,106.79199999999996,106.79199999999996,115.48883758615925,98.09516241384067,43963563,43.64029223250368,39.03467159111979,NaN,NaN,NaN,NaN,NaN,NaN,-0.309085140310583,-2.043240494450174,-1.734155354139591,71.70658682634735,68.66267465069863,4640974916,11118985464.30913,12.632046761150248,51.579923542967364,48.9478590738637,14.285714285714286,50
2015-09-03,104.31,105.02,103.1,103.39,105.89560550886615,107.94895535810177,107.73255589558711,105.67592143405156,106.90724999999999,108.93860000000006,108.70440000000006,106.43899999999996,106.43899999999996,115.0862582938193,97.79174170618063,45131794,42.656198286303706,38.60546229902673,NaN,NaN,NaN,NaN,NaN,NaN,-0.20170479338665692,-1.9862863458729123,-1.7845815524862554,69.79790419161678,67.51497005988026,4595843122,11087487233.079964,14.763500043620459,49.118187469579034,51.448645223361986,7.142857142857143,42.857142857142854
2015-09-04,101.97,102.845,101.59,102.16,105.85843530479784,107.83432257873342,107.5140242918386,105.3410717736657,106.89965000000001,108.88180000000007,108.54760000000005,106.03149999999997,106.03149999999997,114.67880541845412,97.38419458154581,49379643,40.2960925313654,37.66941032706357,NaN,NaN,NaN,NaN,NaN,NaN,-0.1860532107953785,-2.0171480659804786,-1.8310948551851,65.41494555013142,68.97314552269852,4546463479,11082962405.235342,14.084815560841443,50.716611653472,54.753917032216556,0,35.714285714285715
2015-09-08,104.12,105.165,103.69,105.04,105.85029166992423,107.77898945836246,107.41700373137434,105.31239827141182,106.90879999999999,108.85530000000006,108.46300000000005,105.70499999999996,105.70499999999996,113.97610028956446,97.43389971043545,37343527,47.60586784964302,37.47665263294448,NaN,NaN,NaN,NaN,NaN,NaN,0.033998728763902086,-1.7885964442302225,-1.8225951729941245,76.99601744737343,70.73628906304054,4583807006,11113976520.87941,18.9033354723204,46.8449448342943,57.056942507990485,0,28.571428571428573
2015-09-09,106.28,106.31,103.59,103.86,105.83048777271105,107.70138570671172,107.2775133889675,105.17407462651546,106.90974999999999,108.83380000000005,108.40640000000005,105.39099999999993,105.39099999999993,113.43858821014422,97.34341178985565,47146743,45.16588912438251,37.375683513053865,NaN,NaN,NaN,NaN,NaN,NaN,0.11145216080768483,-1.6832799719845184,-1.7947321327922032,77.34627831715213,73.25241377155233,4536660263,11076189793.033821,20.509640359582857,43.60044484544462,58.167837546181204,0,21.428571428571427
2015-09-10,103.74,105.68,103.62,104.99,105.82212471029602,107.64769490063821,107.18780698155702,105.15654370970447,106.91534999999998,108.80770000000005,108.36480000000005,105.11449999999995,105.11449999999995,112.81051838615542,97.41848161384448,47686714,47.91877292682132,38.30284454324427,NaN,NaN,NaN,NaN,NaN,NaN,0.24263215543931937,-1.491441938493054,-1.7340740939323733,93.18913943856418,82.51047840102991,4584346977,11091931038.431879,19.413008426841934,41.269168467071474,58.16805731528658,0,14.285714285714286
2015-09-11,104.51,105.57,104.21,105.57,105.81961600671099,107.60655242735825,107.12436357051557,105.19592049925642,106.91979999999998,108.78280000000007,108.31780000000002,104.87599999999993,104.87599999999993,112.19593825110951,97.55606174889036,29106088,49.32503027866583,40.05985308298246,NaN,NaN,NaN,NaN,NaN,NaN,0.3649575236998961,-1.2778771893075032,-1.6428347130073992,96.56930922577651,89.03490899383094,4613453065,11121037126.431879,18.702043341725116,39.75776244350418,56.84783212270666,0,7.142857142857143
2015-09-14,105.96,105.98,104.85,105.25,105.81394818574869,107.55988802285611,107.05085911676986,105.20107092789867,106.92184999999998,108.74880000000005,108.26380000000005,104.61299999999994,104.61299999999994,111.46751705082461,97.75848294917527,19718804,48.54619527057089,42.131212408598216,NaN,NaN,NaN,NaN,NaN,NaN,0.4170527763006673,-1.1215187426315651,-1.5385715189322324,87.22891566265058,92.32912144233042,4593734261,11115278537.653118,19.259900521649477,38.4962316164764,53.57712796461662,78.57142857142857,0
2015-09-15,105.5,106.82,105.11,106.49,105.82067506947259,107.53870212141342,107.02886464160241,105.3238260776226,106.92669999999998,108.72310000000004,108.23960000000005,104.36599999999996,104.36599999999996,110.54262496838201,98.1893750316179,30020216,51.72701219878731,44.45873838087855,NaN,NaN,NaN,NaN,NaN,NaN,0.5210032416819239,-0.8873174668298276,-1.4083207085117515,95.8174904942966,93.20523846090789,4623754477,11133712003.61803,20.72819839669782,36.603450848883895,49.9932340649752,100,0
2015-09-16,106.51,107.19,106.14,107.09,105.8333051682838,107.52981693089039,107.03126210663761,105.49203311784902,106.93209999999999,108.68860000000006,108.22200000000004,104.17749999999997,104.17749999999997,109.75048797773994,98.60451202226,31329146,53.23351572032819,45.56690384918077,NaN,NaN,NaN,NaN,NaN,NaN,0.6099755180470647,-0.6458513109529207,-1.2558268289999854,98.47560975609765,93.84067197101494,4655083623,11159073693.237078,21.185106302046755,35.450830245256284,46.44639405405819,100,0
2015-09-17,106.98,108.725,106.64,107.13,105.84620760442029,107.52189976394206,107.03513418088711,105.64802996376815,106.94369999999999,108.65730000000006,108.24280000000005,104.02749999999996,104.02749999999996,109.08963344352324,98.96536655647668,56139806,53.33806526304568,46.16822046774825,NaN,NaN,NaN,NaN,53.33806526304568,NaN,0.6477675326369987,-0.4461174132037371,-1.0938849458407358,80.29647930821496,91.52985985286973,4711223429,11129320942.3354,24.493315736272876,33.21422222421969,43.237873987370754,100,21.428571428571427
2015-09-18,105.23,106.6,105.17,105.35,105.84127021532157,107.4788918478244,106.96905048751898,105.619646157695,106.94429999999998,108.61040000000007,108.22920000000005,103.94099999999996,103.94099999999996,108.84829212499463,99.03370787500529,48383995,48.176651015986856,46.4039228876374,NaN,NaN,NaN,NaN,NaN,NaN,0.5338750894345887,-0.4265410840474999,-0.9604161734820886,58.307597282273,79.02656211552853,4662839434,11093117533.489244,23.022842560860973,35.722860335719325,40.614760998224554,92.85714285714286,14.285714285714286
2015-09-21,105.93,106.55,104.73,105.68,105.83966553656215,107.4432702270754,106.91849948800844,105.62539414267643,106.94559999999997,108.57370000000006,108.18980000000005,104.10499999999998,104.10499999999998,109.01456413544273,99.19543586455723,35772624,49.15890760821737,46.91172759500016,NaN,NaN,NaN,NaN,NaN,NaN,0.46431865810984685,-0.38001785084478,-0.8443365089546269,62.384187770228685,66.99608812023888,4698612058,11094689956.522211,21.718931466735512,35.068887720767286,38.03616024583835,85.71428571428571,7.142857142857143
2015-09-22,104.06,104.4225,103.13,104.1,105.82235543172074,107.37706685624222,106.80797009632182,105.48011851004058,106.93924999999999,108.53840000000008,108.08100000000005,104.38699999999997,104.38699999999997,108.5598316524907,100.21416834750924,47359654,44.78233587988404,47.540773299036076,NaN,NaN,NaN,NaN,NaN,NaN,0.3032474291297609,-0.46527722254242576,-0.7685246516721866,35.17869656622276,51.95682720624148,4651252404,11118415585.89552,20.009039201580542,37.247785795232744,35.5746539689142,78.57142857142857,0
2015-09-23,104.38,104.66,103.64,104.18,105.80601358662899,107.31375860166317,106.70491244548568,105.35629769956053,106.93324999999999,108.48970000000007,107.95940000000006,104.69149999999998,104.69149999999998,107.7113958591336,101.67160414086635,21775134,45.049098046252155,47.6414022857324,NaN,NaN,NaN,NaN,NaN,NaN,0.1985062776019667,-0.5203918046697282,-0.7188980822716949,36.299929922915304,44.620938086455574,4673027538,11119696476.130814,20.116472371800185,36.02601104553406,33.26626996511551,71.42857142857143,14.285714285714286
2015-09-24,103.17,104.19,102.27,103.8,105.78605325243367,107.24417922341242,106.59099431036859,105.20807887103095,106.9291,108.43540000000009,107.82780000000007,104.72999999999998,104.72999999999998,107.68307974833274,101.7769202516672,38284331,43.962651470060706,47.73472037028647,NaN,NaN,NaN,NaN,NaN,NaN,0.10475387024948923,-0.5879557444598333,-0.6927096147093226,30.974071478626442,34.15089932258817,4634743207,11142427797.662064,18.862262515375605,38.22862988299185,31.847939605836153,64.28571428571429,7.142857142857143
2015-09-25,104.91,105.01,102.28,102.92,105.75753530962339,107.15855191205772,106.44703374917766,104.99016659759943,106.9189,108.39010000000007,107.64740000000008,104.59399999999998,104.59399999999998,107.61663064233977,101.57136935766019,44700006,41.468491679013745,47.81846316654706,NaN,NaN,NaN,NaN,NaN,NaN,-0.009343936197995895,-0.7043895349568174,-0.6950455987588215,10.069713400464847,25.781238267335524,4590043201,11118686036.233492,19.83610151023393,34.89702919693497,29.775633723897695,57.142857142857146,0
2015-09-28,102.48,102.55,99.69,99.99,105.70014689858236,107.01660038904667,106.19381673940599,104.51396025497091,106.90230000000001,108.32290000000008,107.37540000000007,104.31249999999997,104.31249999999997,107.89693231209826,100.72806768790169,44077490,34.45864896574541,46.879376103411516,NaN,NaN,NaN,NaN,NaN,NaN,-0.26101756319621006,-1.021317552754084,-0.760299989557874,3.320420586607607,14.788068488566294,4545965711,11083855572.107618,17.853595719000236,39.423380713246736,29.429982265386496,50,100
2015-09-29,100.24,101.26,98.75,99.47,105.63815538715367,106.8671627575804,105.93013765158615,104.03358308783082,106.88065,108.24410000000007,107.08520000000007,104.07049999999997,104.07049999999997,108.23029073993166,99.91070926006827,49315527,33.38020053637416,46.03754120426807,NaN,NaN,33.38020053637416,NaN,NaN,NaN,-0.431332420205369,-1.2994655148145853,-0.8681330946092163,7.218045112781947,6.869393033284797,4496650184,11062832618.366583,16.475578343465152,39.27108206995143,29.778112002829964,42.857142857142854,100
2015-09-30,100.89,101.87,100.5,101.76,105.59956677633622,106.76603082178673,105.76660284172003,103.81705136518026,106.87610000000001,108.17480000000006,106.84220000000006,104.10599999999997,104.10599999999997,108.17316313909569,100.03883686090424,41411432,41.99047970340551,45.61409168830979,NaN,NaN,NaN,NaN,NaN,NaN,-0.36141426096743634,-1.3199009208185117,-0.9584866598510754,30.175438596491297,13.571301431960281,4538061616,11097594039.388481,17.1338838317064,36.37967020583457,29.774318569860505,35.714285714285715,92.85714285714286
2015-10-01,101.94,102.23,100.59,102.22,105.56593924622342,106.67601040947412,105.62752037733885,103.66495123516309,106.87915000000001,108.11430000000007,106.63420000000008,104.02199999999998,104.02199999999998,108.17127752747433,99.87272247252562,39339134,43.56825242766077,45.20289327038086,NaN,NaN,NaN,NaN,NaN,NaN,-0.26055051525327166,-1.284174803917665,-1.0236242886643934,34.786967418546375,24.060150375939873,4577400750,11136453427.851896,17.3814810307017,34.509859787636,29.55937104576658,28.571428571428573,85.71428571428571
2015-10-02,100.8,104.01,100.48,104.01,105.55045726367393,106.62321812413799,105.5640882056785,103.69781302229042,106.8993,108.07660000000007,106.47040000000008,104.05299999999997,104.05299999999997,108.19217914567793,99.91382085432201,59370859,49.342182591471634,45.25974950758806,NaN,NaN,NaN,NaN,NaN,NaN,-0.06010677946552523,-1.0987577629963,-1.0386509835307747,52.73182957393491,39.23141186299086,4636771609,11195824286.851896,20.899155485337975,30.83607696493611,28.552309191157896,21.428571428571427,78.57142857142857
2015-10-05,104.78,105.78,104.55,105.5,105.54995520134882,106.60097618108576,105.56157494271072,103.86944987731037,106.9178,108.05160000000006,106.35840000000007,104.21999999999998,104.21999999999998,108.30941560617217,100.1305843938278,32853533,53.598176482022936,45.393404099247746,NaN,NaN,NaN,NaN,NaN,NaN,0.17323586943125735,-0.822106146741703,-0.9953420161729604,67.66917293233087,51.729323308270715,4669625142,11213720113.770596,25.199076597798303,29.15982813117804,27.094887073854697,14.285714285714286,71.42857142857143
2015-10-06,105.25,105.6,104.18,105,105.54448301029062,106.5692736824504,105.53955239593775,103.97712131756653,106.92155000000001,108.00580000000008,106.25480000000009,104.21799999999999,104.21799999999999,108.30584833378265,100.13015166621733,33051534,52.01880845839647,45.30663929482405,NaN,NaN,NaN,NaN,NaN,NaN,0.28757472188570266,-0.6358736138158321,-0.9234483357015347,62.65664160401006,61.01921470342527,4636573608,11218840773.96778,24.068678607090664,29.020609578347045,25.961964605901738,7.142857142857143,64.28571428571429
2015-10-07,105.66,105.86,104.29,105.63,105.54533392561112,106.55067420358999,105.54309936080293,104.13453833494114,106.92810000000001,107.96630000000006,106.14480000000009,104.30649999999999,104.30649999999999,108.4359419719869,100.17705802801306,37389334,53.86353857073699,45.34417310251629,NaN,NaN,NaN,NaN,NaN,NaN,0.3927889877874905,-0.43246210096717164,-0.8252510887546621,87.64331210191084,72.65637554608392,4673962942,11245275271.254404,23.68798259712632,27.549141608553718,25.42079415340672,0,57.142857142857146
2015-10-08,105.23,106.23,104.21,106.05,105.5503554785901,106.54075986292484,105.56297781724203,104.31696325542293,106.93545000000002,107.92620000000005,106.0348000000001,104.35949999999998,104.35949999999998,108.54943782770187,100.1695621722981,50188873,55.102832091887656,45.83890032222349,NaN,NaN,NaN,NaN,NaN,NaN,0.47247167897585896,-0.2346614900348385,-0.7071331690106974,93.58974358974359,81.2965657652215,4724151815,11286519592.630642,23.335400264805045,25.740713441593964,24.22669104040904,0,50
2015-10-09,106.1,106.73,105.81,106.53,105.5601031852708,106.54054679633228,105.60090025578155,104.52772865966837,106.94705000000002,107.89210000000004,105.9238000000001,104.40749999999998,104.40749999999998,108.67312011904644,100.14187988095352,23916227,56.53964364258825,46.36609575324997,NaN,NaN,NaN,NaN,NaN,NaN,0.5347267767226255,-0.038724698107415634,-0.5734514748300411,97.49373433583956,92.90893000916465,4748068042,11300037460.065424,24.30275889855273,24.937793298250476,22.639631884875847,100,42.857142857142854
2015-10-12,106.73,106.9899,106.35,106.79,105.57234096452184,106.54548646373163,105.64753161829992,104.7431830730333,106.95950000000002,107.85990000000005,105.82060000000013,104.48449999999998,104.48449999999998,108.86229613504472,100.10670386495525,16161955,57.33609320820718,47.26279270527306,NaN,NaN,NaN,NaN,NaN,NaN,0.5675364449051163,0.13596908130135432,-0.431567363603762,97.57399968446221,96.21915920334845,4764229997,11306101666.028074,24.675204738791614,24.368431510772997,20.533757047349038,100,35.714285714285715
2015-10-13,106.18,107.26,106,106.1,105.57759130318331,106.53666494959833,105.66527547640581,104.8724037327444,106.96480000000001,107.81510000000006,105.7106000000001,104.46499999999999,104.46499999999999,108.81024337638436,100.11975662361561,26999613,54.48256001504051,47.93661141732937,NaN,NaN,NaN,NaN,NaN,NaN,0.5182500402823965,0.21624518674923365,-0.30200485353316286,86.36897767332538,93.81223723120904,4737230384,11283387705.885218,23.535739046165187,24.52587024924182,18.656781317453557,100,28.571428571428573
2015-10-14,106.1,106.63,105.49,105.93,105.5810978573805,106.52465178227955,105.67565683027225,104.97312718676875,106.96935000000002,107.76970000000007,105.6014000000001,104.407,104.407,108.64006083112454,100.17393916887545,30902637,53.77249271228099,48.63731436320224,NaN,NaN,53.77249271228099,NaN,NaN,NaN,0.45209507097501983,0.2631139851856119,-0.18898108578940792,84.37132784958875,89.4381017357921,4706327747,11276339736.043114,22.522356752131873,25.396097480429415,16.662149692492115,92.85714285714286,21.428571428571427
2015-10-15,106.32,107.675,106.18,107.67,105.60188295332696,106.54733194500669,105.75386636634,105.2299722166003,106.98610000000001,107.75440000000006,105.50980000000013,104.434,104.434,108.74240759446097,100.12559240553902,38393838,59.57922326125746,49.93093804764823,NaN,NaN,NaN,NaN,NaN,NaN,0.49969648670424954,0.435639522590904,-0.06405696411334555,99.94397759103647,90.22809437131686,4744721585,11314476759.073214,24.998538255733184,23.713007358152545,14.88515298169912,100,14.285714285714286
2015-10-16,107.9,108.18,107.3794,108.12,105.62693884433864,106.57847388668972,105.84665592060118,105.50521295787647,107.01045000000002,107.72600000000007,105.46320000000013,104.57249999999999,104.57249999999999,109.1589098159685,99.98609018403148,27091100,60.94553512222687,51.82285848739691,NaN,NaN,NaN,NaN,NaN,NaN,0.532639160180711,0.6017419861125433,0.0691028259318322,99.36373276776244,94.5596794027959,4771812685,11337507239.537865,26.20590553117792,22.961144292051102,12.66663352202366,100,7.142857142857143
2015-10-19,107.98,108.81,107.74,108.74,105.6579145772308,106.62127638398299,105.96012039430309,105.81328791426918,107.03945000000002,107.70630000000008,105.43180000000011,104.72549999999998,104.72549999999998,109.64178101312535,99.80921898687461,23776270,62.810740151285046,53.92503988846197,NaN,NaN,NaN,NaN,NaN,NaN,0.5643021190824613,0.7744804747849088,0.2101783557024475,99.15966386554614,99.48912474144835,4795588955,11358172595.706089,27.631868543718063,21.959028043385253,10.562921559712047,100,0
2015-10-20,108.545,108.78,107.81,108.18,105.68300995457179,106.65214219816154,106.04717449648729,106.03868906529117,107.07320000000001,107.68760000000007,105.3640000000001,104.92949999999999,104.92949999999999,110.05900475192458,99.7999952480754,23404691,60.02237232101062,55.213032218290905,NaN,NaN,NaN,NaN,NaN,NaN,0.516912151073966,0.8563185445449051,0.33940639347093904,92.43697478991601,96.98679047440821,4772184264,11352623029.798872,26.502628762100183,21.061621919980304,8.811132767813351,92.85714285714286,14.285714285714286
2015-10-21,108.73,108.84,107.48,107.52,105.7012884624865,106.66932750116824,106.10493235937014,106.1797662971682,107.11045000000001,107.65860000000009,105.31160000000011,105.09649999999999,105.09649999999999,110.33387061892799,99.859129381072,30195241,56.82079461400732,56.15964237445852,NaN,NaN,NaN,NaN,NaN,NaN,0.4148976866844,0.8580285018264391,0.44313081514203906,84.21052631578938,91.93572165708385,4741989023,11324203979.44593,24.96230352074744,21.247784248317714,7.027573201496111,100,7.142857142857143
2015-10-22,108.48,109.8,108.171,109.71,105.74117613947669,106.72953883777878,106.24630756096347,106.51597903077123,107.15220000000004,107.65500000000007,105.29540000000011,105.39199999999998,105.39199999999998,110.95989583236096,99.824104167639,42778702,63.733411101109766,57.187587268004094,NaN,NaN,NaN,NaN,NaN,NaN,0.4649281191369612,1.0242909640632405,0.5593628449262793,98.39857651245545,91.6820258727203,4784767725,11362255753.04814,26.590304710248695,19.229963594084165,6.803019156698592,100,0
2015-10-23,112.66,113.24,112.07,112.78,105.81121418784011,106.84934994990196,106.50253079386687,107.11255245641208,107.19960000000003,107.67880000000008,105.34420000000011,105.88499999999999,105.88499999999999,112.18766768916296,99.58233231083702,53170910,70.79240175850944,58.415746216324564,NaN,NaN,NaN,NaN,NaN,NaN,0.6627345483212288,1.3877810303278153,0.7250464820065865,94.92273730684333,92.51061337836273,4837938635,11373617058.603695,36.27662673284167,16.601297155478846,8.940352734403536,100,7.142857142857143
2015-10-26,112.7,113.07,112.27,112.85,105.88125185761284,106.96817470336926,106.7514511548917,107.65897603199188,107.25075000000002,107.71170000000008,105.39100000000012,106.52799999999999,106.52799999999999,112.91719901083165,100.13880098916833,25918004,70.93133473386249,59.76664095028642,NaN,NaN,NaN,NaN,NaN,NaN,0.7498312719366396,1.662335571927386,0.9125042999907464,95.68106312292358,96.33412564740748,4863856639,11385280160.403694,35.10542627316637,16.065319899299716,10.931882420241056,92.85714285714286,0
2015-10-27,112.55,113.24,112.52,113.08,105.95288119236297,107.0892009468669,106.99962954097438,108.17526402894504,107.30840000000003,107.74950000000008,105.4240000000001,107.2085,107.2085,113.33974873088695,101.07725126911305,31390511,71.41250640462393,61.02013865270692,NaN,NaN,NaN,NaN,NaN,NaN,0.7714733517992705,1.8768459897398344,1.105372637940564,98.22812846068663,96.2773096301512,4895247150,11402719333.181473,34.75666115932065,15.577859529138308,13.115226597849247,85.71428571428571,7.142857142857143
2015-10-28,113.25,114.02,112.34,114.02,106.03315103124493,107.22644449247349,107.27493818642637,108.73190554999789,107.37090000000003,107.80780000000009,105.48720000000012,107.82149999999999,107.82149999999999,114.1009276013039,101.54207239869608,42221867,73.35381550627416,62.3237803251631,NaN,NaN,NaN,NaN,73.35381550627416,NaN,0.7945074129253822,2.0985069040972917,1.3039994911719095,100,97.96973052787008,4937469017,11444941200.181473,35.58354060319209,14.474268812021881,15.777269325251385,100,0
2015-10-29,113.5,114.03,113.38,113.84,106.11083112048627,107.35740598767204,107.53239159088024,109.21839073571238,107.43530000000004,107.86610000000007,105.56140000000012,108.40249999999999,108.40249999999999,114.65150592094564,102.15349407905434,24913340,72.34076512785617,63.45243185982509,NaN,NaN,NaN,NaN,NaN,NaN,0.7439198308118975,2.2338992796867814,1.4899794488748839,97.77517564402814,98.66776803490495,4912555677,11455289818.33532,34.60740679031405,14.059265422626382,18.701022620232873,100,21.428571428571427
2015-10-30,113.89,114.08,113.3,113.33,106.18266364665058,107.47567517603497,107.75974878339474,109.60997257040644,107.50370000000004,107.90450000000008,105.68640000000012,108.8685,108.8685,115.12778837808327,102.60921162191673,27199231,69.41561691163254,64.31525498149833,NaN,NaN,69.41561691163254,NaN,NaN,NaN,0.6270841408167314,2.273834624895798,1.6467504840790668,91.26891734575088,96.34803099659302,4885356446,11430182835.873781,33.37092099401689,13.923393456636783,21.593502060357284,100,14.285714285714286
2015-11-02,113.63,114.745,113.39,114.61,106.26651773971874,107.61694893492536,108.0283860860067,110.08616565893917,107.57265000000005,107.9541000000001,105.93060000000013,109.324,109.324,115.85640966259788,102.79159033740211,22176916,72.42892135904619,65.5971379346416,NaN,NaN,NaN,NaN,NaN,NaN,0.5876545068024348,2.38131861758211,1.7936641107796754,98.54132901134517,95.86180733370809,4907533362,11447940735.401457,34.25995253358449,13.014928105438846,24.656303606354307,100,7.142857142857143
2015-11-03,114.38,115.42,114.21,115.01,106.35351756320412,107.76334598571891,108.30217486694762,110.55510226284972,107.63960000000004,108.01670000000009,106.26160000000013,109.82449999999999,109.82449999999999,116.48761481215925,103.16138518784072,20418387,73.3137625640808,66.99294292405587,NaN,NaN,NaN,NaN,NaN,NaN,0.5413095279910276,2.47030102076846,1.9289914927774323,95.5627705627706,95.1243389732889,4927951749,11454521868.401457,35.48001538041975,12.277232227622486,27.69828171190793,100,0
2015-11-04,115.39,115.47,114.54,115.02,106.43975121929164,107.90704210481358,108.56561898981242,110.98033061876879,107.70400000000005,108.08480000000009,106.60020000000011,110.29400000000001,110.29400000000001,117.03160016623102,103.556399833769,28633048,73.3368007634073,67.97562703135229,NaN,NaN,NaN,NaN,NaN,NaN,0.46693698260517813,2.512662721033905,2.045725738428727,94.43798976590114,96.18069644667231,4956584797,11455445515.111134,34.13097294414958,11.727049922180948,30.999417511112433,100,0
2015-11-05,115.12,115.395,114.11,114.71,106.5220422519355,108.04175414234203,108.80657510785899,111.3355372265051,107.75740000000005,108.1439000000001,106.83380000000012,110.727,110.727,117.43096927200563,104.02303072799438,25004080,71.2823783499542,68.71397297618995,NaN,NaN,NaN,NaN,NaN,NaN,0.3574101369419411,2.4924884096061533,2.135078272664212,90.48811013767202,93.49629015544794,4931580717,11453791548.72981,31.997316150159456,13.08584893306055,33.524310024298885,92.85714285714286,0
2015-11-06,114.49,114.92,113.76,114.79,106.60431048823465,108.17538277318674,109.04121922127628,111.66453368112366,107.81005000000005,108.20080000000011,107.01680000000013,111.13999999999999,111.13999999999999,117.77623085795031,104.50376914204966,29924901,71.50422923673982,69.33493648229386,NaN,NaN,NaN,NaN,NaN,NaN,0.2556651140411681,2.4546596652156722,2.198994551174504,91.48936170212775,92.13848720190033,4961505618,11477009144.33326,30.164131290450136,14.064769535615998,35.307225501231606,85.71428571428571,14.285714285714286
2015-11-09,114.36,114.51,112.865,113.57,106.67362083163529,108.282206876688,109.21881846750074,111.84600666387378,107.85720000000006,108.2296000000001,107.17580000000012,111.479,111.479,117.88027768496366,105.07772231503634,33479755,63.453704177327516,69.58003161488793,NaN,NaN,NaN,NaN,NaN,NaN,0.08058555364150655,2.2997264932263874,2.219140939584881,76.22027534418014,86.06591572799334,4928025863,11472226322.190403,27.362529652956937,17.07670452848041,36.1434070713801,78.57142857142857,7.142857142857143
2015-11-10,112.97,113.39,112.63,113.28,106.73935594773842,108.38117307714961,109.37808048838306,111.98257745779057,107.91640000000005,108.26350000000009,107.35520000000014,111.838,111.838,117.78130076641001,105.89469923358998,35452127,61.67611126324086,69.92683994697605,NaN,NaN,NaN,NaN,NaN,NaN,-0.07211395770208817,2.1289984924572707,2.201112450159359,69.99588984792437,79.23517563141078,4892573736,11497415991.374613,26.088312767769278,17.445676147851508,36.987284813835686,71.42857142857143,0
2015-11-11,113.59,114.14,112.95,113.14,106.80304394825843,108.4754072736417,109.5256067437406,112.09280817609623,107.97750000000005,108.28790000000009,107.59700000000012,112.1985,112.1985,117.50520622891594,106.89179377108405,22748808,60.79073586032452,69.71664885834852,NaN,NaN,NaN,NaN,NaN,NaN,-0.1930443152929242,1.9598070560432035,2.1528513713361277,31.470588235294283,59.22891780913296,4869824928,11481931508.61831,28.293364406610326,16.404207600801364,37.739828097601496,64.28571428571429,0
2015-11-12,112.65,113.23,111.96,112.04,106.85515296369864,108.54599326822304,109.62421040084881,112.08777882599182,108.02825000000006,108.3004000000001,107.75980000000013,112.41699999999999,112.41699999999999,117.30307449800134,107.53092550199864,31196876,54.20642173982959,68.53193599987141,NaN,NaN,NaN,NaN,NaN,NaN,-0.34854798383102104,1.7171663915473516,2.0657143753783727,2.2792022792026323,34.58189345414046,4838628052,11454664947.704926,26.476743283065908,20.35603147607399,36.015565510968436,57.142857142857146,100
2015-11-13,111.57,111.69,109.78,109.84,106.8848529342091,108.57161716390179,109.63267273807043,111.87370465208784,108.07195000000007,108.29660000000008,107.88880000000012,112.503,112.503,117.13759642256048,107.86840357743952,52836036,43.95285599343471,66.60490180412656,NaN,NaN,43.95285599343471,NaN,NaN,NaN,-0.5869747934523808,1.3319958835628967,1.9189706770152775,1.0544815465729753,11.601424020356669,4785792016,11405148453.23372,23.57582159662897,28.694374443414638,34.05724556166395,50,100
2015-11-16,109.74,111.44,109.48,111.42,106.92997877565976,108.62802078441858,109.70276400324414,111.83049468522233,108.11915000000006,108.31080000000009,108.07400000000013,112.63699999999999,112.63699999999999,116.97407320667094,108.29992679332904,33980633,51.10602687171245,65.15443898034717,NaN,NaN,NaN,NaN,NaN,NaN,-0.6223088905567209,1.1410845638193763,1.7633934543760972,32.387312186978285,11.906998670917963,4819772649,11438435603.927599,21.387259403159334,27.451532405796957,32.2225482755409,42.857142857142854,100
2015-11-17,111.61,112.29,111.2099,111.49,106.97535212117559,108.68469364017267,109.77285168939143,111.79806661996307,108.16180000000007,108.33300000000008,108.20300000000012,112.80249999999998,112.80249999999998,116.67429480345056,108.9307051965494,30579457,51.401957235440356,63.58644910385903,NaN,NaN,NaN,NaN,NaN,NaN,-0.6234424427809904,0.9840904008998592,1.6075328436808496,33.55592654424028,22.33257342593051,4850352106,11423716355.99287,24.379651732244138,26.01815319661603,29.442644646851367,35.714285714285715,92.85714285714286
2015-11-18,111.94,113.74,111.83,113.63,107.04156752295494,108.7826204987831,109.92411240745452,111.97253646568088,108.21560000000007,108.40240000000007,108.39840000000011,113.10799999999999,113.10799999999999,116.13677268873406,110.07922731126592,32966463,59.47686625927213,62.66759918467447,NaN,NaN,NaN,NaN,NaN,NaN,-0.46955681782927106,1.0205868213942608,1.4901436392235319,69.28213689482463,45.075125208681065,4883318569,11452885634.772976,28.58066279538356,23.290008558339707,27.15532315864669,28.571428571428573,85.71428571428571
2015-11-19,113.68,114.23,113.49,113.71,107.10792008491558,108.88019237009433,110.07257858755433,112.13800918323507,108.26535000000007,108.46880000000006,108.57280000000011,113.30799999999999,113.30799999999999,115.91120264290336,110.70479735709662,26188119,59.746135863884724,61.976921966978196,NaN,NaN,NaN,NaN,NaN,NaN,-0.35696928708306297,1.043932030369703,1.400901317452766,70.617696160267,57.81858653311064,4909506688,11442268829.772976,29.928341433192767,22.456024621462255,25.23705026920016,21.428571428571427,78.57142857142857
2015-11-20,114.24,114.57,114.14,114.48,107.18127411392139,108.99107964989444,110.24541864294436,112.36105592768887,108.32210000000008,108.53440000000006,108.75100000000012,113.39299999999999,113.39299999999999,116.03245524683165,110.75354475316833,22727591,62.34001577146683,61.256285853579676,NaN,NaN,NaN,NaN,62.34001577146683,NaN,-0.2313208328646983,1.1117502763718932,1.3430711092365915,83.47245409015032,74.45742904841399,4932234279,11455482545.470652,30.340407131567602,21.492789651875093,23.246339747558558,14.285714285714286,71.42857142857143
2015-11-23,114.53,114.94,113.66,114.15,107.25061467000178,109.0932364885104,110.39853948047595,112.53143155362326,108.37885000000007,108.59640000000007,108.92900000000013,113.45799999999997,113.45799999999997,116.10478370858768,110.81121629141226,20696175,60.53953185987446,60.343840803279214,NaN,NaN,NaN,NaN,NaN,NaN,-0.17374494767041293,1.1258899246485754,1.2996348723189883,77.96327212020043,77.35114079020592,4911538104,11450631879.455027,28.38858889009302,22.522543966545598,20.599002918225562,7.142857142857143,64.28571428571429
2015-11-24,113.42,114.32,112.8377,114.05,107.31827024542464,109.19139022141118,110.54173401065336,112.67605711994486,108.42710000000007,108.65990000000006,109.08020000000012,113.50649999999999,113.50649999999999,116.15934206089051,110.85365793910947,26374412,59.97425921000975,59.38937354946511,NaN,NaN,NaN,NaN,NaN,NaN,-0.146779790438335,1.1161601342710696,1.2629399247094046,77.2612003381234,79.56564218282472,4885163692,11467398126.792004,26.280169719707047,24.969891649481006,17.29197918338775,0,57.142857142857146
2015-11-25,114.19,114.36,113.91,114.15,107.38624765591793,109.28958051405651,110.68323463768655,112.81643263233106,108.47395000000007,108.72170000000006,109.22140000000012,113.51299999999996,113.51299999999996,116.17147399837764,110.85452600162229,14159935,60.37273114571584,58.61011303487665,NaN,NaN,NaN,NaN,NaN,NaN,-0.12731632896809897,1.103794513499281,1.23111084246738,85.53113553113566,80.25186932981983,4899323627,11468342122.458672,25.867895186497375,24.377959949669428,14.507502876198547,0,50
2015-11-27,114.395,114.541,113.92,114.31,107.455140714068,109.38899476130291,110.8254607303263,112.95867714353763,108.51550000000009,108.80390000000007,109.36500000000011,113.53649999999998,113.53649999999998,116.2143594063238,110.85864059367616,8827991,61.041029662510496,57.862741636717416,NaN,NaN,NaN,NaN,NaN,NaN,-0.10945585238528643,1.094291026985772,1.2037468793710584,88.46153846153854,83.75129144359919,4908151618,11470602429.333067,25.979472458703896,23.548340329970614,12.258111831811226,78.57142857142857,42.857142857142854
2015-11-30,114.6,114.65,113.65,114.02,107.52046269701259,109.48069783533651,110.95073678011742,113.05975551081976,108.55105000000009,108.88380000000006,109.53840000000011,113.57099999999998,113.57099999999998,116.25510059424433,110.88689940575564,25041649,59.09569251170483,57.55145508917293,NaN,NaN,NaN,NaN,NaN,NaN,-0.12200484806015055,1.0512408192958702,1.1732456673560208,83.1501831501831,85.71428571428577,4883109969,11464091600.593067,24.531693476186938,23.740693747962943,10.721883078038037,71.42857142857143,35.714285714285715
2015-12-01,114.475,115.16,114.34,115.16,107.59647799355973,109.59315926433975,111.11580592599518,113.25977879550359,108.59180000000008,108.95890000000004,109.72800000000011,113.59849999999999,113.59849999999999,116.33536883135348,110.8616311686465,28639445,63.95830611242083,57.714469006971505,NaN,NaN,NaN,NaN,63.95830611242083,NaN,-0.06141873974021905,1.096472242680747,1.157890982420966,100.00000000000001,90.53724053724055,4911749414,11492731045.593067,25.825540400139328,22.220446401992135,9.839797760012846,100,28.571428571428573
2015-12-02,115.23,115.75,114.28,114.45,107.66467224238004,109.68933432841223,111.24655863477967,113.37313319593183,108.62825000000007,109.00800000000007,109.93500000000009,113.5705,113.5705,116.26008342499759,110.8809165750024,22395483,59.235290114682,57.603365739425605,NaN,NaN,NaN,NaN,NaN,NaN,-0.07609168134176802,1.062776380743756,1.138868062085524,79.26634768740035,87.47217694586114,4889353931,11475515470.22572,26.994166975720262,20.405878165841333,8.932670561015012,100,21.428571428571427
2015-12-03,114.76,114.96,111.8432,112.51,107.71288445887377,109.74518909418624,111.29610535498439,113.29093003441452,108.65235000000008,109.03050000000006,110.10160000000009,113.44500000000001,113.44500000000001,116.08613233292195,110.80386766707807,42754345,48.66139330723548,57.20729227995461,NaN,NaN,48.66139330723548,NaN,NaN,NaN,-0.21548865574154896,0.8695072424085879,1.0849958981501369,48.32535885167469,75.86390217969169,4846599586,11451054629.618687,22.75176429567868,29.48609029713601,8.919982520830995,92.85714285714286,14.285714285714286
2015-12-04,112.84,115.33,112.62,115.14,107.78678610604916,109.85201703291523,111.4468463214556,113.46703193589885,108.68600000000008,109.07810000000006,110.32840000000009,113.4665,113.4665,116.1550481212011,110.77795187879889,40037322,59.2748323639975,58.30171916356623,NaN,NaN,NaN,NaN,NaN,NaN,-0.13361495197058004,0.9179772081869118,1.0515921601574918,90.27113237639554,72.62094630515686,4886636908,11485477862.186953,21.47277196843406,25.57043126072067,8.842691729966514,85.71428571428571,7.142857142857143
2015-12-07,115.22,115.29,114.07,114.62,107.85477828409843,109.94643253721394,111.5712837206142,113.5768384181942,108.71650000000008,109.10490000000006,110.56240000000008,113.458,113.458,116.13078581259599,110.78521418740401,25892101,56.775603156084635,58.706688898164245,NaN,NaN,NaN,NaN,NaN,NaN,-0.11806613421169465,0.9040094923928734,1.022075626604568,75.11068038148947,71.23572386985323,4860744807,11482931098.154165,20.22164994128614,24.080557021801326,8.57794163717823,78.57142857142857,0
2015-12-08,113.44,114.995,113.38,114.63,107.92219342555019,110.03917644736812,111.69123337862933,113.67713952122332,108.74665000000009,109.11530000000006,110.85520000000008,113.51099999999997,113.51099999999997,116.23216813152729,110.78983186847265,30792648,56.81331406252319,59.09321438581302,NaN,NaN,NaN,NaN,NaN,NaN,-0.11081110637319946,0.8835617436380687,0.9943728500112682,71.42857142857133,78.93679472881878,4891537455,11499805087.925062,18.67079312067128,25.510411726820582,9.451491393204865,71.42857142857143,0
2015-12-09,114.11,114.76,112.2,112.89,107.97162433673874,110.09562839890539,111.73824383436936,113.60217385253539,108.76945000000006,109.10440000000006,111.12360000000008,113.4915,113.4915,116.22457354456718,110.75842645543283,48509199,48.83038753290832,58.33275161964418,NaN,NaN,NaN,NaN,NaN,NaN,-0.22056313668173955,0.7186689291590938,0.9392320658408333,26.79430736152359,57.7778530571948,4843028256,11477445379.011,16.50937903705974,27.893230546773857,10.554212515526274,64.28571428571429,0
2015-12-10,113.15,114.16,112.811,113.4,108.0256380249304,110.16106149991717,111.80341074282546,113.58291919991296,108.79205000000009,109.09930000000006,111.35640000000008,113.50450000000001,113.50450000000001,116.23323212316706,110.77576787683296,30154621,51.003502273538224,57.708277791762285,NaN,NaN,NaN,NaN,NaN,NaN,-0.25380708985446143,0.6219732035227565,0.875780293377218,39.84846933551777,46.02378270853757,4873182877,11473622962.26452,15.491655742068176,26.17374791594332,11.366597935060101,57.142857142857146,64.28571428571429
2015-12-11,112.09,112.39,110.72,110.79,108.05314411423457,110.17351572764159,111.7636691450676,113.31692689515936,108.80400000000007,109.08100000000006,111.52780000000008,113.44199999999998,113.44199999999998,116.35320318769296,110.530796812307,56022221,41.32986983218556,56.20755308181362,NaN,NaN,NaN,NaN,NaN,NaN,-0.43588719294131095,0.33092130220057925,0.7668084951418902,1.391650099403725,22.678142265481707,4817160656,11422297214.881289,13.686557912948539,32.21518527580868,13.030629607434301,50,100
2015-12-14,110.98,111.68,109.38,111.63,108.08873472006309,110.20235700036156,111.75842721781004,113.15626719085846,108.81525000000009,109.07530000000006,111.68020000000007,113.53149999999998,113.53149999999998,116.08196093873914,110.98103906126082,53098514,44.94879712506783,55.09392917218457,NaN,NaN,NaN,NaN,NaN,NaN,-0.48054555622747075,0.1661265498575517,0.6466721060850225,35.321821036106726,25.520646823676092,4870259170,11473087097.83781,12.35593154476438,34.7473832552655,15.60311285999749,42.857142857142854,100
2015-12-15,112.6,113.28,112.17,112.31,108.13073735966445,110.24409250530489,111.78005752299396,113.0756703155386,108.83245000000008,109.08740000000006,111.81640000000007,113.57599999999998,113.57599999999998,116.00574401944701,111.14625598055295,48428014,47.75808475204565,54.22134528233,NaN,NaN,NaN,NaN,NaN,NaN,-0.44584513579396956,0.08936568634256048,0.53521082213653,45.996860282574644,27.570110472695053,4918687184,11436875159.441414,18.26733300894733,32.319814511336524,17.40469295619081,35.714285714285715,92.85714285714286
2015-12-16,113.07,114.17,111.89,113.98,108.18893897797625,110.31807087153648,111.86632977699419,113.16179695215398,108.86010000000007,109.12540000000004,111.99600000000008,113.70049999999999,113.70049999999999,115.93746647270846,111.46353352729152,44944106,53.97046743011165,53.76404073121541,NaN,NaN,NaN,NaN,53.97046743011165,NaN,-0.29902756210979886,0.16142636949928146,0.4604539316090803,72.21350078492944,51.17739403453694,4963631290,11474328581.10808,20.223110579266177,29.276136021305412,18.49925930000695,28.571428571428573,85.71428571428571
2015-12-17,114.46,114.48,112.3,112.32,108.2300440627725,110.35771303249615,111.88412076613167,113.08162581385359,108.87850000000009,109.13730000000005,112.12980000000007,113.63499999999999,113.63499999999999,115.95168297356796,111.31831702643203,45668795,47.876031022170984,52.823683685476865,NaN,NaN,NaN,NaN,NaN,NaN,-0.30146482486709336,0.0836229005252136,0.38508772539230696,46.15384615384608,54.78806907378339,4917962495,11429497745.649364,19.692464859791674,26.688189171092397,19.22602078920392,21.428571428571427,78.57142857142857
2015-12-18,111.58,111.88,109.83,109.83,108.24596402234691,110.34726326947643,111.80356701059709,112.77194716491515,108.89060000000009,109.12010000000004,112.20540000000007,113.44099999999999,113.44099999999999,116.28897401673994,110.59302598326003,53746061,40.490144375795666,51.49471596148336,NaN,NaN,40.490144375795666,NaN,NaN,NaN,-0.4496059238708173,-0.17691967944621467,0.27268624442460265,7.06436420722139,41.81057038199897,4864216434,11375751684.649364,17.761201605701213,33.79919289137778,21.330780494084173,14.285714285714286,71.42857142857143
2015-12-21,110.87,111.07,110.05,111.05,108.27386487784595,110.36117884829868,111.7740153631227,112.607952196828,108.90725000000009,109.10980000000005,112.29580000000006,113.2695,113.2695,116.25626731601606,110.28273268398392,26432807,44.969667684762776,50.13838464522207,NaN,NaN,NaN,NaN,NaN,NaN,-0.4435172878701203,-0.2817103654130477,0.16180692245707257,26.216640502354796,26.478283621140758,4890649241,11401147910.982698,16.873720199322435,32.110334451075005,23.016625456452353,7.142857142857143,64.28571428571429
2015-12-22,111.65,111.94,111.05,111.78,108.3087517944843,110.38927431664919,111.77425005476495,112.5290996066539,108.93755000000009,109.10810000000005,112.39560000000004,113.151,113.151,116.17643815008985,110.12556184991014,26540310,47.51545463821772,49.30125353976034,NaN,NaN,NaN,NaN,NaN,NaN,-0.37133940791255615,-0.30236733743362265,0.06897207047893351,40.33613445378159,24.539046387785927,4917189551,11418145637.611912,19.881309034483007,30.91627199520654,23.57548775673214,0,57.142857142857146
2015-12-23,112.34,112.69,112.16,112.61,108.35155028409142,110.43324908265613,111.80702456242122,112.5368044060202,108.97505000000008,109.11820000000006,112.52580000000006,113.079,113.079,116.08390199507718,110.0740980049228,25656928,50.32905406909977,49.42037216560778,NaN,NaN,NaN,NaN,NaN,NaN,-0.25429362993330507,-0.24889496693769786,0.005398662995607234,54.28571428571433,40.279496413950234,4942846479,11436057077.9138,22.341233730795054,29.700150584629142,23.664691369644775,7.142857142857143,50
2015-12-24,112.57,112.9,112.54,112.59,108.39372391310543,110.47595702161344,111.83772948154196,112.54187065306589,109.00900000000009,109.13020000000006,112.65900000000006,113.001,113.001,115.97144037139468,110.03055962860533,11480244,50.25913712425849,48.776393934197856,NaN,NaN,NaN,NaN,NaN,NaN,-0.16892668342440295,-0.20575969128489646,-0.03683300786049351,54.31472081218278,49.6455231838929,4931366235,11427765790.580465,22.934466277059744,29.21062382319174,23.902229501376592,0,42.857142857142854
2015-12-28,112.32,112.55,111.51,112.53,108.43488088909443,110.51663113999733,111.8648773450109,112.54074011467866,109.04495000000009,109.13300000000005,112.75620000000008,112.91199999999999,112.91199999999999,115.82636167968562,109.99763832031437,19183637,50.034573290906714,48.29489180097085,NaN,NaN,NaN,NaN,NaN,NaN,-0.11005817962918678,-0.174405732396977,-0.06434755276779021,56.09973285841497,54.900055985437355,4912182598,11446211595.388157,21.774939752611488,32.55554495828531,24.69738862558044,0,35.714285714285715
2015-12-29,113.215,114.545,113.13,114.3,108.4932402832328,110.5915493352449,111.9603723510889,112.70828867518544,109.08295000000007,109.17150000000005,112.87980000000009,112.926,112.926,115.86411095774358,109.98788904225643,27725673,56.24547251481092,48.25433169041998,NaN,NaN,NaN,NaN,56.24547251481092,NaN,0.046152799028884195,-0.006656553981684965,-0.05280935301056916,91.44981412639392,67.28808926566388,4939908271,11464336151.942926,28.897075976099966,29.55337601690877,23.671817073515058,0,28.571428571428573
2015-12-30,114.16,114.24,113.25,113.27,108.54077023066331,110.64458796226975,112.01173029810502,112.76178499183445,109.11495000000008,109.20110000000004,112.97040000000008,112.8315,112.8315,115.59234968805022,110.07065031194979,19520081,52.18063766237964,48.4936352710965,NaN,NaN,NaN,NaN,NaN,NaN,0.07639266721200433,0.04268148100443625,-0.03371118620756808,75.31461761858657,74.28805486779848,4920388190,11445604761.084341,27.475236619324683,28.09924435385838,21.920748006774108,0,21.428571428571427
2015-12-31,112.87,113.08,111.84,111.86,108.57379739254726,110.66865552737332,112.0057800903362,112.67590070689783,109.13465000000008,109.20400000000005,113.04400000000008,112.70200000000003,112.70200000000003,115.38901767764683,110.01498232235322,29886849,47.156479712179184,48.218847945285155,NaN,NaN,NaN,NaN,NaN,NaN,0.0016662333642779373,-0.03162839450222066,-0.033294627866498595,48.01548886737659,71.5933068707857,4890501341,11416682003.987566,25.62593490602767,32.84459946935917,20.971320692623767,85.71428571428571,14.285714285714286
2016-01-04,109.43,109.6,108.12,109.5,108.58301333889008,110.64551383376197,111.90751420444066,112.37343397290756,109.14175000000006,109.19760000000005,113.0836000000001,112.5515,112.5515,115.58013847297892,109.52286152702109,50807643,40.18266762227814,48.136904930291756,NaN,NaN,NaN,NaN,NaN,NaN,-0.19556434022896196,-0.27775005315270107,-0.0821857129237391,21.47859922178982,48.269568569251,4839693698,11460623749.284864,21.54204909642519,43.461620550076574,20.496654051884327,78.57142857142857,100
2016-01-05,110.04,110.18,108.8,109.31,108.59024703701058,110.61906801527164,111.80565090230573,112.08167835644018,109.14565000000006,109.18550000000006,113.07560000000008,112.26000000000002,112.26000000000002,115.35744410764758,109.16255589235246,38795182,39.673968729802546,47.76013147348709,NaN,NaN,NaN,NaN,NaN,NaN,-0.3203089215649751,-0.48257186487995796,-0.16226294331498287,18.52140077821009,29.338496289125505,4800898516,11450503267.023994,22.76215179642668,40.87325694527826,19.13407144677913,71.42857142857143,92.85714285714286
2016-01-06,107.43,108.89,107.41,108.26,108.58696099684133,110.57235379714744,111.66660576888198,111.71770898916016,109.14535000000005,109.16470000000007,112.98520000000009,111.94200000000004,111.94200000000004,115.2999374621908,108.58406253780927,41891091,36.89424856292142,46.98414317426393,NaN,NaN,NaN,NaN,NaN,NaN,-0.4472345122160297,-0.72130608358502,-0.2740715713689903,11.913104414856454,17.304368138285458,4759007425,11456730321.091562,20.915258506727184,43.49279315744685,19.653724486306174,64.28571428571429,100
2016-01-07,105.96,107.29,104.81,104.87,108.5499763103056,110.45943590017423,111.40007220931798,111.06554622828776,109.13005000000007,109.10830000000007,112.82560000000011,111.45400000000004,111.45400000000004,115.79919688851697,107.1088031114831,61386300,29.667118373136518,45.248189670194286,NaN,NaN,NaN,NaN,NaN,NaN,-0.7171874634698059,-1.1705559007062476,-0.45336843723644177,0.6163328197226736,10.350279337596406,4697621125,11398314325.930271,18.05118373188401,47.856913474961374,21.57757803472412,57.142857142857146,100
2016-01-08,105.67,106.29,103.9,104.01,108.50480241667071,110.33172429819058,111.11026545601139,110.39358944464131,109.12280000000005,109.03410000000007,112.6442000000001,111.01000000000003,111.01000000000003,116.3730588286896,105.64694117131047,69344012,28.160079279402908,43.83990740285371,NaN,NaN,NaN,NaN,NaN,NaN,-0.8995425089080699,-1.5777965733715291,-0.6782540644634593,1.0333489901362092,4.520928741571781,4628277113,11335353444.741987,16.37799357431708,46.950242946762394,23.948476383462832,50,100
2016-01-11,104.79,105.06,102.73,104.33,108.46326209411677,110.21287827248383,110.84437269303055,109.81610473562785,109.11895000000005,108.96880000000006,112.45040000000009,110.55650000000003,110.55650000000003,116.53327262408307,104.57972737591699,50024094,29.5932556110655,43.06155820537298,NaN,NaN,NaN,NaN,NaN,NaN,-0.9400784485839269,-1.8533521251933678,-0.9132736766094409,13.54210749047816,5.063929766779014,4678301207,11354031969.111086,14.925509183239665,47.23974217170146,25.43961421337753,42.857142857142854,100
2016-01-12,105.31,106.08,104.08,105.54,108.43417490910069,110.12034602946436,110.63635807761759,109.40885666556805,109.11905000000006,108.92290000000007,112.28440000000008,110.29400000000003,110.29400000000003,116.65547278544823,103.93252721455183,46734241,34.8831527074673,42.341092849851876,NaN,NaN,NaN,NaN,NaN,NaN,-0.8306596095799206,-1.9515981885843416,-1.120938579004421,23.783326280152373,12.78626092025558,4725035448,11375529719.971087,17.658828619155862,43.660445485811934,26.246643308876035,35.714285714285715,92.85714285714286
2016-01-13,106,106.23,101.74,101.9,108.36915824333849,109.95756690016803,110.29375580006396,108.69372745932348,109.09490000000005,108.87110000000006,112.05580000000008,109.80750000000003,109.80750000000003,117.10520340586548,102.50979659413458,69870673,28.05448527285492,40.95102360946881,NaN,NaN,28.05448527285492,NaN,NaN,NaN,-0.9406103649931274,-2.2967015352458304,-1.356091170252703,1.2495119094104703,12.858315226680334,4655164775,11310638694.044584,14.92481770648082,44.96953949922198,28.27803304338146,28.571428571428573,100
2016-01-14,102.3,104.98,100.67,104.07,108.32638054937492,109.84098141699639,110.0496869451595,108.25337246319744,109.08725000000005,108.88780000000006,111.84500000000007,109.39550000000001,109.39550000000001,117.00528179713534,101.78571820286469,78445735,36.087015440053335,39.9337351359655,NaN,NaN,NaN,NaN,NaN,NaN,-0.8093694639396352,-2.367803000177247,-1.5584335362376118,24.504504504504443,16.512447564689094,4733610510,11355958851.852009,12.86567461140341,42.1903793277851,31.072522435705235,21.428571428571427,100
2016-01-15,100.57,101.94,99.51,100.84,108.25188920062492,109.66274416121428,109.68852275123167,107.54733699051197,109.06620000000007,108.91160000000005,111.56160000000008,108.73850000000002,108.73850000000002,116.90048327614066,100.57651672385937,91443918,30.60897857608822,38.53015238252477,NaN,NaN,NaN,NaN,NaN,NaN,-0.876604838058668,-2.654189583810947,-1.7775847457522789,8.84602593947455,11.53334745112982,4642166592,11364614037.50633,11.117944912102734,39.914743633273126,34.243393320898285,14.285714285714286,100
2016-01-19,102.2,102.37,99.88,101.06,108.18032811405153,109.49239279168528,109.3501493100069,106.92949537236797,109.04590000000006,108.94130000000004,111.2824000000001,108.17550000000001,108.17550000000001,116.81127089784124,99.53972910215879,56563845,31.373118848924122,37.19719135095458,NaN,NaN,NaN,NaN,NaN,NaN,-0.8425478070031089,-2.830769504506165,-1.988221697503056,10.309278350515447,14.553269598164812,4698730437,11361660905.036451,11.572973526167468,36.962059108192626,36.56255044786267,7.142857142857143,92.85714285714286
2016-01-20,99.48,101.83,97.25,100.75,108.10639450097639,109.31927610274101,109.01288855275173,106.34097200357101,109.01975000000007,108.91850000000005,111.00320000000009,107.72150000000002,107.72150000000002,116.89931079560891,98.54368920439113,86674981,30.85747027089114,35.383762619246035,NaN,NaN,NaN,NaN,NaN,NaN,-0.7786910095299344,-2.961585459415474,-2.1828944498855396,20.60035314891113,13.251885812967041,4612055456,11407458602.42073,10.093888854444746,39.57714528335543,40.72213689389182,0,100
2016-01-21,101.19,102.349,99.82,100.85,108.03419157061842,109.15156766506297,108.69277527617324,105.8180222889452,108.99500000000008,108.87060000000005,110.7244000000001,107.2115,107.2115,116.72041849791627,97.70258150208373,61660101,31.25001731585951,33.888718308780305,NaN,NaN,NaN,NaN,NaN,NaN,-0.6715637381365225,-3.022349122556193,-2.3507853844196704,22.741629816803503,17.88375377207669,4673715557,11396023811.052996,10.830447007193644,36.78171846518943,44.5351880409777,0,92.85714285714286
2016-01-22,102.84,103.81,102.5305,103.77,107.9917618037466,109.04500196872509,108.49972526534292,105.62297254714089,108.98065000000008,108.85210000000005,110.52840000000009,106.811,106.811,116.19036437078815,97.43163562921187,42229803,41.664687291266006,33.49644742157223,NaN,NaN,NaN,NaN,NaN,NaN,-0.3614347189957776,-2.8025787831643925,-2.441144064168615,50.42536736272229,31.255783442812305,4715945360,11435613219.961554,13.980112623207816,33.77478498837447,46.614098311443264,0,85.71428571428571
2016-01-25,103.46,103.99,102.14,102.23,107.93443084052524,108.91005143469093,108.25385368630987,105.29983230455605,108.95525000000009,108.83130000000004,110.30740000000009,106.292,106.292,115.47712188269816,97.10687811730185,38881485,38.363895214567584,33.36653510673576,NaN,NaN,NaN,NaN,NaN,NaN,-0.2241286106031084,-2.7213048274225002,-2.497176216819392,38.51508120649653,37.22735946200744,4677063875,11400514798.366959,13.250983224940033,33.1141575141416,47.26554378745799,7.142857142857143,78.57142857142857
2016-01-26,102.65,103.59,101.76,103.15,107.88682456350509,108.79599101024161,108.05370256135654,105.0950863707888,108.93225000000008,108.85230000000006,110.10760000000008,105.82000000000001,105.82000000000001,114.62436255500675,97.01563744499326,36143916,41.35304252138119,33.48646894899138,NaN,NaN,NaN,NaN,NaN,NaN,-0.04484008018912844,-2.5532263170558025,-2.508386236866674,50.687285223367745,46.542577930862194,4713207791,11419278033.448925,12.5535166694278,32.46416006473028,48.391812742953974,0,71.42857142857143
2016-01-27,102.55,102.99,100.15,100.58,107.81411984148016,108.6332981189497,107.76061618640139,104.6650781449994,108.89775000000009,108.81910000000005,109.87840000000007,105.22250000000001,105.22250000000001,113.74162407469292,96.7033759253071,54524736,36.087967800744956,33.42887746597877,NaN,NaN,NaN,NaN,NaN,NaN,-0.07125782912209733,-2.597458523269296,-2.5262006941471986,33.1673306772908,40.789899035718356,4658683055,11381264309.054558,11.486170287644214,34.26687553500422,49.444432417947915,0,64.28571428571429
2016-01-28,102.19,102.29,100.26,102,107.75626790275896,108.5019456809507,107.53470966928761,104.41126117880899,108.87190000000008,108.80520000000006,109.72160000000007,104.6075,104.6075,112.13473554832848,97.08026445167152,47641532,40.58892021150168,34.20900616871914,NaN,NaN,NaN,NaN,NaN,NaN,0.029571462934500747,-2.489236365479073,-2.5188078284135735,52.54424778761058,45.46628789608971,4706324587,11415293974.768843,10.816027674252455,32.26762835785762,49.77067585333344,0,57.142857142857146
2016-01-29,102,104.17,101.94,104.13,107.72018563506983,108.4153724991497,107.40119164304103,104.38447439987479,108.85335000000008,108.82490000000006,109.57580000000007,104.15050000000001,104.15050000000001,110.54281562112007,97.75818437887995,54245067,46.65729971867571,35.53023620009578,NaN,NaN,NaN,NaN,NaN,NaN,0.2501142389612272,-2.2061650297120394,-2.4562792686732666,76.61469933184847,54.10875926558328,4760569654,11467593030.396645,15.560858787431012,30.184260169783528,48.605766687894864,0,50
2016-02-01,103.62,104.8,103.23,104.41,107.68724846457162,108.33605819223584,107.2838900099806,104.38690540941053,108.83695000000009,108.81860000000005,109.43420000000008,103.77799999999999,103.77799999999999,109.11024755614658,98.44575244385341,32750348,47.417640817508904,36.80340657198459,NaN,NaN,NaN,NaN,47.417640817508904,NaN,0.4154971517496815,-1.9369078289861648,-2.3524049807358463,79.73273942093535,69.63056218013146,4793320002,11484072504.867983,16.707338246581262,28.775610489513415,46.788083541020406,14.285714285714286,42.857142857142854
2016-02-02,103.97,103.97,101.84,102.15,107.63215146492415,108.21356199040939,107.08256098998136,104.17386679899047,108.81765000000009,108.80150000000005,109.20460000000008,103.4105,103.4105,108.08751389777929,98.73348610222071,44928088,42.19029616928248,37.32534539068568,NaN,NaN,NaN,NaN,NaN,NaN,0.37459341716170647,-1.884163209283713,-2.2587566264454195,54.565701559020084,70.30438010393463,4748391914,11452222076.285824,15.437313066818245,30.699575124503625,46.122135566018144,7.142857142857143,35.714285714285715
2016-02-03,102.8,102.83,99.88,101.66,107.57272707223834,108.08378848564881,106.86991153939385,103.93445091337233,108.7879500000001,108.76820000000005,108.96360000000008,103.02799999999999,103.02799999999999,106.89339312360627,99.16260687639371,61572882,41.13155774731227,38.25942199600406,NaN,NaN,NaN,NaN,NaN,NaN,0.31864094057907666,-1.8604554507215738,-2.1790963913006505,57.050452781371206,63.78296458710887,4686819032,11464954095.95362,14.111305963076495,33.769601369251674,45.47169191607369,0,28.571428571428573
2016-02-04,101.35,102.455,100.44,101.65,107.51379446455438,107.95638673345775,106.66520912608429,103.71688415971782,108.75590000000007,108.72900000000006,108.70700000000008,102.69749999999999,102.69749999999999,105.76496719624272,99.63003280375726,49321638,41.108885195505955,38.618126978536395,NaN,NaN,NaN,NaN,NaN,NaN,0.28609555681078147,-1.8214769452871735,-2.107572502097955,58.27814569536434,56.63143334525187,4637497394,11474867378.033026,13.272676045882347,31.762685916204504,44.59978382423657,0,21.428571428571427
2016-02-05,101.29,101.33,97.72,98.12,107.42032387286727,107.76160679814176,106.33010288584569,103.18384757307803,108.70325000000008,108.65770000000003,108.38640000000008,102.35999999999999,102.35999999999999,105.85291855044295,98.86708144955702,70749932,33.98696614545217,38.85941180491954,NaN,NaN,NaN,NaN,NaN,NaN,0.044637121860264806,-2.051776099772624,-2.096413221632889,11.523178807947085,42.28392576156087,4566747462,11419796101.323885,11.799758471544303,35.9184845162441,44.17949045133348,71.42857142857143,14.285714285714286
2016-02-08,96.33,97.05,94.84,96.62,107.31285796368451,107.54098092095083,105.94931453738116,102.55871923278488,108.64105000000009,108.55900000000003,108.03780000000008,101.99049999999997,101.99049999999997,106.19756298978768,97.78343701021225,91673063,31.490412406514537,38.867789916175994,NaN,NaN,NaN,NaN,NaN,NaN,-0.18565819558166163,-2.328485966109966,-2.1428277705283043,17.871485943775124,29.22427014902885,4475074399,11475795483.699451,10.729552129122787,40.62444079304504,44.60109922284273,64.28571428571429,100
2016-02-09,95.36,97.78,95.18,96.32,107.20347629240406,107.3187832789518,105.57169435944463,101.96455549632918,108.56995000000008,108.45130000000005,107.68120000000008,101.58999999999997,101.58999999999997,106.32223414467579,96.85776585532416,73778426,30.999951703693952,38.8779671613762,NaN,NaN,30.999951703693952,NaN,NaN,NaN,-0.31987987698574516,-2.5426776167604856,-2.2227977397747405,14.859437751003922,14.751367500908712,4401295973,11466715062.037912,11.976147172131753,37.705138111964004,44.06046013499747,57.142857142857146,92.85714285714286
2016-02-10,97.5,98.69,96.62,96.69,107.09886458800203,107.10831232293295,105.22339261985857,101.46221687763116,108.50210000000008,108.34690000000005,107.32880000000006,101.14749999999998,101.14749999999998,105.97371124693353,96.32128875306643,59421699,32.39840498880068,38.95999485230056,NaN,NaN,NaN,NaN,NaN,NaN,-0.3433614365443818,-2.651999535455218,-2.308638098910836,18.574297188754976,17.10174029451134,4460717672,11411312221.907476,13.71710447586089,35.22058664691376,43.30581622220308,50,85.71428571428571
2016-02-11,95.45,97.32,95.19,96.55,106.99390076125574,106.89923683138971,104.88325957594255,100.99438669880915,108.43465000000008,108.25890000000005,106.97940000000008,100.87999999999998,100.87999999999998,106.08770966932926,95.6722903306707,76839183,32.13302923978323,38.279162134337504,NaN,NaN,NaN,NaN,NaN,NaN,-0.3279667093477068,-2.7185964855954694,-2.3906297762477626,17.16867469879513,16.86746987951801,4383878489,11432596314.85114,12.89471926189652,37.13402892156862,43.80583066131192,42.857142857142854,78.57142857142857
2016-02-12,97.68,98.12,96.73,98.02,106.90460821636763,106.72341035948101,104.61411214159186,100.71111177511304,108.37800000000009,108.18230000000005,106.63660000000007,100.57749999999999,100.57749999999999,105.71120382862365,95.44379617137632,49186494,37.88610810292301,38.245034483505755,NaN,NaN,NaN,NaN,NaN,NaN,-0.1855181545919784,-2.6225274694877356,-2.4370093148957572,31.92771084337344,22.55689424364118,4433064983,11474705615.469843,14.623750586948859,35.44709441732209,43.71633147565291,35.714285714285715,71.42857142857143
2016-02-16,99.44,100.23,98.85,100.23,106.83819420426447,106.59482797612495,104.44218617525493,100.66529160605465,108.34100000000008,108.14360000000005,106.35220000000007,100.54699999999998,100.54699999999998,105.68135137091608,95.41264862908389,40565911,45.382211922036966,38.532832297838304,NaN,NaN,NaN,NaN,NaN,NaN,0.07674579383655944,-2.341077072600058,-2.4178228664366173,54.11646586345385,34.404283801874136,4473630894,11515271526.469843,19.832909730020088,33.163279399376535,42.353827830250246,28.571428571428573,64.28571428571429
2016-02-17,101.01,102.64,100.7,102.5,106.79502809277925,106.51374227362743,104.36602201151945,100.84002573881135,108.30825000000009,108.12680000000005,106.15200000000009,100.61899999999997,100.61899999999997,105.82006104559834,95.4179389544016,41766451,51.814709082406736,39.65617096081415,NaN,NaN,NaN,NaN,NaN,NaN,0.40401354090289043,-1.9128059403080044,-2.316819481210895,76.90763052208837,54.317269076305216,4515397345,11551009829.902832,25.47200186798697,30.83051682185969,39.47716971218591,21.428571428571427,57.142857142857146
2016-02-18,102.81,102.84,101.2,101.33,106.74064970379636,106.41109391177342,104.24696232479319,100.88668995416265,108.2687500000001,108.10210000000005,105.87580000000007,100.64799999999997,100.64799999999997,105.85811938443189,95.43788061556805,38991469,48.63533180418334,40.230914646005694,NaN,NaN,NaN,NaN,NaN,NaN,0.5344149014209925,-1.6488008544346542,-2.1832157558556466,65.16064257028113,65.39491298527444,4476405876,11518199935.25649,24.82113695549177,29.31912997801999,36.51413113083359,14.285714285714286,50
2016-02-19,100.91,101.94,100.615,101.63,106.6897974679377,106.31641878480761,104.14433635127189,100.95748138709953,108.2396500000001,108.08920000000003,105.61600000000007,100.68699999999997,100.68699999999997,105.91423292001025,95.45976707998969,28257915,49.491140394511774,40.43333183713684,NaN,NaN,NaN,NaN,NaN,NaN,0.6271822961405897,-1.3992378856799093,-2.026420181820499,68.17269076305217,70.08032128514056,4504663791,11533235278.70932,23.805745885769433,29.92587458120398,35.04434908324659,7.142857142857143,42.857142857142854
2016-02-22,102.54,103.38,102.48,103.28,106.65586913492339,106.25629168015796,104.11044080808476,101.17867363594719,108.2225000000001,108.12210000000003,105.38900000000008,100.66249999999997,100.66249999999997,105.83602056147845,95.48897943852148,23979113,54.027977040300016,40.90549871019335,NaN,NaN,NaN,NaN,NaN,NaN,0.77622280090169,-1.0561416806933863,-1.8323644815950764,92.44249726177439,75.25861019836924,4528642904,11551885699.931543,27.02135787439321,28.28035383784014,33.31170451990849,0,35.714285714285715
2016-02-23,102.67,102.96,101.51,101.58,106.60536297437689,106.1636918449073,104.0112078352187,101.21689519442842,108.19365000000009,108.14320000000004,105.1628000000001,100.62999999999997,100.62999999999997,105.77179346143458,95.48820653856535,29869660,49.131381673972676,41.40129053195694,NaN,NaN,NaN,NaN,NaN,NaN,0.7371629087420142,-0.9109108456675585,-1.6480737544095727,78.92271662763468,79.84596821748708,4498773244,11524900007.103956,25.494419404318553,29.779068996213198,31.502514338522342,0,28.571428571428573
2016-02-24,100.44,102.68,99.77,102.55,106.56501110398507,106.0921335905527,103.9539055671709,101.34385755686381,108.1629500000001,108.15110000000004,104.94580000000009,100.59999999999995,100.59999999999995,105.68936538284039,95.51063461715951,40739103,51.81484852887496,42.164382730639986,NaN,NaN,NaN,NaN,NaN,NaN,0.7509659350044953,-0.7093663356539537,-1.460332270658449,90.28103044496487,87.21541477812464,4539512347,11561999190.248285,23.175683315581455,32.50893204328937,29.767104567167088,85.71428571428571,21.428571428571427
2016-02-25,102.76,103.56,101.84,103.56,106.53511049598522,106.04199233133384,103.93845829002694,101.5549187419244,108.1394000000001,108.16450000000003,104.8012000000001,100.74899999999995,100.74899999999995,105.99924532760608,95.49875467239383,29389315,54.50598009237378,43.12131808041626,NaN,NaN,NaN,NaN,NaN,NaN,0.7980199402460082,-0.4628073453509387,-1.260827285596947,100,89.73458235753317,4568901662,11591388505.248285,24.707273561859523,30.72988562185475,27.61047645379539,100,14.285714285714286
2016-02-26,104.28,104.3659,103.1835,103.43,106.50421387413462,105.99026971091139,103.91851874924157,101.73349790936017,108.11765000000008,108.15870000000002,104.63720000000008,100.82049999999997,100.82049999999997,106.17486074616197,95.46613925383797,30925045,54.08726043687723,44.55705338694662,NaN,NaN,NaN,NaN,NaN,NaN,0.78887738060646,-0.27473055983887207,-1.063607940445332,90.17520654216409,93.485412329043,4537976617,11573357613.821527,26.39909366970406,29.533370348167914,24.400451054079955,100,7.142857142857143
2016-02-29,103.31,104.1,102.5,102.5,106.46437095001387,105.92115545921017,103.86289056299681,101.80649810846872,108.09015000000008,108.12870000000004,104.44100000000009,100.73899999999998,100.73899999999998,105.9367106498951,95.54128935010485,27553937,51.06503334628494,45.95524059693022,NaN,NaN,NaN,NaN,NaN,NaN,0.6921390287134802,-0.1984341545534818,-0.890573183266962,79.68734691211533,89.95418448475981,4510422680,11545803676.821527,24.981610284644447,30.24135134236484,20.92267868916935,92.85714285714286,0
2016-03-01,103.45,105.79,103.16,105.79,106.45766079130726,105.91855832140402,103.93846348209497,102.1858792409955,108.07120000000008,108.13660000000006,104.27720000000008,100.80799999999996,100.80799999999996,106.23058462359451,95.38541537640542,37699779,59.65382569224816,48.00194588182695,NaN,NaN,NaN,NaN,NaN,NaN,0.8133015319660981,0.1260537316906607,-0.6872478002754374,100,89.95418448475981,4548122459,11583503455.821527,27.785583344538278,27.02770071926544,17.322290680921906,100,0
2016-03-02,105.63,105.85,105.01,105.83,106.45141541029923,105.9168046912772,104.01264138475791,102.5329383609007,108.05245000000008,108.13860000000004,104.14740000000009,100.99199999999998,100.99199999999998,106.81891204670484,95.16508795329511,29209756,59.7463310853546,49.95536917443794,NaN,NaN,NaN,NaN,59.7463310853546,NaN,0.8554274450381352,0.3820365060222315,-0.4733909390159036,99.81238273921204,93.16657655044246,4577332215,11611322271.059624,27.19954667765016,26.26039782097496,14.30916218025167,100,7.142857142857143
2016-03-03,105.71,105.75,104.87,105.63,106.44324212263456,105.91112539045983,104.07606721280662,102.82789661224349,108.03030000000008,108.13440000000004,104.06340000000009,101.19049999999997,101.19049999999997,107.35558385993498,95.02541614006496,25474625,59.01771000116157,51.8757035145364,NaN,NaN,NaN,NaN,NaN,NaN,0.8285405131065007,0.5622847023672222,-0.26625581073927845,97.58771929824562,99.13336734581922,4551857590,11629849271.059624,26.28125536893771,25.866165264184332,10.905250155861406,92.85714285714286,0
2016-03-04,105.76,106.35,104.97,105.67,106.43554817116556,105.9063506302527,104.13857438093186,103.09857312536316,108.00895000000008,108.12580000000005,103.9558000000001,101.39149999999998,101.39149999999998,107.85815377146693,94.92484622853303,31655424,59.125074856302874,53.392772568349244,NaN,NaN,NaN,NaN,NaN,NaN,0.7732349522183177,0.7002878795336187,-0.072947072684699,90.93333333333342,96.11114512359701,4583513014,11630308045.320494,27.135414976563897,24.581416383221082,8.287440603058077,100,0
2016-03-07,105.12,105.74,104.27,105.02,106.42146311473606,105.88879913262393,104.17314009148355,103.28156616104286,107.98400000000007,108.10810000000005,103.8206000000001,101.73649999999998,101.73649999999998,108.2044340596539,95.26856594034605,25861160,56.53323703818028,54.18927436235948,NaN,NaN,NaN,NaN,NaN,NaN,0.6572198072507154,0.7485776863786953,0.09135787912797988,79.78723404255321,89.43609555804407,4557651854,11630835824.096004,25.67263317973995,25.823300011786003,6.511664214492339,92.85714285714286,0
2016-03-08,104.3,105.2138,103.97,104.15,106.39886149170385,105.85436746663137,104.17223263691557,103.36427414570545,107.95185000000006,108.08860000000006,103.65140000000011,102.11299999999997,102.11299999999997,108.21188875124349,96.01411124875645,28898525,53.17337878439043,54.28632219821545,NaN,NaN,53.17337878439043,NaN,NaN,NaN,0.49369695380485423,0.7084790713840476,0.21478211757919344,66.56534954407311,79.09530563998656,4528753329,11610301561.035223,24.470628642065712,25.743533553633313,6.012920588256532,85.71428571428571,35.714285714285715
2016-03-09,104.57,104.84,103.96,104.82,106.38315142710978,105.83388494253967,104.19763527860515,103.50291470325732,107.92360000000008,108.07750000000006,103.4960000000001,102.53799999999998,102.53799999999998,108.12617895204085,96.94982104795912,31047351,55.37303440982363,54.7675866700469,NaN,NaN,NaN,NaN,NaN,NaN,0.40612329430528904,0.7224362354608047,0.31631294115551567,76.74772036474162,74.3667679837893,4559800680,11639937668.80795,23.6277316116847,24.895933324283575,5.606173255862463,78.57142857142857,28.571428571428573
2016-03-10,105.31,105.86,103.31,104.66,106.3660056417654,105.81063969615275,104.21576722846378,103.6131133029471,107.90090000000005,108.04740000000007,103.3386000000001,102.93649999999998,102.93649999999998,107.90170805203957,97.9712919479604,44997649,54.712074803114774,55.140510556375695,NaN,NaN,NaN,NaN,NaN,NaN,0.3168495760237423,0.7123749111851936,0.3955253351614513,74.31610942249243,72.54305977710237,4514803031,11642584589.33736,25.216791586106847,22.479583296712804,5.2025045087341715,71.42857142857143,21.428571428571427
2016-03-11,105.8,106.49,105.46,106.49,106.3672394164742,105.82409237543685,104.30495282734755,103.88710251219022,107.87855000000008,108.03110000000007,103.1824000000001,103.43349999999998,103.43349999999998,107.68005754700553,99.18694245299443,31453958,60.5170687828781,55.604017109416986,NaN,NaN,NaN,NaN,NaN,NaN,0.35746515638472853,0.842356780642362,0.48489162425763344,100,83.68794326241134,4546256989,11674038547.33736,25.859401021717105,20.91101934555078,5.795615745066842,100,14.285714285714286
2016-03-14,106.08,106.92,106.06,106.67,106.37025195959387,105.8408430214678,104.3976997752947,104.15214036817211,107.85835000000006,108.01040000000006,103.0504000000001,103.86599999999999,103.86599999999999,107.5427942558746,100.18920574412537,25374912,61.04597393601903,56.455059413848865,NaN,NaN,NaN,NaN,NaN,NaN,0.3712498162260842,0.9489538945402387,0.5777040783141545,96.5034965034965,90.27320197532963,4571631901,11684660603.523407,26.682822144609442,20.197757216229707,6.2300037644334845,100,7.142857142857143
2016-03-15,106.27,106.75,105.95,106.63,106.37283651720985,105.85646989232983,104.48524096057726,104.38812699977477,107.84125000000007,107.99490000000006,102.9458000000001,104.18599999999999,104.18599999999999,107.64909919003605,100.72290080996393,26524632,60.85089626590667,57.10049139506542,NaN,NaN,NaN,NaN,NaN,NaN,0.3526087207728903,1.0184649792802674,0.6658562585073771,94.29133858267704,96.93161169539117,4545107269,11703227845.923407,25.801185089337793,19.98471447081038,5.9401978886940805,92.85714285714286,0
2016-03-16,106.37,107.86,106.34,107.58,106.38484809415303,105.8905992013926,104.60660406016247,104.69211490455812,107.82705000000007,107.99550000000006,102.90740000000011,104.43999999999998,104.43999999999998,108.11019345539569,100.76980654460428,31693050,63.8089119371859,57.76498652683771,NaN,NaN,NaN,NaN,NaN,NaN,0.37699680769840005,1.137102268130377,0.760105460431977,94.77611940298505,95.19031816305285,4576800319,11723244509.0813,28.791781563118807,18.719154889717384,6.6785403553785505,100,0
2016-03-17,107.26,107.77,106.87,107.52,106.3961431379923,105.92286456374127,104.72085488133257,104.9614372946002,107.81430000000006,107.97360000000006,102.87160000000011,104.74949999999998,104.74949999999998,108.36198100341456,101.13701899658541,29623740,63.482665237667206,58.43608686975127,NaN,NaN,NaN,NaN,NaN,NaN,0.3617611962698527,1.212306955769293,0.8505457594994402,93.65671641791039,94.24139146785747,4547176579,11736410615.747967,27.67428879337505,17.992610052639,7.79260949113616,92.85714285714286,7.142857142857143
2016-03-18,107.46,107.635,106.8,107.37,106.40583325602222,105.95152071099392,104.82474292520187,105.19082421892399,107.79915000000007,107.91950000000006,102.8538000000001,105.03649999999998,105.03649999999998,108.52185378405615,101.5511462159438,37682293,62.62066545139049,59.2614891629731,NaN,NaN,NaN,NaN,NaN,NaN,0.3159207775916679,1.2454467314890252,0.9295259538973573,89.5744680851065,92.66910130200063,4509494286,11750174806.604254,26.641151989738255,17.63387272006892,8.56542190592177,85.71428571428571,0
2016-03-21,107.16,107.89,107.12,107.79,106.41960605944489,105.98792624146928,104.94102751637043,105.43836476950266,107.79030000000007,107.86890000000007,102.9122000000001,105.26199999999999,105.26199999999999,108.8457946369768,101.67820536302317,17288559,64.09094103540559,59.578425973198634,NaN,NaN,NaN,NaN,NaN,NaN,0.28895691015759173,1.290722091594347,1.0017651814367552,97.81659388646301,93.68259279649328,4526782845,11762972830.799059,26.872651101400933,17.00348430681978,10.073320694914795,100,0
2016-03-22,107.18,108.37,107.16,108.12,106.43652540213698,106.03014552381643,105.06569310396374,105.6937586009786,107.78440000000006,107.81930000000007,102.99440000000011,105.58899999999998,105.58899999999998,108.95620596341077,102.2217940365892,18840278,65.247589655765,59.971373013942234,NaN,NaN,NaN,NaN,NaN,NaN,0.26883580883852365,1.3378099424849097,1.068974133646386,95.0592885375494,94.15011683637296,4545623123,11774027869.956083,27.60266384094386,16.03349267721453,11.841611842553847,100,42.857142857142854
2016-03-23,107.91,107.99,106.99,107.23,106.44442067176746,106.05390501839432,105.15056788420046,105.84006730564731,107.77960000000006,107.75140000000006,103.0524000000001,105.82299999999998,105.82299999999998,108.9551756017231,102.69082439827686,20912873,59.665680450477815,60.017656617464816,NaN,NaN,NaN,NaN,NaN,NaN,0.17558812108783806,1.2884592850061836,1.1128711639183455,77.4703557312253,90.11541271841254,4524710250,11763153175.996084,26.10494399669296,15.979816274439743,13.503247564957647,92.85714285714286,35.714285714285715
2016-03-24,106.67,107.29,106.53,107.26,106.45253588896381,106.077788087337,105.23329071227103,105.97529899082376,107.77585000000006,107.68560000000006,103.08680000000011,106.008,106.008,109.01837937808824,102.99762062191175,19017258,59.790551666605374,60.06519067534357,NaN,NaN,NaN,NaN,NaN,NaN,0.09970635340206124,1.2375041056709222,1.137797752268861,78.06324110671939,83.53096179183133,4543727508,11780669071.5224,25.11779888637647,17.664319377895975,14.394927734905556,85.71428571428571,28.571428571428573
2016-03-28,107.56,107.58,106.92,107.11,106.45907782041691,106.09822792719172,105.30688715492707,106.08336575360245,107.76395000000007,107.62340000000006,103.19100000000012,106.19199999999998,106.19199999999998,108.99211142636021,103.39188857363975,13892303,58.81017100373422,60.22782881574028,NaN,NaN,58.81017100373422,NaN,NaN,NaN,0.026972625194848776,1.1715135337624218,1.144540908567573,75.09881422924892,76.87747035573118,4529835205,11774775367.21937,25.76068821767448,17.060959118539525,15.825185898909098,78.57142857142857,21.428571428571427
2016-03-29,106.93,108.9,106.73,108.83,106.48266908588539,106.15232242368297,105.44504844296914,106.34494996754508,107.75985000000006,107.56560000000007,103.2862000000001,106.50849999999998,106.50849999999998,108.97944536565186,104.03755463434811,29963923,65.74595967418574,61.125870307868524,NaN,NaN,NaN,NaN,NaN,NaN,0.0793024046347719,1.243668914361038,1.164366509726266,98.7477638640428,83.969939733337,4559799128,11802806133.89679,29.544397507156006,15.220186108344347,17.929759525052763,100,14.285714285714286
2016-03-30,109.48,110.04,109.13,109.36,106.51129924423479,106.21584079153084,105.59857595500957,106.63209758968364,107.76290000000006,107.50910000000005,103.45660000000011,106.68699999999998,106.68699999999998,109.4258106907985,103.94818930920147,23807235,67.55870245926815,61.996275168543136,NaN,NaN,NaN,NaN,NaN,NaN,0.13115258811164798,1.328307244865826,1.197154656754178,89.8959881129271,87.91418873540624,4583606363,11791033325.380306,33.47943866198866,14.294074842652075,20.61157547447795,100,7.142857142857143
2016-03-31,109.3,109.69,109.03,109.2,106.5380524855857,106.27493305308468,105.73980827049938,106.87665972399948,107.76785000000005,107.45090000000006,103.61940000000011,106.85549999999998,106.85549999999998,109.77160339323524,103.93939660676472,21447236,66.41601880229942,62.832271168484894,NaN,NaN,NaN,NaN,NaN,NaN,0.13565098652202434,1.3667183899067084,1.231067403384684,81.65938864628818,90.10104687441934,4562159127,11780634665.501518,32.32409078470582,14.323664402105042,22.957944158372033,92.85714285714286,0
2016-04-01,108.58,110.4,108.39,110.36,106.57608181408733,106.35582546787508,105.92099225989156,107.20840641695192,107.77565000000006,107.40740000000005,103.81160000000011,107.09199999999998,107.09199999999998,110.32245879095143,103.86154120904854,26389045,70.33371353063967,63.53346007903929,NaN,NaN,NaN,NaN,70.33371353063967,NaN,0.19416453013298085,1.47377306605091,1.2796085359179292,99.10112359550548,90.21883345157356,4588548172,11805973400.252762,32.62903797141491,12.867333799391195,25.304774747762423,100,0
2016-04-04,110.31,110.435,109.68,109.94,106.60955363683273,106.42679922098647,106.07860040656249,107.46855818676602,107.77985000000007,107.35890000000005,103.99340000000011,107.30549999999998,107.30549999999998,110.69243652140578,103.91856347859418,17162988,67.27372449074745,63.97829940437703,NaN,NaN,NaN,NaN,NaN,NaN,0.18219189459175666,1.507348404157625,1.3251565095658684,88.96321070234103,89.90790764804485,4571385184,11800631278.160046,31.52320159846671,12.359027249487799,27.436108734253583,100,7.142857142857143
2016-04-05,109.08,109.5,108.74,108.88,106.6321451429339,106.47537745423426,106.18845921414827,107.60298121659783,107.77080000000007,107.31200000000004,104.0956000000001,107.49849999999999,107.49849999999999,110.78079355786925,104.21620644213074,20107915,60.1598774360039,63.928940916526834,NaN,NaN,NaN,NaN,NaN,NaN,0.08540895581634511,1.4319177043362998,1.3465087485199547,62.02686202686185,83.36373210823608,4551277269,11787931542.370571,29.5266941197717,16.537479589954383,28.54285557119143,92.85714285714286,0
2016-04-06,109,110.71,108.99,110.67,106.6723228032032,106.55843928682368,106.36420591163265,107.89507824358851,107.77470000000007,107.28590000000005,104.26440000000011,107.82449999999999,107.82449999999999,111.00530791624317,104.6436920837568,25056031,66.58563222933776,64.12727808025197,NaN,NaN,NaN,NaN,NaN,NaN,0.12222776119276424,1.49929345001091,1.3770656888181458,99.04306220095712,83.34437831005329,4576333300,11811822176.579874,32.97435461532893,14.979400232456872,29.708926531874333,100,0
2016-04-07,110.04,110.225,108.61,109.08,106.696279790236,106.6083711821341,106.47070764058823,108.00792793467532,107.76660000000007,107.24530000000004,104.38300000000012,108.03749999999998,108.03749999999998,110.94368564445566,105.1313143555443,28567202,57.6854562882421,63.71319172672161,NaN,NaN,NaN,NaN,NaN,NaN,0.02487316339404777,1.4081571430607056,1.3832839796666578,61.00478468899526,74.02490297227136,4547766098,11799882324.35077,29.594262134826483,15.33481165938772,30.46157239778444,92.85714285714286,35.714285714285715
2016-04-08,109.77,110.02,108.615,109,106.71920237938788,106.6557301686265,106.56989557625144,108.10241098851577,107.75765000000007,107.21490000000006,104.5514000000001,108.25449999999998,108.25449999999998,110.73670446378803,105.77229553621193,22897951,57.270666697473295,63.33104895858467,NaN,NaN,NaN,NaN,NaN,NaN,-0.05516725386265775,1.3143249123383356,1.3694921662009933,59.09090909090917,73.04625199362049,4524868147,11789533428.347212,27.522082690132223,14.261073738027394,31.275412571206026,85.71428571428571,28.571428571428573
2016-04-11,109.48,110.02,108.585,108.6,106.73791678357307,106.69423056132698,106.64950751443766,108.14980041818093,107.74955000000007,107.20250000000006,104.6834000000001,108.35999999999999,108.35999999999999,110.709042358077,106.01095764192297,25772058,55.13589880008155,62.691403084632945,NaN,NaN,55.13589880008155,NaN,NaN,NaN,-0.14045554234484836,1.193922738269933,1.3343782806147813,49.52153110047839,56.53907496012757,4499096089,11764300159.016201,25.554018285915596,13.390780181317002,31.89960908266641,78.57142857142857,21.428571428571427
2016-04-12,108.66,109.72,108.015,109.51,106.76549970114945,106.74998837199377,106.76168369034207,108.27934323549704,107.74710000000009,107.18340000000003,104.79100000000011,108.50199999999998,108.50199999999998,110.76708807776838,106.23691192223158,28564087,58.89020602396026,62.23730425378975,NaN,NaN,NaN,NaN,NaN,NaN,-0.1406408756351616,1.1585771860708292,1.2992180617059907,71.29186602870836,59.96810207336526,4527660176,11785827931.329985,23.411862091916756,15.070729796711019,31.55405690455705,71.42857142857143,14.285714285714286
2016-04-13,110.32,111.08,110.21,110.91,106.80673851009324,106.83236483987508,106.92436276130904,108.5298819749735,107.75530000000008,107.17760000000006,104.92100000000009,108.71599999999998,108.71599999999998,111.04113569497473,106.39086430502523,25356728,63.89584323508415,62.539458738404484,NaN,NaN,NaN,NaN,NaN,NaN,-0.05588440557716412,1.2293625547345357,1.2852469603116998,96.26373626373622,72.35904446430762,4553016904,11801275133.444927,28.26333524048044,13.9140689463568,32.26565144394797,100,7.142857142857143
2016-04-14,110,111.33,110,110.92,106.84766648511719,106.91330811037261,107.0810544177283,108.75751226307126,107.7764500000001,107.15050000000005,105.0964000000001,108.883,108.883,111.33414748639007,106.43185251360993,17199671,63.929628034027736,62.83510705036322,NaN,NaN,NaN,NaN,NaN,NaN,-0.010910313832485752,1.2716090680210925,1.2825193818535783,91.0869565217392,86.21418627139455,4570216575,11807870496.008837,27.643894664368474,13.003586503097928,33.593922832152735,100,0
2016-04-15,110.83,111.055,110.36,110.64,106.88540114695682,106.98710398937513,107.22062091115072,108.93679680944543,107.79430000000009,107.11980000000005,105.2760000000001,109.03899999999999,109.03899999999999,111.52025693954562,106.55774306045436,21353343,62.17524526045948,63.07546949727216,NaN,NaN,NaN,NaN,NaN,NaN,-0.011710918002247883,1.2678807343507685,1.2795916523530164,85.00000000000003,90.7835642618251,4548863232,11803722724.346966,26.662080469891063,12.541744712609827,34.71546252332946,92.85714285714286,7.142857142857143
2016-04-18,110.33,111.265,110.25,111.23,106.92863098629059,107.07112173215978,107.37785146365461,109.15519711330776,107.8108500000001,107.08730000000006,105.46760000000012,109.232,109.232,111.76392100983281,106.70007899016719,17126086,64.39262847881639,62.97880298331721,NaN,NaN,NaN,NaN,64.39262847881639,NaN,0.014387813297937813,1.2975764189754386,1.2831886056775008,96.9834087481148,91.0234550899513,4565989318,11819667700.967655,26.346114254673004,11.878234093105236,35.13338565646198,85.71428571428571,0
2016-04-19,111.44,111.44,109.88,110.55,106.96466450881506,107.14001041073088,107.50224944547207,109.28803548346893,107.82385000000009,107.05130000000004,105.71620000000011,109.36999999999998,109.36999999999998,111.87319795462805,106.8668020453719,42481435,60.02506843730381,62.44068626746262,NaN,NaN,NaN,NaN,NaN,NaN,-0.02510283746219577,1.251810058849756,1.2769128963119518,74.01459854014595,85.33266909608687,4523507883,11813676729.365091,24.224852317401414,12.83151075998161,34.46102722311837,100,64.28571428571429
2016-04-20,110.54,111.15,110.17,110.64,107.00123501121492,107.20931713527087,107.62529848682611,109.41679400885285,107.83855000000011,107.01720000000005,105.99660000000011,109.49600000000001,109.49600000000001,111.98850396188651,107.00349603811351,18078307,60.407831743641324,62.01153004898704,NaN,NaN,NaN,NaN,NaN,NaN,-0.0544366614682501,1.2088670694766392,1.2633037309448893,76.64233576642341,82.546781018228,4541586190,11812938839.283459,22.973468707913657,12.168673189720245,33.90088429350965,92.85714285714286,57.142857142857146
2016-04-21,110.58,111.05,110.15,110.65,107.03754113050631,107.2774494692259,107.74391423244077,109.53424219848591,107.8519500000001,106.98220000000003,106.28320000000011,109.667,109.667,111.97676275838501,107.357237241615,20215983,60.4531420216287,61.30577494120054,NaN,NaN,NaN,NaN,NaN,NaN,-0.08084799665155495,1.1622437351304455,1.2430917317820005,76.93430656934328,75.86374695863749,4561802173,11815185059.616793,21.856817922515155,11.685214969893002,32.964396028687965,85.71428571428571,50
2016-04-22,109.21,109.72,108.12,108.98,107.0568690794565,107.31116334112242,107.79238818410977,109.48145722720155,107.8664000000001,106.92890000000003,106.52900000000012,109.753,109.753,111.8123892298502,107.6936107701498,39073996,50.13444607481776,60.081540768634135,NaN,NaN,NaN,NaN,NaN,NaN,-0.21107245290124754,0.979251165655441,1.1903236185566886,28.175182481751946,60.583941605839506,4522728177,11818115609.316793,19.053185389548418,20.47855568239789,30.102524637317366,78.57142857142857,42.857142857142854
2016-04-25,108.62,108.99,108.45,108.98,107.0760047105067,107.34420961159525,107.83896119649762,109.4336993960395,107.8811500000001,106.87850000000005,106.7776000000001,109.84649999999999,109.84649999999999,111.55779512359327,108.13520487640672,14351890,50.13444607481776,59.36543852854941,NaN,NaN,NaN,NaN,NaN,NaN,-0.29248180566743165,0.8247213614723989,1.1172031671398306,28.175182481751946,44.42822384428235,4522728177,11831935947.835312,18.507503038335624,19.892050791706858,28.345921116773752,71.42857142857143,35.714285714285715
2016-04-26,109.2,109.39,108.12,108.45,107.08967630542702,107.3661064509696,107.86292350251732,109.34001373927383,107.88515000000012,106.81140000000003,106.98620000000011,109.82749999999999,109.82749999999999,111.59115387761612,108.06384612238385,19118334,47.17091809548772,57.978673233274414,NaN,NaN,NaN,NaN,NaN,NaN,-0.3721839211065314,0.6519732657566664,1.0241571868631978,12.700729927007377,23.01703163017038,4503609843,11822753125.992792,19.385949263245646,18.54670558131706,25.82355075852831,64.28571428571429,28.571428571428573
2016-04-27,107.34,107.83,106.69,107.58,107.09455514815909,107.37034196679198,107.85182846320292,109.17239338315251,107.87535000000011,106.74270000000003,107.1332000000001,109.73849999999997,109.73849999999997,111.74980082286184,107.7271991771381,33059790,42.708081922939726,56.908860778609956,NaN,NaN,NaN,NaN,NaN,NaN,-0.4674875799276309,0.43979771195365913,0.90728529188129,18.736842105263168,19.870918171340787,4470550053,11841313008.098055,17.608600530698638,24.29548885461599,24.696401653941702,57.142857142857146,100
2016-04-28,107.69,108.3335,106.0705,106.28,107.08645012180925,107.3487510367565,107.7901881313126,108.8969273466618,107.8554500000001,106.68040000000002,107.20880000000012,109.59249999999997,109.59249999999997,112.10134734490761,107.08365265509234,29818155,37.06507839816959,55.46560447151683,NaN,NaN,NaN,NaN,NaN,NaN,-0.5939501052951381,0.1648476602623674,0.7587977655575056,3.9016668218643353,11.779746284711583,4440731898,11817015757.62523,15.624967751811914,24.642418637397522,24.028990275509237,50,100
2016-04-29,106.22,106.495,104.88,105.72,107.07285360318429,107.31649854097914,107.70900428302583,108.59436283745592,107.83215000000011,106.58620000000002,107.29660000000013,109.36049999999997,109.36049999999997,112.35390257901359,106.36709742098635,67502786,34.92436684043791,54.021923617256576,NaN,NaN,NaN,NaN,NaN,NaN,-0.6847342263583889,-0.09712001739048048,0.5876142089679084,12.804878048780536,11.814462325302637,4373229112,11819732588.021515,14.379973946876328,28.552524101608885,24.1560791259715,42.857142857142854,100
2016-05-02,105.97,106.87,105.5525,106.72,107.06934262205807,107.30468668868252,107.67021980133855,108.41585209103154,107.8060500000001,106.50720000000003,107.39840000000011,109.19949999999999,109.19949999999999,112.39074724833968,106.0082527516603,24813813,41.429670239668006,52.774742489807124,NaN,NaN,NaN,NaN,NaN,NaN,-0.6472805578046079,-0.22148648828785156,0.42579406951675636,28.04878048780492,14.918441786149932,4398042925,11838896196.922844,15.301318664728031,26.684550506469634,24.54443451854882,35.714285714285715,92.85714285714286
2016-05-03,105.96,106.4399,105.45,105.73,107.0560158297988,107.27350477405514,107.59413275030566,108.16005665379043,107.7667500000001,106.41820000000001,107.44740000000013,109.04199999999999,109.04199999999999,112.57355829628146,105.51044170371851,38569433,37.43943650803097,50.88499915216047,NaN,NaN,NaN,NaN,NaN,NaN,-0.6569351779670354,-0.3953749029420379,0.26156027502499746,12.957317073170858,17.936991869918774,4359473492,11822146020.898296,14.328221319431874,25.500801103010684,24.118015665299502,28.571428571428573,85.71428571428571
2016-05-04,105.12,105.4811,104.7902,105.05,107.03605547328338,107.2294749765491,107.49436283852897,107.86386078200087,107.7221000000001,106.33980000000001,107.51680000000013,108.761,108.761,112.60979149864274,104.91220850135726,27474504,34.94951094717031,48.81499078881351,NaN,NaN,NaN,NaN,NaN,NaN,-0.674329485776792,-0.5813515821959925,0.09297790358079946,3.906884417576446,14.970993992850742,4331998988,11815334061.808413,13.63708248175314,27.657230262062843,23.97044526420053,21.428571428571427,100
2016-05-05,105.43,105.66,104.81,105.02,107.01599521981788,107.18572299681546,107.39732900172392,107.59301689800078,107.6776500000001,106.256,107.56620000000014,108.55799999999999,108.55799999999999,112.73256872024236,104.38343127975763,20788119,34.83942672314767,46.86243232186266,NaN,NaN,34.83942672314767,NaN,NaN,NaN,-0.6526446267206982,-0.7228278798200733,-0.07018325309937512,3.4557430298655203,6.773314840204276,4311210869,11804817719.25547,13.969602929833833,26.41612041565711,23.599113299847396,14.285714285714286,92.85714285714286
2016-05-06,104.51,105.6,104.4,105.58,107.00170671016795,107.153926501829,107.32606119773475,107.40130100295309,107.64245000000011,106.20389999999999,107.60660000000014,108.38699999999999,108.38699999999999,112.75102153982272,104.02297846017726,30758516,38.71964965214905,45.02864811995784,NaN,NaN,NaN,NaN,NaN,NaN,-0.568462528333462,-0.7807614135162027,-0.21229888518274062,16.76136363636355,8.041330361268505,4341969385,11834550951.388803,13.077387879984729,26.91113477250287,23.36656950443695,7.142857142857143,100
2016-05-09,105.61,106.37,105.54,105.88,106.99054544937026,107.12870023446605,107.26935291547063,107.25641519314803,107.6108500000001,106.14640000000001,107.65560000000013,108.25099999999998,108.25099999999998,112.7475137606863,103.75448623931365,19289615,40.755010059937035,43.652215378717365,NaN,NaN,NaN,NaN,NaN,NaN,-0.46481828731035035,-0.7933217443206786,-0.32850345701032824,21.925925925925775,14.047677530718282,4361259000,11831064876.388803,16.696536296053637,25.689013135333933,22.685849764193723,0,92.85714285714286
2016-05-10,106.26,107.38,106.07,107.33,106.99392310659046,107.13268636843702,107.271731232511,107.26342326999108,107.59200000000011,106.09660000000002,107.75220000000014,108.14199999999998,108.14199999999998,112.61678982747061,103.66721017252935,21178851,49.487710577743755,42.87220672401039,NaN,NaN,NaN,NaN,49.487710577743755,NaN,-0.2799590264156901,-0.6784522400299409,-0.3984932136142508,44.06015037593979,27.582479979409708,4382437851,11850627021.205597,20.80863767281659,23.60286566033233,20.93911386039139,0,85.71428571428571
2016-05-11,107.16,107.49,106.33,106.36,106.98761541398757,107.11738564826994,107.23597706653018,107.17738295856336,107.57290000000012,106.02040000000001,107.76360000000014,107.91449999999998,107.91449999999998,112.26415044573014,103.56484955426981,20966257,44.73706292917059,41.74962964597767,NaN,NaN,NaN,NaN,NaN,NaN,-0.20768705557113176,-0.6581020330781655,-0.45041497750703374,36.842105263157826,34.27606052167446,4361471594,11830745225.774563,20.09117461998628,22.10768952660649,19.11437494493168,0,78.57142857142857
2016-05-12,106.68,106.735,105.14,105.89,106.97669386757973,107.09308098196757,107.18319365215645,107.0547750577478,107.54670000000011,105.9561,107.76480000000012,107.66299999999998,107.66299999999998,111.86770736199819,103.45829263800178,29196323,42.6030036262866,41.21166947108259,NaN,NaN,NaN,NaN,NaN,NaN,-0.17738904036789627,-0.6721512779669041,-0.49476223759900784,29.859719438877683,36.920658359325095,4332275271,11829006259.827854,18.368190125411658,26.610038536797276,20.165692732054712,0,71.42857142857143
2016-05-13,105.85,106.449,105.29,105.5,106.96200039626052,107.06153482390881,107.11718605795423,106.90670124272421,107.51645000000012,105.9128,107.76220000000013,107.40599999999999,107.40599999999999,111.47767975165397,103.33432024834602,21059255,40.86119086755825,40.54929409913548,NaN,NaN,NaN,NaN,NaN,NaN,-0.1694780408015254,-0.7066097886009146,-0.5371317477993892,22.044088176352613,29.581970959462705,4311216016,11815578486.36366,17.21303346646804,24.936560474960263,21.21701051917775,7.142857142857143,64.28571428571429
2016-05-16,105.67,107.21,105.56,106.82,106.96058745699425,107.05675195610864,107.10553170274034,106.89844398151239,107.49015000000013,105.8705,107.78520000000013,107.1855,107.1855,110.86356729139403,103.50743270860598,18311860,48.53125252919335,40.64646084440017,NaN,NaN,NaN,NaN,NaN,NaN,-0.06649901673227121,-0.6202555187147283,-0.5537565019824571,61.522816829795104,37.808874815008465,4329527876,11825233830.727297,19.692229137268857,22.67115700068788,21.56125255431297,0,57.142857142857146
2016-05-17,106.74,107.04,105.2,105.48,106.94585524349182,107.02552914509658,107.0417853614564,106.76335407851121,107.45780000000012,105.80750000000002,107.79440000000014,106.93199999999999,106.93199999999999,110.33624793457128,103.5277520654287,29932711,42.50458041088748,40.631925022110714,NaN,NaN,NaN,NaN,NaN,NaN,-0.07893494832926984,-0.6524251873940443,-0.5734902390647745,27.456463709164858,37.00778957177085,4299595165,11804411075.249037,17.816626310028674,22.375329185970244,21.231589940390815,7.142857142857143,50
2016-05-18,105.29,106.43,105.04,105.86,106.93505071370583,107.00244936004516,106.99544083747772,106.67732035674824,107.4291000000001,105.74,107.82860000000014,106.69299999999998,106.69299999999998,109.66628168864617,103.7197183113538,28177911,44.605391695925206,41.17051882909326,NaN,NaN,NaN,NaN,NaN,NaN,-0.05311253561438334,-0.6398809085827537,-0.5867683729683704,47.24919093851129,45.40949049249042,4327773076,11809479044.853354,16.535354779738608,21.594012748441838,20.579672783959264,0,42.857142857142854
2016-05-19,105.45,105.705,104.54,105.31,106.918881054863,106.9689355113314,106.92934511836094,106.54709937039127,107.39870000000012,105.66720000000001,107.83840000000015,106.426,106.426,108.83560909693384,104.01639090306617,27334610,42.20186361815821,41.69034002750185,NaN,NaN,NaN,NaN,NaN,NaN,-0.06389356055432938,-0.6666353236612821,-0.6027417631069527,29.44983818770226,34.7184976117928,4300438466,11818277739.059362,15.402557109290505,22.709643805480408,19.591196005329515,57.142857142857146,35.714285714285715
2016-05-20,105.74,106.9,105.67,106.47,106.91441457670516,106.95905560021592,106.91133158430758,106.53975657321115,107.36980000000011,105.60660000000001,107.87460000000014,106.30049999999999,106.30049999999999,108.40739795672073,104.19360204327924,29549578,48.50435586985358,42.19567471537225,NaN,NaN,NaN,NaN,NaN,NaN,0.012222079529298213,-0.5874641636953299,-0.5996862432246282,66.99029126213594,47.89644012944982,4329988044,11827166636.506517,20.279450458725428,20.85619033527125,17.754766681366938,50,28.571428571428573
2016-05-23,106.55,106.97,106.23,106.33,106.90859950629017,106.94659905367699,106.8885342672759,106.51977975671485,107.34920000000011,105.52690000000003,107.87140000000014,106.16799999999998,106.16799999999998,107.88060736890696,104.45539263109299,15729764,47.82652392576644,42.937609530924775,NaN,NaN,NaN,NaN,NaN,NaN,0.05582193859875417,-0.5299088199761854,-0.5857307585749396,62.45954692556632,52.9665587918015,4314258280,11815688160.074085,19.85423808990434,20.036567648187205,15.783746564654521,42.857142857142854,21.428571428571427
2016-05-24,106.92,108.59,106.885,108.46,106.9240363271231,106.97656738924775,106.95016037444155,106.70456263702772,107.3399500000001,105.4788,107.90720000000012,106.1685,106.1685,107.88377577958305,104.45322422041694,29931309,57.54697070563895,44.551713799386825,NaN,NaN,NaN,NaN,NaN,NaN,0.22149482678252075,-0.30886222509678873,-0.5303570518793095,96.89737470167042,75.44907096312421,4344189589,11841055163.889334,25.786314377335195,17.743206273275753,14.678432269844203,100,14.285714285714286
2016-05-25,108.86,109.57,108.684,109.24,106.94708074177859,107.02138783698541,107.03995800681639,106.9460328620727,107.32830000000011,105.45260000000002,107.95940000000013,106.2515,106.2515,108.34982576117841,104.15317423882158,38464750,60.452686433563066,46.38123235013078,NaN,NaN,NaN,NaN,NaN,NaN,0.3683372004396256,-0.06993555132977747,-0.43827275176940306,93.61702127659576,84.32464763461083,4382654339,11850866714.115067,29.354231261494547,16.73033769840904,14.433702536880944,100,7.142857142857143
2016-05-26,109.35,109.7,109.09,109.56,106.97307993837781,107.07165738476787,107.13878318301967,107.19498211330387,107.3254000000001,105.45320000000001,107.99900000000012,106.4155,106.4155,108.9619600919764,103.8690399080236,21885871,61.61350139727393,48.01650747478256,NaN,NaN,NaN,NaN,NaN,NaN,0.4654836121836065,0.1435817634601051,-0.3219018487235014,97.28682170542635,95.93373922789749,4404540210,11862706611.541296,29.091393617127164,16.183589465436793,13.999095388961866,100,0
2016-05-27,109.65,110.14,109.61,110.13,107.00449207829445,107.13221862467346,107.2560858032934,107.47450762632255,107.32345000000011,105.46140000000001,108.05120000000014,106.636,106.636,109.62811229736015,103.64388770263984,19870010,63.65968347704497,49.65255557600455,NaN,NaN,NaN,NaN,NaN,NaN,0.5412824669853554,0.35470123500819284,-0.18658123197716256,99.82142857142847,96.90842385115019,4424410220,11881826809.843182,30.605806202574005,15.659572410271345,14.791205158844352,100,57.142857142857146
2016-05-31,110.28,110.51,109.7837,110.34,107.03768121184376,107.19573904794724,107.37702361492896,107.74741166191087,107.32345000000012,105.4822,108.11060000000012,106.81699999999998,106.81699999999998,110.21761817910082,103.41638182089913,24366106,64.41233576068669,50.718600231929045,NaN,NaN,NaN,NaN,NaN,NaN,0.5755195342394283,0.5328181858221228,-0.04270134841730547,97.15242881072025,98.08689302919169,4448776326,11894786505.213964,31.456700695786317,15.00439084164216,16.87115266600886,100,50
2016-06-01,110,110.6,109.91,110.35,107.07063960774582,107.25819966085918,107.49361092414743,107.99527721791937,107.32265000000012,105.537,108.16180000000013,107.048,107.048,110.73729044668708,103.35870955331292,19571528,64.45009380794482,52.12667386612721,NaN,NaN,NaN,NaN,NaN,NaN,0.5678364564070268,0.6670942220914782,0.09925776568445127,95.87458745874588,97.61614828029819,4468347854,11900175766.547298,30.700867448566484,14.38848466375949,19.113960138926764,100,42.857142857142854
2016-06-02,110.13,110.59,109.53,110.58,107.10555861662397,107.32397788539662,107.61464578986714,108.24144129240324,107.31840000000011,105.6027,108.21100000000013,107.32449999999999,107.32449999999999,111.19769751626875,103.45130248373123,15696618,65.36041620056906,53.75220333571882,NaN,NaN,NaN,NaN,65.36041620056906,NaN,0.54702707529248,0.7830416098000512,0.23601453450757126,99.66996699669974,97.56566108872194,4484044472,11915576221.943525,28.74853670182874,15.753206182174509,19.89094315270521,92.85714285714286,35.714285714285715
2016-06-03,110.37,110.42,109.34,110.06,107.13495604332422,107.37815654113133,107.71054203340177,108.4146373597934,107.31440000000012,105.66000000000003,108.26760000000013,107.57649999999998,107.57649999999998,111.47292028020995,103.68007971979002,20269923,61.524533757418936,55.228156399280294,NaN,NaN,NaN,NaN,NaN,NaN,0.4699712105032775,0.8234785476366682,0.35350733713339066,91.0891089108912,95.5445544554456,4463774549,11922332862.943525,26.616229456887986,15.72126626252039,20.420194529544712,85.71428571428571,28.571428571428573
2016-06-06,110.25,110.75,110.07,110.46,107.16804105781851,107.43918314427725,107.81836391444483,108.60943380171784,107.3160500000001,105.70920000000002,108.33160000000012,107.8205,107.8205,111.79663618982303,103.84436381017696,12502365,63.30838501457402,56.28366586252177,NaN,NaN,NaN,NaN,NaN,NaN,0.4193416264414192,0.8776843701851647,0.45834274374374545,95.33011272141697,95.36306287633596,4476276914,11924171446.031761,27.518833583939468,15.05223395943814,22.009648936051523,100,21.428571428571427
2016-06-07,110.53,110.63,110.13,110.18,107.19801079853674,107.49345674538067,107.91097709427052,108.75901153488758,107.33155000000012,105.792,108.39300000000011,108.03549999999998,108.03549999999998,112.0336369411298,104.03736305887017,12184296,61.17042790021092,57.616940683187735,NaN,NaN,NaN,NaN,NaN,NaN,0.3435778338485167,0.8878150360543913,0.5442372022058746,90.82125603864743,92.41349255698519,4464092618,11914424009.231762,26.634315530166862,14.568420841192372,23.29121183272966,92.85714285714286,14.285714285714286
2016-06-08,110.37,110.6,109.96,110.37,107.22957288014334,107.55041799794739,108.00740936508345,108.91243900775542,107.37140000000012,105.855,108.4238000000001,108.1875,108.1875,112.29640678891828,104.07859321108172,14568699,62.10560315441456,58.86695578736555,NaN,NaN,NaN,NaN,NaN,NaN,0.2852432880926383,0.9007913123216724,0.6155480242290341,93.88083735909828,93.34406870638755,4478661317,11918521455.825512,25.504299180691188,15.077294648405747,24.17884286156173,85.71428571428571,7.142857142857143
2016-06-09,109.93,110.31,109.71,110.19,107.25902986641057,107.60268694848308,108.09300115468801,109.03411148320728,107.43005000000012,105.94850000000002,108.44040000000012,108.37899999999999,108.37899999999999,112.48636850063706,104.27163149936293,17571631,60.6161650976365,60.18226303589971,NaN,NaN,NaN,NaN,NaN,NaN,0.2166283871105017,0.8863335081171613,0.6697051210066596,88.97637795275585,91.22615711683385,4461089686,11929064434.425512,24.35664940432416,16.103322786692846,24.266427120431597,78.57142857142857,0
2016-06-10,109.2,109.4,108.56,108.94,107.27575593739157,107.62916839504777,108.12621679568063,109.02514848480659,107.48430000000013,106.02730000000001,108.43520000000011,108.53150000000001,108.53150000000001,112.4813570860237,104.58164291397631,32965003,51.39771938138132,60.38893185815169,NaN,NaN,NaN,NaN,NaN,NaN,0.07638822492782382,0.7651904021664393,0.6888021772386155,59.95575221238929,80.93765584141447,4428124683,11925924910.330275,21.753208859831076,21.923264389770754,24.194092011777354,71.42857142857143,0
2016-06-13,108.34,108.93,107.89,108.03,107.28326085343743,107.63710565455177,108.12244358800689,108.93037243863454,107.50930000000011,106.10010000000003,108.38860000000011,108.65800000000002,108.65800000000002,112.36605393704066,104.94994606295937,25412177,45.92239517655462,60.252922661779415,NaN,NaN,NaN,NaN,NaN,NaN,-0.0798697408443344,0.5889650011831975,0.6688347420275319,29.624838292367336,59.51898948583749,4402712506,11907354473.291813,20.25153878811561,24.81476157494706,24.88469951283813,64.28571428571429,0
2016-06-14,107.78,108.415,107.24,108.03,107.29069109370172,107.64488574060026,108.11881834926152,108.8446226825741,107.52125000000011,106.17190000000002,108.35040000000012,108.71850000000002,108.71850000000002,112.34317253693307,105.09382746306697,24588506,45.92239517655462,59.4225958382734,NaN,NaN,NaN,NaN,NaN,NaN,-0.17971994145067682,0.44418481521418585,0.6239047566648627,22.507122507122652,37.36257100395975,4402712506,11915829660.46628,18.696157716001167,27.15759325872689,24.88296588534858,57.142857142857146,0
2016-06-15,108.32,108.44,107.54,107.72,107.29496282411266,107.64637315167748,108.10317841399636,108.73751576042419,107.5317500000001,106.21140000000003,108.3272000000001,108.8305,108.8305,112.17563064020104,105.48536935979897,24605701,44.06768565343019,58.252238639692486,NaN,NaN,NaN,NaN,NaN,NaN,-0.2583543928239854,0.30096176563488086,0.5593161584588663,13.675213675213769,21.93572482490124,4378106805,11901066239.86628,17.747762273711192,25.539580761846224,24.212061400892086,50,92.85714285714286
2016-06-16,107.17,108.14,106.5,108.04,107.30237612934538,107.65416774273338,108.10070082913376,108.67108568800283,107.5504000000001,106.26950000000002,108.2746000000001,108.93950000000002,108.93950000000002,112.02212534213822,105.85687465786182,32079929,46.47101530281417,57.17063249008822,NaN,NaN,NaN,NaN,NaN,NaN,-0.2787751055910319,0.2108472764700764,0.4896223820611083,36.23529411764721,24.13921009999453,4410186734,11929233982.402864,15.889960276123402,29.504269309691335,24.317881639698708,42.857142857142854,100
2016-06-17,107.53,107.6819,106.24,106.49,107.29429278477477,107.6311149161446,108.03753609073635,108.46336324152637,107.57760000000012,106.30290000000005,108.22280000000012,108.9985,108.9985,111.8364589496692,106.16054105033082,29208832,37.962212261281806,55.33509883181942,NaN,NaN,NaN,NaN,NaN,NaN,-0.38034173376331176,0.014195214856968619,0.3945369486202804,5.543237250554317,18.48458168113842,4380977902,11910153741.844711,14.140393014712513,27.846104274099105,24.342003148814552,35.714285714285715,100
2016-06-20,107.73,108.24,107.08,107.16,107.2929565381601,107.62178590790411,108.00312291070748,108.33923340900004,107.5939000000001,106.36870000000003,108.18600000000009,109.03300000000002,109.03300000000002,111.76184664281531,106.30415335718472,20562769,42.83465688777974,53.793836055183206,NaN,NaN,NaN,NaN,NaN,NaN,-0.3849026697525991,-0.08659138857046855,0.29831128118213057,20.399113082039925,20.7258814834138,4401540671,11892427216.844711,15.97522970424689,24.96779029520636,23.38147867397148,28.571428571428573,92.85714285714286
2016-06-21,107.33,107.715,107.1,107.5,107.29501667210876,107.6193743057674,107.98339260048365,108.2593064176667,107.6144500000001,106.42370000000003,108.16400000000009,109.09150000000002,109.09150000000002,111.62954865989605,106.553451340104,22804112,45.187323641954315,52.417923900469596,NaN,NaN,NaN,NaN,NaN,NaN,-0.34860578341065934,-0.1374459480811936,0.21115983532946575,27.937915742793873,17.960088691796027,4424344783,11899286990.373167,15.373810894244968,24.02782892966001,22.366171107785885,21.428571428571427,85.71428571428571
2016-06-22,107.58,108.19,107.15,107.24,107.29446924253554,107.61186194327695,107.95423994948429,108.16222961598416,107.63985000000011,106.45480000000003,108.1186000000001,109.0305,109.0305,111.68241609973079,106.37858390026922,22724174,43.70600718397148,50.87118039928406,NaN,NaN,NaN,NaN,NaN,NaN,-0.3260988035333734,-0.196463669087251,0.1296351344461224,22.17294900221727,23.503325942350344,4401620609,11880495846.488552,17.31785390759377,22.486170035606374,21.20778253090277,14.285714285714286,78.57142857142857
2016-06-23,108.09,108.79,107.62,108.77,107.30915114061976,107.63479537014275,107.98623053970059,108.22011250969996,107.65850000000012,106.49840000000002,108.07580000000009,109.00700000000002,109.00700000000002,111.65940343839297,106.35459656160707,18714227,53.38923640087529,50.29008773095951,NaN,NaN,NaN,NaN,53.38923640087529,NaN,-0.19843805957955585,-0.11841244002832241,0.08002561955123344,56.09756097560972,35.40280857354028,4420334836,11898570270.856073,19.315123119753384,20.38672605474096,19.562462724224364,7.142857142857143,71.42857142857143
2016-06-24,104.81,106.5,104.06,104.29,107.27910983573797,107.56856179845676,107.84128032245742,107.84581608020473,107.66065000000012,106.51980000000003,107.94320000000009,108.74350000000001,108.74350000000001,112.08211812731105,105.40488187268897,68012733,34.61411769211763,48.240497207926914,NaN,NaN,NaN,NaN,NaN,NaN,-0.39465303968343973,-0.41329068005306624,-0.018637640369626507,3.5007610350076743,27.257090337611544,4352322103,11843379610.470827,14.79478157124243,33.304578817228645,20.219477830135506,0,100
2016-06-27,103.6,103.6,101.75,102.22,107.22877043438734,107.46264968363583,107.62083795687086,107.31002407256618,107.64680000000011,106.52540000000003,107.7748000000001,108.34800000000003,108.34800000000003,112.66626631878992,104.02973368121013,50044303,29.459147363288906,45.97540574100391,NaN,NaN,29.459147363288906,NaN,NaN,NaN,-0.6288810717161875,-0.8047389800148608,-0.17585790829867337,5.310734463276827,21.636352157964726,4302277800,11818763223.589746,13.024535976628457,40.201435799876236,21.774853842991142,0,100
2016-06-28,103.33,104.51,103.3,104.46,107.20122047981633,107.40319127405888,107.49688352718965,107.03859320851225,107.64125000000011,106.55350000000004,107.6394000000001,108.05400000000002,108.05400000000002,112.58515614385627,103.52284385614377,28260604,39.89127262879807,44.38866784631701,NaN,NaN,NaN,NaN,NaN,NaN,-0.5981688495540034,-0.9235689702411776,-0.3254001206871742,31.658878504672817,13.49012466765243,4330538404,11844688240.482307,15.804949042666372,36.01715502604613,22.725506249389237,0,92.85714285714286
2016-06-29,105.26,106.53,105.231,106.31,107.19235261434552,107.38154392209732,107.450339075143,106.96920337913014,107.6465500000001,106.63540000000005,107.55460000000011,107.852,107.852,112.31542290176702,103.38857709823299,31356723,46.87858440006711,43.40741208220492,NaN,NaN,NaN,NaN,NaN,NaN,-0.4265327353270123,-0.8585660398459396,-0.4320333045189273,59.60784313725489,32.19248536840151,4361895127,11865423748.60933,23.328621522851005,32.70359877820758,22.463553323231338,0,85.71428571428571
2016-06-30,106.52,107.61,106.13,107.54,107.19581179231224,107.3846816662142,107.45385518984328,107.02356496207013,107.6518000000001,106.74460000000005,107.4926000000001,107.7,107.7,111.98495040811639,103.41504959188362,36300819,50.96026285217663,43.37616518726173,NaN,NaN,NaN,NaN,NaN,NaN,-0.21416050161071548,-0.6997339315323217,-0.4855734299216062,80.6406685236769,57.30246338853487,4398195946,11898290706.352573,26.612653769076044,30.540217249029066,22.926601831156212,0,78.57142857142857
2016-07-01,107.49,108.48,107.45,108.08,107.20460968492606,107.39845034609115,107.4784098882808,107.12417782282535,107.6567500000001,106.86220000000003,107.4412000000001,107.60100000000003,107.60100000000003,111.75269314858278,103.44930685141728,19902803,52.679332005043115,43.85880353215377,NaN,NaN,NaN,NaN,NaN,NaN,-0.03093463373900973,-0.5242417220953683,-0.4933070883563586,89.91477272727262,76.72109479606813,4418098749,11902735021.585583,29.34547523641925,29.097587932997566,22.233642913138823,0,71.42857142857143
2016-07-05,107.58,107.66,106.84,107.42,107.20675287214073,107.39887707191113,107.47611930442665,107.15235136350864,107.6582000000001,106.96950000000004,107.4100000000001,107.449,107.449,111.38802475239982,103.50997524760018,21167903,50.35589760793625,44.175482277252456,NaN,NaN,NaN,NaN,NaN,NaN,0.047907163626551785,-0.4334231338231689,-0.48133029744972067,80.53977272727269,83.6984046594074,4396930846,11911511956.975826,27.652001936669684,30.25728877913022,21.236915516441154,50,64.28571428571429
2016-07-06,106.92,108.35,106.57,108.3,107.21763095301495,107.41672109028913,107.50842835131188,107.26165123365068,107.67295000000009,107.08700000000005,107.3964000000001,107.35500000000002,107.35500000000002,111.114486667087,103.59551333291304,24579270,53.312636184501784,44.83583588661471,NaN,NaN,NaN,NaN,NaN,NaN,0.15536004271924997,-0.28713024405065823,-0.4424902867699082,93.0397727272726,87.8314393939393,4421510116,11934710369.110659,28.56212884497052,27.779079086061614,20.050459187252383,42.857142857142854,57.142857142857146
2016-07-07,108.39,108.86,108.11,108.62,107.23158487388046,107.44054839543192,107.55201939635847,107.39101778282681,107.68765000000009,107.19300000000003,107.3998000000001,107.26750000000001,107.26750000000001,110.81786829075602,103.717131709244,19161748,54.37673896679169,45.400530434041684,NaN,NaN,NaN,NaN,NaN,NaN,0.2390209473688839,-0.14371410255880335,-0.38273504992768725,96.62447257383974,90.06800600946167,4440671864,11941608598.39066,29.97531574207384,26.783664540897657,18.309879785988944,100,50
2016-07-08,109.17,110.36,109.02,110.3,107.2621163676727,107.49717119948276,107.65978334159932,107.66806370827187,107.71865000000008,107.29370000000003,107.45420000000011,107.273,107.273,110.84175384413285,103.70424615586714,29457871,59.584766860206656,46.94499861967917,NaN,NaN,NaN,NaN,NaN,NaN,0.38963110620393177,0.10430383282722744,-0.2853272733767043,99.30313588850173,96.32246039653802,4470129735,11968428451.092152,34.59594059591014,24.582814693310826,17.186808046034855,100,42.857142857142854
2016-07-11,110.68,111.335,110.66,110.93,107.29861272222323,107.5651480074138,107.78802713212484,107.97872430748407,107.7524000000001,107.37800000000003,107.54720000000012,107.37249999999999,107.37249999999999,111.22157196607543,103.52342803392455,20218504,61.36581117910749,48.268652497631145,NaN,NaN,NaN,NaN,NaN,NaN,0.5064119320283306,0.3476876416587089,-0.15872429036962168,95.77464788732408,97.23408544988852,4490348239,11964384750.292152,37.576613194137614,23.35354004723342,17.285354001974476,100,35.714285714285715
2016-07-12,111.59,111.79,111.34,111.49,107.34031806827076,107.64286784885115,107.93320253870817,108.31313151629512,107.7908500000001,107.47960000000005,107.66260000000011,107.54549999999999,107.54549999999999,111.78813349819781,103.30286650180217,21906145,62.92963789154348,49.535960658316085,NaN,NaN,NaN,NaN,NaN,NaN,0.5902458917469309,0.5790830743140418,-0.011162817432888994,97.01195219123495,97.36324532235358,4512254384,11957082701.958818,38.23321426502397,22.353305489589747,17.588689834336396,100,28.571428571428573
2016-07-13,111.79,111.82,111.21,111.22,107.37892186858647,107.7137021488739,108.06209655679805,108.58997613379081,107.83235000000009,107.57550000000005,107.75260000000011,107.705,107.705,112.23838946043908,103.17161053956092,21107762,61.634251366921006,50.81654952852677,NaN,NaN,NaN,NaN,NaN,NaN,0.5947207286293512,0.7322380933538,0.1375173647244488,94.0417080436942,95.60943604075106,4491146622,11936666997.729311,37.02198892962167,22.320300391482302,18.430831339781268,100,21.428571428571427
2016-07-14,111.96,112.19,111.7,111.98,107.42470374054083,107.79818329444076,108.21573982908048,108.91283554962025,107.8923000000001,107.66250000000004,107.87760000000013,107.91799999999998,107.91799999999998,112.8195532232182,103.01644677678176,20870986,63.88763231105503,51.566434950682456,NaN,NaN,NaN,NaN,NaN,NaN,0.6135969313080949,0.9045135288595674,0.29091659755147253,97.9885057471265,96.34738866068521,4512017608,11939648567.157883,37.07974416519243,21.171706296911015,20.188697785000045,100,14.285714285714286
2016-07-15,112.22,112.3,111.55,111.8,107.46823902670461,107.87742718960035,108.35629905146948,109.18780359251356,107.95395000000012,107.76470000000005,108.01260000000013,108.106,108.106,113.29202506743151,102.91997493256848,17999312,62.94467179133523,53.59004595776944,NaN,NaN,NaN,NaN,NaN,NaN,0.5791229938183164,1.014820339824368,0.43569734600605164,95.26066350710902,95.76362576597656,4494018296,11933648796.491217,35.55619647275272,21.12356274940104,19.2587729094113,100,7.142857142857143
2016-07-18,111.86,112.74,111.85,112.54,107.51870431002098,107.96975536406372,108.52036575533342,109.50706039322655,108.0078500000001,107.86460000000002,108.16300000000012,108.4085,108.4085,113.88011868189109,102.93688131810892,20713924,65.21757269167686,56.14421919551143,NaN,NaN,NaN,NaN,NaN,NaN,0.5704097150683878,1.1487094898415364,0.5782997747731486,97.8813559322035,97.04350839547966,4514732220,11945053091.727173,36.1474464750323,20.013630486580027,17.663650234072342,100,0
2016-07-19,112.17,112.48,111.93,112.13,107.56458784922475,108.05213644596344,108.66192003943799,109.75686416530021,108.0574000000001,107.95030000000004,108.29400000000012,108.65700000000001,108.65700000000001,114.32707618996572,102.9869238100343,18936702,62.91496159848618,57.78876840763201,NaN,NaN,NaN,NaN,NaN,NaN,0.5036090901068018,1.207811137406651,0.7042020472998491,91.87641496870422,95.00614480267224,4495795518,11939888536.636263,34.86708780571534,19.30473877231472,16.92969984939225,92.85714285714286,0
2016-07-20,112.75,113.65,112.6,113.44,107.62304966167028,108.15882681337011,108.84929572416591,110.1076390067002,108.1045500000001,108.05040000000004,108.44520000000013,108.95400000000002,108.95400000000002,114.96271167555945,102.9452883244406,24997929,66.93224767980058,59.221172927612976,NaN,NaN,NaN,NaN,NaN,NaN,0.5125207958023074,1.3448530420527334,0.832332246250426,97.20744680851054,95.65507256980608,4520793447,11954887294.036263,38.52192989930257,17.629092249084923,18.392334866997576,100,0
2016-07-21,113.52,113.74,112.87,113.18,107.67834269986261,108.25825598538259,109.0191272643947,110.40024481558589,108.14295000000011,108.15720000000005,108.56220000000013,109.25100000000002,109.25100000000002,115.47482808245876,103.02717191754128,18885367,65.41758723194694,60.25383895473942,NaN,NaN,NaN,NaN,NaN,NaN,0.4670584864639902,1.4161553543304137,0.9490968678664236,92.1896792189681,93.7578469987276,4501908080,11949460464.438562,37.09093084877603,16.73378321447353,20.60298905771914,100,0
2016-07-22,113.28,113.78,112.911,113.65,107.73776217548587,108.36502319359283,109.20073011677138,110.70974530933962,108.18620000000011,108.23580000000005,108.70800000000014,109.49500000000003,109.49500000000003,116.00052534389013,102.98947465610993,20003363,66.87680880045454,61.26794444012596,NaN,NaN,NaN,NaN,NaN,NaN,0.4354211811006219,1.493373344242201,1.0579521631415791,98.19694868238564,95.86469156995474,4521911443,11963478931.719345,35.40806143682683,15.866976243399424,23.29485880749765,100,14.285714285714286
2016-07-25,113.56,113.69,113.28,113.66,107.79668991503327,108.46987421946228,109.37560344552544,110.99072194654538,108.2263500000001,108.31410000000005,108.86340000000014,109.96350000000002,109.96350000000002,116.24799926406244,103.6790007359376,12968085,66.9088025586716,62.450294793749904,NaN,NaN,NaN,NaN,NaN,NaN,0.38375906191473597,1.537650990534999,1.1538919286202631,98.33564493758662,96.24075761298012,4534879528,11974549248.18276,34.50003894554907,15.460075365098538,25.69567440352581,92.85714285714286,7.142857142857143
2016-07-26,113.63,114.2,113.22,113.79,107.85632484125185,108.57522324481947,109.548717035897,111.2573198563982,108.2650500000001,108.39570000000005,109.02920000000015,110.542,110.542,115.93573191770096,105.14826808229904,21223845,67.35031216355628,63.45298593511094,NaN,NaN,NaN,NaN,NaN,NaN,0.32903744615487507,1.565188736313857,1.236151290158982,93.2676518883416,96.60008183610461,4556103373,11978014365.733782,35.58623493834959,14.50272487000753,28.602981196500934,100,0
2016-07-27,114.76,114.88,114.1,114.58,107.9232270816374,108.69412971521908,109.74602225017554,111.57376558436027,108.3053000000001,108.48480000000005,109.18440000000015,111.04800000000003,111.04800000000003,115.93994685171553,106.15605314828453,27646113,69.97223054483423,64.56694961925683,NaN,NaN,NaN,NaN,NaN,NaN,0.31663650995850845,1.6319469276071175,1.315310417648609,94.88054607508538,95.49461430033786,4583749486,11984394237.964552,37.436740154104484,13.501296393983866,31.557707491233025,100,0
2016-07-28,114.76,115.11,114.4,114.98,107.99344372759127,108.81860239412563,109.95127627958043,111.89816886204025,108.34625000000011,108.58440000000004,109.37440000000015,111.48150000000001,111.48150000000001,116.1486030629304,106.81439693706962,16939662,71.23193417830863,65.39889014197841,NaN,NaN,NaN,NaN,NaN,NaN,0.305800865847637,1.6975614999581552,1.3917606341105182,97.07865168539337,95.07561654960678,4600689148,11995130643.45751,37.20378134906936,12.877533479682231,33.818662118322855,100,0
2016-07-29,115.24,115.54,114.87,115.23,108.06544926264012,108.94556076255878,110.15828505293021,112.21548611327451,108.39190000000009,108.69520000000004,109.56180000000015,111.86600000000001,111.86600000000001,116.43695788648371,107.29504211351632,22385320,72.02193525075128,66.16004186138153,NaN,NaN,NaN,NaN,NaN,NaN,0.28624470725748674,1.7495665181823767,1.46332181092489,92.84064665127018,94.93328147058297,4623074468,11996801189.726166,38.41350312746766,12.300034087805027,35.829295356925535,100,0
2016-08-01,115.31,116.13,115.17,115.84,108.14280797644469,109.08208431181505,110.38109740379569,112.56067791201026,108.44145000000009,108.80540000000005,109.77240000000016,112.25399999999999,112.25399999999999,116.79087734020156,107.71712265979842,13990077,73.90493357502851,66.94399155305904,NaN,NaN,NaN,NaN,73.90493357502851,NaN,0.28456981466966225,1.819034079261968,1.5344642645923057,94.10569105691073,94.67499646452474,4637064545,12002338928.538666,39.90497448325917,11.503970573631186,37.903220847515875,100,7.142857142857143
2016-08-02,115.68,115.77,114.22,114.96,108.21064073289797,109.19847868187811,110.56066221148998,112.7891847775331,108.4779000000001,108.90840000000004,109.94220000000014,112.631,112.631,116.73047752768866,108.53152247231134,21278383,66.90887392246648,67.32075030702657,NaN,NaN,66.90887392246648,NaN,NaN,NaN,0.1984534425729716,1.7825310678085202,1.5840776252355486,74.45414847161567,87.1334953932655,4615786162,12001377969.306408,35.70541311880306,16.464729126822284,38.76795341429864,92.85714285714286,0
2016-08-03,114.88,115.35,114.8005,115.34,108.28157963107809,109.32009296540528,110.7480872228041,113.03211956062518,108.51400000000008,108.99690000000004,110.12240000000016,112.98299999999999,112.98299999999999,116.72817342723069,109.2378265727693,15011273,68.30417441981048,67.6362176005091,NaN,NaN,NaN,NaN,NaN,NaN,0.14388309042091318,1.76393148826169,1.620048397840777,82.75109170305693,83.77031041052777,4630797435,12015842881.141714,34.383613049197145,15.855211459754164,39.451623908041725,85.71428571428571,7.142857142857143
2016-08-04,115.32,115.78,115.03,115.67,108.35509625166438,109.4458336987636,110.94110341014512,113.28334626913707,108.5486500000001,109.08690000000004,110.26660000000014,113.3355,113.3355,116.67707732216728,109.99392267783271,12835296,69.50665027295342,68.10493034919611,NaN,NaN,NaN,NaN,NaN,NaN,0.10842701859673909,1.7555821710867008,1.6471551524899617,89.25233644859829,82.1525255410903,4643632731,12024913156.981714,35.56795258420027,15.036989994083367,40.530737586948604,78.57142857142857,0
2016-08-05,116.28,117.04,116.13,116.78,108.43892613970752,109.59106471462967,111.17007974700218,113.61636091017164,108.59165000000009,109.18840000000004,110.41740000000014,113.65950000000001,113.65950000000001,117.01752010119345,110.30147989880656,23196570,73.19090889558979,68.67445436376131,NaN,NaN,NaN,NaN,NaN,NaN,0.1363407239201906,1.8175810573901998,1.6812403334700092,94.9119373776907,88.97178850978196,4666829301,12034854544.12457,40.76614429656707,13.651152996463075,42.03789019872653,100,0
2016-08-08,116.82,116.87,116.28,116.65,108.52062836717312,109.73084561136967,111.38497858045307,113.90527891872672,108.63730000000007,109.27910000000006,110.55920000000015,113.9455,113.9455,117.2992589358861,110.59174106411389,12358181,72.0923104628625,69.32997928264534,NaN,NaN,NaN,NaN,NaN,NaN,0.12306544410231934,1.8350721385979085,1.7120066944955892,91.21621621621622,91.79349668083506,4654471120,12037996454.5483,39.095093599746775,13.091576683305076,43.545042810504455,92.85714285714286,0
2016-08-09,116.73,117.29,116.67,116.92,108.60420420431568,109.87320510421384,111.60203824396471,114.19239521218132,108.67335000000008,109.37310000000004,110.69500000000015,114.21700000000001,114.21700000000001,117.6105945544532,110.82340544554683,13276458,72.9988145402351,69.7633054869621,NaN,NaN,NaN,NaN,NaN,NaN,0.10991619295188815,1.8494019356854494,1.7394857427335613,91.628959276018,92.58570428997497,4667747578,12035426817.51604,40.30743401884681,12.49332928192085,44.649983717811004,100,0
2016-08-10,116.96,117.02,116.31,116.62,108.6839633664618,110.0068050031403,111.79882105792689,114.42359566816405,108.69255000000008,109.46560000000005,110.82060000000016,114.487,114.487,117.74020826262854,111.23379173737145,14688405,70.26767653183826,70.10974043695433,NaN,NaN,NaN,NaN,NaN,NaN,0.06090864998847301,1.8156215552191526,1.7547129052306796,84.69970312856815,89.18162620693413,4653059173,12033564907.023083,38.22077533158247,14.471453173303765,45.16788254174354,92.85714285714286,0
2016-08-11,117.01,117.37,116.78,117.12,108.76790402948208,110.14766034961276,112.00749474192975,114.68039608071986,108.71390000000008,109.55890000000004,110.95600000000015,114.744,114.744,117.97644427639848,111.51155572360152,12969799,72.13863303999696,70.48558502549307,NaN,NaN,NaN,NaN,NaN,NaN,0.04291018871076324,1.8083506411191337,1.7654404524083704,93.97590361445783,90.10152200634799,4666028972,12035543350.938337,38.690504816839756,13.666604048406494,45.85962032972361,100,0
2016-08-12,116.91,117.21,116.79,117.2,108.85180548192504,110.28731063971944,112.21112239910897,114.92035835874654,108.73450000000008,109.64970000000002,111.08840000000016,115.01400000000001,115.01400000000001,118.11723315269883,111.91076684730119,19379036,72.4374865274893,70.88049102326576,NaN,NaN,NaN,NaN,NaN,NaN,0.01838990836579324,1.788427837865612,1.7700379294998188,95.9036144578313,91.52640706695242,4685408008,12053999575.700243,37.43490350464783,13.223089391318895,46.55135811770369,92.85714285714286,7.142857142857143
2016-08-15,117.33,117.97,117.31,117.7,108.9398472184233,110.43409656764578,112.4263725011047,115.18508613410401,108.75290000000008,109.75440000000005,111.24120000000015,115.272,115.272,118.36757490621866,112.17642509378135,11777762,74.29342998845536,71.37642801075856,NaN,NaN,NaN,NaN,74.29342998845536,NaN,0.017828776273997704,1.7923238998423159,1.7744951235683182,93.0232558139536,94.30092462874757,4697185770,12056140986.972971,41.12403794538991,12.42686571388616,47.37253357039034,100,0
2016-08-16,117.47,117.49,117.03,117.05,109.02054525605092,110.56510455640527,112.60769122655157,115.36269697847506,108.76895000000007,109.85230000000003,111.37300000000016,115.518,115.518,118.3461343673903,112.6898656326097,14161446,67.89313728509964,71.22792134934893,NaN,NaN,67.89313728509964,NaN,NaN,NaN,-0.04111675916490465,1.7230991746121873,1.764215933777092,75.46666666666663,88.13117897948383,4683024324,12043210971.059927,38.927554010946125,13.995241553923442,47.3812043772848,92.85714285714286,0
2016-08-17,117.08,117.3,116.43,117.26,109.10252988036882,110.69767674340714,112.79013470786327,115.54339250433458,108.78860000000007,109.95380000000004,111.51460000000016,115.70899999999999,115.70899999999999,118.46503265583432,112.95296734416566,15980334,68.82749202432501,71.05617548120725,NaN,NaN,NaN,NaN,NaN,NaN,-0.07858958086294243,1.6659789576984139,1.7445685385613563,81.06666666666683,83.18552971576234,4699004658,12057721849.059927,36.22212966401621,17.815618301984074,46.34469155788588,85.71428571428571,21.428571428571427
2016-08-18,117.15,117.46,116.945,117.29,109.18399724474325,110.82821779799315,112.96660001343726,115.70973607535034,108.80200000000008,110.03840000000005,111.65300000000016,115.9145,115.9145,118.49278218005949,113.33621781994052,10036285,68.96643361058813,70.83792536405274,NaN,NaN,NaN,NaN,NaN,NaN,-0.11194739228484685,1.6046342982052977,1.7165816904901445,81.86666666666686,79.46666666666677,4709040943,12061132237.166723,36.00346315610718,17.059787552346204,45.21669668935218,78.57142857142857,14.285714285714286
2016-08-19,117.1,117.52,116.76,117.26,109.26435548111397,110.95557982179527,113.1349686403613,115.85738025865031,108.81325000000008,110.11740000000007,111.79440000000015,116.095,116.095,118.51444208445133,113.67555791554867,18742961,68.63697313992836,70.4616424758313,NaN,NaN,NaN,NaN,NaN,NaN,-0.1445512324681657,1.5358926499049375,1.6804438823731032,81.06666666666683,81.3333333333335,4690297982,12067051066.956198,33.72929797591271,17.519776451114943,43.52981445509802,71.42857142857143,7.142857142857143
2016-08-22,117.09,117.55,116.87,117.35,109.34480965543123,111.0822020035419,113.3002639877981,115.99953451973123,108.82490000000007,110.19890000000007,111.96260000000015,116.27950000000001,116.27950000000001,118.48102197354667,114.07797802645335,14500622,69.11366513599485,70.61912756251189,NaN,NaN,NaN,NaN,NaN,NaN,-0.16698576975167478,1.4717116701835096,1.6386974399351844,80.43855497712558,81.12396277015308,4704798604,12073021911.30914,32.047299472327936,16.514636028743908,43.18014454089063,64.28571428571429,0
2016-08-23,117.79,118.0095,117.51,117.56,109.42655284293939,111.21047523119454,113.46731245886484,116.14815027975682,108.83915000000007,110.27090000000005,112.15320000000014,116.468,116.468,118.41555847152827,114.52044152847174,11997927,70.2499042274333,70.75810826305637,NaN,NaN,NaN,NaN,70.2499042274333,NaN,-0.17383161546886083,1.4214079205991084,1.5952395360679692,84.91357610337305,82.13959924905514,4716796531,12063425971.696526,34.17451154111365,15.580986869334115,43.21508351587075,100,0
2016-08-24,117.49,117.64,116.41,116.8,109.49992047634298,111.32115888998277,113.59800608792897,116.21023120549427,108.84920000000007,110.33950000000004,112.32860000000015,116.579,116.579,118.32623667544622,114.83176332455376,17728656,61.440667916664275,70.18196666617857,NaN,NaN,NaN,NaN,NaN,NaN,-0.2320548372596627,1.3051709894933907,1.5372258267530534,35.64777866453839,66.99996991501233,4699067875,12056939878.037989,30.6896780537597,23.1115884457145,41.32324600951581,92.85714285714286,0
2016-08-25,116.48,116.97,116.36,116.61,109.57066753627987,111.4258884169138,113.71612349624547,116.24830442401863,108.86440000000006,110.41680000000005,112.50640000000016,116.6605,116.6605,118.24640636546603,115.07459363453397,24266264,59.43410427957631,69.19933776503476,NaN,NaN,NaN,NaN,NaN,NaN,-0.2825232772425881,1.1840717301998183,1.4665950074424063,19.08065915004325,46.547337972651555,4674801611,12052563994.365858,29.104599638519552,22.341256677513968,38.70314855802836,85.71428571428571,0
2016-08-26,116.66,117.54,116.08,116.78,109.64240218766017,111.53191042846007,113.83627551600055,116.29894209792161,108.88190000000006,110.47790000000005,112.68120000000016,116.73800000000001,116.73800000000001,118.18183655585011,115.29416344414992,23895963,60.67170936131481,68.38358054349563,NaN,NaN,NaN,NaN,NaN,NaN,-0.30186724453260383,1.0892609517766516,1.3911281963092554,36.27882871210164,30.335755508894426,4698697574,12051581968.489145,30.272002655241675,19.716463210930833,36.65229566427214,78.57142857142857,100
2016-08-29,116.81,117.251,116.79,116.94,109.71501510121578,111.63900131106482,113.95799020164759,116.35999523145288,108.90090000000005,110.55650000000006,112.89020000000015,116.793,116.793,118.17844000231733,115.40755999768268,11184872,61.85136635369841,67.5873342444573,NaN,NaN,NaN,NaN,NaN,NaN,-0.30063911271662547,1.0153293054134735,1.315968418130099,44.57113241772467,33.31020675995652,4709882446,12047675755.057474,29.084848600064085,18.94325770083672,34.39790158094613,71.42857142857143,92.85714285714286
2016-08-30,116.73,117.09,116.16,116.56,109.78312440369125,111.7364468296576,114.06002980158298,116.37904330464785,108.92350000000006,110.63210000000005,113.07820000000014,116.873,116.873,117.98328104551197,115.76271895448804,19843301,57.44433463345241,66.67138125171546,NaN,NaN,NaN,NaN,NaN,NaN,-0.32035748953860677,0.9155215562068406,1.2358790457454474,24.876911116869806,35.242290748898704,4690039145,12044901960.294033,26.84615458160497,22.69934766932131,31.776324434164998,64.28571428571429,85.71428571428571
2016-08-31,116.38,116.56,115.95,116.44,109.84936197181372,111.82958649639704,114.15336196622678,116.3848487042052,108.95650000000006,110.71050000000005,113.25700000000013,116.928,116.928,117.81575221770248,116.04024778229751,16169794,56.08530692300273,65.52471510050158,NaN,NaN,56.08530692300273,NaN,NaN,NaN,-0.3348483101645785,0.8173186580397243,1.1521669682043028,23.792182568584362,31.08007536772628,4673869351,12054709868.130098,25.461796186577057,23.304060246379546,28.678469327348246,57.142857142857146,100
2016-09-01,116.48,116.88,115.91,116.74,109.91792553428324,111.92682240735948,114.25479875186495,116.41867263713803,108.98310000000006,110.78280000000007,113.44700000000013,116.98149999999998,116.98149999999998,117.66502834619092,116.29797165380904,20944727,58.71496030380073,64.54453465595239,NaN,NaN,NaN,NaN,NaN,NaN,-0.31773636124417304,0.7549965166490864,1.0727328778932594,39.5332221957607,29.400771960404956,4694814078,12069608694.552778,26.07261908345369,21.41313928270727,25.965449028507287,50,100
2016-09-02,117.32,117.56,116.68,117.12,109.98958796677793,112.02965760721375,114.36715958512515,116.48546571931536,109.01125000000006,110.84490000000007,113.61400000000015,116.99849999999999,116.99849999999999,117.67803734262648,116.3189626573735,18088215,61.83261549263222,63.65447647767932,NaN,NaN,NaN,NaN,NaN,NaN,-0.27588384671390775,0.7278780695008749,1.0037619162147826,57.63276970707332,40.319391490472796,4712902293,12069608694.552778,29.83338307763886,19.840295668409073,23.57465500429931,42.857142857142854,92.85714285714286
2016-09-06,117.29,117.85,117.06,117.85,110.06780102183487,112.1449119120214,114.50374156217907,116.61542136509485,109.03235000000008,110.91420000000005,113.88520000000015,117.05849999999998,117.05849999999998,117.8122181170999,116.30478188290006,18525231,66.98974667041719,63.58994857663056,NaN,NaN,NaN,NaN,NaN,NaN,-0.1977534255050596,0.7565701343334581,0.9543235598385177,92.40295308406726,63.18964832896709,4731427524,12088133925.552778,30.289254821358323,18.52480449808091,21.931070162121394,35.714285714285715,85.71428571428571
2016-09-07,117.95,118.12,117.47,117.92,110.14593235495094,112.25927009198138,114.63771248130931,116.73966694937153,109.05340000000007,110.98700000000007,114.19920000000015,117.1085,117.1085,117.94676666403222,116.27023333596779,17546872,67.44400883235917,63.49112834863301,NaN,NaN,NaN,NaN,67.44400883235917,NaN,-0.14264937905560682,0.7760118360190091,0.918661215074616,90.9502262443438,80.3286496784948,4748974396,12094882722.475855,30.913476807040645,17.496857324651664,21.477645119296874,100,78.57142857142857
2016-09-08,117.57,117.6,116.92,117.23,110.21642059022507,112.35770038718967,114.73937081537561,116.78636533514566,109.06715000000005,111.04700000000007,114.45460000000014,117.13899999999998,117.13899999999998,117.9478238374575,116.33017616254246,20125319,58.84751132656337,62.768348185488385,NaN,NaN,NaN,NaN,NaN,NaN,-0.15304276109189474,0.7273577637097475,0.8804005248016422,59.72850678733044,81.02722870524717,4728849077,12093106959.03468,28.31068809189803,20.654469040314382,20.044493411285924,92.85714285714286,71.42857142857143
2016-09-09,116.23,116.51,114.26,114.28,110.25685421619298,112.39576572605719,114.72135627359617,116.5476638746556,109.06780000000006,111.08430000000007,114.61400000000015,116.99699999999999,116.99699999999999,118.48301615066514,115.51098384933483,50813287,37.084209050244496,60.51457932193954,NaN,NaN,37.084209050244496,NaN,NaN,NaN,-0.3478229289644206,0.44562186359611644,0.793444792560537,0.5181347150258038,50.39895591556668,4678035790,12043197019.359123,22.3042193336175,35.27413034359769,19.39426252003795,85.71428571428571,100
2016-09-12,113.64,116.49,113.63,116.33,110.31728352747464,112.47367135524418,114.78444034129828,116.52693398183125,109.07920000000007,111.14120000000007,114.78980000000014,116.95349999999999,116.95349999999999,118.4639340435866,115.44306595641338,39645960,50.722547639749585,59.20092807220773,NaN,NaN,NaN,NaN,NaN,NaN,-0.3280813858738396,0.3833430602182375,0.7114244460920771,60.133630289532235,40.12675726396282,4717681750,12078407067.750732,18.28184042723616,32.88529677796589,19.148221821562238,78.57142857142857,100
2016-09-13,115.73,116.09,114.73,115.29,110.36676329337041,112.52944023929875,114.80426621026697,116.40913074546637,109.08490000000008,111.18760000000006,114.93400000000014,116.833,116.833,118.46558200407307,115.20041799592693,45863935,45.35151525413721,57.422471716972304,NaN,NaN,NaN,NaN,NaN,NaN,-0.3713654919920337,0.24721758110203496,0.6185830730940687,36.971046770601504,32.54093725838651,4671817815,12070313432.162497,16.490164076879445,29.66243698187202,18.517572233899017,71.42857142857143,92.85714285714286
2016-09-14,115.43,116.47,115.38,115.84,110.42122336010304,112.59499587812452,114.84488322162905,116.35492781732671,109.09255000000006,111.25620000000006,115.10240000000015,116.7725,116.7725,118.45727743337983,115.08772256662016,28221762,48.45977332594714,56.4952649604925,NaN,NaN,NaN,NaN,NaN,NaN,-0.34956732711241045,0.18162391420355561,0.5311912413159661,49.22048997772836,48.77505567928736,4700039577,12065911872.951488,17.624909913995328,27.520335327403146,19.07712579061152,64.28571428571429,85.71428571428571
2016-09-15,115.89,117.815,115.86,117.64,110.4930519833856,112.69489694984483,114.95449564431026,116.47731564424798,109.11065000000008,111.34280000000007,115.28920000000015,116.7915,116.7915,118.50614602761425,115.07685397238575,39466531,57.06636343574915,56.326140614504844,NaN,NaN,NaN,NaN,NaN,NaN,-0.2075507370264404,0.27175282003291557,0.47930355705935596,89.30957683741642,58.50037119524876,4739506108,12098312784.590876,23.438550121105074,24.350666576718364,18.274418492613645,57.142857142857146,78.57142857142857
2016-09-16,117.22,117.412,116.71,117.29,110.560683306934,112.78588908945187,115.04608405041574,116.5547141543196,109.12130000000008,111.43120000000006,115.46260000000015,116.7915,116.7915,118.50614602761425,115.07685397238575,27596527,55.13831256040441,55.93089798586839,NaN,NaN,NaN,NaN,NaN,NaN,-0.13436323845774267,0.3113495089871776,0.4457127474449203,81.5144766146994,73.3481811432814,4711909581,12116317356.337315,22.145131941113306,23.006914737013677,16.902466636884522,50,71.42857142857143
2016-09-19,117.57,117.95,116.55,116.78,110.62256705512371,112.86498039461124,115.11408075432101,116.5761699491463,109.1329500000001,111.52320000000005,115.59220000000016,116.7675,116.7675,118.46862756723802,115.06637243276198,16222870,52.36216405880567,55.253097821947485,NaN,NaN,NaN,NaN,NaN,NaN,-0.11805767583406757,0.2981406526523358,0.41619832848640337,70.15590200445433,80.32665181885672,4695686711,12105424857.908743,23.48225721092894,21.1176869053231,15.772879766398884,42.857142857142854,64.28571428571429
2016-09-20,117.19,117.48,116.8,117,110.68602409935133,112.94686197095557,115.18803837179861,116.61653471589428,109.15540000000009,111.63040000000005,115.71360000000016,116.75,116.75,118.43391211172714,115.06608788827286,18078584,53.45093708621859,54.96785514000221,NaN,NaN,NaN,NaN,NaN,NaN,-0.09140340130017066,0.30194407686119007,0.39334747816136073,75.05567928730507,75.57535263548625,4713765295,12097980735.085213,22.487928255224016,20.223482937669566,15.553739753524164,35.714285714285715,57.142857142857146
2016-09-21,117.48,118.32,116.81,118.15,110.76029251627321,113.04989440717426,115.30419372976729,116.76257902866625,109.17045000000009,111.75470000000003,115.84680000000014,116.77950000000003,116.77950000000003,118.53815260924287,115.02084739075718,31546776,58.7572492498472,55.158708163348244,NaN,NaN,NaN,NaN,NaN,NaN,-0.00010126155298245676,0.39322090122013265,0.3933221627731151,96.37526652452053,80.52894927209331,4745312071,12122424263.509054,25.455999604546097,18.412301667886805,16.384581040762274,100,50
2016-09-22,118.85,119.22,118.7177,119.09,110.84317517780283,113.16950045851735,115.4526567207568,116.98423816879328,109.19280000000009,111.87840000000001,116.00420000000017,116.89400000000003,116.89400000000003,118.92082411668876,114.8671758833113,22614422,62.518352228910246,55.43037901514178,NaN,NaN,NaN,NaN,62.518352228910246,NaN,0.11353322003129895,0.5352386878122388,0.42170546778093987,97.67441860465125,89.70178813882562,4767926493,12133333032.074852,29.20832163886121,17.23443906804894,17.525270212209158,100,42.857142857142854
2016-09-23,118.92,119,118.16,118.33,110.91767094717792,113.27168856824967,115.56549371209968,117.11240596224154,109.21130000000008,112.00440000000002,116.13120000000015,116.98000000000002,116.98000000000002,119.09535339837241,114.86464660162763,22213394,57.91936881289132,55.150861395160284,NaN,NaN,NaN,NaN,NaN,NaN,0.12645947986910544,0.5797798176173217,0.45332033774821623,84.07871198568873,92.7094657049535,4745713099,12120110773.741518,27.55818102616082,19.64868112715305,17.285092294009594,92.85714285714286,35.714285714285715
2016-09-26,117.66,117.8,117.17,117.34,110.9815747188478,113.35224919066057,115.63508219397812,117.13408158488521,109.2335500000001,112.12730000000003,116.24200000000017,117.00800000000001,117.00800000000001,119.12684496837593,114.88915503162409,16403881,52.501456656187685,54.115983537001036,NaN,NaN,NaN,NaN,NaN,NaN,0.0606198720455442,0.5290951778051465,0.4684753057596023,66.3685152057246,82.70721526535486,4729309218,12112559780.900248,25.61435455717443,24.28258306270855,15.754271420015854,85.71428571428571,28.571428571428573
2016-09-27,117.31,118.5552,117.15,118.5,111.0563849206503,113.45418485025145,115.74743191186133,117.26416905299138,109.25905000000007,112.26210000000003,116.36120000000015,117.08600000000001,117.08600000000001,119.30172922533775,114.87027077466227,20238432,57.51609942858948,53.40684715101749,NaN,NaN,NaN,NaN,NaN,NaN,0.08593257761462636,0.5758910277778853,0.4899584501632589,87.11985688729878,79.18902802623738,4749547650,12131208173.8362,27.98460688345176,22.236435505806995,14.592226571348471,78.57142857142857,21.428571428571427
2016-09-28,118.62,118.77,118.09,118.7,111.13244079208661,113.55806237796925,115.8632188957099,117.4009148574684,109.29860000000009,112.39330000000004,116.49260000000015,117.19300000000003,117.19300000000003,119.50153286742713,114.88446713257292,14794330,58.33288827096158,53.370088361331646,NaN,NaN,NaN,NaN,NaN,NaN,0.10559003845954629,0.6219459982376918,0.5163559597781455,90.69767441860473,81.39534883720938,4764341980,12142956612.365612,28.13619774875558,21.30103370643687,14.462932921723405,71.42857142857143,14.285714285714286
2016-09-29,118.51,118.72,117.3338,117.84,111.19918267475242,113.64285322196986,115.94073972332913,117.44273249009045,109.32965000000009,112.51290000000003,116.58060000000016,117.26300000000003,117.26300000000003,119.56083463286461,114.96516536713546,27207499,53.56405640949965,54.54722031556416,NaN,NaN,NaN,NaN,NaN,NaN,0.05278504018871799,0.5823372600140431,0.5295522198253251,75.31305903398936,84.37686344663096,4737134481,12135619891.022228,25.757504302523937,24.112141536674528,13.08962247388709,64.28571428571429,7.142857142857143
2016-09-30,118.145,119.07,118.03,118.72,111.27401667798871,113.74339078193086,116.04973032241426,117.56437701484374,109.36170000000011,112.62680000000005,116.69140000000016,117.36200000000004,117.36200000000004,119.73069246631647,114.9933075336836,25543200,57.401659984124116,55.02429976873377,NaN,NaN,NaN,NaN,NaN,NaN,0.0682525288995477,0.6148678809497596,0.546615352050212,88.86414253897549,84.95829199718986,4762677681,12143970552.56069,25.959156874092233,22.309817071473955,11.591031824122975,57.142857142857146,0
2016-10-03,118.53,118.7,118.09,118.55,111.34641452198882,113.83857116248669,116.14778011369214,117.65824587057291,109.3845500000001,112.74870000000004,116.78940000000017,117.43350000000002,117.43350000000002,119.854411192094,115.01258880790604,19216438,56.43142312280083,55.8157217593526,NaN,NaN,NaN,NaN,NaN,NaN,0.058536950147605404,0.6197865397347186,0.5612495895871132,82.5520833333333,82.24309496876606,4743461243,12153736283.347574,24.931232727882684,21.42639856229373,10.092441174358859,50,0
2016-10-04,118.86,119.16,117.92,118.37,111.4163009446556,113.92830242659586,116.23492599158656,117.7260319781374,109.4148000000001,112.87350000000004,116.88360000000019,117.45950000000002,117.45950000000002,119.90874866030539,115.01025133969465,21239742,55.36435576129136,56.30890621902004,NaN,NaN,NaN,NaN,NaN,NaN,0.032774825091138604,0.6022181209510364,0.5694432958598978,74.70238095238112,82.03953560822997,4722221501,12147912483.121767,25.873263378206364,19.767259572985466,9.482397150445545,42.857142857142854,0
2016-10-05,118.7,119.17,118.67,118.79,111.48967108450978,114.02457366567317,116.33512497230866,117.82736226593384,109.4596000000001,113.00640000000004,116.9836000000002,117.50300000000001,117.50300000000001,120.0135545204235,114.99244547957653,14481285,57.38902361711191,56.331953374831656,NaN,NaN,NaN,NaN,NaN,NaN,0.03652142668415781,0.6150950792150951,0.5785736525309373,83.89513108614261,80.38319845728567,4736702786,12140382214.921768,24.616151957273306,18.758065649821614,10.31077530114936,35.714285714285715,0
2016-10-06,118.63,118.981,118.15,118.73,111.56171415829576,114.11775042476876,116.42904164006126,117.91332776441634,109.4980000000001,113.12550000000005,117.06660000000018,117.57800000000002,117.57800000000002,120.14053468269216,115.01546531730787,11987056,56.99131290761028,56.46431054248922,NaN,NaN,NaN,NaN,NaN,NaN,0.027851405064141188,0.6133879088611138,0.5855365037969726,81.64794007490657,80.08181737114343,4724715730,12145127992.808651,23.28623895681113,21.12533210153026,10.521990680291925,28.571428571428573,7.142857142857143
2016-10-07,118.86,119.01,117.89,118.47,111.63045332089978,114.20393358467433,116.50907922280395,117.96634416780526,109.53145000000009,113.25540000000005,117.1364000000002,117.78750000000002,117.78750000000002,119.87910106138897,115.69589893861108,19984158,55.205931638986776,56.66743679821645,NaN,NaN,NaN,NaN,NaN,NaN,-0.0009736303254153089,0.5843194658902036,0.5852930962156189,69.00826446280993,78.18377854128637,4704731572,12145841712.737223,21.593001871146303,21.277228409642184,10.19590825358347,21.428571428571427,0
2016-10-10,119.06,119.48,119.03,119.22,111.70597119830376,114.30326163250257,116.61538984151751,118.08573996134761,109.5645000000001,113.38900000000005,117.21620000000019,117.93200000000002,117.93200000000002,120.00004835533421,115.86395164466582,19687341,59.17860412146693,57.07655587216276,NaN,NaN,NaN,NaN,59.17860412146693,NaN,0.02353767766432191,0.6147151932960213,0.5911775156316994,90.26217228464401,80.30612560745351,4724418913,12142779237.470556,23.238122374286743,19.873808729333415,10.37461811754549,100,0
2016-10-11,119.1,119.14,117,117.52,111.76382223115645,114.36695942195796,116.6508647496933,118.03185996502879,109.5891500000001,113.51110000000006,117.24980000000019,118.04350000000002,118.04350000000002,119.73613433735753,116.35086566264252,27774426,48.647077099754384,56.3544007185847,NaN,NaN,NaN,NaN,NaN,NaN,-0.07621267436218226,0.4959116726789716,0.5721243470411539,20.967741935483676,60.07939289431255,4696644487,12128502663.358406,20.099906418774165,29.538732739025285,10.585947752189446,92.85714285714286,0
2016-10-12,117.575,117.82,117.06,117.42,111.82010260696585,114.4274156710281,116.68102691637199,117.973587587407,109.61360000000009,113.62060000000007,117.29900000000019,118.12250000000002,118.12250000000002,119.51774728991155,116.72725271008848,14267824,48.10476352501943,55.32485866830678,NaN,NaN,NaN,NaN,NaN,NaN,-0.1463367830462291,0.38920336823336754,0.5355401512795966,16.935483870967783,42.72179936369849,4682376663,12127751725.253143,19.14662877107434,28.13780016377755,10.102594694648843,85.71428571428571,92.85714285714286
2016-10-13,116.635,117.32,115.94,117,111.87164387455823,114.47835793496814,116.69353566474956,117.8808649600349,109.6271000000001,113.72730000000006,117.3322000000002,118.09050000000002,118.09050000000002,119.55612580490606,116.62487419509398,22821011,45.79561638800444,54.45887635224343,NaN,NaN,NaN,NaN,NaN,NaN,-0.21430383599932173,0.2676603562804445,0.4819641922797662,29.94350282485877,22.615576210436746,4659555652,12139989078.977781,17.41453984807206,32.43828713627343,11.058396134557109,78.57142857142857,100
2016-10-14,117.58,118.05,117.07,117.14,111.92406532854272,114.53106371843413,116.7110440700535,117.81030639241253,109.6464500000001,113.81410000000005,117.3616000000002,118.08300000000001,118.08300000000001,119.5663623967228,116.59963760327723,21313321,46.71382528321508,54.04547411131682,NaN,NaN,NaN,NaN,NaN,NaN,-0.24112960945398448,0.1805521804622856,0.4216817899162701,33.898305084745786,26.925763926857456,4680868973,12121720518.120638,20.783373338395,30.34117104246892,12.203116198286404,71.42857142857143,92.85714285714286
2016-10-17,117.1,117.3,116.672,116.82,111.97278109641792,114.57638918935622,116.71531685162003,117.71599149789705,109.67125000000011,113.88990000000005,117.36240000000018,118.08500000000001,118.08500000000001,119.56142134908006,116.60857865091995,14182694,44.84392962220425,53.14031912514645,NaN,NaN,44.84392962220425,NaN,NaN,NaN,-0.2695691167867547,0.08472039393282671,0.3542895107195814,24.85875706214672,29.566854990583767,4666686279,12114222660.783058,19.95253290587098,31.661770051555383,13.005993974060443,64.28571428571429,85.71428571428571
2016-10-18,118.18,118.41,117.8,117.86,112.03136038899088,114.64141118560659,116.76020638685061,117.72970659333542,109.7130500000001,113.97290000000007,117.3866000000002,118.12800000000001,118.12800000000001,119.52338668476288,116.73261331523715,19276656,51.62175116861564,52.66095218926459,NaN,NaN,NaN,NaN,NaN,NaN,-0.2101228099452666,0.09163599828799818,0.3017588082332648,54.237288135593175,37.66478342749524,4685962935,12098738133.83224,24.85296288478841,28.54985550568614,12.512901852976727,57.142857142857146,78.57142857142857
2016-10-19,117.77,118.02,117.64,117.85,112.08925730054321,114.70494759777279,116.80294339128784,117.74116310825586,109.75575000000009,114.05010000000006,117.40520000000019,118.11300000000001,118.11300000000001,119.513558460048,116.71244153995202,13702918,51.55614742631436,52.51753011903707,NaN,NaN,NaN,NaN,NaN,NaN,-0.16523728566671003,0.09521220114987727,0.2604494868165873,53.95480225988681,44.350282485875574,4672260017,12100180546.253292,24.239776863825632,28.884302006866626,12.90172042451833,50,71.42857142857143
2016-10-20,117.68,117.97,117.03,117.71,112.1451850885975,114.7644535859357,116.83851423868832,117.73819519318387,109.8030000000001,114.12380000000005,117.42700000000019,118.04400000000001,118.04400000000001,119.37970056525316,116.70829943474686,18132245,50.58687370026174,52.03075967018976,NaN,NaN,NaN,NaN,NaN,NaN,-0.1397508382600484,0.08576093899152681,0.2255117772515752,49.9999999999998,52.73069679849328,4654127772,12108282187.63627,22.744830150680855,31.10511482316461,13.470629311264886,42.857142857142854,64.28571428571429
2016-10-21,117.8,118.22,117.41,118.15,112.204934490701,114.83149410898648,116.8899450528574,117.77741469859492,109.86940000000011,114.20180000000003,117.44760000000018,118.03500000000001,118.03500000000001,119.36528568361085,116.70471431638917,15707804,53.543022296176126,51.82444532543086,NaN,NaN,NaN,NaN,NaN,NaN,-0.09042663265820969,0.11247848642881308,0.20290511908702277,62.42937853107356,55.46139359698674,4669835576,12121275062.54985,23.184362490782096,29.421276259496267,13.777454601850925,35.714285714285715,57.142857142857146
2016-10-24,118.93,119.65,118.8918,119.57,112.27821872462438,114.92532590880853,116.99504524686299,117.94813710825255,109.94720000000012,114.29170000000003,117.4950000000002,118.14650000000002,118.14650000000002,119.59376327944022,116.69923672055981,19142985,61.53981211697368,52.265549350836736,NaN,NaN,NaN,NaN,61.53981211697368,NaN,0.03400037273278084,0.2454055850029988,0.21140521227021797,97.84366576819374,70.09101476642238,4688978561,12136378377.80572,30.214534444487978,26.55447679186261,13.282369649396324,100,50
2016-10-25,119.62,119.66,119.01,119.19,112.34699266766295,115.00977490071331,117.08112190384875,118.06640976460945,110.02150000000012,114.38300000000005,117.5248000000002,118.18100000000001,118.18100000000001,119.69182626400892,116.6701737359911,20341835,58.63127887721905,52.35428186941581,NaN,NaN,NaN,NaN,NaN,NaN,0.08402840022130564,0.31644071254685,0.23241231232554438,87.36559139784949,82.54621189903894,4668636726,12127302789.882643,28.967294756631162,25.399513995749697,12.786405818498348,100,42.857142857142854
2016-10-26,118.41,119.03,118.03,118.38,112.40702259136779,115.07651203139226,117.13205829977625,118.09627550131331,110.08570000000013,114.46220000000005,117.5514000000002,118.165,118.165,119.66019898342037,116.66980101657964,20463696,52.892755398745955,52.06152776163979,NaN,NaN,NaN,NaN,NaN,NaN,0.057168924677028166,0.3038734681718296,0.24670454349480142,65.59139784946233,83.60021833850186,4648173030,12121163681.082642,26.732682852095262,29.957348025704285,12.845163031648054,92.85714285714286,35.714285714285715
2016-10-27,118.9,118.99,117.67,117.84,112.4610820680706,115.1312345654241,117.15982071939287,118.07186831071205,110.16540000000012,114.53880000000005,117.56300000000017,118.165,118.165,119.66019898342037,116.66980101657964,19099790,49.42005404793074,51.64825079085007,NaN,NaN,NaN,NaN,NaN,NaN,0.0006263395688158313,0.24748746795582122,0.24686112838700539,51.07526881720447,68.0107526881721,4629073240,12106983533.96143,24.423770217239404,29.72547624498405,13.49190117145936,85.71428571428571,28.571428571428573
2016-10-28,117.47,118.11,116.74,117.1,112.50724045545297,115.17022001957412,117.15747480882844,117.97930942397757,110.23055000000011,114.60610000000004,117.55920000000019,118.08400000000002,118.08400000000002,119.6249789096572,116.54302109034283,35369254,45.05456696629469,50.63939099405205,NaN,NaN,NaN,NaN,NaN,NaN,-0.08432194813121499,0.14145869322298665,0.22578064135420164,31.18279569892465,49.28315412186382,4593703986,12090202501.041721,22.273537475785318,33.08482704708463,14.329470357656104,78.57142857142857,21.428571428571427
2016-10-31,117.53,117.53,116.93,116.99,112.55184502803553,115.20625526671127,117.15090716926655,117.88508947883685,110.31130000000012,114.67410000000005,117.5538000000002,118.006,118.006,119.60168668604595,116.41031331395405,18749357,44.42634128111559,50.337909864149275,NaN,NaN,NaN,NaN,NaN,NaN,-0.14222393531277613,0.048000722213231484,0.19022465752600762,28.225806451612836,36.82795698924732,4574954629,12075203015.441721,21.385546632624223,31.765816831607225,14.366224768374414,71.42857142857143,14.285714285714286
2016-11-01,117.19,117.21,115.1047,116.11,112.58724955511975,115.22415120202392,117.1100872802757,117.71603333799524,110.38655000000011,114.74580000000006,117.5290000000002,117.893,117.893,119.67838623273171,116.10761376726829,23498712,39.66177193742639,49.73483903646406,NaN,NaN,NaN,NaN,NaN,NaN,-0.22895395147879044,-0.09596778182248045,0.13298616965631,22.06879898140638,27.15913371064795,4551455917,12074146003.126896,18.585636160782983,38.958125217512325,15.53682423861702,64.28571428571429,100
2016-11-02,116.05,116.3,114.89,115.18,112.6130480670091,115.22327692079573,117.03439758300999,117.47450635342426,110.45870000000014,114.81730000000005,117.48140000000019,117.7125,117.7125,119.8025801420103,115.62241985798971,26960093,35.347329565883854,48.988532834884026,NaN,NaN,NaN,NaN,NaN,NaN,-0.33187533778139255,-0.2818580025704307,0.050017335210961855,6.079664570230744,18.79142333441665,4524495824,12058275877.46023,16.98201150302447,36.91052798497687,16.02554194799904,57.142857142857146,100
2016-11-03,115.02,115.37,113.92,114.05,112.6273460961931,115.20004371444334,116.91736238367626,117.14836289119337,110.52470000000014,114.87750000000004,117.4264000000002,117.47850000000001,117.47850000000001,120.05243298281634,114.90456701718368,36205193,30.942863757515624,47.862035583048346,NaN,NaN,NaN,NaN,NaN,NaN,-0.4515569738043796,-0.5144288820445126,-0.06287190824013306,2.2648083623692608,10.137757304668792,4488290631,12028562650.101608,15.500812751012353,39.52595790223612,17.80880660619264,50,100
2016-11-04,113.72,114.54,113.45,113.65,112.63752175692748,115.16934977950386,116.78923052549288,116.81518547298448,110.57410000000013,114.93680000000003,117.36720000000021,117.2375,117.2375,120.25870423011206,114.21629576988794,26997454,29.53969819043614,46.76887619506491,NaN,NaN,29.53969819043614,NaN,NaN,NaN,-0.5278536162564877,-0.7226889285607427,-0.19483531230425502,3.220611916264139,3.8550282829547116,4461293177,12011472518.670416,14.47848421615866,39.76294815030551,19.517994953141848,42.857142857142854,100
2016-11-07,115.45,116.47,115.3,116.35,112.6744618389481,115.19272899179091,116.77200579900297,116.770882094605,110.64470000000011,115.01990000000005,117.35860000000021,117.09400000000001,117.09400000000001,119.99516804063813,114.19283195936188,26591245,47.00789393593478,46.43931496415913,NaN,NaN,NaN,NaN,NaN,NaN,-0.3739199461737781,-0.6622352450214777,-0.2883152988476996,46.69887278582922,17.39476435482087,4487884422,12032609149.311441,22.8549861791412,33.59047209113994,20.382035347581674,35.714285714285715,92.85714285714286
2016-11-08,116.21,117.64,115.96,117.11,112.71859654701828,115.2306947543297,116.78526047355187,116.80317903797595,110.71450000000013,115.12610000000004,117.3620000000002,117.07350000000001,117.07350000000001,119.96812450069365,114.17887549930637,20777919,50.711967032958114,46.379016364633685,NaN,NaN,NaN,NaN,NaN,NaN,-0.20670586245836925,-0.5466976269206612,-0.3399917644622919,58.937198067632856,36.285560923242066,4508662341,12040277190.847157,27.092657738584286,30.548115486384837,20.185751625834293,28.571428571428573,85.71428571428571
2016-11-09,115.71,117.84,115.6,117.65,112.76766523809272,115.27860178889743,116.81917182753023,116.88382865340681,110.79985000000012,115.23100000000004,117.3838000000002,117.08500000000001,117.08500000000001,119.98685802547648,114.18314197452354,70234393,53.21430685628599,46.56669016149256,NaN,NaN,NaN,NaN,53.21430685628599,NaN,-0.053502272905943615,-0.4068696055947214,-0.3533673326887778,67.63285024154601,57.756307031669365,4578896734,12098596820.748943,23.974697539596853,28.882065073406977,19.739974893531905,21.428571428571427,78.57142857142857
2016-11-10,118.14,118.38,114.195,115.75,112.79734021084802,115.28793640693907,116.77724352056826,116.77584497212997,110.86860000000011,115.31350000000002,117.37000000000022,117.02250000000001,117.02250000000001,119.98225590210163,114.06274409789839,72825446,44.62882327977887,45.929961660321325,NaN,NaN,NaN,NaN,NaN,NaN,-0.07270453220052003,-0.4442479979394278,-0.3715434657389078,37.03703703703703,54.535695115405304,4506071288,12079890164.966387,19.467039231828302,29.763907068550772,20.38707903804643,14.285714285714286,71.42857142857143
2016-11-11,115.21,116.05,114.84,115.8,112.82721742268038,115.29807628006898,116.73892024525186,116.68290735573665,110.92695000000012,115.39910000000003,117.3512000000002,116.95550000000003,116.95550000000003,119.96188304279515,113.94911695720491,41115166,44.88084616592512,44.74003552096071,NaN,NaN,NaN,NaN,NaN,NaN,-0.07435067055365752,-0.4644818039309797,-0.3901311333773222,37.842190016103004,47.50402576489535,4547186454,12104015592.949858,18.390415417426844,28.11781539646736,21.420518795634155,7.142857142857143,64.28571428571429
2016-11-14,115.84,115.94,114.03,114.63,112.84515555777809,115.2848470468003,116.65621749053611,116.48739236947601,110.97805000000012,115.45770000000005,117.30140000000021,116.84600000000003,116.84600000000003,120.01905783117766,113.6729421688224,35905979,40.26277641746685,43.42799963097841,NaN,NaN,40.26277641746685,NaN,NaN,NaN,-0.14259476876647004,-0.5683745943354097,-0.4257798255689397,21.146953405017793,32.00872681938595,4511280475,12090668344.211637,16.81002257254906,29.34588451491626,22.891761435358863,0,57.142857142857146
2016-11-15,115.47,116.62,115.33,116.22,112.87873609949173,115.30336492706168,116.63911092227978,116.46192642952592,111.04840000000013,115.57700000000003,117.26880000000021,116.76400000000004,116.76400000000004,119.91267210106096,113.61532789893911,31796602,48.081213266338246,43.08431805009214,NaN,NaN,NaN,NaN,NaN,NaN,-0.07254195514735651,-0.5164572695031353,-0.4439153143557788,50,36.329714473706936,4543077077,12102746123.265902,18.336781744330835,26.765126915597232,23.820268265470748,0,50
2016-11-16,115.7,116.9932,115.67,116.91,112.91884817810376,115.33517948296145,116.64973402336685,116.5046001029044,111.12465000000012,115.72390000000003,117.24860000000021,116.71700000000003,116.71700000000003,119.82725465195398,113.60674534804608,16538132,51.07384083403731,43.202445677671186,NaN,NaN,NaN,NaN,NaN,NaN,0.0232498396584912,-0.4148530147826648,-0.438102854441156,70.18255578093304,47.10983639531694,4559615209,12117204490.177631,18.921363140069865,25.17948900006996,24.134523523808785,0,42.857142857142854
2016-11-17,116.86,117.78,116.61,117.76,112.96701884299824,115.3831957308236,116.69327386558776,116.6241619978659,111.20520000000012,115.85690000000004,117.2592000000002,116.71950000000001,116.71950000000001,119.83302196074224,113.60597803925778,20598553,54.549382085194125,43.88064675759257,NaN,NaN,NaN,NaN,NaN,NaN,0.1403106001763953,-0.26271460422066184,-0.40302520439705714,87.42393509127807,69.20216362407037,4580213762,12137098819.143444,21.502026431878363,23.834889601726655,23.107093134633622,64.28571428571429,35.714285714285715
2016-11-18,117.83,118.1,117.21,117.32,113.01033208834154,115.42154829060927,116.7178513610549,116.69043228378344,111.30120000000014,115.96700000000004,117.3200000000002,116.67800000000003,116.67800000000003,119.73577435400453,113.62022564599552,16428659,52.47148923711349,44.455300183020995,NaN,NaN,NaN,NaN,NaN,NaN,0.18192123528968135,-0.17562366028495546,-0.3575448955746368,78.49898580121696,78.70182555780936,4563785103,12124731176.974905,22.107784278818844,22.835917645046933,21.82784031437467,57.142857142857146,28.571428571428573
2016-11-21,117.6,118.65,117.57,118.54,113.06535365960183,115.4832998096071,116.7893081704253,116.86658159008978,111.41080000000012,116.07700000000004,117.3642000000002,116.62650000000004,116.62650000000004,119.51787527830676,113.73512472169331,20268547,57.32542831634734,45.7169899243725,NaN,NaN,NaN,NaN,NaN,NaN,0.2795825819034486,-0.008066668195326088,-0.2876492500987747,97.8846153846154,87.93584542570348,4584053650,12140870945.882313,23.323886494021053,21.39294827969591,19.60745993464005,100,21.428571428571427
2016-11-22,118.97,119.19,118.61,118.9,113.12340984209335,115.55095723911984,116.87208039903608,117.06024048627171,111.52370000000013,116.18520000000004,117.43640000000019,116.61200000000004,116.61200000000004,119.45429906941688,113.7697009305832,18850641,58.66685194479959,47.38267009429505,NaN,NaN,NaN,NaN,58.66685194479959,NaN,0.3517354432946782,0.15202005401957308,-0.19971538927510513,94.94773519163776,90.44377879249004,4602904291,12140870945.882313,25.24714031018646,20.70437960150211,17.67229840121052,100,14.285714285714286
2016-11-23,118.51,118.64,117.9,118.42,113.17611223172426,115.60776996705806,116.93278312848564,117.18974139234108,111.63235000000013,116.29520000000004,117.4880000000002,116.61400000000006,116.61400000000006,119.46132435805771,113.76667564194241,22925954,56.13323880821447,49.181982597916395,NaN,NaN,NaN,NaN,NaN,NaN,0.34970919427794855,0.2374211035723306,-0.11228809070561797,86.5853658536586,93.13923880997059,4579978337,12150165251.55799,23.968945983147197,23.250710626657515,14.662314184949986,92.85714285714286,7.142857142857143
2016-11-25,118.56,118.85,118.42,118.8,113.23207131399566,115.67098244295791,117.00600731952542,117.34309935497527,111.74360000000013,116.40020000000004,117.51120000000019,116.66200000000006,116.66200000000006,119.62057127681385,113.70342872318628,7162785,57.691022281405026,51.19279146155703,NaN,NaN,NaN,NaN,NaN,NaN,0.35538126815790705,0.3319384944917658,-0.02344277366614121,92.44186046511626,91.32498717013755,4587141122,12155662272.604502,24.53861036204646,22.71809998722106,11.607865350371977,85.71428571428571,0
2016-11-28,118.64,119.08,118.4101,118.53,113.2847870223141,115.72759665200824,117.06577173836756,117.45613751164429,111.84615000000012,116.49930000000003,117.53600000000019,116.73350000000008,116.73350000000008,119.79817143426129,113.66882856573886,13479045,56.164858846009665,51.846860383705234,NaN,NaN,NaN,NaN,NaN,NaN,0.32328969492489895,0.3806693449899825,0.05737965006508354,87.20930232558145,88.74550954811878,4573662077,12147008238.786768,24.901120596985187,21.877298437614314,10.71107386738869,78.57142857142857,35.714285714285715
2016-11-29,118.63,119.51,118.3,118.94,113.34105779821148,115.79120859949323,117.13927088588255,117.59745774863055,111.93970000000012,116.58570000000005,117.57920000000018,116.83100000000006,116.83100000000006,120.04265938418135,113.61934061581877,18552957,57.982578820411085,52.36618979709474,NaN,NaN,NaN,NaN,NaN,NaN,0.3118700613690891,0.44721722677644493,0.1353471654073558,89.59854014598527,89.74990097889433,4592215034,12148081550.348751,25.615405339253506,20.40808835985888,11.09104962326971,100,28.571428571428573
2016-11-30,119.06,119.1335,117.46,117.5,113.38244030768202,115.82504605296862,117.15341712565187,117.58817605828477,112.01470000000012,116.65140000000005,117.58920000000018,116.90050000000008,116.90050000000008,120.10689657559409,113.69410342440607,30405342,50.12134669333404,52.1452640711696,NaN,NaN,NaN,NaN,NaN,NaN,0.19523234216461338,0.37938759311312253,0.18415525094850915,63.321167883211615,80.04300345159278,4561809692,12119129705.426731,23.286170340228175,23.116570289650266,10.453993917928376,92.85714285714286,21.428571428571427
2016-12-01,117.46,117.47,115.29,115.47,113.40321204591403,115.81801543805835,117.08740076778317,117.3864450051148,112.08540000000012,116.69120000000004,117.53560000000017,116.91500000000008,116.91500000000008,120.09263748718614,113.73736251281402,39796590,41.565804897276735,51.92647704384802,NaN,NaN,41.565804897276735,NaN,NaN,NaN,-0.019337088387660017,0.15998389046393413,0.17932097885159415,26.27737226277366,59.73236009732352,4522013102,12085905029.371685,20.61965161252873,31.713296329500622,10.47419147297949,85.71428571428571,14.285714285714286
2016-12-02,115.57,116.16,115.22,115.7,113.42606565739747,115.81567849869086,117.03299289453676,117.22583119510386,112.15575000000014,116.73600000000005,117.46780000000017,116.99750000000006,116.99750000000006,119.95110034533992,114.0438996546602,32876845,42.758023484844045,51.774846852342215,NaN,NaN,NaN,NaN,NaN,NaN,-0.13976814088764655,0.004610802742035958,0.1443789436296825,30.474452554744534,40.02433090024328,4554889947,12086604536.71211,19.5920006845613,30.503892834515717,10.536089448931062,78.57142857142857,7.142857142857143
2016-12-05,116.32,117.06,115.77,116.6,113.45764709364228,115.83120961752866,117.01601278102551,117.16622822414159,112.22235000000013,116.78220000000005,117.43320000000018,117.14500000000007,117.14500000000007,119.68018835591846,114.60981164408167,21419667,47.28993796988957,52.276786963229554,NaN,NaN,NaN,NaN,NaN,NaN,-0.15180549238986601,-0.045377921857649994,0.106427570532216,32.16783216783202,29.6398856617834,4576309614,12092748162.130714,22.948774818215934,28.305849609930288,9.342665472777284,71.42857142857143,0
2016-12-06,116.88,117.08,116.39,116.88,113.4917003563921,115.85197774391423,117.0106789464755,117.13896839327096,112.29885000000013,116.83300000000004,117.42400000000018,117.17150000000007,117.17150000000007,119.68387158875295,114.65912841124718,27293348,48.65198147518417,52.317556121004266,NaN,NaN,NaN,NaN,NaN,NaN,-0.1344937103278062,-0.06168956737754172,0.07280414295026447,38.694638694638556,33.77897447240503,4603602962,12104219279.406076,22.189280573979556,27.233635665755596,8.736892223189686,64.28571428571429,85.71428571428571
2016-12-07,116.64,118.51,116.2919,118.36,113.54014114886581,115.90164155096544,117.0635934975941,117.25525711772134,112.37790000000014,116.89120000000004,117.42120000000017,117.23400000000007,117.23400000000007,119.7987877105084,114.66921228949172,26622442,55.23631274161638,52.6148755429742,NaN,NaN,NaN,NaN,NaN,NaN,-0.02280623720460244,0.044296346444511414,0.06710258364911385,73.1934731934731,48.01864801864789,4630225404,12127241012.420908,27.090964571320274,24.07635809379916,8.144119089062887,57.142857142857146,78.57142857142857
2016-12-08,118.4,118.87,118.18,118.57,113.59018949564327,115.95448033213444,117.12266826239433,117.3804707255574,112.45295000000013,116.95560000000003,117.41860000000017,117.28000000000006,117.28000000000006,119.90526950997123,114.65473049002888,18578433,56.09657068345598,52.72538901427862,NaN,NaN,NaN,NaN,NaN,NaN,0.061182795798222375,0.14358107839689183,0.08239828259866945,78.08857808857785,63.32556332556317,4648803837,12129664286.290472,28.028721847242892,23.17623345313979,8.453475101890312,50,71.42857142857143
2016-12-09,119.03,119.5402,119,119.5,113.64899358026373,116.02468864238921,117.2158969579867,117.58233065645669,112.53330000000012,117.01620000000003,117.45180000000016,117.46750000000006,117.46750000000006,120.16359254291953,114.77140745708058,21863133,59.782649608271896,53.247614755075645,NaN,NaN,NaN,NaN,NaN,NaN,0.16921740922734177,0.29392004413284667,0.1247026349055049,99.06948752372578,83.45051293525891,4670666970,12148273446.885437,30.228122814906833,21.934478143426933,9.473439284308276,100,64.28571428571429
2016-12-12,118.95,119.21,118.47,118.96,113.70183941528599,116.08281361976763,117.28429315571272,117.71353726060367,112.61560000000014,117.07400000000001,117.45660000000018,117.62550000000006,117.62550000000006,120.2822760537888,114.96872394621131,23259310,56.80060169999615,53.21012713962199,NaN,NaN,NaN,NaN,NaN,NaN,0.19246232715590728,0.365280543850389,0.17281821669448172,86.57006620063875,87.90937727098078,4647407660,12155817006.885437,28.483327334850415,23.638505888964474,9.828942154954948,92.85714285714286,57.142857142857146
2016-12-13,119.35,121.11,119.32,120.46,113.76908479423837,116.16949057779203,117.4088306790181,117.97510514054618,112.68895000000013,117.14210000000001,117.4948000000002,117.91700000000006,117.91700000000006,120.47255160385905,115.36144839614107,54477889,62.40974922698522,53.47747694549239,NaN,NaN,NaN,NaN,62.40974922698522,NaN,0.29109354319917785,0.536685145693454,0.2455916024942762,88.96434634974524,91.5346333580366,4701885549,12170729948.567001,35.36162416172291,20.923595034163718,10.955053631383777,100,50
2016-12-14,120.56,121,119.86,120.21,113.83317350275341,116.2495006653605,117.5186804563115,118.18795227001797,112.76085000000013,117.2076,117.5316000000002,118.11650000000004,118.11650000000004,120.73322524350421,115.49977475649588,28745991,60.98840306986536,53.82427439275317,NaN,NaN,NaN,NaN,NaN,NaN,0.3194606463520896,0.6449174104343882,0.3254567640822986,84.71986417657037,86.75142557565145,4673139558,12159635004.672264,33.185258660635974,19.63583205747444,12.678660401843256,92.85714285714286,42.857142857142854
2016-12-15,120.37,121.11,120.08,120.4,113.89851505993994,116.33168877099692,117.63167337959341,118.39862348239721,112.83470000000014,117.2737,117.56380000000019,118.29100000000005,118.29100000000005,121.02544619621334,115.55655380378677,22762305,61.70227236736197,54.1107922560358,NaN,NaN,NaN,NaN,NaN,NaN,0.3296521710122122,0.7375219778475639,0.4078698068353517,87.94567062818346,87.20996038483302,4695901863,12151016267.827604,31.913661586013525,18.526383100472643,14.299273815316923,85.71428571428571,35.714285714285715
2016-12-16,120.28,120.5817,119.36,119.6,113.95524625337337,116.3964078052346,117.70886265882504,118.51304029359748,112.90435000000014,117.32390000000001,117.58120000000021,118.38300000000007,118.38300000000007,121.16322373199898,115.60277626800115,26283907,56.97480145455479,54.16864529950332,NaN,NaN,NaN,NaN,NaN,NaN,0.2639865074701323,0.737852941173017,0.4738664337028847,74.36332767402368,82.34295415959251,4669617956,12135059180.308655,29.765424866024258,21.24640036634459,15.030413681082267,78.57142857142857,28.571428571428573
2016-12-19,119.74,120.83,119.55,120.09,114.01628857921045,116.46954824473491,117.80224059377308,118.66322693230249,112.97970000000014,117.37500000000001,117.6136000000002,118.52150000000006,118.52150000000006,121.35163974919575,115.69136025080437,21138658,59.04460715798344,54.24450446647277,NaN,NaN,NaN,NaN,NaN,NaN,0.23594043822637023,0.7687919814858475,0.5328515432594773,82.68251273344659,81.66383701188458,4690756614,12131756264.996155,29.033619637381992,19.746617803777358,15.582126241176102,71.42857142857143,21.428571428571427
2016-12-20,120.43,120.77,120.33,120.55,114.08130063314866,116.55034926959165,117.9099958646055,118.84291960541654,113.06170000000014,117.42820000000002,117.6402000000002,118.62200000000007,118.62200000000007,121.58716171565219,115.65683828434796,11461799,60.94410884238212,55.017558905690485,NaN,NaN,NaN,NaN,NaN,NaN,0.2304915372707499,0.8209659648479146,0.5904744275771647,90.49235993208823,82.5127334465195,4702218413,12131756264.996155,27.90659498786909,18.98009522452881,16.91590879193621,64.28571428571429,14.285714285714286
2016-12-21,120.57,120.68,120.19,120.46,114.14477027858996,116.62776809593637,118.00999602677784,118.99692726204354,113.13990000000014,117.4744,117.69900000000021,118.70000000000007,118.70000000000007,121.77051135805915,115.629488641941,7079300,60.35430687773096,56.35959476143722,NaN,NaN,NaN,NaN,NaN,NaN,0.2038666920734148,0.8453077926689332,0.6414411005955184,88.96434634974524,87.37973967176003,4695139113,12132478642.547174,27.090535766526607,19.260570002125622,16.608374768703754,57.142857142857146,7.142857142857143
2016-12-22,120.46,120.5,119.65,120.12,114.20422530069354,116.69692120294754,118.0927412806297,119.10388657042034,113.21720000000013,117.52600000000002,117.75300000000021,118.78500000000005,118.78500000000005,121.91337657579481,115.65662342420529,16644996,58.0680105338763,57.45316526493952,NaN,NaN,NaN,NaN,NaN,NaN,0.1489458242686592,0.8276233809313425,0.6786775566626833,81.46067415730347,86.97246014637899,4678494117,12134241053.888351,25.68726884690064,21.55365869372478,15.677521350407988,50,0
2016-12-23,119.96,120.25,119.81,120.2,114.26388475043788,116.76628909991886,118.17537887746775,119.20827832561841,113.28575000000014,117.57460000000003,117.8170000000002,118.85500000000006,118.85500000000006,122.04365802493474,115.66634197506538,9007470,58.46668334787651,58.25150422051002,NaN,NaN,NaN,NaN,NaN,NaN,0.10563254146264378,0.8107182334909879,0.7050856920283441,81.1128868226065,83.84596910988508,4687501587,12141201371.615623,24.966334184531807,20.94873725401133,15.555962465684418,42.857142857142854,0
2016-12-27,120.44,121.52,120.41,120.82,114.32911972804547,116.84656060289076,118.27908950972392,119.36177562794046,113.35650000000014,117.62610000000002,117.89060000000022,118.96950000000007,118.96950000000007,122.265894848916,115.67310515108413,16110554,61.52013520405099,59.17065805828622,NaN,NaN,NaN,NaN,61.52013520405099,NaN,0.10608600244632116,0.8376931950862456,0.7316071926399245,86.61081463629229,83.06145853873409,4703612141,12136992307.957966,30.889420302389638,19.207144101733633,16.492605700459496,100,7.142857142857143
2016-12-28,121.06,121.19,119.795,119.88,114.3843523675674,116.9066287097642,118.34187031326415,119.41113033004137,113.42275000000014,117.65710000000003,117.9518000000002,119.01650000000006,119.01650000000006,122.33659201679353,115.6964079832066,17975235,54.9268751813225,59.14855537540809,NaN,NaN,NaN,NaN,NaN,NaN,0.03415049234646639,0.7742953080730075,0.7401448157265411,50.8982035928142,72.87396835057099,4685636906,12121207603.388073,28.219360513423798,21.357656785357467,17.060379252773515,92.85714285714286,0
2016-12-29,119.86,120.13,119.33,119.71,114.43734388629808,116.96214101254115,118.39552245784203,119.43959410813267,113.48340000000013,117.68770000000002,117.98880000000021,119.12700000000007,119.12700000000007,122.38436150894715,115.86963849105298,13267519,53.80381825527191,58.984787344823516,NaN,NaN,NaN,NaN,NaN,NaN,-0.030324278854291564,0.7022394671586767,0.7325637460129683,40.655737704917904,59.38825197800813,4672369387,12120544227.438072,26.78924172573342,23.22097570357706,16.893127451558748,85.71428571428571,0
2016-12-30,119.93,119.95,118.14,118.48,114.47756932026526,116.9921976261542,118.39883530263255,119.34820419307242,113.53820000000013,117.70330000000001,118.00140000000022,119.27750000000006,119.27750000000006,122.09331160590887,116.46168839409125,41749028,46.40999194099771,58.02959751144679,NaN,NaN,46.40999194099771,NaN,NaN,NaN,-0.1543205378870287,0.5396630736541823,0.693983611541211,10.05917159763325,33.871037631788454,4630620359,12094479917.13973,23.8448667662422,27.894836764040715,16.316555083239923,78.57142857142857,100
2017-01-03,119.31,119.99,118.89,119.54,114.52794176483974,117.04264915830956,118.44358685939206,119.36647046039886,113.59905000000013,117.73250000000002,118.03800000000021,119.46950000000007,119.46950000000007,121.75760380008762,117.18139619991251,22307608,52.4716857530419,57.72038922952148,NaN,NaN,NaN,NaN,NaN,NaN,-0.16262944571327387,0.4906968043996187,0.6533262501128926,41.42011834319549,30.71167588191555,4652927967,12098535845.867004,21.939977096104553,25.387904464917906,16.17298411881825,71.42857142857143,92.85714285714286
2017-01-04,119.67,120.41,119.6561,120.19,114.58428065275179,117.10497293735294,118.51207364921981,119.44490184512277,113.66105000000012,117.76320000000001,118.07880000000021,119.64900000000007,119.64900000000007,121.53673832931689,117.76126167068325,19749074,55.775143669868456,57.24648883258457,NaN,NaN,NaN,NaN,NaN,NaN,-0.12378677312356856,0.49859278370843185,0.6223795568320004,60.650887573964496,37.376725838264406,4672677041,12106758732.627317,23.33097753842295,24.04697415721689,14.448676828464636,64.28571428571429,85.71428571428571
2017-01-05,120.16,120.95,120.1,120.87,114.64682512386868,117.17952792869248,118.60454134925041,119.58062547892061,113.72480000000013,117.79990000000002,118.1048000000002,119.84850000000009,119.84850000000009,121.32126983943647,118.3757301605637,20644254,58.98673962600802,57.10351287230903,NaN,NaN,NaN,NaN,NaN,NaN,-0.055229935478700254,0.5533421374836252,0.6085720729623254,80.769230769231,60.94674556213033,4693321295,12123517009.403788,25.447313340805017,22.78096782320401,13.011323033918003,57.142857142857146,78.57142857142857
2017-01-06,120.99,122.25,120.685,121.93,114.71929452562124,117.27359668257975,118.73495149241707,119.80437543330912,113.79830000000013,117.84220000000003,118.1596000000002,120.02700000000007,120.02700000000007,121.59703312066219,118.45696687933795,24074305,63.44333016528603,57.227874143589325,NaN,NaN,NaN,NaN,NaN,NaN,0.052733894895089284,0.6744894415811871,0.6217555466860978,92.21411192214129,77.87807675511226,4717395600,12137746231.2089,30.89365627528181,20.627662749352968,12.53880495084411,100,71.42857142857143
2017-01-09,122.03,122.55,121.95,122.33,114.79502293830163,117.3737234809445,118.87593378683208,120.04491110632729,113.87365000000013,117.89500000000002,118.2386000000002,120.21500000000006,120.21500000000006,121.93541274117058,118.49458725882954,18909234,64.98935804836955,57.800342471718956,NaN,NaN,NaN,NaN,NaN,NaN,0.13749777314798572,0.79362776312108,0.6561299899730942,95.01133786848075,89.33156018661766,4736304834,12142788693.6089,31.571767300084996,19.828057575795018,12.977923860276203,100,64.28571428571429
2017-01-10,122.37,122.97,122.1,122.6,114.87268440160211,117.47721410508422,119.02197559911318,120.28825290572469,113.95110000000011,117.94840000000002,118.33380000000021,120.37000000000008,120.37000000000008,122.34461895057395,118.3953810494262,16176631,66.03357092308147,58.29955416922595,NaN,NaN,NaN,NaN,NaN,NaN,0.19466722677134485,0.8994640234372753,0.7047967966659304,92.33954451345745,93.18833143469317,4752481465,12145205891.344532,32.49612001120792,18.730834467923728,13.537404245794223,100,57.142857142857146
2017-01-11,122.63,122.93,122.02,122.93,114.95285669611354,117.58519006339938,119.17523145797148,120.53984786708425,114.02160000000012,118.00480000000002,118.45040000000022,120.56850000000009,120.56850000000009,122.72595475038408,118.4110452496161,20685983,67.3166413874242,58.754735065300395,NaN,NaN,NaN,NaN,NaN,NaN,0.23492948624490362,0.99845865447206,0.7635291682271563,99.17184265010368,95.50757501068063,4773167448,12165891874.344532,30.589376727572727,18.147616702406243,14.000969857141774,92.85714285714286,50
2017-01-12,122.49,122.819,121.6,122.74,115.03034070908754,117.68726550768851,119.3150263027569,120.74938616545718,114.08850000000011,118.05960000000003,118.56540000000022,120.68250000000008,120.68250000000008,123.03693305276782,118.32806694723233,19622511,65.77603168212906,59.1420011227574,NaN,NaN,NaN,NaN,NaN,NaN,0.22876339279460645,1.0494834092204144,0.8207200164258079,95.23809523809516,95.5831608005521,4753544937,12182971024.607862,28.00317214168169,19.283179851417877,14.111548114235395,85.71428571428571,42.857142857142854
2017-01-13,122.81,123.37,122.8,123.16,115.11123284133542,117.79563648773428,119.46580958500174,120.97896843541363,114.15830000000011,118.11770000000003,118.70640000000023,120.83000000000007,120.83000000000007,123.40668003445796,118.25331996554218,16930803,67.54427442808372,59.81887711520079,NaN,NaN,NaN,NaN,67.54427442808372,NaN,0.2322275208884903,1.1110044175364209,0.8787768966479306,95.98470363288703,96.79821384036195,4770475740,12187426499.081547,30.4614559595363,18.485907652568066,15.234127756434889,100,35.714285714285715
2017-01-17,122.79,123.03,122.4342,122.79,115.18763848470522,117.89453477510588,119.59616999343304,121.15144763204091,114.22045000000011,118.17000000000003,118.85860000000022,120.94950000000006,120.94950000000006,123.65384816545036,118.24515183454976,14538484,64.38814676172458,60.24183878761851,NaN,NaN,64.38814676172458,NaN,NaN,NaN,0.19060084204813044,1.1170279492080937,0.9264271071599632,88.91013384321228,93.37764423806482,4755937256,12190252206.445091,28.975128709690416,20.04309289880516,15.910685397892506,92.85714285714286,28.571428571428573
2017-01-18,122.96,123.16,122.66,123.04,115.26577143510616,117.99642517559883,119.73122215055331,121.33130976232273,114.28595000000013,118.23240000000004,119.03840000000022,121.12150000000005,121.12150000000005,123.89728295260461,118.3457170473955,12499663,65.55916239869165,60.53034073009284,NaN,NaN,NaN,NaN,NaN,NaN,0.16202679195844483,1.1289605971080192,0.9669338051495744,93.69024856596562,92.861695347355,4768436919,12196752031.205091,28.871193206194874,19.342891611627422,15.656611823168566,85.71428571428571,21.428571428571427
2017-01-19,123.19,123.65,122.72,122.98,115.34252992828918,118.09510982558697,119.85862520347278,121.48832788019676,114.35645000000014,118.29610000000004,119.22500000000022,121.26600000000008,121.26600000000008,124.11195432148041,118.42004567851974,12710659,65.0066754784959,61.25032646560522,NaN,NaN,NaN,NaN,NaN,NaN,0.12297900800333983,1.1206575651537491,0.9976785571504093,87.8402903811252,90.14689093010104,4755726260,12191148407.344877,30.428836431333252,18.077856097263055,16.48674982498715,100,14.285714285714286
2017-01-20,123.51,123.83,122.92,123.25,115.42121122253506,118.19718685874366,119.99162029353268,121.65610617732088,114.41935000000012,118.36080000000004,119.36300000000021,121.40100000000007,121.40100000000007,124.35248708280395,118.44951291719619,22091039,66.3797276184044,62.14860570582896,NaN,NaN,NaN,NaN,NaN,NaN,0.10019297495414214,1.122919775843087,1.022726800888945,89.80667838312831,90.44573911007306,4777817299,12185079440.586636,29.74228388988898,16.9123152149043,17.941380341563917,100,7.142857142857143
2017-01-23,123.16,123.53,122.57,123.35,115.50010464320636,118.29922276253092,120.12332145849219,121.81742939852842,114.49070000000015,118.42490000000005,119.4878000000002,121.54550000000006,121.54550000000006,124.58036062282281,118.51063937717731,17434167,66.89778727044208,63.61201965793213,NaN,NaN,NaN,NaN,NaN,NaN,0.07771661092899795,1.1198725645501924,1.0421559536211944,90.28340080971651,89.31012319132334,4795251466,12195975794.961636,27.712408480822464,18.246307643685363,18.853478838132656,92.85714285714286,0
2017-01-24,123.59,124.37,123.3847,124.18,115.5864717611844,118.41567379693625,120.28240689149249,122.0424361224781,114.56660000000012,118.50110000000004,119.61840000000021,121.74850000000006,121.74850000000006,124.91508349012994,118.58191650987018,17640869,70.90514014938164,64.9286949719564,NaN,NaN,NaN,NaN,NaN,NaN,0.10302235230162404,1.1709338939982246,1.0679115416966005,95.969367190649,92.01981546116463,4812892335,12206813121.669949,31.670334168152024,16.92462342577853,20.50054485335919,100,0
2017-01-25,124.94,125.46,124.85,125.43,115.68441731579948,118.55457134551176,120.48427328790454,122.36506125367066,114.65075000000013,118.59100000000007,119.81200000000021,122.01000000000008,122.01000000000008,125.4719127660799,118.54808723392026,15036221,75.6801847946226,66.35048362372456,NaN,NaN,NaN,NaN,NaN,NaN,0.1835190328890821,1.2973103328079532,1.113791299918871,99.44029850746293,95.23102216927616,4827928556,12220370370.112572,36.43933072883312,15.415563149759103,23.288560177127632,100,0
2017-01-26,125.59,125.82,125.3438,125.56,115.78268182011988,118.69329270500658,120.68332139426123,122.66934113427345,114.73100000000014,118.67920000000005,120.00720000000021,122.24700000000007,122.24700000000007,125.98831581130989,118.50568418869025,16052150,76.11914888155576,67.57422714197796,NaN,NaN,NaN,NaN,NaN,NaN,0.2224944954655499,1.3919094192508084,1.1694149237852585,94.93670886075967,96.78212485295721,4843980706,12218893922.884516,37.78997588266679,14.883862339611929,25.999853450559822,100,0
2017-01-27,125.8,125.9211,125.39,125.8,115.88235662787987,118.83401958213517,120.88397545723137,122.9674991214855,114.80545000000012,118.76600000000006,120.23060000000021,122.54300000000008,122.54300000000008,126.42258812246259,118.66341187753757,15052983,76.94644171183555,68.53873510958864,NaN,NaN,NaN,NaN,76.94644171183555,NaN,0.23991493789901264,1.4693085961590242,1.2293936582600116,97.19747286570554,97.1914934113094,4859033689,12227082224.124771,37.043965187880524,14.291801290541242,27.742323231992348,100,0
2017-01-30,125.37,125.38,124.13,124.82,115.97128840272684,118.95255384783546,121.03832936086935,123.14392777658212,114.87495000000011,118.83570000000005,120.4026000000002,122.79850000000006,122.79850000000006,126.56968694842435,119.02731305157577,25006715,66.77417969214422,68.66622236985826,NaN,NaN,NaN,NaN,NaN,NaN,0.16450753838787202,1.4350280812448517,1.2705205428569797,74.51806253037417,88.88408141894648,4834026974,12229682922.484772,32.646411508229406,21.551891038306408,27.572499940835886,92.85714285714286,21.428571428571427
2017-01-31,124.4,124.6,123.85,124.57,116.05684772210269,119.06379040530406,121.1768262486784,123.2797441788124,114.94460000000012,118.90220000000005,120.5558000000002,123.10300000000007,123.10300000000007,126.38152466819362,119.82447533180651,19091133,64.43403379770436,68.55196971804561,NaN,NaN,64.43403379770436,NaN,NaN,NaN,0.08108237503762905,1.371873511654016,1.290791136616387,68.73249866932026,80.14934468846667,4814935841,12247246764.844772,30.389777402657902,22.05746639693734,26.787918246132506,85.71428571428571,14.285714285714286
2017-02-01,125.42,125.68,124.86,125.43,116.15011291889769,119.18985396163467,121.3436173761812,123.48453044749692,115.01560000000012,118.98420000000006,120.7092000000002,123.39750000000006,123.39750000000006,126.38845218951606,120.40654781048407,22861876,68.5209781753268,68.63799377432437,NaN,NaN,NaN,NaN,NaN,NaN,0.06765792126293868,1.3753635381950602,1.3077056169321215,88.63483835134599,77.29513318368015,4837797717,12256168472.55209,35.64187626779891,20.326001915610444,26.919139855992587,78.57142857142857,7.142857142857143
2017-02-02,125.21,125.7,124.86,125.32,116.2413555764211,119.31124299209735,121.49955394966429,123.65933707154484,115.08945000000011,119.09460000000004,120.8692000000002,123.65400000000007,123.65400000000007,126.36770890110904,120.9402910988911,15101363,67.45328579614295,68.75779763961107,NaN,NaN,NaN,NaN,NaN,NaN,0.03675494816933744,1.3536493021437934,1.316894353974456,82.76119188964398,80.04284297010344,4822696354,12257606697.599709,33.642002801803514,19.103864128966592,27.570696244261814,71.42857142857143,0
2017-02-03,125.49,125.81,125.33,125.68,116.33527243635722,119.43735699225384,121.66349301046176,123.85178115996914,115.16465000000012,119.18810000000005,121.01200000000019,123.89450000000006,123.89450000000006,126.42504519816723,121.3639548018329,16957154,69.14764470975439,68.87232408830184,NaN,NaN,NaN,NaN,NaN,NaN,0.026427292728810725,1.3499284698854694,1.3235011771566587,93.08554876824718,88.16052633641239,4839653508,12265378726.516376,33.23460830949748,18.408537327448542,27.873732987150476,64.28571428571429,7.142857142857143
2017-02-06,125.42,125.85,125.35,125.83,116.429747337488,119.56394398250625,121.82688544142405,124.04018295425779,115.24055000000011,119.29350000000005,121.1506000000002,124.08950000000007,124.08950000000007,126.5852842454742,121.59371575452595,11630139,69.85190242783413,69.2625923501668,NaN,NaN,NaN,NaN,NaN,NaN,0.016075297999383675,1.3435952996558882,1.3275200016565045,97.28148966011169,91.0427434393343,4851283647,12276078454.396378,32.26411872453729,17.700569383919387,28.654148381754034,57.142857142857146,0
2017-02-07,126.06,126.55,125.97,126.29,116.52785930427916,119.69713321057543,122.00190954176037,124.25445124432848,115.32710000000012,119.39800000000005,121.30800000000018,124.28750000000007,124.28750000000007,126.82154715819605,121.75345284180408,17541101,71.96534188560086,69.72017659923173,NaN,NaN,NaN,NaN,NaN,NaN,0.02599755347243149,1.360016943497044,1.3340193900246125,93.46733668341732,94.61145837059208,4868824748,12277893051.05155,35.92020354354107,16.704315190405612,29.85076270320144,100,21.428571428571427
2017-02-08,126.12,126.68,125.88,126.5,116.6270845848336,119.83184344402939,122.17830524600507,124.4683130305829,115.41470000000012,119.48660000000005,121.46200000000017,124.48250000000004,124.48250000000004,127.06683647190005,121.89816352810004,12569147,72.89936061077104,70.28393982296568,NaN,NaN,NaN,NaN,NaN,NaN,0.03209350552968626,1.3741362719367203,1.342042766407034,95.62043795620423,95.45642143324442,4881393895,12284806081.90155,34.67904320863877,15.650297961242451,30.73262181939554,100,14.285714285714286
2017-02-09,126.63,127.24,126.56,126.96,116.72989966359147,119.9729950589991,122.3658226873382,124.70561655147976,115.50725000000011,119.58330000000005,121.63060000000017,124.68400000000004,124.68400000000004,127.37879795160755,121.98920204839253,17542726,74.87408051181028,70.89067931535182,NaN,NaN,NaN,NaN,NaN,NaN,0.05135291321728275,1.4062339079286374,1.3548809947113547,94.00428265524623,94.36401909828926,4898936621,12287901857.07802,37.10352698493313,14.72476112521782,31.85253392509285,100,7.142857142857143
2017-02-10,127.2,127.56,127.02,127.38,116.83587081121742,120.11966842416744,122.5624570917563,124.96031973705313,115.60625000000013,119.68930000000005,121.79940000000016,124.91600000000003,124.91600000000003,127.69889345825649,122.13310654174356,13915697,76.55393647374483,71.58040425844486,NaN,NaN,NaN,NaN,NaN,NaN,0.0751835596702648,1.4488604442991857,1.373676884628921,95.68893253179397,95.10455104774815,4912852318,12292540422.744686,37.90046049650604,14.001729972615781,33.670301181955594,100,0
2017-02-13,127.76,128.26,127.7199,128.1,116.94795169866799,120.27769479200572,122.77961563717763,125.25933690495283,115.71535000000013,119.80030000000005,122.01140000000018,125.16299999999998,125.16299999999998,128.1481840814323,122.17781591856765,19120150,79.12991473680052,72.16788815754622,NaN,NaN,NaN,NaN,NaN,NaN,0.1196040687611799,1.5231819705803957,1.4035779018192158,96.37188208616787,95.3550324244027,4931972468,12300332211.330133,40.89787725545397,12.993949300949609,35.201268709199304,100,0
2017-02-14,128.15,128.535,127.74,128.53,117.0631959603728,120.44110677632244,123.00512090630792,125.57082862829066,115.82940000000012,119.90410000000006,122.27260000000017,125.45,125.45,128.56816612771368,122.33183387228631,16333480,80.50732804052143,72.51268410368185,NaN,NaN,NaN,NaN,NaN,NaN,0.15582158400042312,1.5983548818197448,1.4425332978193217,99.89327641408761,97.31803034401649,4948305948,12316460238.751516,40.48515254435378,12.143593483529623,36.15186884728293,100,28.571428571428573
2017-02-15,128.44,129.35,128.37,129.29,117.18485570206063,120.6163323847121,123.25158675311938,125.9250354255963,115.94225000000013,120.00610000000005,122.54440000000017,125.7625,125.7625,129.09714165991292,122.42785834008708,17891355,82.68277353453756,72.98151443603768,NaN,NaN,NaN,NaN,NaN,NaN,0.20570371976681545,1.699662947527841,1.4939592277610256,98.90909090909086,98.39141646978213,4966197303,12332160815.588251,43.8965167703959,11.172926841905758,37.29013382713777,100,21.428571428571427
2017-02-16,129.36,129.63,128.92,129.25,117.3049068891048,120.78729609986631,123.48681864515392,126.24169871839666,116.05985000000011,120.11530000000005,122.79740000000017,126.076,126.076,129.48345887723355,122.66854112276644,15098286,82.16303562983015,73.35412828732301,NaN,NaN,NaN,NaN,NaN,NaN,0.21001269952766877,1.7564751021706115,1.5464624026429428,93.42560553633226,97.40932428650358,4951099017,12331097556.010786,43.63470390480091,10.517033676794654,38.492767653133264,100,14.285714285714286
2017-02-17,129.09,129.82,129.04,129.81,117.42933567627789,120.96596350382936,123.7347865414224,126.58153693569221,116.18365000000013,120.24000000000005,123.05600000000015,126.40400000000002,126.40400000000002,129.921347864514,122.88665213548606,15563730,83.70714892340078,74.56362608955563,NaN,NaN,NaN,NaN,NaN,NaN,0.22334336103088104,1.825641603931544,1.602298242900663,99.83249581239546,97.38906408593952,4966662747,12346262216.010786,42.382899534876884,9.83403650753317,41.483030776659525,100,7.142857142857143
2017-02-21,130.03,130.53,129.99,130.45,117.55889452527015,121.15376620672383,123.99812824568033,126.9499619894358,116.31080000000011,120.35950000000004,123.29780000000015,126.75900000000001,126.75900000000001,130.40266244320247,123.11533755679756,18479628,85.27593123691989,76.0523330494996,NaN,NaN,NaN,NaN,NaN,NaN,0.24622619097518417,1.9100809816196431,1.663854790644459,98.5890652557317,97.28238886815313,4985142375,12359266398.677452,45.792733801956715,9.237673334544171,45.093029956255755,100,0
2017-02-22,130.32,130.59,130.111,130.5,117.68766174392418,121.33884014322435,124.25310360859483,127.28806084758477,116.4354000000001,120.47750000000003,123.53640000000016,127.075,127.075,130.8625612206283,123.2874387793717,12110876,85.39425285175672,77.25756695495888,NaN,NaN,NaN,NaN,85.39425285175672,NaN,0.23568295833627384,1.9584584885648013,1.7227755302285275,98.42931937172769,98.95029347995161,4997253251,12366826214.802713,44.407557898789975,8.85302963855779,47.906624365665834,100,0
2017-02-23,130.7,130.7,129.49,130.01,117.81027207483041,121.51054627900209,124.47886425139502,127.5472931478148,116.55605000000013,120.59920000000004,123.74660000000014,127.304,127.304,131.21775727402846,123.39024272597156,17489023,78.7181660061226,78.0622012556717,NaN,NaN,NaN,NaN,NaN,NaN,0.16974290332009678,1.9349541593786483,1.7652112560585516,87.15083798882684,94.72307420542874,4979764228,12364369079.339903,39.8891508729606,13.17422004272466,49.53396158222485,100,0
2017-02-24,129.47,130.26,129.38,130.26,117.9341499646331,121.68380278832878,124.70557545722266,127.80564618135625,116.67070000000011,120.71460000000005,123.97260000000014,127.53899999999999,127.53899999999999,131.56837662672964,123.50962337327034,18624489,79.59469258261832,78.80841896087627,NaN,NaN,NaN,NaN,NaN,NaN,0.1193760727103137,1.9144313469464436,1.7950552742361299,91.77570093457948,92.45195276504467,4998388717,12382993568.339903,36.94496198743369,13.124456357292832,50.881552224831296,92.85714285714286,0
2017-02-27,130.02,130.43,129.8,130.42,118.05838727841784,121.85679679252029,124.92967053733157,128.05463225932232,116.7910000000001,120.83330000000004,124.17180000000015,127.76999999999998,127.76999999999998,131.9025101330828,123.63748986691715,12008672,80.15795039704108,79.54456524439105,NaN,NaN,NaN,NaN,NaN,NaN,0.07539487798217448,1.889298871713848,1.8139039937316734,94.19087136929457,91.03913676423365,5010397389,12394621012.657362,36.408655476129134,12.417815659056796,52.30921081932202,85.71428571428571,0
2017-02-28,130.39,130.45,129.66,130.02,118.17740830052314,122.01844438078722,125.12929130057347,128.24181013938687,116.9116500000001,120.94980000000005,124.36800000000015,128.03,128.03,132.03989276664862,124.02010723335138,16598581,74.61293329880323,79.73367891676266,NaN,NaN,NaN,NaN,NaN,NaN,0.0018119111018202183,1.8161688826089488,1.8143569715071286,85.89211618257305,90.61956282881572,4993798808,12393150252.31559,33.94084820157165,12.77730483778307,52.93673830756908,78.57142857142857,7.142857142857143
2017-03-01,130.81,131.68,130.6,131.44,118.3093743870851,122.20500983859341,125.3767700731,128.54639964992145,117.0413500000001,121.07630000000003,124.58880000000016,128.37349999999998,128.37349999999998,132.31539941526174,124.43160058473822,25813827,79.92269217668354,80.23534545718498,NaN,NaN,NaN,NaN,NaN,NaN,0.02967648606825901,1.8514525790924523,1.8217760930241933,95.31249999999983,91.79849585062249,5019612635,12407491267.31559,39.2808921697734,11.0781277342583,54.23637754021722,100,0
2017-03-02,131.43,131.43,130.62,130.78,118.43346021407928,122.3748116239678,125.58866144278235,128.75912349278607,117.16115000000009,121.19680000000004,124.81240000000014,128.64100000000002,128.64100000000002,132.47215596132423,124.8098440386758,19951386,72.34856691586124,80.05495162890291,NaN,NaN,NaN,NaN,NaN,NaN,-0.013142671620376856,1.8053477534987223,1.8184904251190992,80.68669527896988,87.29710382051427,4999661249,12395421910.352627,36.68560441562624,10.34619605808007,55.15242978563582,92.85714285714286,0
2017-03-03,130.65,131.06,130.341,131.02,118.55869941592923,122.54600347299814,125.80165511169285,128.9744450649017,117.2888500000001,121.32230000000003,125.03100000000015,128.926,128.926,132.5700329306986,125.28196706930137,13722749,73.33804539490451,79.82524512327144,NaN,NaN,NaN,NaN,NaN,NaN,-0.04055452032143125,1.76779727471731,1.8083517950387413,83.33375419812644,86.44431649236539,5013383998,12407617788.810207,34.53125446268427,12.017364949524284,55.31819327629525,85.71428571428571,0
2017-03-06,130.56,130.95,130.21,130.73,118.67980688442745,122.7080628101665,125.99492353868528,129.1416407730063,117.41320000000009,121.43740000000004,125.23460000000016,129.1785,129.1785,132.57960731968186,125.77739268031819,12026151,70.07499900308372,79.17846542800598,NaN,NaN,NaN,NaN,NaN,NaN,-0.09060332170159513,1.6950976429117475,1.7857009646133426,75.88832487309608,79.96959145006413,5001357847,12412493255.43183,32.23465918484178,12.293736120873028,54.81853793474744,78.57142857142857,0
2017-03-07,130.45,131.08,130.28,130.51,118.7975202487615,122.86255661590577,126.17198536069763,129.27196069938665,117.5392000000001,121.56730000000005,125.43560000000016,129.4125,129.4125,132.48830802392249,126.33669197607752,15500945,67.61712298636306,78.25773649556608,NaN,NaN,67.61712298636306,NaN,NaN,NaN,-0.14754314583574502,1.6012720323186613,1.7488151781544063,64.65256797583037,74.62488234901764,4985856902,12405905353.80683,31.178616835591544,11.48153826141144,54.26998176604102,71.42857142857143,0
2017-03-08,130.57,131.15,130.46,130.74,118.91635089305242,123.01854559380862,126.35112318968989,129.41177396611172,117.6605500000001,121.70050000000005,125.64800000000015,129.63500000000002,129.63500000000002,132.40357725194474,126.8664227480553,15776027,68.84734031744448,77.26949126577372,NaN,NaN,NaN,NaN,NaN,NaN,-0.1767630204688806,1.5278614025683055,1.704624423037186,65.94202898550756,68.82764061147802,5001632929,12402933058.864801,29.962508192342856,10.817708073622303,53.378830688035364,64.28571428571429,0
2017-03-09,130.71,131.02,130.14,130.84,119.03499416774842,123.17342587907974,126.52715757440794,129.5477954931487,117.7831000000001,121.83890000000002,125.86080000000014,129.852,129.852,132.26061453952667,127.44338546047332,20855253,69.39179423880226,76.35725973784317,NaN,NaN,NaN,NaN,NaN,NaN,-0.19497023128478586,1.4609116339312038,1.6558818652159897,68.18181818181823,66.25880504771874,5022488182,12415256617.45571,27.758227407266915,12.697070058444377,51.66968533579296,57.142857142857146,0
2017-03-10,131.42,131.6,130.82,131.39,119.15792954916387,123.33613031711776,126.71785727737233,129.72324354142026,117.8977500000001,121.98140000000004,126.07220000000014,130.07350000000002,130.07350000000002,132.17243568267273,127.97456431732732,21922601,72.26305117533535,75.53982418440991,NaN,NaN,NaN,NaN,NaN,NaN,-0.17615814038039246,1.435684189740499,1.6118423301208915,87.39130434782525,73.8383838383837,5044410783,12425374740.994171,30.815988625763424,11.863937309446165,50.389053263261005,50,0
2017-03-13,131.34,131.64,131.27,131.61,119.28183074767965,123.4999693207392,126.90970601159303,129.90293463271357,118.0096000000001,122.12930000000004,126.30680000000015,130.28500000000003,130.28500000000003,132.08715981533012,128.48284018466993,10731575,73.34034312715872,74.68728217656984,NaN,NaN,NaN,NaN,73.34034312715872,NaN,-0.15578755825623447,1.4171078823005985,1.572895440556833,96.95652173913075,84.17654808959144,5055142358,12434366060.588768,30.167165867542117,11.479157299006793,48.84948954484956,42.857142857142854,21.428571428571427
2017-03-14,131.31,131.36,130.76,131.29,119.40131501884701,123.65422735399189,127.08148224643251,130.03503609626466,118.1182500000001,122.26360000000004,126.53840000000015,130.4445,130.4445,131.9914903037901,128.8975096962099,14019689,69.13424011651085,73.52585269548084,NaN,NaN,NaN,NaN,NaN,NaN,-0.16961447070793723,1.3608773521719115,1.5304918228798488,83.04347826086901,89.13043478260835,5041122669,12445114488.8221,27.926380809885465,15.083233989097078,46.2141546919872,35.714285714285715,14.285714285714286
2017-03-15,131.58,132.405,131.14,132.1,119.52767009328635,123.82147037668511,127.27828686421948,130.23169932519184,118.2281000000001,122.40610000000004,126.81080000000014,130.623,130.623,132.065499220118,129.18050077988198,22709139,73.30725495874262,73.13935904923942,NaN,NaN,NaN,NaN,NaN,NaN,-0.13165033484343347,1.365928904325557,1.4975792391689904,89.91735537190063,89.97245179063346,5063831808,12456872975.814194,33.74366340256318,13.478630475527345,45.68335391895998,100,7.142857142857143
2017-03-16,132.33,132.35,131.71,132.01,119.65187238091534,123.98361947813689,127.46384424209323,130.4010612942212,118.3364500000001,122.54910000000005,127.06020000000015,130.75900000000001,130.75900000000001,132.1859533979831,129.33204660201693,18457291,72.14019692248726,72.60689507351576,NaN,NaN,NaN,NaN,NaN,NaN,-0.12035055568114084,1.3471410445675644,1.4674916002487053,85.61020036429838,86.19034466568934,5045374517,12455719395.126694,31.894951053271818,12.740177441712722,45.350436954322866,92.85714285714286,0
2017-03-17,131.86,132.04,131.62,131.69,119.77165474528434,124.13622107262923,127.62957584044251,130.52381736143823,118.4431500000001,122.68450000000006,127.29020000000016,130.88100000000003,130.88100000000003,132.18276649212362,129.57923350787644,21234529,67.99527474133531,71.73813252667962,NaN,NaN,NaN,NaN,NaN,NaN,-0.14075959123829196,1.2915421112008403,1.4323017024391322,73.95264116575584,83.16006563398496,5024139988,12441563042.460026,30.706025350516263,13.064048605816147,44.71980269194523,85.71428571428571,7.142857142857143
2017-03-20,131.65,132.11,131.4601,131.81,119.89143927518201,124.288177090993,127.7935140427781,130.64631094606315,118.54930000000009,122.80690000000006,127.50900000000016,130.981,130.981,132.24503955635532,129.71696044364467,10105210,68.72105819172701,71.31728430474561,NaN,NaN,NaN,NaN,NaN,NaN,-0.15157263053056247,1.242835914275929,1.3944085448064916,73.73068432671104,77.76450861892175,5034245198,12442338931.025959,28.910193365715998,13.738946376900198,44.024927817560055,78.57142857142857,0
2017-03-21,132.31,132.43,129.73,129.81,119.99013142169761,124.39752011889414,127.87259192345347,130.56666228453332,118.6480500000001,122.91310000000007,127.66660000000016,130.949,130.949,132.29494056332928,129.60305943667075,35841897,48.841218405648085,69.09717903538595,NaN,NaN,48.841218405648085,NaN,NaN,NaN,-0.2907522304904515,1.030968256693427,1.3217204871838786,2.9629629629634073,50.21542948514344,4998403301,12408620998.292625,22.914336078747237,24.179016605914068,40.216504497372334,100,100
2017-03-22,129.89,130.82,129.68,130.69,120.09659777571058,124.52212368089623,127.98307851469059,130.5784087336254,118.74920000000009,123.03620000000006,127.83380000000015,130.95850000000002,130.95850000000002,132.2942735586611,129.62272644133893,29177883,55.00846372929171,67.85860023634527,NaN,NaN,NaN,NaN,NaN,NaN,-0.3186359242486989,0.9234255818730048,1.2420615061217037,36.7272727272724,37.80697333898228,5027581184,12431144276.397888,20.939660740046047,22.473322366170887,36.4685990391119,92.85714285714286,100
2017-03-23,130.52,130.88,130.14,130.36,120.1987211809274,124.6377251921656,128.07629112195764,130.55760790185155,118.8501000000001,123.16140000000007,127.98900000000016,130.97599999999997,130.97599999999997,132.27013136893362,129.68186863106632,20311655,52.45475228261973,66.36693644261064,NaN,NaN,NaN,NaN,NaN,NaN,-0.351792928351895,0.8023203456818351,1.15411327403373,24.727272727272975,21.472502805836267,5007269529,12422909821.66816,20.21058248179687,21.19640668824907,33.18391476342795,85.71428571428571,92.85714285714286
2017-03-24,130.78,131.29,130.13,130.63,120.30251500002264,124.75638409925143,128.17643656815537,130.5645023873895,118.9514000000001,123.29670000000007,128.14300000000014,130.9945,130.9945,132.25736143343164,129.73163856656834,22967566,54.32316501439383,65.2418054434185,NaN,NaN,NaN,NaN,NaN,NaN,-0.34742459073918086,0.7198325356097541,1.067257126348935,34.545454545454135,31.99999999999984,5030237095,12419741881.530228,21.53519266120286,19.34121167373838,30.36854802584306,78.57142857142857,85.71428571428571
2017-03-27,129.73,131.07,129.4,130.84,120.40736559703734,124.87685174085041,128.28089003607084,130.59074025525717,119.0546500000001,123.43520000000008,128.30500000000018,131.0155,131.0155,132.25316675645743,129.77783324354257,18472445,55.77874793920639,64.39620722576446,NaN,NaN,NaN,NaN,NaN,NaN,-0.32280230031159396,0.6637542509594425,0.9865565512710365,47.52475247524743,35.59915991599152,5048709540,12433126108.146994,18.96209219194053,22.25318775924363,27.640909462564878,71.42857142857143,100
2017-03-28,130.81,132.03,130.55,131.64,120.51913310353449,125.01077546875436,128.41261983857788,130.6906697547565,119.1681500000001,123.59050000000006,128.47460000000018,131.0965,131.0965,132.273517841853,129.919482158147,23721947,60.89163275869038,63.82794240013916,NaN,NaN,NaN,NaN,NaN,NaN,-0.24838781240353025,0.6760717857666236,0.9244595981701539,73.92739273927326,51.99919991999161,5072431487,12444345947.94429,23.660795467897657,19.975305179690437,24.89088606253437,64.28571428571429,92.85714285714286
2017-03-29,131.73,132.3,131.59,132.25,120.63585814728042,125.15412644957111,128.56310533510424,130.83917739716065,119.2892500000001,123.76120000000006,128.66380000000018,131.137,131.137,132.41031221624397,129.86368778375603,13168901,64.28271230784358,63.46300797649926,NaN,NaN,NaN,NaN,NaN,NaN,-0.15822470022728363,0.7266787228860494,0.884903423113333,94.05940594059383,71.83718371837152,5085600388,12455660074.155558,24.382430270396924,18.97199894825795,23.1230575092571,57.142857142857146,85.71428571428571
2017-03-30,132.22,132.61,132.08,132.47,120.75361080253136,125.29899523274791,128.71631689059035,130.9944938355263,119.41145000000012,123.94540000000008,128.85240000000016,131.2215,131.2215,132.60809691332048,129.8349030866795,16092374,65.44640695401199,62.9761048178333,NaN,NaN,NaN,NaN,65.44640695401199,NaN,-0.08744541758059421,0.7755966511375902,0.8630420687181845,95.63862928348864,87.8751426544519,5101692762,12463250816.608387,25.706190140684004,18.235682808374364,21.165615675887626,100,78.57142857142857
2017-03-31,132.27,132.74,132.125,132.38,120.86929626718279,125.43921314893112,128.85999073801818,131.1264468035714,119.53475000000012,124.13270000000007,129.04040000000018,131.2895,131.2895,132.76071004619376,129.81828995380624,19841411,64.52029935014255,62.34610169090358,NaN,NaN,NaN,NaN,NaN,NaN,-0.052110080697796546,0.7979044678459388,0.8500145485437354,89.22155688622715,92.97319737010321,5081851351,12459863258.632776,25.494894224557328,17.392175097669504,19.309902978699345,100,71.42857142857143
2017-04-03,132.48,132.81,131.56,132.3,120.98303461278296,125.57507031429881,128.99489306201747,131.23821377465984,119.6560500000001,124.29220000000008,129.22140000000016,131.368,131.368,132.87843834698552,129.85756165301447,23700310,63.65799464509629,61.95494130008825,NaN,NaN,NaN,NaN,NaN,NaN,-0.040085713051902006,0.7999074072288579,0.8399931202807599,85.04398826979498,89.96805814650361,5058151041,12464224115.672777,23.150910047903373,19.94880863315765,17.70764667667549,100,64.28571428571429
2017-04-04,131.9,132.53,131.87,132.51,121.09773078579009,125.71239565460972,129.13274039291875,131.35933627231128,119.78615000000009,124.44620000000008,129.4046000000002,131.468,131.468,133.00260874493569,129.9333912550643,13400022,64.9810602112552,61.36021310383915,NaN,NaN,NaN,NaN,NaN,NaN,-0.02470406058080854,0.8091130445547492,0.8338171051355577,91.20234604105538,88.4892970656925,5071551063,12476812015.127323,22.000751823950022,18.957733713855472,15.173032096456057,92.85714285714286,57.142857142857146
2017-04-05,132.68,133.48,131.72,131.97,121.20591256901606,125.83630861194418,129.2440054755494,131.41749472256734,119.91020000000009,124.58940000000008,129.5604000000002,131.52949999999998,131.52949999999998,133.0408897578222,130.01811024217776,32011155,59.02987469824208,60.423761516393064,NaN,NaN,NaN,NaN,NaN,NaN,-0.05583140097428929,0.7640278539176961,0.8198592548919854,62.99019607843145,79.7455101297606,5039539908,12453894938.252323,25.993317223780082,16.59068471831365,13.684894743570169,100,50
2017-04-06,132.12,132.39,131.7,132.04,121.31371443400099,125.95915398596509,129.35365231964548,131.4767809394657,120.0329000000001,124.75230000000006,129.6926000000002,131.5895,131.5895,133.08179320177314,130.09720679822684,18832193,59.547071259445794,59.82031841054381,NaN,NaN,NaN,NaN,NaN,NaN,-0.07542190446229535,0.7255818743141162,0.8010037787764116,64.70588235294109,72.9661414908093,5058372101,12453622007.91899,24.691672554747658,15.905035669863643,12.351872820477928,92.85714285714286,42.857142857142854
2017-04-07,131.99,132.37,131.5,131.97,121.41974712619998,126.07818063970835,129.4562541894633,131.5237541833261,120.1565500000001,124.91400000000004,129.8208000000002,131.61849999999998,131.61849999999998,133.1166892404036,130.12031075959638,16743064,58.74839817372335,59.10798555211498,NaN,NaN,NaN,NaN,NaN,NaN,-0.09551694667695165,0.6816075954302221,0.7771245421071737,62.99019607843145,63.56209150326799,5041629037,12454969150.999449,23.119622666559295,16.35602044289811,11.034828960263313,85.71428571428571,35.714285714285715
2017-04-10,132.11,132.565,131.6564,132.02,121.52522227917311,126.19584042902106,129.5567932408569,131.571015689676,120.2728000000001,125.08790000000005,129.9452000000002,131.63899999999998,131.63899999999998,133.14734876605596,130.130651233944,15619276,59.1696563336374,59.84573111839993,NaN,NaN,NaN,NaN,NaN,NaN,-0.10699898657182971,0.6433758088923867,0.7503747954642164,64.21568627451016,63.97058823529424,5057248313,12451850796.755117,23.00882979625195,15.263080793711017,12.288632906954348,78.57142857142857,28.571428571428573
2017-04-11,131.86,132.095,130.5,131.45,121.62397628634551,126.29988319280282,129.63103664317623,131.55949038589733,120.40860000000009,125.24020000000004,130.0778000000002,131.647,131.647,133.14954583958067,130.14445416041931,33778359,52.57791166807171,59.67212025688422,NaN,NaN,NaN,NaN,NaN,NaN,-0.15180373520270662,0.560620126460833,0.7124238616635397,50.24509803921546,59.150326797385695,5023469954,12458309981.391481,20.42822337784851,21.68279041036848,12.249094626807773,71.42857142857143,21.428571428571427
2017-04-12,131.45,131.54,130.78,130.92,121.71647403474009,126.39137065433148,129.68158422579677,131.49858653962139,120.5521000000001,125.38030000000005,130.2048000000002,131.588,131.588,133.1073366973937,130.0686633026063,15955195,47.30124567312748,59.30401264192049,NaN,NaN,NaN,NaN,NaN,NaN,-0.21224707516961538,0.4471150177015204,0.6593620928711358,37.25490196078401,50.571895424836555,5007514759,12448233016.128323,19.316508399258684,20.50280121449112,12.291835616283787,64.28571428571429,14.285714285714286
2017-04-13,130.75,131.51,130.38,130.4,121.80287727817552,126.4707494532556,129.7097573934126,131.39395925013363,120.6818000000001,125.50670000000005,130.30420000000018,131.5075,131.5075,133.09781915037698,129.917180849623,23683020,42.76631870058874,58.47852361950583,NaN,NaN,42.76631870058874,NaN,NaN,NaN,-0.27820191080150025,0.3116097043692605,0.5898116151707608,24.50980392156872,37.336601307189405,4983831739,12425388333.119474,17.768205385203768,21.69673528086452,12.619487580957497,57.142857142857146,7.142857142857143
2017-04-17,130.8,131.5,130.72,131.48,121.89916705650212,126.56994253338915,129.7791786721023,131.40215360726376,120.80765000000008,125.64830000000005,130.42740000000018,131.49699999999999,131.49699999999999,133.08513223632897,129.908867763671,13325508,52.87231092161841,58.27092097539241,NaN,NaN,NaN,NaN,NaN,NaN,-0.24141144313430307,0.28804731125288185,0.5294587543871849,35.483870967741815,32.41619228336486,4997157247,12438030481.73486,16.39090347511228,20.01491349316903,12.760155160582782,50,0
2017-04-18,131.01,131.66,130.95,131.28,121.99250867783046,126.66321099807452,129.83803441045123,131.3905199303815,120.92635000000007,125.77570000000006,130.53940000000017,131.47049999999996,131.47049999999996,133.05453882530486,129.88646117469506,12841087,51.07378682137571,57.56964626558421,NaN,NaN,NaN,NaN,NaN,NaN,-0.22328721115020989,0.2503497404494226,0.4736369515996325,29.032258064516366,29.67531098460897,4984316160,12437126179.833452,16.705039182435947,18.991625074108896,12.614414794817389,42.857142857142854,85.71428571428571
2017-04-19,131.85,132.29,131.31,131.49,122.08701107904608,126.75879097831067,129.90281737474726,131.39999422272612,121.04340000000008,125.90160000000007,130.65260000000018,131.5545,131.5545,132.94359286948242,130.16540713051756,17764817,52.88601062692756,56.75559614551879,NaN,NaN,NaN,NaN,NaN,NaN,-0.19113855737088176,0.2347137548860303,0.42585231225691206,35.80645161290373,33.440860215053966,5002080977,12425887213.976309,20.02234408661968,17.612177782448764,12.180457762726501,35.714285714285715,78.57142857142857
2017-04-20,132.04,132.88,131.82,132.59,122.19151843149338,126.87426046388867,130.0081970855415,131.51332810627602,121.16925000000009,126.04330000000006,130.77860000000018,131.6495,131.6495,133.04894953465458,130.2500504653454,21977910,61.028782617095274,56.440051550024734,NaN,NaN,NaN,NaN,NaN,NaN,-0.09465158902941462,0.3075378259701438,0.4021894149995584,71.29032258064555,45.37634408602188,5024058887,12435839475.108385,22.201684696057125,15.900464914426571,12.147373222251327,28.571428571428573,71.42857142857143
2017-04-21,132.7,132.76,132.22,132.56,122.29468740232429,126.98684936559386,130.10826778806927,131.61301114377355,121.29055000000008,126.18090000000008,130.89980000000017,131.7595,131.7595,133.07984048640415,130.43915951359585,22454948,60.720555119307505,56.16864124782223,NaN,NaN,NaN,NaN,NaN,NaN,-0.03479484787481246,0.35869585515604285,0.3934907030308553,70.32258064516164,59.13978494623697,5001603939,12441661128.293571,21.334207604518344,15.279192734098256,11.979126771993318,21.428571428571427,64.28571428571429
2017-04-24,134.02,134.285,133.8042,134.16,122.41275021424146,127.12889195241378,130.26715924736067,131.85558151103322,121.41825000000006,126.33720000000007,131.04380000000018,131.93599999999998,131.93599999999998,133.52219544825562,130.34980455174434,22469948,69.55274235736869,56.58969465584169,NaN,NaN,NaN,NaN,NaN,NaN,0.10306708376395574,0.5223245577358,0.41925747397184426,96.79897567221511,79.47062629934076,5024073887,12452447451.085585,29.28148235157667,13.468769819092024,14.090488552478885,100,57.142857142857146
2017-04-25,134.58,135.3664,134.48,135.13,122.53929001310472,127.2873297355343,130.45785888471906,132.1674308909348,121.54240000000007,126.49910000000007,131.1988000000002,132.1505,132.1505,134.18324666401253,130.11775333598746,19339384,73.45035033529035,57.19464395041563,NaN,NaN,NaN,NaN,NaN,NaN,0.242154168386647,0.721950184455153,0.479796016068506,95.25910476496063,87.46022036077913,5043413271,12461471333.331072,34.22653406713313,12.365274948316523,16.911295870985118,100,50
2017-04-26,135.17,135.51,134.86,134.94,122.66268016222806,127.43886776057323,130.633629124534,132.43148509179815,121.66245000000006,126.67350000000008,131.33560000000017,132.3155,132.3155,134.6665208421166,129.96447915788337,25398542,71.51910003516066,58.08673147448125,NaN,NaN,NaN,NaN,NaN,NaN,0.3001375719970717,0.8549679810648456,0.5548304090677739,88.88888888888901,93.6489897753549,5018014729,12442324740.131071,33.67586455264101,11.804120100696606,18.76920471372002,100,42.857142857142854
2017-04-27,135.28,135.75,135.19,135.75,122.79290225016608,127.60344463660148,130.8342711196503,132.74753413067452,121.78375000000007,126.87630000000007,131.4800000000002,132.4905,132.4905,135.27673383800814,129.70426616199185,16136538,74.58684580257295,59.16100108470461,NaN,NaN,NaN,NaN,NaN,NaN,0.36738076333762304,1.0140563632398027,0.6466755999021797,100,94.71599788461656,5034151267,12458461278.131071,33.44358504392806,11.126488853389139,20.799791311426905,100,35.714285714285715
2017-04-28,136.28,136.34,135.77,135.99,122.92421665563707,127.76951503983709,131.03645656593852,133.0563404039436,121.90760000000007,127.07920000000007,131.6140000000002,132.66649999999998,132.66649999999998,135.84272590507618,129.4902740949238,22771946,75.43126737071259,60.352634598775275,NaN,NaN,NaN,NaN,NaN,NaN,0.3996894075821287,1.1462873593798406,0.7465979517977119,94.1275167785236,94.33880188913754,5056923213,12453267676.411774,36.31153938335287,10.647042026051752,23.47978188381425,100,28.571428571428573
2017-05-01,136.46,137.38,136.38,137.2,123.06626425110336,127.95625731627595,131.278164151588,133.45097465118707,122.03370000000008,127.28520000000007,131.7730000000002,132.90749999999997,132.90749999999997,136.64249598394298,129.17250401605696,24815525,79.18626435208682,61.782392314378804,NaN,NaN,NaN,NaN,NaN,NaN,0.4694002428770647,1.3333482553940428,0.8639480125169781,97.42857142857133,97.18536273569832,5081738738,12469149612.411774,40.10667892807267,9.597743804254403,26.41849576007456,100,21.428571428571427
2017-05-02,137.38,137.49,137.02,137.43,123.20918699487348,128.14385618130018,131.5194126162316,133.82992944631212,122.16185000000009,127.49070000000007,131.9254000000002,133.164,133.164,137.37159028424423,128.95640971575574,18345071,79.81769372369564,63.72809103263764,NaN,NaN,NaN,NaN,79.81769372369564,NaN,0.4952885210989907,1.4830586638907164,0.9877701427917257,99.15611814345989,96.9040687835183,5100083809,12482810835.49688,39.528043791791575,9.265241652219434,30.635873108575357,100,14.285714285714286
2017-05-03,137.14,137.17,136.615,136.99,123.34630951233743,128.3190273460269,131.73394545481074,134.13088854666336,122.2841000000001,127.67700000000006,132.05620000000022,133.388,133.388,137.8985680351851,128.87743196481492,23827550,75.12249200645391,65.71532291358953,NaN,NaN,NaN,NaN,NaN,NaN,0.44846586572482927,1.5483524749477624,1.0998866092229331,92.96765119549931,96.51744692251019,5076256259,12491182677.388773,37.12617152032493,11.721799240459468,34.13786073885267,92.85714285714286,7.142857142857143
2017-05-04,137.01,137.43,136.56,137.04,123.48256513908034,128.49171987382834,131.9420260252103,134.40794678031446,122.4086500000001,127.86170000000007,132.1870000000002,133.6415,133.6415,138.3694436333391,128.9135563666609,14630063,75.30029897919161,68.03917864777546,NaN,NaN,NaN,NaN,NaN,NaN,0.38877243763032676,1.5858521562608416,1.1970797186305149,93.35302806499237,95.15893246798386,5090886322,12492696132.181875,36.65337767916543,10.956448156268502,37.28211243758172,85.71428571428571,0
2017-05-05,137.39,137.54,136.88,137.54,123.62244011282083,128.67089373771293,132.16155441637852,134.70623756314166,122.52915000000009,128.04210000000006,132.3376000000002,133.9165,133.9165,138.87408519846542,128.9589148015346,19330652,77.06558191116324,69.76726943274294,NaN,NaN,NaN,NaN,NaN,NaN,0.3519729443744757,1.6370458990986094,1.2850729547241337,100,95.44022642016388,5110216974,12512026784.181875,35.64122182323238,10.401597828235145,40.486629537512286,100,0
2017-05-08,137.61,137.84,137.33,137.84,123.76390837040469,128.85246019835228,132.3842385569127,135.00469112855674,122.65245000000009,128.23090000000005,132.4892000000002,134.21,134.21,139.36306510729736,129.05693489270266,13279931,78.07795284392958,71.69613843435393,NaN,NaN,NaN,NaN,NaN,NaN,0.3178862658904409,1.6824307870871849,1.364544521196744,100,97.7843426883308,5123496905,12525306715.181875,36.57866871490849,9.980977684390355,44.109519386433476,100,0
2017-05-09,138.05,138.628,137.93,138.32,123.90874510303748,129.03993623402846,132.61701351546515,135.32043483059897,122.77580000000009,128.40950000000007,132.64720000000023,134.525,134.525,139.87068798191984,129.17931201808017,28426109,79.6274871914674,73.60624390324963,NaN,NaN,NaN,NaN,NaN,NaN,0.2980494595465566,1.7371063456299396,1.439056886083383,95.4759106933021,98.49197023110071,5151923014,12528646172.113108,40.57705635287612,9.351728550393096,48.1192046835447,100,0
2017-05-10,138.4,138.45,137.91,138.4,124.05293669405202,129.22528403137443,132.8437972991724,135.6137267514943,122.89950000000007,128.59140000000008,132.8148000000002,134.8725,134.8725,140.2766979053377,129.4683020946623,20499363,79.88271204609947,74.9529531481785,NaN,NaN,NaN,NaN,NaN,NaN,0.26197769462697407,1.7665290043671007,1.5045513097401266,96.44194756554337,97.30595275294849,5172422377,12545349356.779776,38.773075123863954,9.100627762898531,51.365131831611684,92.85714285714286,0
2017-05-11,138.03,138.33,137.38,138.29,124.19459901550424,129.40478335748583,133.05737387567544,135.86860991801865,123.02200000000006,128.77030000000008,132.9518000000002,135.241,135.241,140.52054505616238,129.96145494383765,27232074,78.42780315706406,76.21775657944683,NaN,NaN,NaN,NaN,NaN,NaN,0.20489865743433855,1.7606746315330497,1.5557759740987112,92.99307599817581,94.97031141900709,5145190303,12570288203.495564,35.55739726498423,12.65527118512696,53.57688881651078,85.71428571428571,0
2017-05-12,138.37,138.63,138.23,138.6,124.33793633873306,129.58686685535739,133.27473176290385,136.12874230677878,123.14210000000007,128.96030000000007,133.1082000000002,135.651,135.651,140.62801878638783,130.6739812136122,19738629,79.55776817243799,76.93240128052321,NaN,NaN,NaN,NaN,NaN,NaN,0.16398125972411637,1.7607525487538567,1.5967712890297403,99.27710843373491,96.2373773324847,5164928932,12587066038.145563,36.89215124517654,12.227011577153172,54.52162591180617,100,0
2017-05-15,138.63,139.12,138.53,139.04,124.48422552939243,129.77405761069684,133.5008207133782,136.4060049442284,123.26240000000007,129.14980000000008,133.2686000000002,136.02900000000002,136.02900000000002,140.82658230779214,131.2314176922079,20481327,81.07315825254904,77.4768875603274,NaN,NaN,NaN,NaN,NaN,NaN,0.14326117197464816,1.7758477539980504,1.6325865820234022,98.12206572769924,96.79741671986999,5185410259,12601993106.97607,39.24680242595101,11.603286264051272,55.05319364272436,100,0
2017-05-16,139.36,139.64,138.99,139.62,124.63483025049301,129.96902676692068,133.74078852853984,136.71209971144475,123.38435000000008,129.34050000000008,133.44640000000018,136.44600000000003,136.44600000000003,140.96149510021078,131.93050489978927,21785994,82.87526304086164,78.28804206073461,NaN,NaN,NaN,NaN,82.87526304086164,NaN,0.14489449980456293,1.813704706779106,1.668810206974543,99.55056179775322,98.98324531972912,5207196253,12622438424.422226,41.57254022489767,10.941100151973355,55.78458805707824,100,0
2017-05-17,138.55,138.77,136.05,136.07,124.74861303407019,130.08983811807076,133.8321301548716,136.65094735797382,123.48550000000009,129.49660000000006,133.55760000000018,136.675,136.675,140.58598708768554,132.76401291231448,55642178,50.9185112314033,76.59744673422249,NaN,NaN,50.9185112314033,NaN,NaN,NaN,-0.103444301722881,1.5395048298209417,1.6429491315438227,7.751937984495731,68.47485516998272,5151554075,12567614513.745754,31.08110227213657,28.962921651162194,52.46000110469623,92.85714285714286,0
2017-05-18,136.06,137.72,135.87,137.26,124.8731044466665,130.2318215216733,133.96655642330802,136.70895237150012,123.59700000000008,129.66800000000006,133.6880000000002,136.90850000000003,136.90850000000003,140.34488341865574,133.47211658134432,41319882,56.915849388600535,75.27491687835733,NaN,NaN,NaN,NaN,NaN,NaN,-0.1927109638461899,1.4020604267360852,1.5947713905822751,36.87002652519875,48.05750876914923,5192873957,12588386130.10251,27.244122773612556,26.58857332697583,48.643163719532744,85.71428571428571,0
2017-05-19,137.71,138.42,137.66,137.84,125.00212828301808,130.38247852124414,134.11845617141358,136.816671193262,123.70950000000008,129.84440000000006,133.8280000000002,137.17250000000004,137.17250000000004,139.9870328209175,134.35796717908258,36730112,59.51257848459068,73.86965360210762,NaN,NaN,NaN,NaN,NaN,NaN,-0.2160843324565076,1.3246659750116407,1.5407503074681483,52.254641909814545,32.29220213983634,5229604069,12569054492.207775,29.79111705723802,24.54266691329128,44.94880078284889,78.57142857142857,92.85714285714286
2017-05-22,138.14,139.075,138.0967,139,125.1414105886597,130.55312251092246,134.3098892627307,137.0246072700942,123.82615000000007,130.02620000000007,133.9802000000002,137.41450000000003,137.41450000000003,139.97189300852068,134.85710699147938,19509659,64.16454624020577,72.7515716390012,NaN,NaN,NaN,NaN,NaN,NaN,-0.15942504573562566,1.3414690002986163,1.500894046034242,83.02387267904537,57.382847038019555,5249113728,12585572789.815565,31.675641632602584,22.552964961862543,41.72024043641669,71.42857142857143,85.71428571428571
2017-05-23,139.42,139.42,138.7801,139.14,125.2807000355387,130.723159688924,134.4993053700746,137.22607324437095,123.93795000000007,130.21880000000007,134.1308000000002,137.61500000000004,137.61500000000004,140.05039319208007,135.17960680792,19687534,64.69183253613632,72.00652453397852,NaN,NaN,NaN,NaN,NaN,NaN,-0.12030366974468754,1.3505144588533824,1.47081812859807,86.73740053050392,74.00530503978794,5268801262,12588031039.48989,32.638133622493356,21.576886164833695,39.46277865743901,64.28571428571429,78.57142857142857
2017-05-24,139.56,139.85,139.17,139.78,125.42497167697613,130.90250306142056,134.70639143399325,137.46930436395468,124.05360000000007,130.41950000000008,134.3006000000002,137.85700000000003,137.85700000000003,140.1380532655033,135.57594673449677,18323864,67.07674766467767,71.41912801151324,NaN,NaN,NaN,NaN,NaN,NaN,-0.062042495300807854,1.39326500947206,1.4553075047728679,98.24120603015092,89.33415974656673,5287125126,12602582343.254595,34.01126256261963,20.51591624065272,37.37533268089151,100,71.42857142857143
2017-05-25,140.315,141.33,140.01,140.97,125.57964857571268,131.10185943644194,134.9520231424641,137.80270394833994,124.17385000000009,130.6444000000001,134.47800000000018,138.11800000000005,138.11800000000005,140.56360503762122,135.6723949623789,23928591,70.99921372337586,70.98581599809985,NaN,NaN,NaN,NaN,NaN,NaN,0.04040210947388845,1.5058101416152283,1.4654080321413399,93.40659340659316,92.79506665574934,5311053717,12613458975.52732,40.381329099133694,18.389965269949865,36.13253453340869,100,64.28571428571429
2017-05-26,141,141.28,140.81,141.22,125.73527396301903,131.3022186555223,135.19782615648512,138.1281607151647,124.29685000000009,130.8612000000001,134.66220000000018,138.37950000000004,138.37950000000004,140.97300322923107,135.785996770769,13851582,71.76040304712546,70.53456244118527,NaN,NaN,NaN,NaN,NaN,NaN,0.10508902837204959,1.5967693176064017,1.4916802892343521,97.98534798534774,96.54438247403061,5324905299,12623773983.399662,39.0596043855004,17.788041754245867,34.72485504113552,92.85714285714286,57.142857142857146
2017-05-30,141.13,141.505,141.06,141.34,125.89054486885964,131.5009866029377,135.4386957189759,138.43405017086332,124.41795000000009,131.07270000000008,134.8552000000002,138.58650000000003,138.58650000000003,141.4201427086087,135.75285729139136,20306409,72.13842283434276,69.99962927281923,NaN,NaN,NaN,NaN,NaN,NaN,0.1341833506227661,1.6594094775128099,1.5252261268900438,97.07187222715187,96.15460453969759,5345211708,12629021707.07382,39.43108008139205,17.21355782946774,33.05934851693389,100,50
2017-05-31,141.8,141.84,140.57,141.29,126.04377327812472,131.69482845238448,135.66815863195725,138.70604539268587,124.5384000000001,131.2769000000001,135.0448000000002,138.77950000000004,138.77950000000004,141.7919440243813,135.76705597561877,33229404,71.70770258510504,69.41570002560535,NaN,NaN,NaN,NaN,NaN,NaN,0.12828891654200136,1.6855872725675454,1.557298356025544,90.78726968174185,95.28149663141382,5311982304,12633469737.530512,35.870538735727706,19.143143140314105,30.804005739655288,100,42.857142857142854
2017-06-01,141.57,141.9,140.98,141.84,126.200949663417,131.89572293847587,135.91019162678245,139.0045172600491,124.6591000000001,131.47600000000008,135.28540000000018,139.02200000000002,139.02200000000002,142.19571454293788,135.84828545706216,20120741,73.57663717987617,69.06918817009192,NaN,NaN,NaN,NaN,NaN,NaN,0.13877140571173396,1.7307626131652114,1.5919912074534774,99.00497512437808,95.62137234442393,5332103045,12650966034.052252,33.93913796901102,17.883361417183526,29.624002248917794,100,35.714285714285715
2017-06-02,142.34,143.49,142.11,143.46,126.3726815075621,132.12471852385258,136.2062625433792,139.42884894956825,124.79115000000009,131.68730000000008,135.5408000000002,139.34300000000002,139.34300000000002,142.92263741181264,135.7633625881874,37222881,78.15416982219526,68.96893114507459,NaN,NaN,NaN,NaN,78.15416982219526,NaN,0.22693773587809374,1.8756633773010947,1.648725641423001,99.60629921259842,96.46618133957277,5369325926,12686570528.921818,40.97882767381657,15.866632112287697,29.192670328699705,100,28.571428571428573
2017-06-05,143.44,143.68,143.23,143.43,126.54240606967592,132.3485854837763,136.48954636520747,139.80991095437128,124.9220000000001,131.8956000000001,135.8022000000002,139.63750000000005,139.63750000000005,143.53075506485646,135.74424493514363,15727526,77.88508538182552,68.74121165430861,NaN,NaN,NaN,NaN,NaN,NaN,0.25335658557578267,1.9654213733927293,1.7120647878169466,96.79897567221511,98.4700833363972,5353598400,12684823026.03293,41.018690603429064,15.357951710003764,28.56080215547294,100,21.428571428571427
2017-06-06,143.28,143.73,142.65,142.86,126.70477018838561,132.55673230587973,136.7393680763758,140.10039562538353,125.04985000000009,132.09490000000008,136.0468000000002,139.88850000000002,139.88850000000002,143.9302979909995,135.84670200900055,22393024,72.75926901999001,68.01864065281778,NaN,NaN,NaN,NaN,NaN,NaN,0.2046494016381153,1.9678765398645908,1.7632271382264755,88.93129770992395,95.11219086491248,5331205376,12671138400.255154,37.87988225305299,18.2922230089811,26.885112821269338,100,14.285714285714286
2017-06-07,143.23,143.54,142.6,143.42,126.87109088302854,132.7718465176445,137.00135364200813,140.41654842296606,125.1806500000001,132.30170000000007,136.2984000000002,140.14350000000005,140.14350000000005,144.3953573588507,135.8916426411494,18842408,74.53260536618797,69.70536166244527,NaN,NaN,NaN,NaN,NaN,NaN,0.1830555090490924,1.992046524537841,1.8089910154887485,96.05597964376587,93.92875100863496,5350047784,12685169980.680685,35.34477134190628,17.424000098112796,29.058914834678145,92.85714285714286,7.142857142857143
2017-06-08,143.74,143.8,142.79,143.57,127.0372491826999,132.98567133907727,137.25894761683134,140.71687714458835,125.3117500000001,132.50580000000008,136.53700000000023,140.40200000000004,140.40200000000004,144.82367660509277,135.98032339490732,25417408,75.00202908749617,70.99723164093781,NaN,NaN,NaN,NaN,NaN,NaN,0.15300522703868902,2.00024754928711,1.8472423222484209,96.2540716612375,93.74711633830911,5375465192,12699011143.452961,34.654620563642105,16.17166304208373,31.569429571728897,100,0
2017-06-09,143.73,143.9,138.11,139.98,127.16603277292178,133.1241728967193,137.3656555534262,140.64669836891326,125.42385000000012,132.67770000000007,136.69160000000022,140.48650000000004,140.48650000000004,144.80693643629135,136.16606356370872,109783737,50.84601372384859,70.37819130088481,NaN,NaN,NaN,NaN,NaN,NaN,-0.11979686313508298,1.6974962433295673,1.8172931064646503,32.45222545792892,74.92075892097742,5265681455,12660141253.84156,24.003593245544096,36.04396914768734,32.31169773033989,100,0
2017-06-12,138.84,139.48,137.47,139.23,127.28607224781808,133.245080364111,137.43876710035065,140.51177471473105,125.5360000000001,132.83960000000008,136.82680000000022,140.51800000000003,140.51800000000003,144.79189564683517,136.2441043531649,104453977,47.410598615081845,69.1814807562331,NaN,NaN,NaN,NaN,NaN,NaN,-0.3489351409049877,1.3811241803334156,1.7300593212384032,27.371695178848974,52.025997432671794,5161227478,12738611654.4734,20.991589445507213,34.72064747568015,32.870281829094615,92.85714285714286,100
2017-06-13,140.01,140.56,139.28,140.36,127.41616108117313,133.38596986185138,137.55332525327808,140.49731997999476,125.65475000000009,133.01340000000005,136.98640000000023,140.58400000000003,140.58400000000003,144.80500177683209,136.36299822316798,51193010,52.60630654330808,68.31822889960252,NaN,NaN,NaN,NaN,NaN,NaN,-0.4179214780693452,1.2076574736517216,1.6255789517210668,44.945567651633155,34.92316276280368,5212420488,12773806848.8484,25.01492340878472,32.400609770442024,32.33178301717088,85.71428571428571,92.85714285714286
2017-06-14,140.92,140.93,138.62,139.75,127.5388858465346,133.5119902606266,137.63946936099265,140.4261466485667,125.76960000000008,133.17840000000007,137.13540000000023,140.59050000000005,140.59050000000005,144.80594054637476,136.37505945362534,60093764,49.7489371779904,67.08052815055342,NaN,NaN,NaN,NaN,NaN,NaN,-0.4930015111895609,1.0093270627341155,1.5023285739236765,35.45878693623637,35.9253499222395,5152326724,12772506118.025888,22.235816058883692,31.975195491118484,31.847206156481658,78.57142857142857,85.71428571428571
2017-06-15,138.35,139.28,137.49,139.13,127.65422031572331,133.62323797823794,137.69792154291451,140.30270411060795,125.8805500000001,133.33620000000008,137.26780000000022,140.74350000000004,140.74350000000004,144.48728565091955,136.99971434908053,55145160,46.95718317383276,65.36324025415747,NaN,NaN,NaN,NaN,NaN,NaN,-0.5674796619505511,0.7929789964854876,1.3604586584360387,25.816485225505364,35.40694660445829,5097181564,12818409072.439297,19.90576152905915,33.86398505853991,31.028685090469846,71.42857142857143,78.57142857142857
2017-06-16,138.72,138.777,137.638,138.15,127.75865593447233,133.71287683015402,137.71565010985904,140.09768467150244,125.9885000000001,133.47590000000005,137.3914000000002,140.78800000000007,140.78800000000007,144.3833169540381,137.19268304596204,48087413,42.86276158215371,63.29912300665949,NaN,NaN,42.86276158215371,NaN,NaN,NaN,-0.6593572548124436,0.5362620899204842,1.1956193447329277,10.575427682737264,23.950233281492995,5049094151,12813553890.266338,18.52559868542708,31.516030982687116,30.210164024458038,64.28571428571429,71.42857142857143
2017-06-19,139.45,140.59,139.28,140.46,127.88503746746265,133.8464832295569,137.8232716741783,140.1321908932641,126.1086000000001,133.62620000000004,137.55980000000022,140.91900000000004,140.91900000000004,144.25681904842304,137.58118095157704,39626533,53.2176054857334,61.9476360531874,NaN,NaN,NaN,NaN,NaN,NaN,-0.5458611831435252,0.5132928658035212,1.0591540489470463,46.50077760497676,27.630896837739787,5088720684,12845315615.190002,24.595499336145455,28.086358451322475,27.881854203010597,57.142857142857146,64.28571428571429
2017-06-20,140.31,140.5,139.31,139.36,127.99921619912969,133.95566177946665,137.88353553009287,140.05864890342943,126.2217000000001,133.76420000000005,137.7076000000002,140.93700000000007,140.93700000000007,144.2368975741664,137.63710242583375,40935078,48.692280111882305,60.30367730510006,NaN,NaN,NaN,NaN,NaN,NaN,-0.525964634481485,0.40169825584519003,0.927662890326675,29.393468118196154,28.82322446863672,5047785606,12807820459.711012,23.265720371046474,26.567842882097537,26.183312738591695,50,57.142857142857146
2017-06-21,139.66,140.81,139.59,140.74,128.12599016729754,134.09000511056632,137.99555374459902,140.1235394840552,126.33980000000008,133.91360000000003,137.8820000000002,141.01700000000005,141.01700000000005,144.21475608826032,137.8192439117398,35743366,53.979385628198756,58.90387362283739,NaN,NaN,NaN,NaN,NaN,NaN,-0.40631087741294514,0.41977429356049356,0.8260851709734387,50.85536547433914,42.24987039917068,5083528972,12839462127.973307,23.140752619949527,24.807820654518505,24.21863652014893,42.857142857142854,50
2017-06-22,140.94,141.22,140.34,140.7,128.25110469299608,134.2208960984759,138.10161046049708,140.17844048557373,126.45405000000008,134.07240000000004,138.0670000000002,141.06300000000005,141.06300000000005,144.21438763087335,137.91161236912674,24099115,53.8063107373197,57.16474083106056,NaN,NaN,NaN,NaN,NaN,NaN,-0.32009870034068777,0.42596179554757896,0.7460604958882667,50.23328149300134,43.49403836184555,5059429857,12835080470.700579,24.11394535138131,23.77828420884323,21.113251672736684,35.714285714285715,42.857142857142854
2017-06-23,140.53,141.42,140.15,141.24,128.38034743236926,134.35988825494172,138.22468456008542,140.27954139170956,126.57065000000007,134.23910000000004,138.2734000000002,141.07650000000007,141.07650000000007,144.22849159262736,137.92450840737277,21654314,55.86371826379997,55.59178603691588,NaN,NaN,NaN,NaN,55.86371826379997,NaN,-0.22162262781840336,0.4690322111152625,0.6906548389336659,58.63141524105764,53.24002073613271,5081084171,12850596553.960423,23.60704029984351,22.337517235764633,18.059433723332916,28.571428571428573,35.714285714285715
2017-06-26,142,142.29,140.27,140.58,128.50173701015663,134.48305878454684,138.31704987145463,140.30815649726102,126.68740000000007,134.39060000000003,138.47700000000023,141.04450000000006,141.04450000000006,144.20300265157496,137.88599734842515,34411094,52.770142196975044,54.16399126384338,NaN,NaN,NaN,NaN,NaN,NaN,-0.19669813544754633,0.4447821696242329,0.6414803050717792,48.36702954898927,52.41057542768275,5046673077,12826747280.891115,25.437050292390474,20.23715140862389,16.381859949122564,21.428571428571427,28.571428571428573
2017-06-27,140.07,140.22,138.02,138.03,128.59654559712024,134.55329524425878,138.30579301375053,140.0911892118076,126.80615000000007,134.51770000000005,138.60800000000023,140.87900000000008,140.87900000000008,144.29463405533767,137.46336594466248,65957819,42.888063170704925,51.903666821308875,NaN,NaN,NaN,NaN,NaN,NaN,-0.3393480014372914,0.217295303275165,0.5566433047124564,8.709175738724754,38.56920684292389,4980715258,12761389078.427479,22.54395091097806,27.93176302230472,14.71851190175197,14.285714285714286,21.428571428571427
2017-06-28,138.54,140.14,137.74,140.02,128.71021181008422,134.66154682358038,138.37301681713285,140.08440928687355,126.92460000000007,134.66110000000003,138.78280000000024,140.81550000000004,140.81550000000004,144.24540072742704,137.38559927257305,57427180,50.65424316433631,50.16453925536888,NaN,NaN,NaN,NaN,NaN,NaN,-0.28904665062926044,0.19533499142588084,0.4843816420551413,39.65785381026452,32.24468636599285,5038142438,12813073540.42748,20.221886645191837,26.25643117048612,13.048412579542482,7.142857142857143,14.285714285714286
2017-06-29,139.4,139.44,136.25,137.59,128.79856791147643,134.71953599539066,138.3423102752845,139.8468464976475,127.03610000000006,134.77870000000001,138.90480000000022,140.60300000000007,140.60300000000007,144.27102998897072,136.9349700110294,88769351,42.9702596908263,49.60198539586729,NaN,NaN,NaN,NaN,NaN,NaN,-0.40185937343618494,-0.017942574740089867,0.3839167986960951,22.185430463576246,23.517486670855174,4949373087,12798881575.220585,17.221189632238698,28.22497115384458,13.345654537264746,0,100
2017-06-30,138,138.6687,137.19,137.64,128.88654236011845,134.77736696577895,138.31476869586157,139.63667064072868,127.14510000000006,134.89220000000003,139.00580000000025,140.31200000000007,140.31200000000007,143.95055795611103,136.6734420438891,68898255,43.161316717144096,49.298465260300304,NaN,NaN,NaN,NaN,NaN,NaN,-0.45181128312885044,-0.18084730521496795,0.2709639779138825,23.013245033112387,28.285509768984383,5018271342,12771917742.009993,16.205444327260427,26.5601975496451,13.314938857261462,71.42857142857143,92.85714285714286
2017-07-03,138.25,138.43,136.1,136.19,128.9592135804158,134.80533989714968,138.23144443327877,139.30841629399262,127.23785000000007,134.98910000000004,139.07840000000024,139.95000000000005,139.95000000000005,143.71413602304722,136.18586397695287,32797005,39.073200042525734,48.3318147959587,NaN,NaN,39.073200042525734,NaN,NaN,NaN,-0.5544414177503335,-0.4220877942740344,0.13235362347629911,1.453957996769038,15.550877831152553,4985474337,12741654411.216002,14.731043030416407,28.399934097889385,14.659797319207158,64.28571428571429,100
2017-07-05,136.57,137.9,136.16,137.53,129.04449503732707,134.85929356255266,138.2039368084443,139.13904331361238,127.33905000000006,135.09480000000002,139.14580000000024,139.68350000000004,139.68350000000004,143.33894675792536,136.02805324207472,42116584,44.32170933259325,47.94415566414462,NaN,NaN,NaN,NaN,NaN,NaN,-0.5053942357709793,-0.499389171237425,0.0060050645335542885,23.101777059773948,15.856326696551788,5027590921,12765859344.549335,13.726663702677039,26.463594175578116,15.640218896733687,57.142857142857146,92.85714285714286
2017-07-06,136.47,137.06,135.8,136.29,129.11658961407008,134.88762438309618,138.12888046301512,138.8677058551731,127.43660000000006,135.18390000000005,139.16900000000024,139.32700000000006,139.32700000000006,142.84336232490304,135.81063767509707,48430476,40.81760751075392,47.50561454535328,NaN,NaN,NaN,NaN,NaN,NaN,-0.5273474615056107,-0.6531792623484591,-0.1258318008428484,7.55007704160219,10.701937366048389,4979160445,12755097016.549334,12.792744046133766,26.07889002354159,16.227382438120223,50,100
2017-07-07,136.74,138.13,136.74,137.76,129.20259369751216,134.9445031081834,138.11441456250472,138.76221005944234,127.54040000000006,135.28050000000002,139.22540000000023,139.03650000000005,139.03650000000005,142.02275702175967,136.05024297824042,36970402,46.243503967106555,47.74709614427848,NaN,NaN,NaN,NaN,NaN,NaN,-0.41850374243787014,-0.6489614788901861,-0.23045773645231593,30.200308166409634,20.28405408926192,5016130847,12772385334.031347,16.072021967617047,24.1935063553183,15.813851610703832,42.857142857142854,92.85714285714286
2017-07-10,137.84,138.985,137.5,138.66,129.29669724281055,135.01807730406097,138.13581006985748,138.7524757680669,127.64295000000006,135.38180000000003,139.28360000000026,138.97050000000004,138.97050000000004,141.9286445197984,136.01235548020168,24853545,49.30779509436701,47.467823973466594,NaN,NaN,NaN,NaN,NaN,NaN,-0.26880701362758225,-0.5664665034867937,-0.2976594898592115,44.067796610169395,27.27272727272707,5040984392,12786360222.970741,18.52574282279459,22.76317459760851,16.07360711871485,35.714285714285715,85.71428571428571
2017-07-11,138.44,139.22,137.94,139.05,129.3937450314393,135.0979173574459,138.17166065535326,138.78081140920338,127.74275000000007,135.47940000000003,139.34480000000025,138.96150000000006,138.96150000000006,141.91752621774688,136.00547378225323,31517660,50.62134067089815,47.6056140133963,NaN,NaN,NaN,NaN,NaN,NaN,-0.13328610264024038,-0.46426711815951194,-0.33098101551927156,50.07704160246548,41.44838212634817,5072502052,12809506004.533241,18.517087707581105,21.578943804320648,16.145750323225293,28.571428571428573,78.57142857142857
2017-07-12,140.21,140.86,139.955,140.7,129.5062450808777,135.20884968700145,138.27081121788842,138.96359127499355,127.85460000000006,135.59390000000002,139.41480000000024,138.97850000000003,138.97850000000003,141.97019701006732,135.98680298993273,36045799,55.83546784287652,47.738191314444705,NaN,NaN,NaN,NaN,NaN,NaN,0.06695949267444867,-0.2472816496762107,-0.31424114235065936,75.50077041602452,56.548536209553134,5108547851,12832806327.643736,23.809140096284068,19.99487006243232,16.51937878347284,21.428571428571427,71.42857142857143
2017-07-13,140.85,141.35,140.6,141.01,129.62071030395356,135.32372395062518,138.37823038581436,139.1584873440418,127.97295000000005,135.7059,139.48640000000026,139.04150000000004,139.04150000000004,142.14645265664973,135.93654734335036,31073595,56.759309161162925,47.94911977329065,NaN,NaN,NaN,NaN,NaN,NaN,0.2116077774594765,-0.04973142052631374,-0.26133919798579025,80.27734976887511,68.61838726245504,5139621446,12835706529.843735,25.126229848219843,19.360660547507372,17.395042061566745,14.285714285714286,64.28571428571429
2017-07-14,141.57,142.3,141.19,142.12,129.74508134570527,135.45830367437517,138.52496644911577,139.44053616841876,128.09105000000005,135.82260000000002,139.58900000000028,139.19100000000003,139.19100000000003,142.57407493266768,135.80792506733238,34544847,59.98685489627886,48.243629532753424,NaN,NaN,NaN,NaN,NaN,NaN,0.36439787712047245,0.19415814841480028,-0.17023972870567214,97.23076923076913,84.33629647188958,5174166293,12859047642.681572,27.8185602496454,18.286292789436125,18.674472785473082,100,57.142857142857146
2017-07-17,142.25,142.69,141.92,142.19,129.86891138206641,135.5916045917143,138.6686932550328,139.7023898666646,128.20850000000007,135.93950000000004,139.69200000000026,139.39300000000006,139.39300000000006,142.9796480173,135.8063519827001,25343155,60.188666554047984,48.77352412968721,NaN,NaN,NaN,NaN,NaN,NaN,0.4470806922722018,0.38861113663458013,-0.05846955563762167,92.7431059506531,90.08374165009911,5199509448,12851477609.369884,28.604913190139598,17.656464393048317,19.551739808664145,100,50
2017-07-18,142.06,143.17,141.64,143.14,130.0009620150807,135.74107776811599,138.84403861758054,140.02978130793463,128.33500000000006,136.07080000000002,139.80400000000026,139.52700000000004,139.52700000000004,143.44778104464157,135.60621895535851,25748527,62.921868081666574,50.20451019475589,NaN,NaN,NaN,NaN,NaN,NaN,0.5366278067269319,0.6123152027710432,0.07568739604411133,99.59294436906376,96.52227318349533,5225257975,12876216390.213022,28.79489278410412,16.44446680993939,20.739319126729747,100,42.857142857142854
2017-07-19,143.53,144.19,143.5,143.98,130.14005692040328,135.9042247430048,139.0454488678715,140.40599261194086,128.46130000000005,136.208,139.92680000000027,139.75800000000004,139.75800000000004,144.13056720932173,135.38543279067835,33752309,65.19707569219398,51.24328394674573,NaN,NaN,NaN,NaN,NaN,NaN,0.6175400969518068,0.8476125172338698,0.23007242028206304,97.49702026221682,96.61102352731125,5259010284,12889423815.47389,32.094895190020104,15.650488810068557,22.272055395408135,100,35.714285714285715
2017-07-20,144.31,144.44,143.52,144.17,130.27965834408087,136.06790346096508,139.24641165736674,140.76446950604173,128.58940000000004,136.34550000000002,140.04380000000026,139.92950000000002,139.92950000000002,144.69415937922625,135.1648406207738,36139449,65.709623567425,52.86752422364564,NaN,NaN,NaN,NaN,NaN,NaN,0.6459097104009459,1.0374595582832455,0.3915498478822996,96.87499999999987,97.98832154376015,5295149733,12904350979.19128,31.880470283835187,14.968540675547153,23.121056239738778,100,28.571428571428573
2017-07-21,143.62,144.11,143.35,144.11,130.41727368394078,136.22715289738161,139.4371406119798,141.08309145784727,128.71810000000005,136.4864,140.15800000000024,140.10000000000002,140.10000000000002,145.19531942080678,135.00468057919326,39697094,65.38216201921846,54.454727459508085,NaN,NaN,NaN,NaN,NaN,NaN,0.6224328351138093,1.1695908917745612,0.5471580566607519,96.18055555555573,96.85085860592415,5255452639,12944048073.19128,30.60060527825562,15.199907253271554,23.793400255797177,92.85714285714286,21.428571428571427
2017-07-24,144.07,144.87,143.92,144.77,130.5600868811155,136.39631818654237,139.64627235268648,141.43422560471896,128.84800000000004,136.61970000000002,140.28760000000025,140.27650000000003,140.27650000000003,145.74820275143307,134.80479724856698,26712732,67.31190013984796,56.47177746645967,NaN,NaN,NaN,NaN,67.31190013984796,NaN,0.6122203493286834,1.3124334933216062,0.7002131439929228,98.89746416758551,97.31767324104703,5282165371,12965137072.138649,32.95690105387508,14.474888708966837,24.312962215070456,100,14.285714285714286
2017-07-25,144.29,144.74,144.01,144.4,130.69779745941284,136.5548069353237,139.832693044738,141.71668030903143,128.97635000000005,136.75590000000003,140.40360000000024,140.46750000000003,140.46750000000003,146.22734678616197,134.70765321383809,28120884,65.1203196249636,57.95739248734327,NaN,NaN,NaN,NaN,NaN,NaN,0.5437295135419187,1.3798750359203211,0.8361455223784025,94.8180815876516,96.63203377026429,5254044487,12967063160.083855,31.6560154818381,13.903531169993316,24.832524174343735,92.85714285714286,7.142857142857143
2017-07-26,144.74,144.95,144.53,144.87,130.8388144001152,136.71946422373315,140.03023449396395,142.01699647007607,129.10835000000006,136.89440000000002,140.52020000000024,140.8095,140.8095,146.75896207652957,134.86003792347046,18610634,66.60760388204713,59.79953508529278,NaN,NaN,NaN,NaN,NaN,NaN,0.4946689078613755,1.4544816572051218,0.9598127493437463,99.02557856272857,97.58037477265525,5272655121,12978584028.750523,31.85077634599213,13.488583941283865,25.28394640374745,100,0
2017-07-27,145.86,145.96,142.3,143.96,130.96937346081057,136.86284116979783,140.18434294518104,142.20204442530692,129.23205000000004,137.0267,140.60700000000026,141.00650000000002,141.00650000000002,147.09758619213818,134.91541380786185,80665866,61.169072975580605,60.865647157326634,NaN,NaN,NaN,NaN,NaN,NaN,0.3711628054332503,1.423766256135309,1.0526034507020587,76.35933806146575,90.0676660706153,5191989255,12971090478.35708,26.238810962179144,21.847367889209764,24.495562396764342,100,0
2017-07-28,143.14,144.0752,142.87,143.84,131.0974393965239,137.00100273079192,140.32770204537002,142.3580401943253,129.36365000000006,137.16000000000003,140.76240000000024,141.31900000000002,141.31900000000002,147.31749614487345,135.3205038551266,38013176,60.467928657060156,61.66279955466185,NaN,NaN,NaN,NaN,NaN,NaN,0.25704010116999676,1.3739035771645547,1.116863475994558,73.5660847880299,82.98366713740808,5153976079,12994266782.476562,24.695760641396877,20.56256927244754,24.414816973535533,92.85714285714286,0
2017-07-31,144.22,144.43,142.92,143.23,131.2181613925784,137.12434921137032,140.44151765143394,142.44108398534195,129.49270000000007,137.28490000000002,140.88180000000025,141.5985,141.5985,147.40305433259718,135.79394566740282,33848645,56.89764219873965,62.11110680665053,NaN,NaN,NaN,NaN,NaN,NaN,0.12292472817105571,1.2705193862083775,1.1475946580373217,54.537885095753204,68.15443598174963,5120127434,12974316256.615635,24.607610705772757,19.050909164221572,24.77848398685322,85.71428571428571,0
2017-08-01,143.7,143.76,143.12,143.56,131.34096575683134,137.25178784084812,140.5638110768679,142.54764741530937,129.62550000000007,137.41210000000004,140.99620000000024,141.96700000000004,141.96700000000004,147.26500000000232,136.66899999999777,20149421,58.331016663508535,62.289360293838534,NaN,NaN,NaN,NaN,NaN,NaN,0.043017320866691744,1.2013663091206865,1.1583489882539948,55.22388059701493,61.10928349359935,5140276855,12981872289.490635,23.808696572097592,18.432399680605275,25.06563137508445,78.57142857142857,0
2017-08-02,144.45,144.52,142.61,143.95,131.46642878412655,137.38442570538578,140.69660279934365,142.68120480432754,129.75955000000005,137.53770000000003,141.09520000000023,142.28800000000004,142.28800000000004,147.2383236257885,137.33767637421158,41769667,60.023030293614006,62.52248323187076,NaN,NaN,NaN,NaN,NaN,NaN,0.005006309261792907,1.164606874831236,1.159600565569443,57.86163522012547,55.874466970964534,5182046522,12998711369.904247,25.31874921147976,16.690808895910653,25.606909058843492,71.42857142857143,0
2017-08-03,144.17,144.17,143.13,143.39,131.585071283787,137.50334796864547,140.80222621897724,142.7487091086773,129.89240000000007,137.65550000000002,141.18020000000024,142.64300000000003,142.64300000000003,146.77207786316168,138.51392213683837,27112799,56.47678308095017,62.271763816490136,NaN,NaN,NaN,NaN,NaN,NaN,-0.0653904441664579,1.0778625103613706,1.1432529545278285,40.50925925925905,51.19825835879982,5154933723,12985154970.404247,23.98960532623534,15.814601054895968,25.597112478146837,64.28571428571429,0
2017-08-04,143.65,143.97,143.06,143.65,131.70512032573936,137.62506385045447,140.9139036221546,142.83454633642233,130.02135000000007,137.77910000000006,141.25760000000025,142.93750000000003,142.93750000000003,146.42123865266203,139.45376134733803,29472909,57.72559936598348,62.095830445914096,NaN,NaN,NaN,NaN,NaN,NaN,-0.09991611663382738,1.0183578087355443,1.1182739253693716,46.52777777777799,48.29955741905417,5184406632,12993899679.667984,22.85882959975067,15.43174806282282,25.29212175813912,57.142857142857146,7.142857142857143
2017-08-07,143.89,144.56,143.71,144.56,131.8330295762295,137.7623893187623,141.05688779383482,142.99887525676306,130.15490000000008,137.90370000000004,141.32940000000025,143.23250000000002,143.23250000000002,146.17451206660536,140.29048793339467,17933942,61.85140565581651,62.01936884406767,NaN,NaN,NaN,NaN,61.85140565581651,NaN,-0.06843938716926279,1.0327246914077932,1.101164078577056,61.74863387978123,49.59522363893942,5202340574,13011833621.667984,24.886690917280067,14.686245989262673,25.183274367106247,50,0
2017-08-08,144.27,145.47,143.9,144.31,131.95717853567,137.8920449758165,141.18446082152758,143.12374427992847,130.28790000000006,138.02670000000003,141.39120000000025,143.49550000000002,143.49550000000002,145.75653936278079,141.23446063721926,30810364,60.11559704221025,61.65640608335455,NaN,NaN,NaN,NaN,NaN,NaN,-0.07111619584541073,1.0122688337702925,1.0833850296157033,54.91803278688505,54.398148148148096,5171530210,12997115294.916391,27.610943602768817,13.476603263422055,25.180322139410286,42.857142857142854,42.857142857142854
2017-08-09,143.14,144.19,142.795,144.12,132.07820163481756,138.01537081787956,141.2995800049971,143.21862577707813,130.41775000000007,138.15100000000004,141.44680000000028,143.6665,143.6665,145.54009840949305,141.79290159050697,36169473,58.765779578697035,61.16041722701683,NaN,NaN,NaN,NaN,NaN,NaN,-0.0910683098054319,0.9695496423589134,1.0606179521643453,49.726775956284015,55.46448087431677,5135360737,13029654856.647575,25.433947025891168,18.164806660794433,23.792752093556718,35.714285714285715,35.714285714285715
2017-08-10,143.33,143.4,140.89,141.03,132.16727425536664,138.07506644524827,141.28900824009526,143.01018522688022,130.52505000000008,138.24320000000006,141.44160000000028,143.66750000000002,143.66750000000002,145.5354387035033,141.79956129649673,63331663,42.17868076645907,59.50302570896259,NaN,NaN,42.17868076645907,NaN,NaN,NaN,-0.30566598962796765,0.6785354651293858,0.9842014547573534,2.761341222879964,35.80204998868301,5072029074,12973388080.356739,21.535390607780712,24.42076905926067,21.83939092892265,28.571428571428573,100
2017-08-11,141.24,142.41,140.9,142.1,132.26610734735303,138.15476809979782,141.3208118385229,142.9235009195583,130.6396000000001,138.36610000000005,141.44680000000025,143.6665,143.6665,145.53776988969295,141.79523011030707,45862488,47.68523809204032,58.101121276976336,NaN,NaN,NaN,NaN,NaN,NaN,-0.3648360181380321,0.5281564320848133,0.8929924502228455,23.865877712031615,25.45133163039853,5117891562,13000419613.01899,19.992562205101336,22.67122772025712,19.504611740572123,21.428571428571427,92.85714285714286
2017-08-14,143.23,144.15,143.19,143.93,132.3821659807127,138.2691291275246,141.42313294289454,143.01935797483847,130.76735000000008,138.49850000000004,141.45620000000025,143.75350000000003,143.75350000000003,145.4997104684239,142.00728953157616,34161024,55.492172953390345,57.41339651472111,NaN,NaN,NaN,NaN,NaN,NaN,-0.2741522556855758,0.5503021306158757,0.8244543863014515,59.960552268244726,28.862590401052103,5152052586,13018923501.01899,26.144509951931777,20.521714544772625,17.582005112390732,14.285714285714286,85.71428571428571
2017-08-15,144.22,144.302,143.64,144.03,132.49806482667574,138.3832057784647,141.52536302356535,143.11560959628244,130.89830000000006,138.63520000000005,141.46820000000028,143.79800000000003,143.79800000000003,145.5246568854418,142.07134311455826,25509181,55.87963484503993,56.64711301207773,NaN,NaN,NaN,NaN,NaN,NaN,-0.20407654284228793,0.5693587077485915,0.7734352505908795,61.93293885601581,48.58645627876405,5177561767,13023470454.731981,26.042883029138782,19.8666581321747,15.6501179206917,7.142857142857143,78.57142857142857
2017-08-16,144.37,144.96,143.8007,144.28,132.61529801247997,138.49997398087135,141.63338800303336,143.22650392044602,131.03420000000008,138.77170000000004,141.49660000000029,143.81300000000005,143.81300000000005,145.5508964296074,142.07510357039268,31913002,56.89003854816525,56.34146769583378,NaN,NaN,NaN,NaN,NaN,NaN,-0.14055325961741172,0.5977436760691148,0.7382969356865265,74.01746724890842,65.30365279105632,5209474769,13017945621.210546,27.786929146840105,18.738616537230023,16.386947150275013,0,71.42857142857143
2017-08-17,143.73,143.94,141.33,141.33,132.7020114650921,138.55601410006201,141.62149043428695,143.04588449945118,131.1559000000001,138.87660000000005,141.45480000000026,143.67100000000002,143.67100000000002,145.7074665477399,141.63453345226014,70190975,44.065969418153436,55.16989917876901,NaN,NaN,NaN,NaN,NaN,NaN,-0.28836308271646016,0.3778430822909513,0.6662061650074115,9.606986899563864,48.51913100149603,5139283794,12947754646.210546,24.045444490217456,27.49268233181441,16.21239504070227,50,64.28571428571429
2017-08-18,141.43,142.2,140.65,141.23,132.78686707240462,138.60896431590237,141.6061378682365,142.87294311855106,131.28150000000008,138.97250000000005,141.40800000000027,143.52700000000002,143.52700000000002,145.81116374195958,141.24283625804046,60751940,43.70630589775598,54.22766087155589,NaN,NaN,NaN,NaN,NaN,NaN,-0.3783463878099741,0.1932731802449439,0.571619568054918,12.033195020746575,31.885883056406286,5078531854,12932468674.210546,22.343122726627104,28.65219974956429,16.18698280398289,42.857142857142854,100
2017-08-21,141.23,141.53,140.18,141.05,132.8690873005399,138.65730165618152,141.58432854007035,142.69932948821287,131.41085000000007,139.06050000000005,141.42940000000027,143.341,143.341,145.7899009780045,140.8920990219955,37111487,43.025572731217935,53.13441487639227,NaN,NaN,43.025572731217935,NaN,NaN,NaN,-0.43161116331608945,0.03210561390980615,0.4637167772258956,16.446124763705214,12.69543556133855,5041420367,12943189770.454992,20.951832876493057,29.035941265710928,16.43302036657659,35.714285714285715,100
2017-08-22,141.8,143.35,141.76,143.2,132.9718824517783,138.74725607883138,141.64768820516562,142.74701239409737,131.55660000000006,139.16780000000006,141.50880000000026,143.281,143.281,145.68149911478392,140.8805008852161,36294232,52.53504691649809,52.599558920883986,NaN,NaN,NaN,NaN,NaN,NaN,-0.30939036244273954,0.07697882417247115,0.3863691866152107,57.08884688090711,28.522722221786307,5077714599,12972636034.153105,26.917149708729998,26.058754061183414,15.08175679529411,28.571428571428573,92.85714285714286
2017-08-23,142.5,143.01,142.38,142.69,133.06858013882527,138.82533021588424,141.68856317751207,142.74158264227856,131.70180000000005,139.27090000000004,141.55540000000028,143.172,143.172,145.46976935310897,140.87423064689102,25702324,50.38667894307327,52.16455148246422,NaN,NaN,NaN,NaN,NaN,NaN,-0.252635440893117,0.07057488549881441,0.3232103263919314,47.448015122873244,40.32766225582853,5052012275,12972228060.756279,25.897617960630058,25.07173547382206,13.730493224011628,21.428571428571427,85.71428571428571
2017-08-24,143.03,143.17,141.47,142.27,133.16013655535437,138.89354149873802,141.7113646215312,142.6966700096806,131.83140000000006,139.37060000000002,141.6058000000003,143.0875,143.0875,145.38743804266093,140.78756195733908,38160803,48.62321331564349,51.514381050297075,NaN,NaN,NaN,NaN,NaN,NaN,-0.23356905397319117,0.031249008925442467,0.26481806289863363,39.508506616257215,48.01512287334586,5013851472,12969983307.638632,23.87834230155721,27.290622675545155,12.821351987285382,14.285714285714286,78.57142857142857
2017-08-25,142.8,143.18,141.78,141.97,133.24779688813692,138.95446146906005,141.72150718539274,142.62746334209197,131.95570000000006,139.46520000000004,141.66260000000028,142.994,142.994,145.3159078362578,140.6720921637422,26380436,47.34849538390934,50.478458888018,NaN,NaN,NaN,NaN,NaN,NaN,-0.23093413114068523,-0.02384960102722289,0.20708453011346234,33.837429111531094,40.264650283553856,4987471036,12950763275.695774,22.38012404101192,25.525503984865434,11.44917117409952,7.142857142857143,71.42857142857143
2017-08-28,142.41,142.74,141.9501,142.41,133.33896308825496,139.02288797462322,141.74850690361262,142.60675254760702,132.07950000000008,139.56960000000004,141.7478000000003,142.95300000000003,142.95300000000003,145.2857245872693,140.62027541273076,15362141,49.442011603427034,49.71605992810491,NaN,NaN,NaN,NaN,NaN,NaN,-0.19098484185356016,-0.03164652220348785,0.1593383196500723,46.65271966527174,39.999551797686685,5002833177,12953289598.161781,21.53385019773293,24.560291892237174,9.460973892034806,0,64.28571428571429
2017-08-29,141.18,143.21,141.06,142.97,133.43479430130714,139.10104860878909,141.79640859366702,142.641347543073,132.21560000000008,139.67890000000003,141.7980000000003,142.92350000000005,142.92350000000005,145.2396370857593,140.60736291424078,24498333,52.054951040855705,49.236715032544815,NaN,NaN,NaN,NaN,NaN,NaN,-0.12164842558462158,0.007277787669295321,0.1289262132539169,58.3682008368199,46.28611653787425,5027331510,12972318535.887363,19.385182067119423,26.24057404372126,9.343291804586908,35.714285714285715,57.142857142857146
2017-08-30,143.11,144.89,143,144.65,133.5463883878613,139.21092883435762,141.9083141390134,142.83264777706606,132.35985000000008,139.8057,141.90380000000027,142.95850000000002,142.95850000000002,145.35537525751022,140.5616247424898,33642716,58.915021279411626,50.432167926327146,NaN,NaN,NaN,NaN,NaN,NaN,0.03422558788406796,0.17170819810900184,0.13748261022493388,93.51464435146438,66.17852161785201,5060974226,12997417070.046095,25.349236207178222,23.942979937000025,9.098602633799523,28.571428571428573,50
2017-08-31,145.03,146.21,144.98,146.2,133.67229497106666,139.34932628318222,142.0766155453266,143.15334798877404,132.51770000000008,139.94750000000002,142.0130000000003,143.09900000000005,143.09900000000005,145.87933738960686,140.31866261039323,38480747,64.02885041499518,51.59956880653821,NaN,NaN,NaN,NaN,64.02885041499518,NaN,0.2277942140758584,0.4222253778197569,0.1944311637438985,99.83416252072936,83.90566923633789,5099454973,13035272113.842842,29.566732591924005,22.239150111096347,9.660442647640656,100,42.857142857142854
2017-09-01,146.36,146.585,145.61,146,133.79495870269784,139.48102279242613,142.23047375923537,143.42445770412888,132.66660000000007,140.09300000000002,142.11900000000026,143.21650000000005,143.21650000000005,146.26567874189422,140.1673212581059,22293553,62.94023498011346,52.13157323701842,NaN,NaN,NaN,NaN,NaN,NaN,0.3226418052417342,0.5977334202960662,0.27509161505433205,90.86651053864156,94.73843913694509,5077161420,13030813403.242842,29.973297968669478,21.22263906229379,10.02069447497523,100,35.714285714285715
2017-09-05,145.55,145.88,143.6,144.69,133.90336707381528,139.58417085594243,142.3269257686771,143.5449855418309,132.80550000000008,140.2307,142.18800000000027,143.223,143.223,146.28413769701234,140.16186230298769,45480562,56.200193388173396,52.15447027581367,NaN,NaN,NaN,NaN,NaN,NaN,0.27906792396501356,0.623926520010599,0.34485859604558544,70.41373926619814,87.03813744185635,5031680858,13028818641.751614,26.734011498168563,27.98012148993178,9.222441673563893,92.85714285714286,28.571428571428573
2017-09-06,145.06,145.46,144.08,145.13,134.01507486412558,139.69398925483466,142.43685024833684,143.69593929975176,132.9423500000001,140.37800000000001,142.27900000000028,143.26400000000004,143.26400000000004,146.40324449510535,140.12475550489472,30722723,57.83350041570022,52.22186040920902,NaN,NaN,NaN,NaN,NaN,NaN,0.2620632197223339,0.6724376206985028,0.4103744009761689,77.28337236533939,79.5212073900597,5062403581,13044847888.534222,25.057143363839174,26.22509216616772,7.995973056059969,85.71428571428571,21.428571428571427
2017-09-07,145.4,145.84,144.94,145.47,134.1290542187114,139.80836570523397,142.55579729742166,143.86489746168016,133.0831000000001,140.5179,142.42780000000027,143.33150000000006,143.33150000000006,146.59698174087725,140.06601825912287,22721131,59.10261858987517,53.29590677861772,NaN,NaN,NaN,NaN,NaN,NaN,0.2556239141399813,0.7299042936511455,0.4742803795111642,82.59172521467589,76.76294561540448,5085124712,13048887200.712,25.78142226317371,25.118526851451268,7.611232768400753,78.57142857142857,14.285714285714286
2017-09-08,145.28,145.35,144.06,144.21,134.22936213693316,139.89552678037785,142.62066799164043,143.89776437009158,133.21145000000007,140.6472,142.5116000000003,143.49050000000005,143.49050000000005,146.59810663533867,140.38289336466144,27890115,52.76460043770777,53.9429278171857,NaN,NaN,52.76460043770777,NaN,NaN,NaN,0.1534534740752348,0.6660972221052077,0.5126437480299729,62.91959406713506,74.26489721571677,5057234597,13027483158.967813,24.068011366687685,27.596975272102352,7.215418544336172,71.42857142857143,7.142857142857143
2017-09-11,145.3,146.12,145.3,145.87,134.34518937935175,140.0138331807664,142.748092776282,144.08559633484475,133.34630000000007,140.791,142.67720000000028,143.67900000000003,143.67900000000003,146.8822477269221,140.47575227307797,27126332,59.00235013728555,55.08412620333338,NaN,NaN,NaN,NaN,NaN,NaN,0.18263438367373497,0.7409367276221417,0.5583023439484067,87.05882352941171,77.52338093707421,5084360929,13038069044.62635,25.503884373847796,25.15788579935873,6.109046171018821,64.28571428571429,0
2017-09-12,146.25,146.41,145.53,146.22,134.46334669896018,140.13672757322647,142.8842460007415,144.28887287438334,133.48530000000008,140.9273,142.8488000000003,143.79350000000005,143.79350000000005,147.1827611289214,140.4042388710787,30256661,60.19587927257891,55.631328514482014,NaN,NaN,NaN,NaN,NaN,NaN,0.20859666273766364,0.8190481723704863,0.6104515096328227,93.39366515837088,81.12402758497255,5114617590,13055260329.285442,25.816892535174407,24.100983131040664,6.238840005529725,57.142857142857146,35.714285714285715
2017-09-13,145.95,146.44,145.73,146.42,134.5823183735974,140.2611488094002,143.02290302032029,144.4918373625373,133.62340000000006,141.06589999999997,143.0534000000003,143.91300000000007,143.91300000000007,147.4904968902851,140.33550310971503,28450864,60.89642606661927,56.38202473759244,NaN,NaN,NaN,NaN,60.89642606661927,NaN,0.22113249740679186,0.8868671313913126,0.6657346339845207,97.01357466063311,92.48868778280523,5143068454,13082108327.707977,25.05650579340404,23.252221640295936,6.389879432216242,50,28.571428571428573
2017-09-14,145.85,146.2869,145.47,145.56,134.69154903654666,140.36607655574872,143.12239701952342,144.59356713753374,133.75855000000007,141.17989999999998,143.21400000000028,143.97700000000006,143.97700000000006,147.62359896341854,140.33040103658158,35296413,56.307329616887024,56.930890187681264,NaN,NaN,NaN,NaN,NaN,NaN,0.15644501833606328,0.8612909069045998,0.7048458885685365,81.44796380090489,90.61840120663628,5107772041,13054589310.154177,23.8463991182237,23.451013939043,5.973258208096174,42.857142857142854,21.428571428571427
2017-09-15,145.56,146.59,145.29,146.06,134.8046679516059,140.47882751504082,143.23759713640484,144.73322741014957,133.89415000000005,141.2892,143.4094000000003,144.21350000000004,144.21350000000004,147.75474427285437,140.6722557271457,46422402,58.2760196772618,57.71142763720644,NaN,NaN,NaN,NaN,NaN,NaN,0.13318193977093407,0.871323313282204,0.73814137351127,90.41591320072331,89.62581722075377,5154194443,13063159599.754177,23.811116983327015,21.89286094541023,5.804068758555481,100,14.285714285714286
2017-09-18,145.88,146.37,145.11,145.55,134.9115866784556,140.57924677216872,143.32827960164386,144.8110152758496,134.03440000000006,141.3953,143.5652000000003,144.42950000000005,144.42950000000005,147.73567286299908,141.123327137001,24858157,55.52772379957104,58.14612136550244,NaN,NaN,NaN,NaN,NaN,NaN,0.07234297290099123,0.828570089637509,0.7562271167365178,81.1934900542497,84.35245568529263,5129336286,13055662695.262114,22.266860816701918,21.399503865694687,5.47696473052274,92.85714285714286,7.142857142857143
2017-09-19,145.81,146.01,145.31,145.8,135.01992909956547,140.68262802420497,143.4252098133441,144.90520429719726,134.18605000000008,141.49579999999997,143.7080000000003,144.66700000000006,144.66700000000006,147.63290694392174,141.70109305607838,20871237,56.60800723423285,58.47133966502938,NaN,NaN,NaN,NaN,NaN,NaN,0.03947798661517399,0.8055746000054853,0.7660966133903113,77.99442896935957,83.20127740811085,5150207523,13064011190.062115,21.4351390655697,20.600180019596632,4.545611852460589,85.71428571428571,0
2017-09-20,145.75,145.91,144.23,145.35,135.12271587469417,140.77505123164647,143.50069178144827,144.94756579270228,134.33430000000007,141.58939999999996,143.8340000000003,144.77450000000005,144.77450000000005,147.67506184213042,141.87393815786967,34236155,54.062346977672306,58.124720072048,NaN,NaN,NaN,NaN,NaN,NaN,-0.01889295668810953,0.7424804175301745,0.761373374218284,58.52842809364531,72.57211570575153,5115971368,13075423241.72878,19.547946838405732,24.446341243665742,5.13713061821896,78.57142857142857,0
2017-09-21,145.25,145.26,143.95,144.46,135.21562417444846,140.84802051418814,143.53831171158754,144.90113095530205,134.47360000000006,141.66199999999998,143.90920000000028,144.86300000000006,144.86300000000006,147.6075735552213,142.1184264447788,28841835,49.33676381069049,57.07528531459767,NaN,NaN,NaN,NaN,NaN,NaN,-0.1182273496259002,0.6135891871859087,0.7318165368118089,28.762541806020437,55.095132956341764,5087129533,13069038408.026491,18.116523381224162,24.12075220828365,5.142214042482104,71.42857142857143,14.285714285714286
2017-09-22,144,144.53,143.855,144.32,135.30621497868282,140.9167725832141,143.56896615427038,144.8457851500352,134.61080000000007,141.73089999999996,143.9754000000003,144.96550000000008,144.96550000000008,147.4564634682166,142.47453653178354,21702401,48.61686708741799,56.05218760797657,NaN,NaN,NaN,NaN,NaN,NaN,-0.18989685427259484,0.49444546897106534,0.6843423232436602,24.080267558528316,37.12374581939802,5065427132,13077237092.848713,17.452939270262803,23.75275577555119,5.013372354313333,64.28571428571429,7.142857142857143
2017-09-25,143.75,143.8299,142.1,142.8,135.38078000377055,140.95406421522966,143.5388106188088,144.65094846907945,134.73300000000006,141.78899999999996,143.98900000000032,145.00700000000003,145.00700000000003,147.3181218055423,142.69587819445778,54947712,41.531290459650954,55.00440882736782,NaN,NaN,41.531290459650954,NaN,NaN,NaN,-0.32810507175988013,0.27421098354381,0.6023160553036901,15.590200445434647,22.811003269994455,5010479420,13066758307.838713,15.448710714271133,30.103344606283954,7.148635812582043,57.142857142857146,100
2017-09-26,143.51,143.8,142.67,143.17,135.45828468034995,140.99794413175977,143.5243474572869,144.50990575773855,134.85600000000008,141.85029999999998,144.00860000000029,145.04500000000002,145.04500000000002,147.20405998065345,142.88594001934658,29628806,43.682937561827224,53.99365433780547,NaN,NaN,NaN,NaN,NaN,NaN,-0.379410159804878,0.12805335554759267,0.5074635153524707,23.830734966592228,21.167067656851717,5040108226,13063349684.139597,14.533821232752336,28.320591737891977,9.283899270850753,50,92.85714285714286
2017-09-27,143.93,145,143.57,144.46,135.54785398701313,141.0664996935071,143.5610397138639,144.5051528284301,134.98080000000007,141.91949999999994,144.03500000000028,145.11950000000004,145.11950000000004,147.08079013662368,143.1582098633764,33249403,50.519728195911796,53.380590738236656,NaN,NaN,NaN,NaN,NaN,NaN,-0.313979549202646,0.1149890788491632,0.4289686280518092,52.56124721603583,30.660727542687557,5073357629,13071487649.908829,19.311935968337597,25.669354057060573,10.200408004911182,42.857142857142854,85.71428571428571
2017-09-28,144.14,144.5566,143.78,144.41,135.63603454435628,141.13270762036834,143.59433227410452,144.4960906542939,135.10805000000008,141.98519999999996,144.0436000000003,145.10750000000004,145.10750000000004,147.0830189191753,143.1319810808248,24149422,50.265019880712025,53.202049269879815,NaN,NaN,NaN,NaN,NaN,NaN,-0.2636112915728661,0.09945451358572654,0.36306580515859266,51.44766146993313,42.61321455085372,5049208207,13086519623.376251,18.51960078564163,24.61618505474851,10.722050669477683,35.714285714285715,78.57142857142857
2017-09-29,144.7,145.555,144.32,145.45,135.73368594192488,141.21819855857888,143.66710355747296,144.58693916340877,135.2330000000001,142.05649999999994,144.06920000000028,145.07000000000002,145.07000000000002,146.98880170941385,143.1511982905862,43102366,55.311889949894926,52.93844497078049,NaN,NaN,NaN,NaN,NaN,NaN,-0.15516213525666683,0.16911313608775913,0.32427527134442596,74.61024498886387,59.53971789161093,5092310573,13122292842.12119,22.611180967216015,23.00008994174943,10.73417223246194,28.571428571428573,71.42857142857143
2017-10-02,145.67,146.17,144.93,145.58,135.83165921613457,141.30457086434959,143.74211910423872,144.68151638594128,135.35985000000008,142.12829999999997,144.0986000000003,145.04900000000004,145.04900000000004,146.93555135101968,143.1624486489804,27351260,55.91410900653733,52.6326042374918,NaN,NaN,NaN,NaN,NaN,NaN,-0.0737145090174009,0.23213213507267483,0.3058466440900757,77.50556792873076,67.85449146250924,5119661833,13123616290.185705,24.39986200236625,21.475579276354313,10.943953099864045,21.428571428571427,64.28571428571429
2017-10-03,145.74,146.06,145.45,145.89,135.93174220900886,141.39537144129315,143.82634972760192,144.79661006347067,135.48730000000006,142.20429999999996,144.12100000000027,145.10900000000004,145.10900000000004,147.02220568680863,143.19579431319144,19715152,57.38876149658395,52.382056768203554,NaN,NaN,NaN,NaN,NaN,NaN,-0.0018053481129253202,0.30358995894891905,0.30539530706184437,84.40979955456535,78.84187082405332,5139376985,13132342668.939802,23.572124758012052,20.74704495884892,11.132488375090537,14.285714285714286,57.142857142857146
2017-10-04,145.6,146.34,145.47,146.03,136.03222238603365,141.48714626423785,143.91276738534302,144.91407577171157,135.61945000000006,142.27859999999995,144.15360000000027,145.15400000000002,145.15400000000002,147.1089465465977,143.19905345340234,26381099,58.07087537637106,52.508024322452414,NaN,NaN,NaN,NaN,NaN,NaN,0.04951080237615235,0.3672838100320348,0.31777300765588246,87.52783964365254,83.14773570898286,5165758084,13139923444.514515,23.998619070681052,19.719557807377857,11.771908074857919,7.142857142857143,50
2017-10-05,146.54,147.54,146.4063,147.46,136.14593161602338,141.6054205956391,144.05187454670212,145.15654474583428,135.75630000000007,142.36279999999994,144.20540000000028,145.2535,145.2535,147.45026375609126,143.05673624390874,31562353,64.34859683357092,52.94177983361736,NaN,NaN,NaN,NaN,NaN,NaN,0.1674415166763577,0.5270749035013296,0.35963338682497187,98.52941176470617,90.155683654308,5197320437,13167031377.050549,28.698473934059592,18.048809284892407,13.099352629375721,100,42.857142857142854
2017-10-06,146.97,147.66,146.96,147.66,136.26049946064006,141.7253132571116,144.19336966251774,145.3949690557548,135.89185000000006,142.44319999999993,144.27940000000027,145.42600000000002,145.42600000000002,147.8023871738536,143.04961282614644,23561069,65.13483941030688,53.62800237724134,NaN,NaN,NaN,NaN,NaN,NaN,0.24206546653777739,0.6622152199971936,0.4201497534594162,100,95.35241713611957,5220881506,13190592446.050549,28.22953000007873,17.31636204450173,14.668959049399108,100,35.714285714285715
2017-10-09,147.86,148.0093,147.3,147.49,136.37223578441478,141.83946546984205,144.32264928359547,145.5944958123496,136.02700000000007,142.55739999999992,144.35240000000027,145.507,145.507,148.04344712148293,142.97055287851708,13704835,63.845946399441566,54.14499803189911,NaN,NaN,NaN,NaN,NaN,NaN,0.26146941290287196,0.7469865195880061,0.48551710668513415,91.21215710828716,96.58052295766443,5207176671,13184229831.972584,29.120740254635873,16.582046821775272,16.486742291734494,100,28.571428571428573
2017-10-10,147.98,148.14,146.95,147.6,136.48395483133604,141.95353546053826,144.45117284110154,145.78549621117347,136.1644000000001,142.66079999999994,144.43980000000028,145.57600000000002,145.57600000000002,148.25722658499114,142.8947734150089,19223092,64.33769304145157,54.87895132216905,NaN,NaN,NaN,NaN,NaN,NaN,0.26251834812087727,0.8136650418362308,0.5511466937153535,91.05960264900675,94.09058658576464,5226399763,13186006756.443172,27.04836420465305,17.495073064878113,17.223383368912653,100,21.428571428571427
2017-10-11,147.53,148.07,147.34,148.04,136.59894035540233,142.07405951082464,144.59191116105833,146.00021085772838,136.30360000000007,142.76279999999994,144.52940000000027,145.65700000000004,145.65700000000004,148.52658603287014,142.78741396712994,12439051,66.31152609731072,56.09143434264193,NaN,NaN,NaN,NaN,NaN,NaN,0.27246922767257,0.8917332283060659,0.619264000633496,98.34437086092724,93.53871020607373,5238838814,13197423419.689747,25.833814553050715,16.709493769400797,17.739930602957525,92.85714285714286,14.285714285714286
2017-10-12,147.84,148.355,147.615,147.77,136.71009517773663,142.1868504116004,144.71654209591878,146.1687622046114,136.43835000000007,142.85049999999993,144.60580000000027,145.76750000000004,145.76750000000004,148.78026534101906,142.75473465898102,14513477,63.9716944572675,57.18820772620261,NaN,NaN,NaN,NaN,NaN,NaN,0.24154647812891616,0.9211970982946411,0.679650620165725,90.64748201438881,93.35048517477428,5224325337,13188989912.784342,26.42632122135915,15.928679767956522,18.418229821660653,100,7.142857142857143
2017-10-13,148.4,148.51,147.7772,148.34,136.8258156237293,142.30869495790535,144.85863848431413,146.37554675655318,136.58065000000005,142.94249999999994,144.7048000000003,145.88150000000005,145.88150000000005,149.0957201231444,142.6672798768557,18409888,66.64730154836792,58.98220851825382,NaN,NaN,NaN,NaN,NaN,NaN,0.23968225567390866,0.9792534397581107,0.7395711840842021,97.08904109589062,95.36029799040222,5242735225,13198858095.107487,26.16374445974635,15.165501894170783,18.02109426846795,100,0
2017-10-16,148.7,148.89,148.3928,148.85,136.94545924936384,142.4382257508181,145.01516246532142,146.6112089702148,136.72635000000008,143.03319999999994,144.80880000000028,146.04650000000004,146.04650000000004,149.5052181151456,142.58778188485448,21809410,68.87457621871758,60.78161127946027,NaN,NaN,NaN,NaN,NaN,NaN,0.25175373648993093,1.0542633546966158,0.8025096182066849,99.24812030075203,95.66154780367715,5264544635,13217158348.228968,27.749185941464937,14.605389992984449,17.93977887145312,100,0
2017-10-17,148.79,149.06,148.57,149.04,137.0658029384249,142.5689539537722,145.17299923138725,146.84252240162292,136.87915000000007,143.11389999999994,144.8984000000003,146.20850000000002,146.20850000000002,149.90144069815182,142.5155593018482,13138157,69.6867398830864,62.15068354282989,NaN,NaN,NaN,NaN,69.6867398830864,NaN,0.2509315890535957,1.1161741045236795,0.8652425154700838,99.62121212121193,98.6527911726182,5277682792,13229224002.616722,27.986851410084824,14.105555435567751,19.285827105267938,100,0
2017-10-18,149.21,149.21,148.64,148.86,137.18315813306742,142.69352912300442,145.31758749682305,147.0346631252779,137.02575000000007,143.19029999999995,144.9894000000003,146.38400000000004,146.38400000000004,150.2276045582258,142.54039544177428,17218243,67.8796836008579,63.408873808554596,NaN,NaN,NaN,NaN,NaN,NaN,0.2178866040847105,1.1376007705759719,0.9197141664912614,92.8425357873212,97.23728940309506,5260464549,13225297034.914968,27.918154373509374,13.525678749631478,20.756840897964334,100,0
2017-10-19,148.02,148.33,147.27,148.31,137.29387297751452,142.80474636809345,145.43493700675157,147.15612378001333,137.16635000000008,143.25999999999996,145.0732000000003,146.57650000000007,146.57650000000007,150.40097525812368,142.75202474187645,27680285,62.542958637222426,63.925378714792274,NaN,NaN,NaN,NaN,NaN,NaN,0.14226809826963005,1.097549289328299,0.9552811910586689,78.9719626168223,90.47857017511848,5232784264,13251932780.858364,24.849361089423276,21.510107898978752,21.21043364300804,92.85714285714286,0
2017-10-20,148.91,149.04,148.53,148.71,137.40746628122085,142.92168208357674,145.56337084962405,147.30411199144064,137.30555000000007,143.33419999999995,145.2268000000003,146.79600000000005,146.79600000000005,150.5809565387233,143.01104346127678,30173268,64.71565509295911,64.55406057810812,NaN,NaN,NaN,NaN,NaN,NaN,0.10423190425577056,1.0855710713783822,0.9813391671226116,86.70212765957454,86.17220868790601,5262957532,13243058290.27013,28.581957144928765,20.401317238836725,21.948039871913174,85.71428571428571,0
2017-10-23,149.01,149.03,147.53,147.74,137.51027756200472,143.01709431954552,145.64872885552114,147.34562513511295,137.43460000000007,143.39319999999995,145.33960000000033,147.04300000000006,147.04300000000006,150.36963253155656,143.71636746844356,29297126,56.20203864045425,64.46929465981313,NaN,NaN,NaN,NaN,NaN,NaN,0.004077730306643046,0.9864363300059154,0.9823585996992723,60.69518716577553,75.45642581405747,5233660406,13221964359.55013,25.655509878484317,25.138330336912574,21.5654539064385,78.57142857142857,0
2017-10-24,148,148.3,147.44,147.99,137.6145534071589,143.1155676993565,145.74054341020658,147.4069941698641,137.56290000000007,143.43849999999995,145.42080000000033,147.28400000000005,147.28400000000005,150.11481189767431,144.45318810232578,20289467,57.744933994625285,64.44601313254559,NaN,NaN,NaN,NaN,NaN,NaN,-0.05191228685999172,0.9174682411242827,0.9693805279842744,56.48607197631737,67.96112893388916,5253949873,13227626536.38734,24.130056452993966,24.26587429322035,20.886368762188475,71.42857142857143,0
2017-10-25,147.7,148.18,146.33,147.43,137.71221954241105,143.20100200233952,145.80679660980633,147.40918520130563,137.68705000000008,143.47849999999994,145.48880000000034,147.43250000000006,147.43250000000006,149.94935418727601,144.9156458127241,36179124,53.222132291110874,63.651265665227015,NaN,NaN,NaN,NaN,NaN,NaN,-0.12885996602804273,0.808305570449221,0.9371655364772637,38.19444444444431,51.79190119551242,5217770749,13234471235.522476,21.208665941781124,28.59215243391315,20.3181315643015,64.28571428571429,100
2017-10-26,147.36,147.705,146.92,146.96,137.80423725840697,143.2754376062536,145.85202027216687,147.36640565832414,137.80720000000008,143.51949999999994,145.54240000000036,147.56000000000003,147.56000000000003,149.67827288139074,145.44172711860932,28230199,49.703490467091704,62.54902645499735,NaN,NaN,49.703490467091704,NaN,NaN,NaN,-0.2088724895573456,0.6760749245305817,0.8849474140879273,21.874999999999876,38.85183880692053,5189540550,13209117999.477892,20.09682821032814,27.093244676737633,19.66564707940099,57.142857142857146,92.85714285714286
2017-10-27,149.33,151.52,149.2,151.24,137.93792643991537,143.43315171306045,146.06331359482698,147.73531940515042,137.9497000000001,143.59769999999992,145.74060000000034,147.84950000000006,147.84950000000006,150.29283767621038,145.40616232378974,60165127,69.48686064457364,62.95194890107835,NaN,NaN,NaN,NaN,NaN,NaN,0.016998356329638087,0.906195359499975,0.8891970031703369,94.60500963391134,51.55815135945184,5249705677,13254760509.615824,35.79493480485622,20.402304452809787,19.66243813172261,100,85.71428571428571
2017-10-30,151.08,152.19,150.9899,151.58,138.07366846538886,143.5944754415147,146.2796542381671,148.10147946180277,138.0918000000001,143.67779999999993,145.94760000000034,148.14950000000005,148.14950000000005,150.86300308642242,145.43599691357767,31733386,70.48019564142847,63.390699086790995,NaN,NaN,NaN,NaN,NaN,NaN,0.17127011111175627,1.1032846420600322,0.9320145309482759,89.59044368600705,68.69015110663942,5281439063,13254234308.148113,37.105456036983526,19.067673725984022,20.424146410529467,100,78.57142857142857
2017-10-31,152.04,152.37,151.63,152.15,138.21373146573325,143.7638917694055,146.50986387588603,148.48705284639297,138.2386000000001,143.79949999999994,146.16960000000034,148.46250000000003,148.46250000000003,151.4875545449684,145.43744545503168,26319327,72.1188955860172,63.80551119312717,NaN,NaN,NaN,NaN,NaN,NaN,0.2868654658370504,1.290596363244589,1.0037308974075385,96.35761589403975,93.51768973798606,5307758390,13264904305.580545,36.47078040146506,18.222614919585567,21.275385145857975,100,71.42857142857143
2017-11-01,152.75,152.83,151.5,152.1,138.35190329194486,143.92896321951628,146.72908490036107,148.8311430514984,138.3839000000001,143.92819999999995,146.34760000000034,148.76600000000002,148.76600000000002,151.96683988978674,145.5651601102133,29481569,71.74267430510412,64.36058118225836,NaN,NaN,NaN,NaN,NaN,NaN,0.3319387267956224,1.4186543059020664,1.086715579106444,88.76923076923049,91.57243011642576,5278276821,13262022648.460243,36.33063257363608,16.867289014021267,22.118368656073297,100,64.28571428571429
2017-11-02,151.92,151.99,150.77,151.81,138.48581470197527,144.08502335378327,146.92833647289592,149.11484371326046,138.5280500000001,144.04269999999994,146.53000000000034,148.98350000000005,148.98350000000005,152.38470728565903,145.58229271434107,31017426,69.47876483386078,64.56282855979356,NaN,NaN,NaN,NaN,NaN,NaN,0.3143744959828001,1.4796836990849442,1.1653092031021441,84.30769230769215,89.81151299032081,5247259395,13283887391.378275,33.6364450815548,19.686750443374866,22.086180621233563,92.85714285714286,57.142857142857146
2017-11-03,152.39,153.29,151.84,153.27,138.63292102334864,144.26690407945094,147.17702916023333,149.51057288342614,138.67815000000007,144.17789999999997,146.75000000000034,149.26400000000004,149.26400000000004,153.08211157511727,145.4458884248828,26199249,73.9377229525065,64.92448189792135,NaN,NaN,NaN,NaN,NaN,NaN,0.3694354334334289,1.6271034948939302,1.2576680614605014,99.71264367816119,90.92985558502794,5273458644,13309363902.474827,38.06013300955264,18.080001320350362,22.411679336265784,100,50
2017-11-06,153.13,153.85,153.1,153.79,138.78373772958398,144.45548023629348,147.4363613500281,149.91813737071888,138.83035000000007,144.32449999999994,146.98640000000034,149.57900000000004,149.57900000000004,153.78002320870257,145.3779767912975,28693919,75.32065273108691,65.32690424420709,NaN,NaN,NaN,NaN,NaN,NaN,0.40629941197272923,1.765542326426413,1.3592429144536837,99.20212765957443,94.40748788180925,5302152563,13333466794.434826,39.62109185978478,17.30904227960752,22.855524872444597,100,42.857142857142854
2017-11-07,153.67,154.0823,153.34,153.88,138.93394929446373,144.64210439003025,147.68905306179172,150.29545762112662,138.97885000000008,144.48179999999994,147.21580000000034,149.89300000000003,149.89300000000003,154.38417401132955,145.4018259886705,21333062,75.56234962407642,65.87566610300841,NaN,NaN,NaN,NaN,NaN,NaN,0.4014577845428027,1.8610651451321871,1.4596073605893845,97.39045186589776,98.76840773454445,5323485625,13343172001.274918,39.259104714103735,16.55654415820848,23.280276320008134,100,35.714285714285715
2017-11-08,153.81,154.54,153.62,154.5,139.08883537113573,144.83731024369303,147.95614902015282,150.69589022863838,139.1242000000001,144.62219999999994,147.44640000000035,150.21600000000004,150.21600000000004,155.04419800754417,145.3878019924559,17373517,77.21762501266092,66.92385655839688,NaN,NaN,NaN,NaN,77.21762501266092,NaN,0.4036380556993462,1.9641549302135672,1.560516874514221,99.51278928136429,98.70178960227884,5340859142,13359034777.666222,39.83446713093582,15.648517435831316,25.879468750082474,100,28.571428571428573
2017-11-09,153.26,153.77,152.11,153.69,139.23412059132343,145.01261103094663,148.1810059213233,150.98104354019662,139.26485000000008,144.76549999999995,147.62720000000033,150.51200000000003,150.51200000000003,155.42913168423038,145.59486831576967,40594482,70.49912178175049,67.33696132188197,NaN,NaN,NaN,NaN,NaN,NaN,0.31792599140054545,1.9579243637649029,1.6399983723643574,89.64677222898908,95.51667112541703,5300264660,13395716538.509594,34.5355188588118,21.971343925523694,26.274746811474397,92.85714285714286,21.428571428571427
2017-11-10,153.36,153.8,153.06,153.68,139.3778606849421,145.18424249568037,148.39665274793808,151.23808701255885,139.40425000000008,144.89489999999992,147.77680000000035,150.77900000000005,150.77900000000005,155.77467372834028,145.78332627165983,20150762,70.41766310267346,68.35236306918334,NaN,NaN,NaN,NaN,NaN,NaN,0.2319473954487783,1.9299326166753303,1.697985221226552,89.52496954933024,92.8948436865612,5280113898,13409331918.239323,33.240915964652714,21.038181243981303,27.807837438129077,85.71428571428571,14.285714285714286
2017-11-13,153.12,154.0693,153.1,153.87,139.5220610761367,145.35623769378572,148.6112938166464,151.48874539231514,139.54950000000008,145.02659999999992,147.93420000000032,151.03000000000003,151.03000000000003,156.11639361434624,145.94360638565382,12522399,71.10090760249875,69.30636118403145,NaN,NaN,NaN,NaN,NaN,NaN,0.16254376042434782,1.9011649217569868,1.738621161332639,91.83922046285032,90.33698741372321,5292636297,13416704798.78126,32.93240248730675,19.848993548072112,29.55835733801445,78.57142857142857,7.142857142857143
2017-11-14,153.31,153.5,152.57,153.31,139.65925449826472,145.51373793747314,148.79555680422888,151.66219821209464,139.69320000000008,145.14729999999992,148.10660000000033,151.24350000000004,151.24350000000004,156.33631169886075,146.15068830113933,25173763,66.24452634668452,70.236532188001,NaN,NaN,NaN,NaN,NaN,NaN,0.05893352505841487,1.8122880676556576,1.7533545425972428,83.85826771653558,88.40748590957203,5267462534,13431592508.082335,30.446683496166614,21.428041143516545,29.741171086829496,71.42857142857143,0
2017-11-15,152.61,153,151.78,152.59,139.78791863261034,145.6538619387113,148.9443584981807,151.75056028713325,139.8290000000001,145.2673999999999,148.25580000000033,151.43000000000004,151.43000000000004,156.43239942428121,146.42760057571886,24808004,60.52088933124771,71.0092035354407,NaN,NaN,60.52088933124771,NaN,NaN,NaN,-0.07103047259939155,1.6645664518480032,1.7355969244473948,63.483146067415966,79.72687808226728,5242654530,13439726279.885612,27.788268018994344,24.06543689752318,29.194989279632665,64.28571428571429,0
2017-11-16,153.38,154.89,153.33,154.54,139.93470551188784,145.8298250686378,149.16379541982067,152.01622121216818,139.97510000000008,145.43249999999992,148.43720000000033,151.74150000000006,151.74150000000006,156.7036982024122,146.77930179758792,34790570,68.46728591444757,70.93637676900313,NaN,NaN,NaN,NaN,NaN,NaN,-0.04014451518379647,1.6854162804676491,1.7255607956514456,91.50485436893213,79.61542271762788,5277445100,13458905696.680485,34.52374544849023,21.085014269801245,28.9647182018385,100,0
2017-11-17,154.58,154.69,153.8,153.95,140.0741611784362,145.9906206118331,149.35148971708261,152.2003906205331,140.1164500000001,145.57179999999994,148.63200000000035,152.00350000000006,152.00350000000006,156.84976980264435,147.15723019735577,28725800,64.25323337690767,70.49159375010879,NaN,NaN,NaN,NaN,NaN,NaN,-0.07206538366034376,1.635479066076016,1.7075444497363597,77.1844660194174,77.39082215192182,5248719300,13439862750.613068,32.82942989937014,20.050228875961377,28.397255449288025,92.85714285714286,21.428571428571427
2017-11-20,154.08,154.2,153.61,153.83,140.21103519656123,146.14585584724233,149.52711757131468,152.35559151381568,140.25645000000011,145.7341999999999,148.79120000000034,152.30800000000005,152.30800000000005,156.79656146221095,147.81943853778915,21143944,63.39854064255149,69.86871125414696,NaN,NaN,NaN,NaN,NaN,NaN,-0.11152045558242141,1.568143880258333,1.6796643358407544,74.27184466019466,80.98705501618137,5227575356,13434487171.630018,31.718131535735523,20.46162157827682,27.55497583302455,85.71428571428571,14.285714285714286
2017-11-21,154.56,155.57,154.485,155.5,140.36316419958052,146.33108642452467,149.76134825479252,152.65505898869037,140.40250000000012,145.91279999999992,148.97680000000034,152.68350000000007,152.68350000000007,156.91338545944458,148.45361454055555,20147763,69.4824717610177,69.70726821528363,NaN,NaN,NaN,NaN,NaN,NaN,-0.03914172428564999,1.6307371804836919,1.6698789047693419,98.5416666666668,83.33265911542627,5247723119,13452035223.275179,36.282294039064496,18.47533637218504,27.264470816967055,100,7.142857142857143
2017-11-22,155.63,155.84,155.341,155.69,140.5156700284404,146.5164114458212,149.9938444016634,152.9441009897675,140.54845000000012,146.1077999999999,149.16220000000033,153.09650000000005,153.09650000000005,156.77040949807463,149.42259050192547,17299040,70.09158920479308,69.75104138463594,NaN,NaN,NaN,NaN,NaN,NaN,0.005177125050209286,1.6763503110821034,1.6711731860318941,96.30541871921169,89.7063100153577,5265022159,13458934038.82628,36.80116646019872,17.937560973923624,27.85736503468818,100,0
2017-11-24,155.86,156.31,155.76,156.26,140.67233002815743,146.7093537934287,150.23957599375504,153.25990089550393,140.69495000000012,146.29509999999993,149.37620000000032,153.56150000000008,153.56150000000008,156.22663245449485,150.8963675455053,8209832,71.90339429990723,69.60573219516456,NaN,NaN,NaN,NaN,NaN,NaN,0.053824229203109475,1.738453472535781,1.6846292433326715,98.89624724061785,97.9144442088321,5273231991,13465651174.099007,38.26339103270106,17.265120243798318,28.016332816370227,100,57.142857142857146
2017-11-27,156.2,156.56,155.83,156.19,140.82673470449419,146.89708936187566,150.47292595478424,153.538957953075,140.8390000000001,146.49409999999992,149.57880000000034,153.80900000000005,153.80900000000005,156.48516068277735,151.13283931722276,22653389,71.33190274637981,69.3208214819712,NaN,NaN,NaN,NaN,NaN,NaN,0.06166805688867005,1.761714314443509,1.700046257554839,92.25941422594133,95.82036006192361,5250578602,13465340853.701746,38.08111895010581,16.481676425167365,28.04450481191128,100,50
2017-11-28,156.52,156.69,155.7,156.59,140.98358311539474,147.08902818639297,150.71281121145938,153.8295333861155,140.9814500000001,146.68239999999992,149.79960000000034,154.05950000000007,154.05950000000007,156.79152104677533,151.3274789532248,25227320,72.66870529077849,69.11413260102135,NaN,NaN,NaN,NaN,72.66870529077849,NaN,0.07337974298523542,1.7917709362863832,1.7183911933011478,97.96334012219971,96.37300052958626,5275805922,13485471745.418919,35.714236757919,15.457279361645535,27.966805337186035,100,42.857142857142854
2017-11-29,156.45,156.45,153.12,153.86,141.11170666648533,147.22310683616737,150.83623037963744,153.8324349683902,141.1081000000001,146.83439999999993,149.96080000000035,154.14500000000004,154.14500000000004,156.73602682349548,151.5539731765046,71986338,54.120002532597766,67.46430242387399,NaN,NaN,NaN,NaN,NaN,NaN,-0.11301475316360254,1.5771227518466446,1.6901375050102472,42.362525458248754,77.5284266021299,5203819584,13445479335.418919,28.927553125335514,26.64881126908162,25.145987288291504,92.85714285714286,35.714285714285715
2017-11-30,154.46,155.45,154.145,155.15,141.25139117726658,147.3800750176294,151.00539781573008,153.95791735235304,141.2374000000001,146.99539999999993,150.15680000000035,154.29750000000007,154.29750000000007,156.74412931397973,151.85087068602041,56595465,59.39430265823189,66.67110105790837,NaN,NaN,NaN,NaN,NaN,NaN,-0.15700266686891817,1.4938841714240993,1.6508868382930175,68.63543788187387,69.65376782077409,5260415049,13476053896.970644,26.44754069162174,24.364159573700878,23.850660328863743,85.71428571428571,28.571428571428573
2017-12-01,154.19,155.24,152.26,154.49,141.38311862823906,147.5208656113397,151.14204888177989,154.00859189022418,141.3636000000001,147.13329999999993,150.35740000000035,154.43150000000009,154.43150000000009,156.59576685046096,152.2672331495392,59015828,55.856343121123395,65.63100677351194,NaN,NaN,NaN,NaN,NaN,NaN,-0.23351357805786277,1.358994865720689,1.5925084437785517,55.19348268839124,55.39714867617126,5201399221,13505363771.27937,22.546158193537593,30.101107929806037,23.269850696997715,78.57142857142857,21.428571428571427
2017-12-04,155.47,155.625,152.56,152.71,141.49582391552028,147.62362074774882,151.20353716092578,153.8849164721076,141.4781000000001,147.25029999999992,150.52520000000038,154.40350000000007,154.40350000000007,156.64041998069482,152.16658001930531,51319146,47.61799840320174,63.95365611641929,NaN,NaN,47.61799840320174,NaN,NaN,NaN,-0.39734200439803224,1.0958309382810114,1.4931729426790437,18.94093686354394,47.58995247793632,5150080075,13459067706.45392,21.14381848704211,25.873561809322005,22.21782542107867,71.42857142857143,14.285714285714286
2017-12-05,152.64,154.55,152.1,152.81,141.6084027820325,147.7263213270013,151.26653570363456,153.782543474764,141.58990000000009,147.35719999999992,150.72540000000038,154.3545000000001,154.3545000000001,156.68404480532178,152.0249551946784,40604211,48.081291704601476,62.656282213413355,NaN,NaN,NaN,NaN,NaN,NaN,-0.4864283700119514,0.8851374801641043,1.3715658501760557,20.977596741344232,31.704005431093112,5190684286,13441997364.686573,18.8632520432576,25.107967916379625,21.990425309149913,64.28571428571429,7.142857142857143
2017-12-06,152.26,153.735,152.06,153.5,141.72672713246004,147.84065159775375,151.35412253878616,153.7556345724055,141.7049000000001,147.47029999999992,150.93200000000036,154.33550000000008,154.33550000000008,156.68631666661153,151.98468333338863,28647769,51.28304483227296,61.9964361777723,NaN,NaN,NaN,NaN,NaN,NaN,-0.48523671516123956,0.7650199562245064,1.250256671385746,31.101511879049657,23.673348494645918,5219332055,13462606655.220901,17.47546905437262,23.43644796545371,22.51833860004844,57.142857142857146,0
2017-12-07,153.49,154.46,153.33,154.02,141.84904825552013,147.9630149324517,151.45866675295142,153.78081223217643,141.8249500000001,147.57909999999993,151.12320000000037,154.31150000000008,154.31150000000008,156.664908379357,151.95809162064316,32666207,53.60510310185515,60.93485169115856,NaN,NaN,NaN,NaN,NaN,NaN,-0.43726606479746444,0.7036740903889154,1.1409401551863798,42.33261339092894,31.470574003774274,5251998262,13469833692.167805,19.84414423593223,22.247313719480605,21.199969106007728,50,92.85714285714286
2017-12-08,155.1,155.53,154.46,154.7,141.97691842213186,148.09642057735365,151.5857778606788,153.8683539243501,141.94715000000008,147.68629999999993,151.32900000000038,154.36200000000005,154.36200000000005,156.7032099436104,152.0207900563897,28081666,56.523458747103994,60.38272493188687,NaN,NaN,NaN,NaN,NaN,NaN,-0.3512825030433149,0.7018370263822362,1.053119529425551,57.01943844492417,43.48452123830092,5280079928,13454349409.046309,23.31573772547922,20.733427012922863,19.892523757493784,42.857142857142854,85.71428571428571
2017-12-11,154.76,155.95,154.76,155.9,142.11545654728477,148.25094690255457,151.75496304261296,154.06184402679293,142.0745500000001,147.8035999999999,151.53800000000038,154.47300000000004,154.47300000000004,156.8838181184121,152.06218188158797,20821528,61.16582215152662,60.223245039670815,NaN,NaN,NaN,NaN,NaN,NaN,-0.21199475618362262,0.7881260841960227,1.0001208403796453,82.9373650107993,60.76313894888413,5300901456,13473421228.811014,23.90394273292249,19.54758545570429,19.06775400095112,35.714285714285715,78.57142857142857
2017-12-12,155.81,156.15,155.36,155.69,142.25052663139138,148.39825488468222,151.90927821741244,154.2169065004317,142.2029000000001,147.91939999999994,151.74020000000036,154.56400000000005,154.56400000000005,157.01398285709246,152.11401714290764,20310252,59.95922338127333,59.54301301254621,NaN,NaN,NaN,NaN,NaN,NaN,-0.1360983996773666,0.8299978407829371,0.9660962404603037,78.40172786177104,72.7861771058315,5280591204,13470079035.443926,23.95686817627092,18.81515704369859,17.60358326003013,28.571428571428573,71.42857142857143
2017-12-13,156.28,156.49,155.76,155.99,142.3872378091885,148.54858647112417,152.06930652261195,154.3857725480096,142.3256500000001,148.0315999999999,151.94220000000038,154.69800000000004,154.69800000000004,157.15213610056037,152.2438638994397,24418479,61.13861748148777,58.90351503231012,NaN,NaN,NaN,NaN,NaN,NaN,-0.07105594664044568,0.8772763071597467,0.9483322538001924,84.88120950323997,82.07343412527011,5305009683,13461047543.21105,24.684831623528147,18.07651447175237,16.24592476264899,21.428571428571427,64.28571428571429
2017-12-14,156.28,156.66,155.71,155.88,142.52149414939558,148.69376297664647,152.21874548250952,154.52807992438966,142.4511500000001,148.14639999999991,152.13920000000036,154.86250000000007,154.86250000000007,157.16580957537985,152.55919042462028,24594682,60.43569714442969,58.08439380691886,NaN,NaN,NaN,NaN,NaN,NaN,-0.042229434178480796,0.8955454610770914,0.9377748952555722,82.50539956803449,81.9294456443485,5280415001,13445255168.453156,24.360233019239065,17.212371693658227,14.772952326861274,14.285714285714286,57.142857142857146
2017-12-15,156.49,157.82,156.23,157.65,142.672026545919,148.87111420483168,152.43173585574445,154.82540564587634,142.5843000000001,148.27419999999992,152.3430000000004,155.0180000000001,155.0180000000001,157.61448685727734,152.42151314272283,49816151,67.00859105239515,57.775585828777096,NaN,NaN,NaN,NaN,NaN,NaN,0.0824599523334767,1.040849835672418,0.9583898833389414,97.04861111111133,88.14507339412859,5330231152,13484418809.176426,27.73104586181408,15.574950884322755,13.95036961068044,100,50
2017-12-18,158.29,158.77,158.07,158.64,142.83091185391982,149.06455748790432,152.67519719473486,155.18870034626906,142.7238500000001,148.4209999999999,152.56260000000037,155.25250000000008,155.25250000000008,158.23870746098214,152.26629253901802,26844519,70.00969224151046,57.58565632525796,NaN,NaN,NaN,NaN,70.00969224151046,NaN,0.21073218675800032,1.2218051167864417,1.0110729300284413,98.06259314456,92.53886794123527,5357075671,13501292506.833567,30.91911666742263,14.705206386976212,13.661189041840641,100,42.857142857142854
2017-12-19,158.34,158.5,157.26,157.7,142.97886297975145,149.23555634953,152.87224828513743,155.42787174186248,142.8598000000001,148.5595999999999,152.76680000000036,155.44600000000008,155.44600000000008,158.53808926132598,152.3539107386742,31414968,64.0518525504832,58.295074183678345,NaN,NaN,NaN,NaN,NaN,NaN,0.21087744590603785,1.2746697374109885,1.0637922915049507,84.05365126676571,93.05495184081235,5325660703,13492172032.252922,28.786103055499414,17.73997030560304,15.064161339780162,92.85714285714286,35.714285714285715
2017-12-20,158.25,158.28,156.91,157.53,143.12365041278875,149.3998027584502,153.05490521513204,155.62807443311368,142.99375000000012,148.7025999999999,152.9654000000004,155.54750000000007,155.54750000000007,158.77051644426714,152.324483555733,38972602,63.00754373154759,58.553162831772326,NaN,NaN,NaN,NaN,NaN,NaN,0.1793665532424389,1.2880004830579992,1.1086339298155603,81.52011922503715,87.8787878787876,5286688101,13488473902.136133,26.808813354967636,18.27625824203459,16.12310818381251,85.71428571428571,28.571428571428573
2017-12-21,157.73,158.25,157.37,157.55,143.26719617982567,149.56119280283733,153.2311834419896,155.81111496329333,143.12730000000013,148.8424999999999,153.1556000000004,155.6405000000001,155.6405000000001,158.97983810806778,152.3011618919324,18638679,63.08380077950821,59.06940980737124,NaN,NaN,NaN,NaN,NaN,NaN,0.1413825944360103,1.285362172860573,1.1439795784245628,81.81818181818186,82.46398410332824,5305326780,13477460137.272497,25.592763446971333,17.447245713226614,16.449917329400172,78.57142857142857,21.428571428571427
2017-12-22,157.31,157.432,156.95,157.37,143.40752258599656,149.71582264832568,153.39348997367628,155.95958020488445,143.25720000000013,148.9766999999999,153.3476000000004,155.69600000000008,155.69600000000008,159.11072341486334,152.28127658513682,23330440,61.84808032066827,60.08584423004742,NaN,NaN,NaN,NaN,NaN,NaN,0.08824685276649724,1.2542881443826843,1.166041291616187,79.13561847988072,80.82463984103325,5281996340,13494788555.363785,24.76783714090874,19.141167886071674,16.6466903281699,71.42857142857143,14.285714285714286
2017-12-26,156.53,156.72,155.95,156.52,143.5379949980762,149.85055883350736,153.5160982100027,156.012953518705,143.38175000000012,149.1079999999999,153.5112000000004,155.7125000000001,155.7125000000001,159.13977807450954,152.28522192549065,21918720,56.24511072832395,60.66897416031332,NaN,NaN,NaN,NaN,NaN,NaN,-0.014559236667587072,1.1478422457817032,1.1624014824492903,66.467958271237,75.8072528564332,5260077620,13505320927.311838,22.887570492244862,23.034226619092248,15.655085701524214,64.28571428571429,7.142857142857143
2017-12-27,156.52,156.96,156.39,156.54,143.66736818217493,149.98302301502207,153.63468259392417,156.06314842168547,143.50800000000012,149.2368999999999,153.6650000000004,155.7100000000001,155.7100000000001,159.13478612470956,152.28521387529062,22388186,56.34532246283304,61.03056541963904,NaN,NaN,NaN,NaN,NaN,NaN,-0.08755392175207244,1.0529590802591997,1.1405130020112721,59.007352941176116,68.20364323076461,5282465806,13494715997.101313,23.49820353784591,22.302325022048716,14.80085592299891,57.142857142857146,0
2017-12-28,157.05,157.0653,156.54,156.73,143.79734461817318,150.1166265196751,153.75606759024086,156.12665809581065,143.6311500000001,149.3585999999999,153.81880000000038,155.8535000000001,155.8535000000001,159.19571049606407,152.51128950393615,25393825,57.34479825345738,61.29768650189634,NaN,NaN,NaN,NaN,NaN,NaN,-0.1269883381759518,0.9817775792913324,1.1087659174672841,52.668213457076114,59.381174889829744,5307859631,13487691967.456347,23.39265606637506,21.620516610274347,14.6742513338405,50,0
2017-12-29,156.9,156.9,155.7,155.76,143.91637601500727,150.22837648958253,153.8346531749373,156.09173827716202,143.7499000000001,149.47309999999987,153.95680000000038,155.8840000000001,155.8840000000001,159.21107318825406,152.55692681174614,33185962,50.93347572831777,60.89840200055447,NaN,NaN,50.93347572831777,NaN,NaN,NaN,-0.2170596690212987,0.8374413311906608,1.0545010002119595,24.937655860349007,45.53774075286708,5274673669,13457824601.656347,21.756377194846895,25.004584082622817,14.751684898589312,42.857142857142854,0
2018-01-02,156.5,158.525,156.17,158.49,144.06138719893755,150.39197299473932,154.017215795528,156.32014415552754,143.88390000000012,149.6167999999999,154.16040000000038,156.0840000000001,156.0840000000001,159.53059484129,152.63740515871018,32573272,63.352202473154186,61.054572023527875,NaN,NaN,NaN,NaN,NaN,NaN,-0.09752746980950855,0.9325916629500739,1.0301191327595824,91.7888563049853,56.46490854080347,5307246941,13489429665.99605,27.2307294108029,21.30641515752936,14.907395388082842,35.714285714285715,0
2018-01-03,158.61,160.17,158.61,160.03,144.22027886859988,150.58282501464546,154.25301125452688,156.67346375976302,144.02500000000012,149.8067999999999,154.38680000000036,156.4500000000001,156.4500000000001,159.9400716324996,152.9599283675006,29383557,68.23611764649084,61.645778756757686,NaN,NaN,NaN,NaN,NaN,NaN,0.071393350835113,1.1193608213034736,1.0479674704683606,96.86800894854616,71.19817370462683,5336630498,13513539251.22682,33.4678073957256,19.42641217425385,15.944893952033249,100,0
2018-01-04,160.59,160.79,160.0825,160.31,144.3803755962755,150.77544234108814,154.4905402249376,157.0198005445475,144.17750000000012,149.98889999999992,154.63820000000038,156.8250000000001,156.8250000000001,160.2816023780578,153.3683976219424,24776125,69.04388931642563,62.210441030681814,NaN,NaN,NaN,NaN,NaN,NaN,0.18184191773239355,1.2752698676338525,1.093427949901459,90.56974459724971,93.07553661692707,5361406623,13504696888.59431,35.450721486964746,18.625747162690867,17.063418987529765,100,78.57142857142857
2018-01-05,161.04,162.03,160.77,161.92,144.55489922218322,150.9961266511656,154.78189158866553,157.48648620697156,144.33365000000012,150.1687999999999,154.9168000000004,157.2460000000001,157.2460000000001,161.0169171298237,153.4750828701765,26992340,73.25544831597404,63.126137542934984,NaN,NaN,NaN,NaN,NaN,NaN,0.33431435075643345,1.5113208883470008,1.1770065375905674,98.26224328593976,95.23333227724521,5388398963,13526976280.340342,38.79551648779301,16.92554540163717,18.63880034148594,100,71.42857142857143
2018-01-08,161.9,162.63,161.86,162.55,144.73395495131572,151.22491622242967,155.0865232910708,157.9687256158314,144.4946000000001,150.3539999999999,155.21920000000037,157.6725000000001,157.6725000000001,161.80012340820736,153.54487659179284,23159061,74.70562149353142,63.67592543158757,NaN,NaN,NaN,NaN,NaN,NaN,0.4418303914717774,1.729294526930289,1.2874641354585117,98.84559884559907,95.89252890959618,5411558024,13545323068.924759,40.444823433215596,16.212080722844217,19.68885729602024,100,64.28571428571429
2018-01-09,162.85,163.04,162.07,162.56,144.9113285338897,151.449373326936,155.37960080906802,158.40598984289508,144.65425000000013,150.53679999999991,155.53120000000038,158.0655000000001,158.0655000000001,162.47343137423695,153.65756862576325,24782448,74.72904491514663,64.013022051133,NaN,NaN,NaN,NaN,NaN,NaN,0.4749584955197024,1.8811622548581397,1.4062037593384373,93.46049046321541,96.85611086491808,5436340472,13545578558.0794,40.54344737019978,15.335115159994702,20.372774592731055,100,57.142857142857146
2018-01-10,161.8,162.21,161.12,162.18,145.08315611066692,151.66186098382838,155.64628313028103,158.765419381667,144.81095000000013,150.74529999999993,155.75000000000037,158.3795000000001,158.3795000000001,163.01452092767474,153.74447907232545,34004028,72.00050600648713,64.58078301227614,NaN,NaN,NaN,NaN,NaN,NaN,0.4337536366681447,1.948395805173618,1.5146421685054734,88.28337874659421,93.52982268513624,5402336444,13577710804.721601,37.31630683305367,19.365681662941636,20.939003110705677,92.85714285714286,50
2018-01-11,162.48,163.3,162.21,163.29,145.26431873643142,151.89212116236644,155.94603673301512,159.19633182150824,144.96920000000011,150.96589999999992,155.98420000000038,158.7595000000001,158.7595000000001,163.68715045432248,153.8318495456777,20473518,74.88516877314116,65.4291848009614,NaN,NaN,NaN,NaN,NaN,NaN,0.442218050339785,2.0674147314302047,1.6251966810904197,99.86842105263132,93.87076342081366,5422809962,13597808661.840866,41.066859118390056,18.15525162774028,22.350584165790217,100,42.857142857142854
2018-01-12,163.03,164.66,162.94,164.49,145.4556190475117,152.14158410964632,156.28109411603413,159.7004906956503,145.13040000000012,151.2002999999999,156.23100000000036,159.1845000000001,159.1845000000001,164.53173657602377,153.83726342397642,37762708,77.5749736617637,66.46426857826536,NaN,NaN,NaN,NaN,NaN,NaN,0.48610616857915456,2.232829391814363,1.7467232232352083,98.10267857142871,95.41815945688477,5460572670,13628106648.49203,44.62724418627742,16.454337417465894,24.293295028202955,100,35.714285714285715
2018-01-16,165.55,166.415,163.53,164.02,145.64033925599418,152.37680026589095,156.5845806212877,160.1118725341598,145.28815000000012,151.40849999999992,156.46940000000038,159.59150000000008,159.59150000000008,165.1071877177735,154.07581228222665,41231849,74.22204195256147,67.34812298054345,NaN,NaN,NaN,NaN,NaN,NaN,0.44221305802774324,2.2994895457698874,1.8572764877421442,77.64815678954754,91.87308547120251,5419340821,13600880765.530157,46.97266653685941,14.072775155992026,27.22756033514832,100,28.571428571428573
2018-01-17,164.77,166.04,163.9982,165.79,145.84083339275045,152.64240818141786,156.94557745966858,160.65264657852552,145.4552000000001,151.6394999999999,156.74900000000036,159.9985000000001,159.9985000000001,166.0557775237725,153.9412224762277,33849879,78.06677097890285,68.90681299844195,NaN,NaN,NaN,NaN,NaN,NaN,0.4875449972021073,2.4667077342447783,1.979162737042671,94.16705552963136,89.97263029686921,5453190700,13626441419.581583,42.305721245919806,12.674581768499912,31.054327433907808,92.85714285714286,21.428571428571427
2018-01-18,165.55,166.1999,165.135,165.82,146.03963107043452,152.90335059366703,157.29359402987765,161.1447754758088,145.62280000000013,151.87499999999991,157.00000000000037,160.35750000000013,160.35750000000013,166.88313828295384,153.83186171704642,26432166,78.12631960662668,70.46259850871293,NaN,NaN,NaN,NaN,NaN,NaN,0.4742711450975663,2.5720016684146287,2.0977305233170624,94.44703686420907,88.75408306112934,5479622866,13634014387.791367,40.863301969938945,12.00466937936676,34.76683971684506,85.71428571428571,14.285714285714286
2018-01-19,166.32,166.61,165.535,166.34,146.24162479112672,153.16942285913896,157.64835504831382,161.639558763827,145.7919500000001,152.1186999999999,157.25100000000037,160.78950000000012,160.78950000000012,167.68754747736307,153.89145252263717,38937588,79.18140445093488,72.02235609424703,NaN,NaN,NaN,NaN,NaN,NaN,0.45514985105935946,2.6666678371412615,2.211517986081902,97.52520623281383,95.37976620888476,5518560454,13653392629.261133,40.71580306867958,11.352358261125207,38.513790186557415,100,7.142857142857143
2018-01-22,166.27,168.12,166.09,168.12,146.4593200668369,153.46547389163126,158.0590077915172,162.25674364346253,145.97270000000012,152.3757999999999,157.5358000000004,161.31900000000013,161.31900000000013,168.7408566410253,153.89714335897497,26081388,82.32438318568641,74.26456376977337,NaN,NaN,NaN,NaN,NaN,NaN,0.5127387413631816,2.852441412785879,2.3397026714226974,100.00000000000001,97.32408103234098,5544641842,13679474017.261133,44.06607247698886,10.222710850447058,42.47044038540662,100,0
2018-01-23,168.64,169.66,168.555,169.51,146.68868006617186,153.78318727991578,158.5080663094969,162.94752996313275,146.1600500000001,152.6411999999999,157.83600000000038,161.9170000000001,161.9170000000001,169.9314222499185,153.90257775008166,37989650,84.31567670989197,75.7619547866832,NaN,NaN,NaN,NaN,84.31567670989197,NaN,0.5893316601016427,3.0763672465497507,2.487035586448108,98.64253393665153,98.72258005648848,5582631492,13707149735.134436,48.27137392589355,9.454132946929864,46.40178243608813,100,0
2018-01-24,169.81,170.24,167.44,168.41,146.90481260282687,154.07282713575904,158.8963774346147,163.46776520473915,146.3422500000001,152.8787999999999,158.13040000000038,162.4690000000001,162.4690000000001,170.67320111893702,154.2647988810632,54287377,76.92955450103344,76.38291456200768,NaN,NaN,NaN,NaN,NaN,NaN,0.5135716193608064,3.129000110649116,2.6154284912883097,81.98375584543429,93.54209659402864,5528344115,13690475755.055864,42.07710989051176,13.350915487808376,48.20749230057778,100,0
2018-01-25,169.55,169.63,167.81,168.35,147.11819755205246,154.35554343010045,159.26710773129648,163.93273994714494,146.5239000000001,153.1002999999999,158.42380000000037,163.0605000000001,163.0605000000001,171.16904728049056,154.95195271950965,28924956,76.53571835715663,76.91804520777418,NaN,NaN,NaN,NaN,NaN,NaN,0.41149099847376913,3.129792239380521,2.7183012409067517,80.0422386483631,86.88950947681633,5499419159,13678715058.66026,38.60904545450678,12.250511127531313,49.68697932004574,92.85714285714286,0
2018-01-26,169.27,170.952,168.96,170.93,147.35513090974348,154.68375049089053,159.72447605555936,164.59914566646447,146.7213000000001,153.3495999999999,158.76500000000036,163.78000000000011,163.78000000000011,171.99950363464546,155.56049636535477,32038184,81.0323642869219,77.47353920569903,NaN,NaN,NaN,NaN,NaN,NaN,0.4658051439496398,3.3005576708438014,2.8347525268941616,99.77624084621652,87.26741178000465,5531457343,13710045571.929337,39.982663524452846,10.870982717697554,50.97247819339731,100,0
2018-01-29,170.52,170.91,169.74,170.1,147.58144801511918,154.98902275839765,160.1313593474982,165.1230365553726,146.9172000000001,153.6036999999999,159.1008000000004,164.4485000000001,164.4485000000001,172.43728282343187,156.45971717656835,37277849,75.98731298743475,77.5650885981207,NaN,NaN,NaN,NaN,NaN,NaN,0.3966173640919597,3.330524232009111,2.9339068679171514,91.33441822620011,90.38429924025992,5494179494,13695707937.698566,37.88164618974393,10.299732052487748,52.006404814248256,92.85714285714286,14.285714285714286
2018-01-30,168.55,169.42,167.82,168.7,147.79158286073988,155.26052725823135,160.4673844711257,165.4636997405752,147.1087000000001,153.8393999999999,159.42300000000037,165.0955000000001,165.0955000000001,172.21331279607477,157.97768720392543,44987688,68.26671869634473,77.10349386820626,NaN,NaN,NaN,NaN,NaN,NaN,0.21636786823638143,3.204366703212628,2.9879988349762465,77.09519934906417,89.40195280716028,5449191806,13700206706.498566,34.17609420280192,17.529626159175027,51.08368539677336,85.71428571428571,7.142857142857143
2018-01-31,169.67,169.9899,168.34,169.4,148.00659198650365,155.5405168174743,160.81768311931685,165.83858547956805,147.2983000000001,154.0786999999999,159.72020000000037,165.6410000000001,165.6410000000001,172.30824800798322,158.973751992017,42449199,69.912781393215,76.95437068154398,NaN,NaN,NaN,NaN,NaN,NaN,0.10947996471587018,3.1248487908710842,3.015368826155214,82.24662548615883,83.55874768714106,5491641005,13712301602.219458,34.20197552434663,16.287977598764947,51.35592189413776,78.57142857142857,0
2018-02-01,168.12,169.73,167.42,167.96,148.20513335977228,155.7864471775243,161.09777397738287,166.04062495770444,147.4817000000001,154.3161999999999,160.00040000000038,166.0375000000001,166.0375000000001,172.2505696921845,159.8244303078157,38037875,62.706769799574225,76.08448504057492,NaN,NaN,NaN,NaN,NaN,NaN,-0.08264240100772025,2.9120658248955635,2.994708225903284,62.65601597603607,73.99928027041972,5453603130,13692047668.7779,30.901718886988462,18.55931675719357,50.374936047464466,71.42857142857143,0
2018-02-02,167.34,167.7,164.47,164.61,148.36836586365513,155.96117099579115,161.235508331211,165.9043749617326,147.64730000000012,154.5035999999999,160.21600000000038,166.2525000000001,166.2525000000001,171.93264392422662,160.5723560757736,68478082,49.83731824662527,74.10322393949359,NaN,NaN,NaN,NaN,NaN,NaN,-0.4398200836388946,2.4449331213546657,2.8847532049935602,14.5513338722718,53.15132511148892,5385125048,13629505767.260874,26.70852823645582,27.510792847176386,47.18609733865899,64.28571428571429,0
2018-02-05,163.13,165.75,158,158.12,148.4653970490914,156.0039200849834,161.11333153390862,165.16300591775806,147.7749500000001,154.6225999999999,160.26840000000036,166.0625000000001,166.0625000000001,172.51176623732707,159.61323376267316,105372224,34.89559252889896,71.29419183780341,NaN,NaN,NaN,NaN,NaN,NaN,-1.0811124223736006,1.5333626770265596,2.61447509940016,0.9264978381717461,26.04461589549322,5279752824,13527396683.100874,20.164895618682618,41.2242875206479,45.78685643674032,57.142857142857146,100
2018-02-06,155.96,162.51,155.1,162.31,148.603154292384,156.1287929545877,161.16025970904946,164.89129106844777,147.9237000000001,154.78149999999988,160.40080000000037,166.0505000000001,166.0505000000001,172.526700969699,159.57429903030123,118537891,46.12565361980133,69.01268345501045,NaN,NaN,NaN,NaN,NaN,NaN,-1.1828279957868122,1.1359401046666449,2.318768100453457,45.48321978299272,20.320350497812104,5398290715,13639535767.56916,16.102640179218568,40.803659043116284,45.03774040652438,50,100
2018-02-07,161.79,163.55,160.2,160.21,148.71864529444983,156.20960893568497,161.12299462242007,164.4454538238337,148.0539500000001,154.92799999999988,160.47980000000038,165.9330000000001,165.9330000000001,172.73531754624403,159.13068245375618,91028328,42.197003977479994,66.44630376721426,NaN,NaN,NaN,NaN,NaN,NaN,-1.3397324087494464,0.644102589516649,1.9838349982660954,32.23568004037353,26.215132553846015,5307262387,13549050892.27364,17.437270690962645,37.15907914050086,43.7189341871773,42.857142857142854,92.85714285714286
2018-02-08,160.69,160.8,153.45,153.45,148.76572345072395,156.15496321418627,160.82209287252124,163.39826774537335,148.1455500000001,155.0018999999999,160.42500000000035,165.4965000000001,165.4965000000001,174.09053578069887,156.90246421930135,94184831,32.57787746362918,63.11748041097814,NaN,NaN,32.57787746362918,NaN,NaN,NaN,-1.817339720787156,-0.2878396527178495,1.5295000680693065,0,25.9062999411221,5213077556,13454866061.27364,14.398529447164899,46.687591370934044,43.466364216498164,35.714285714285715,100
2018-02-09,155.66,157.24,150.125,156.1,148.83870132683614,156.15387483370733,160.63691275987335,162.70319462676636,148.2513500000001,155.1073999999999,160.41520000000037,165.1370000000001,165.1370000000001,174.6251823338266,155.64881766617364,113836554,38.49671220024867,59.98693248344687,NaN,NaN,NaN,NaN,NaN,NaN,-1.8662541310539462,-0.8033175957481262,1.06293653530582,28.68872137129685,20.308133803890126,5326914110,13532223719.543491,12.18488056543794,46.694458138719455,43.20001881061594,28.571428571428573,100
2018-02-12,157.67,159.95,156.46,158.87,148.93851524398207,156.2076594904656,160.56762206340773,162.33812847183623,148.3669500000001,155.2380999999999,160.51540000000037,164.8560000000001,164.8560000000001,174.72925154141035,154.98274845858987,63050637,44.02796454847763,57.10923875763156,NaN,NaN,NaN,NaN,NaN,NaN,-1.6319962711117086,-0.9770588035838159,0.6549374675278928,41.988764584433696,23.559161985243517,5389964747,13556251612.726873,16.97069820118095,42.85505948629343,41.48728504813105,21.428571428571427,92.85714285714286
2018-02-13,157.98,160.01,157.7197,159.69,149.04549519180313,156.27661672827816,160.53320551190154,162.08592576023278,148.4854500000001,155.3814999999999,160.60620000000037,164.6395000000001,164.6395000000001,174.76330062031766,154.51569937968256,31785595,45.58801441557487,54.87055732295595,NaN,NaN,NaN,NaN,NaN,NaN,-1.3532564970955878,-1.036633153841592,0.3166233432539959,45.92596149229365,38.86781581600807,5421750342,13579155060.933878,16.25257298396688,40.71058192978268,40.85231526250015,14.285714285714286,85.71428571428571
2018-02-14,158.79,162.93,158,162.68,149.18116190631255,156.40341639702513,160.61739353104267,162.14250425925823,148.6128500000001,155.56369999999987,160.77000000000038,164.4840000000001,164.4840000000001,174.62785607153336,154.34014392846683,52107431,50.9558211083303,53.04342180518264,NaN,NaN,NaN,NaN,NaN,NaN,-0.9196796448685419,-0.8329762128316816,0.0867034320368604,60.28232582705146,49.3990173012596,5473857773,13625977762.623533,20.719684442465066,36.47901044823635,39.118442324066415,7.142857142857143,78.57142857142857
2018-02-15,164.14,165.7,162.44,165.7,149.34552845450844,156.58750716144047,160.8167114317861,162.4813133774241,148.75420000000008,155.7774999999999,161.02980000000036,164.47800000000012,164.47800000000012,174.618829551863,154.33717044813724,51633887,55.708545926141696,51.23457763655548,NaN,NaN,NaN,NaN,NaN,NaN,-0.40777206089984824,-0.4230116440879499,-0.01523958318810166,74.93384652393549,60.38071128109353,5525491660,13677611649.623533,25.147688650626637,33.964923054329184,36.094870214013135,0,71.42857142857143
2018-02-16,165.18,166.755,164.6799,164.96,149.50089633058298,156.7532990988377,160.97919333642193,162.71737877005037,148.89405000000008,155.99909999999988,161.2728000000004,164.4090000000001,164.4090000000001,174.51693925584954,154.30106074415067,62256291,54.31948808578115,49.686875857865935,NaN,NaN,NaN,NaN,NaN,NaN,-0.11262835417656157,-0.15602502590880363,-0.043396671732242056,74.67945975061544,69.96521070053413,5463235369,13632162247.071415,26.306771510359283,32.43268467962764,32.75079543162757,0,64.28571428571429
2018-02-20,164.39,166.68,164.31,165.29,149.6580018397314,156.9223426810389,161.14824457813089,162.96239031575985,149.0353000000001,156.2202999999999,161.5086000000004,164.2675000000001,164.2675000000001,174.2420313173084,154.2929686826918,36785626,54.86002668120594,48.72925499964174,NaN,NaN,NaN,NaN,NaN,NaN,0.09972163598158891,0.08125537324474408,-0.01846626273684483,76.34068130219627,75.31799585891574,5500020995,13625798488.987026,24.9238279886747,31.548191922598573,31.289060565925702,7.142857142857143,57.142857142857146
2018-02-21,166.06,167.72,164.72,164.82,149.80886749306742,157.07873193487973,161.29223498683163,163.13930552378272,149.17170000000007,156.4238999999999,161.72460000000038,164.0330000000001,164.0330000000001,173.7198779284125,154.3461220715877,41161779,53.88209432427266,47.58420592328872,NaN,NaN,NaN,NaN,NaN,NaN,0.1977649743676075,0.22873995522266455,0.03097498085505705,74.95536852843662,75.32516986041611,5458859216,13587380828.587027,25.575339047778982,29.438540248005285,29.25633971996269,0,50
2018-02-22,165.54,166.42,164.3769,164.8,149.95803299064883,157.23162833220883,161.42979439911275,163.2974669024701,149.30650000000006,156.6277999999999,161.9266000000004,163.8525000000001,163.8525000000001,173.3388752297685,154.36612477023172,37074413,53.83811389546415,46.950730501566575,NaN,NaN,NaN,NaN,NaN,NaN,0.24729072644118388,0.3400883889065369,0.09279766246535302,83.404376243251,78.2334753579613,5421784803,13565661693.488548,24.379653810145275,28.847347457852727,28.07347343007762,0,42.857142857142854
2018-02-23,166.06,168.17,165.45,168.17,150.13924659273192,157.44822975137302,161.69411618738283,163.7615176736634,149.45575000000008,156.8549999999999,162.1720000000004,163.84350000000012,163.84350000000012,173.31311725731027,154.37388274268997,50096916,59.79333190720318,47.661874334465,NaN,NaN,NaN,NaN,NaN,NaN,0.4795886283493969,0.6922834479020992,0.21269481955270225,100,86.11991492389588,5471881719,13615758609.488548,26.492078699635137,26.635377217375876,27.98704917122176,100,35.714285714285715
2018-02-26,168.93,170.4,168.82,170.4,150.34084612912264,157.70470044936565,162.03552339572076,164.39375408569546,149.61575000000008,157.1031999999999,162.46620000000038,163.8170000000001,163.8170000000001,173.20979958265764,154.42420041734255,39266658,63.17846433033309,49.682079463138855,NaN,NaN,NaN,NaN,63.17846433033309,NaN,0.7404219167699408,1.1382222155151283,0.39780029874518746,100,94.468125414417,5511148377,13655025267.488548,30.30064731676076,25.25535367731561,26.185386912718283,100,28.571428571428573
2018-02-27,170.42,170.73,168.21,168.29,150.5194446751015,157.91431034145742,162.28079698804544,164.76482512515304,149.7657500000001,157.3271999999999,162.71220000000037,163.7265000000001,163.7265000000001,172.9079078985727,154.5450921014275,42209873,58.18659935676338,50.54357558720757,NaN,NaN,NaN,NaN,NaN,NaN,0.7268110883595862,1.3063141591946703,0.5795030708350841,88.15821402572192,96.05273800857397,5468938504,13615495386.425056,28.503412350129587,25.19313363641467,23.525266437960475,100,21.428571428571427
2018-02-28,169.25,169.8,167.1,167.21,150.6855198524637,158.09838340400282,162.47409906694563,164.9976989227575,149.90880000000007,157.53899999999987,162.93880000000038,163.6520000000001,163.6520000000001,172.69389493413655,154.61010506586365,42936334,55.758155077150924,51.512229237184066,NaN,NaN,NaN,NaN,NaN,NaN,0.6059731507448676,1.3369695092661686,0.7309963585213011,82.91676777481203,90.35832726684465,5426002170,13576057568.52876,26.677633540185457,26.212755624598728,21.007838059148128,92.85714285714286,14.285714285714286
2018-03-01,167.29,168.07,163.001,164.48,150.8227783613944,158.2247520494681,162.55276184863402,164.94839426344726,150.0360000000001,157.7091999999999,163.07540000000037,163.4060000000001,163.4060000000001,172.0687372117592,154.74326278824097,76809904,50.069589456064016,52.7616372366437,NaN,NaN,50.069589456064016,NaN,NaN,NaN,0.3175815820946879,1.1279733361396609,0.810391754044973,69.66755641834506,80.24751273962634,5349192266,13544069857.472536,23.618821811256606,32.47898230333474,18.36040009200993,85.71428571428571,7.142857142857143
2018-03-02,162.59,166.28,161.96,165.99,150.97369598963922,158.37851933561723,162.68755550162876,165.0475948097856,150.1678500000001,157.8924999999999,163.22240000000036,163.3075000000001,163.3075000000001,171.80407784051863,154.81092215948155,57445063,52.93005705254365,53.79259044037906,NaN,NaN,NaN,NaN,NaN,NaN,0.20915166805899488,1.0718313391187166,0.8626796710597218,66.78346180798889,73.12259533371532,5406637329,13593802388.866055,21.36999503110247,31.680926977550055,15.5622029609332,78.57142857142857,0
2018-03-05,165.26,168.26,164.59,167.83,151.14142040765276,158.5656773685753,162.88921999176097,165.3125857802822,150.3266500000001,158.0958999999999,163.42500000000035,163.4685000000001,163.4685000000001,172.17708490226542,154.75991509773476,38540207,56.22130263726841,54.66354316100698,NaN,NaN,NaN,NaN,NaN,NaN,0.2397854380660318,1.1624114686422615,0.9226260305762297,77.70996825592049,71.38699549408481,5445177536,13623311375.697117,23.980685615994712,29.142355332801323,13.165788209671765,71.42857142857143,0
2018-03-06,168.61,169.11,167.48,168.54,151.31454060260148,158.76318870781145,163.11081920777033,165.61995856311248,150.4830500000001,158.3052999999999,163.64520000000036,163.98950000000008,163.98950000000008,172.6020733088315,155.37692669116865,29480927,57.45743644125496,55.51135901998413,NaN,NaN,NaN,NaN,NaN,NaN,0.2833152786452239,1.2767701288827595,0.9934548502375357,82.79654359780046,75.76332455390327,5474658463,13632173740.255398,25.0203605960227,28.06666186751453,10.508772087884322,64.28571428571429,0
2018-03-07,167.26,169.07,166.96,168.93,151.48981880556067,158.96451170369636,163.33902237609306,165.93520060472082,150.6385000000001,158.5141999999999,163.87280000000035,164.3205000000001,164.3205000000001,173.15541590225826,155.48558409774193,34609407,58.15634950105777,56.025682476607514,NaN,NaN,NaN,NaN,NaN,NaN,0.3115788349973325,1.3829283939842014,1.071349558986869,79.4754846066136,79.99399882011153,5509267870,13662190429.73881,23.795898024443552,27.899188334445135,9.107742677122651,57.142857142857146,0
2018-03-08,169.54,169.98,168.95,169.86,151.67260667814216,159.1802639471875,163.5947469887953,166.30899102331884,150.79280000000008,158.7350999999999,164.12260000000038,164.80300000000008,164.80300000000008,173.74070015160436,155.8652998483958,25828371,59.85024054552375,56.32151780656337,NaN,NaN,NaN,NaN,NaN,NaN,0.36254354509635367,1.524528990357311,1.1619854452609573,90.07981755986341,84.11728192142583,5535096241,13682000539.534927,25.402650366716617,27.186184705382114,8.284562265407063,50,71.42857142857143
2018-03-09,171.1,173.16,170.82,173.16,151.88641158681736,159.45709040367885,163.969854950019,166.96146806871704,150.96290000000008,158.9832999999999,164.45540000000037,165.78850000000008,165.78850000000008,173.8002046251081,157.77679537489206,38310546,65.22907121128061,57.10077374409904,NaN,NaN,NaN,NaN,NaN,NaN,0.5754867974244768,1.8813439420415534,1.3058571446170766,100,89.85176738882568,5573406787,13720311085.534927,31.05201924283541,25.02182941102829,8.307780594603342,100,64.28571428571429
2018-03-12,173.65,174.48,173.28,174.08,152.10724331232166,159.74665296994263,164.36633122648885,167.63942349074398,151.13440000000008,159.2355999999999,164.80620000000036,166.68750000000009,166.68750000000009,174.1662027618424,159.20879723815776,37634971,66.5735493927846,57.937453937783225,NaN,NaN,NaN,NaN,66.5735493927846,NaN,0.7255945341105208,2.2128503122552274,1.4872557781447067,96.80511182108644,95.62830979364996,5611041758,13732856075.868261,33.338156421603024,24.192170095858447,8.605447122224797,100,57.142857142857146
2018-03-13,174.8,175.21,171.2666,171.71,152.3022956176717,159.98355093093386,164.65431823721477,168.02709744400647,151.2881000000001,159.46229999999989,165.10580000000036,167.3295000000001,167.3295000000001,174.19279214006878,160.46620785993144,55638925,60.123984411048504,58.383303229695784,NaN,NaN,NaN,NaN,NaN,NaN,0.6168354006439647,2.2583000289496624,1.6414646283056977,73.58490566037736,90.1300058271546,5555402833,13689729348.132044,30.124615521183284,26.781776935184574,8.523450403559407,100,50
2018-03-14,172.58,172.74,170.93,171.68,152.49510859660032,160.21516378378666,164.9298351690887,168.37499292552965,151.44040000000007,159.69049999999987,165.42420000000035,167.92900000000012,167.92900000000012,174.07555643429083,161.7824435657094,40536383,60.044686657259874,58.826629855538336,NaN,NaN,NaN,NaN,NaN,NaN,0.49945230222494996,2.265780006086885,1.7663277038619352,73.35849056603773,81.2495026825005,5514866450,13682786652.701105,28.754550252098372,26.40951956767606,8.227546886780503,92.85714285714286,42.857142857142854
2018-03-15,171.83,172.53,170.9,171.53,152.68451050111176,160.43921994648395,165.18866516245777,168.67546978976492,151.5913500000001,159.9226999999999,165.68500000000037,168.3715000000001,168.3715000000001,174.20930532391478,162.53369467608545,28810366,59.62126893195432,58.81433964302057,NaN,NaN,NaN,NaN,NaN,NaN,0.3740208131495004,2.2338537202988107,1.8598329071493103,72.22641509433957,73.05660377358488,5486056084,13676246876.369816,27.539834178400717,25.371617952086062,8.500982199824572,85.71428571428571,35.714285714285715
2018-03-16,171.78,172.2,170.935,171.02,152.86695318269273,160.64874034358328,165.41734496000845,168.89875838121588,151.7400000000001,160.1457999999999,165.90480000000036,168.6375000000001,168.6375000000001,174.44890903739775,162.82609096260245,31176742,58.12058905314152,58.45306283750688,NaN,NaN,NaN,NaN,NaN,NaN,0.22629324659272987,2.1426994653902227,1.9164062187974928,68.37735849056605,71.32075471698111,5454879342,13649259894.164282,26.600655671613545,24.5063811424286,8.145008240033755,78.57142857142857,28.571428571428573
2018-03-19,169.16,169.22,165.6393,167.1,153.00857553908384,160.77648805955192,165.483331432165,168.72744805919532,151.86630000000008,160.3393999999999,166.04060000000035,168.74450000000007,168.74450000000007,174.35651024589137,163.13248975410878,71395061,48.099250620309604,57.73253792776018,NaN,NaN,NaN,NaN,NaN,NaN,-0.14579894793702297,1.734157533876214,1.879956481813237,38.79245283018857,59.79874213836472,5383484281,13636114206.52854,23.006690165539446,34.49275162121903,9.131519959169365,71.42857142857143,21.428571428571427
2018-03-20,167.1,168.04,166.61,167.65,153.15426135461533,160.91259720688754,165.56829882698204,168.62483395831958,151.98725000000007,160.5359999999999,166.15520000000038,168.8625000000001,168.8625000000001,174.27469317836486,163.45030682163534,34075664,49.41708514114021,57.279604360902276,NaN,NaN,NaN,NaN,NaN,NaN,-0.3534155943652755,1.4381869888566428,1.7916025832219182,42.943396226415075,50.03773584905656,5417559945,13651603144.710358,22.150164348072487,33.20860635449562,10.49559189237708,64.28571428571429,14.285714285714286
2018-03-21,167.23,168.76,166.19,166.92,153.29123387845002,161.03155567803827,165.62130671612,168.462468819432,152.1047000000001,160.7308999999999,166.24260000000035,168.9675000000001,168.9675000000001,174.13799659123362,163.79700340876656,43863543,47.6863670148631,57.10937418653078,NaN,NaN,NaN,NaN,NaN,NaN,-0.5279396500467457,1.131678020663486,1.6596176707102317,37.433962264150786,39.72327044025147,5373696402,13632658190.340708,22.544393172159417,30.976569296837052,10.492789968816112,57.142857142857146,7.142857142857143
2018-03-22,164.7,165.77,162.59,162.8,153.38584846672416,161.06657437748305,165.51066723705645,167.92318607472419,152.20440000000008,160.8892999999999,166.24740000000034,168.8675000000001,168.8675000000001,174.41979997388074,163.31520002611944,66607288,39.317063302602755,56.13701749010643,NaN,NaN,NaN,NaN,NaN,NaN,-0.8877116706602568,0.5499780823849107,1.4376897530451676,1.6640253565769245,27.347127949047586,5307089114,13574848091.32184,20.093895238538316,36.64665004485231,11.18827535761938,50,0
2018-03-23,162.6,163.3,158.43,158.51,153.4368350491448,161.01594914228536,165.2361312669758,167.02669216284568,152.27985000000007,160.9619999999999,166.17400000000035,168.38450000000006,168.38450000000006,175.5436297655507,161.22537023444943,80110392,32.85164072656514,54.4677559250562,NaN,NaN,32.85164072656514,NaN,NaN,NaN,-1.3535594114139977,-0.2542595112223296,1.0992999001916681,0.4767580452919194,13.191581888673197,5226978722,13497369662.919376,17.756182520467632,42.321024637034334,13.41487149547512,42.857142857142854,100
2018-03-26,161.68,164.6,159.16,164.4,153.54592126756128,161.08296005035893,165.20334180552578,166.7765310044794,152.3840000000001,161.0901999999999,166.19620000000035,168.08450000000008,168.08450000000008,175.38216668188997,160.78683331811018,57481503,45.984929092884144,53.64829111445828,NaN,NaN,NaN,NaN,NaN,NaN,-1.2087239968169008,-0.4116050958294579,0.7971189009874429,35.57806912991656,12.572950843928465,5284460225,13550624584.816435,18.242497679864428,36.588514879942494,15.394934491468039,35.714285714285715,92.85714285714286
2018-03-27,165.6,165.62,157.68,159.08,153.60098672758554,161.0432974751043,164.96321075432868,166.04352805167184,152.4795000000001,161.1594999999999,166.08800000000036,167.62400000000008,167.62400000000008,175.90744469408543,159.34055530591473,78889105,38.63476022688164,52.25389188058856,NaN,NaN,NaN,NaN,NaN,NaN,-1.4013578080145412,-0.9545783590307337,0.4467794489838075,7.986309184255594,14.68037878648802,5205571120,13499555315.332808,15.32744567282932,33.72040752653722,17.506545086715768,28.571428571428573,100
2018-03-28,158.25,159.78,156.04,157.25,153.6372953173608,160.9681826736171,164.66073190121776,165.20604918960785,152.5696000000001,161.2109999999999,165.95260000000036,167.1260000000001,167.1260000000001,176.56597542369383,157.68602457630635,89369655,36.47502019821709,50.58423328435237,NaN,NaN,NaN,NaN,NaN,NaN,-1.5694949847460662,-1.5150892819487751,0.054405702797290956,6.3119457485655035,16.625441354245883,5116201465,13468013084.156338,14.178185283885089,34.479950044140786,20.244530770119642,21.428571428571427,100
2018-03-29,158.13,161.71,156.6338,160.13,153.70189934405374,160.9515849969118,164.48305614038568,164.72261593345473,152.6684500000001,161.2941999999999,165.83940000000035,166.9085000000001,166.9085000000001,176.7732073448716,157.04379265512858,68692566,41.97272612391558,48.92306577811201,NaN,NaN,NaN,NaN,NaN,NaN,-1.4093057238074673,-1.7072264519620433,-0.29792072815457593,21.335419926969223,11.877891619930104,5184894031,13493943641.456917,16.533151258693053,31.074287320782595,21.658089161259586,14.285714285714286,92.85714285714286
2018-04-02,159,159.74,153.88,155.51,153.71989039535669,160.84383083855712,164.13117158586076,163.8452239397924,152.74725000000007,161.31659999999988,165.63320000000036,166.3845000000001,166.3845000000001,177.43124517674514,155.33775482325504,85549443,36.51357083953574,46.775924452879956,NaN,NaN,NaN,NaN,NaN,NaN,-1.527145584050655,-2.2068527082178946,-0.6797071241672397,7.6418190342240715,11.763061569919598,5099344588,13455986550.706064,14.618600902571337,32.57813447525063,23.2405757851152,7.142857142857143,100
2018-04-03,156.92,157.92,154.44,157.26,153.75511536654716,160.77286389125896,163.8617138766113,163.21805975505026,152.83790000000008,161.3512999999999,165.45160000000035,165.85600000000008,165.85600000000008,177.56696648445242,154.14503351554774,64090049,39.71223196800794,45.31794213551991,NaN,NaN,NaN,NaN,NaN,NaN,-1.4030721587219865,-2.433547322569723,-1.0304751638477363,17.921527041357333,15.63292200085021,5163434637,13495766581.119858,13.66942784668985,30.46286450783859,25.539019723469476,0,92.85714285714286
2018-04-04,154.27,160.23,154.04,159.74,153.81466645742728,160.752411140937,163.70007803831282,162.886815968855,152.94585000000006,161.40989999999988,165.2840000000004,165.41600000000008,165.41600000000008,177.34967738796215,153.48232261203802,65768692,44.016926929971476,44.173102154999306,NaN,NaN,NaN,NaN,NaN,NaN,-1.0840915267644078,-2.385589572303246,-1.3014980455388383,31.4209115281502,18.994752534577202,5229203329,13551122782.30241,16.285404266823058,27.09313568865396,27.015013699050375,0,85.71428571428571
2018-04-05,161.33,161.58,159.48,160.65,153.8826797265076,160.7503831975521,163.58046713484958,162.67378587658308,153.04680000000005,161.47139999999987,165.10680000000036,165.00200000000007,165.00200000000007,176.99367978224856,153.01032021775157,43054868,45.5531708039972,43.16823800300238,NaN,NaN,NaN,NaN,NaN,NaN,-0.757391193804708,-2.2482370377947234,-1.4908458439900154,36.95414847161579,28.765529013707777,5272258197,13556043338.645267,18.14995916853387,26.04071250782213,27.997751650956793,0,78.57142857142857
2018-04-06,158.94,160.4601,155.88,156.63,153.91001624664185,160.66879145106594,163.30789979622804,162.0981872216704,153.13315000000006,161.50079999999988,164.87120000000036,164.34050000000008,164.34050000000008,176.6428615212683,152.03813847873187,59870865,40.2929728826017,41.894836847963816,NaN,NaN,NaN,NaN,NaN,NaN,-0.7558733079987068,-2.435687478988399,-1.679814170989692,17.926988265971314,28.76734942191244,5212387332,13515780407.424006,16.5750028512777,30.330068881822665,29.79971647087601,0,71.42857142857143
2018-04-09,158.01,160.88,157.46,157.73,153.9480260352325,160.61059756094582,163.0891586277485,161.68216939103513,153.21810000000008,161.5412999999999,164.65880000000038,163.56900000000007,163.56900000000007,175.4916790613502,151.64632093864995,41810380,42.25781650319683,41.47759155388434,NaN,NaN,NaN,NaN,NaN,NaN,-0.6297838234070654,-2.4670439502485237,-1.8372601268414583,25.873655913978464,26.918264217188522,5254197712,13480571666.371374,16.060408214172945,27.998824050967325,30.308311727504755,0,64.28571428571429
2018-04-10,160.13,161.73,159.07,161.21,154.02028448264312,160.6224669161746,163.01546613254268,161.63720087760322,153.32065000000006,161.61469999999989,164.46440000000038,162.92550000000008,162.92550000000008,173.85759307497656,151.9934069250236,48601323,48.07906682619637,41.38201881710263,NaN,NaN,NaN,NaN,NaN,NaN,-0.27890364857301964,-2.185889687557733,-1.9069860389847133,49.26075268817214,31.02046562270731,5302799035,13510170968.348818,16.43548707726725,25.975203017479625,30.48814786005403,7.142857142857143,57.142857142857146
2018-04-11,160.2,162,160.1,160.28,154.08257020918398,160.61568539308203,162.90819295087434,161.50794365116482,153.41585000000006,161.6843999999999,164.2680000000004,162.35400000000007,162.35400000000007,172.56039289856926,152.14760710143088,41622139,46.72342144685162,41.3132369908161,NaN,NaN,NaN,NaN,NaN,NaN,-0.08632296218561253,-2.014889741716729,-1.9285667795311165,53.82674516400335,42.98705125538465,5261176896,13476435129.369871,16.356159680903186,25.049098943609792,30.86242409759372,0,50
2018-04-12,161.3,162.77,161.16,162.21,154.16344015735132,160.64725597935762,162.88081283515376,161.5748061605777,153.52400000000006,161.7805999999999,164.13820000000035,161.88050000000004,161.88050000000004,171.14780484013576,152.61319515986432,30467889,49.88166587957298,42.067851460599684,NaN,NaN,NaN,NaN,NaN,NaN,0.17965853981991664,-1.7039936047562207,-1.8836521445761374,70.95400340715507,58.01383375311019,5291644785,13485707965.15248,17.054064439811746,23.84904105864471,29.965257187943184,0,42.857142857142854
2018-04-13,163.01,163.26,160.67,161.37,154.23514722046224,160.6615677421426,162.82156527299088,161.55530081195127,153.64070000000004,161.8488999999999,163.9776000000004,161.37250000000006,161.37250000000006,169.51376740747227,153.23123259252785,44604892,48.53315456782901,43.18795959211853,NaN,NaN,NaN,NaN,NaN,NaN,0.3005186542676981,-1.5080038267415148,-1.8085224810092129,63.79897785349236,62.859908808216936,5247039893,13465213825.584911,16.185463437831498,22.63435695604169,28.23122754467057,14.285714285714286,35.714285714285715
2018-04-16,162.45,163.19,161.48,162.6,154.3183795864278,160.6999525393279,162.81287643875595,161.6547959727178,153.75360000000006,161.9353999999999,163.87040000000036,160.95150000000007,160.95150000000007,167.8259287762676,154.07707122373253,28180780,50.6375198381224,43.52028750249269,NaN,NaN,NaN,NaN,NaN,NaN,0.4555014288523751,-1.239145694943744,-1.6946471237961191,74.27597955706977,69.67632027257241,5275220673,13473948219.386082,15.584775003116363,21.794331799954474,27.02788291206442,7.142857142857143,28.571428571428573
2018-04-17,164.19,166.4592,163.91,166.1,154.4356096402942,160.8068841722125,162.94178324507925,162.07814873722089,153.89615000000006,162.0580999999999,163.90020000000038,160.90150000000006,160.90150000000006,167.60883710200895,154.19416289799116,35536087,56.13382637006223,44.77022079843415,NaN,NaN,NaN,NaN,NaN,NaN,0.7675750895757028,-0.7351782618264906,-1.5027533514021933,97.14449249554809,78.40648330203675,5310756760,13499469743.032558,20.985519992207642,20.09158919586399,24.504753747552623,100,21.428571428571427
2018-04-18,166.12,167,165.31,166.44,154.55505631054,160.9184310202875,163.07896821586044,162.49356314319985,154.04015000000007,162.1674999999999,164.06660000000036,160.84100000000007,160.84100000000007,167.32176199223346,154.36023800776667,29573880,56.6389173888902,46.21049916919652,NaN,NaN,NaN,NaN,56.6389173888902,NaN,0.958337580844729,-0.30483137534628213,-1.263168956191011,95.73170731707316,89.05072645656368,5340330640,13509444365.281078,21.37692796911393,19.377619196878822,21.874929650601,100,14.285714285714286
2018-04-19,165.65,165.99,164.34,164.91,154.6580905761068,160.9974719901828,163.15077338386592,162.72369998670462,154.18375000000006,162.2596999999999,164.11860000000036,160.74050000000005,160.74050000000005,166.8952038109072,154.58579618909292,34705692,53.64547969422583,47.04426728136154,NaN,NaN,NaN,NaN,NaN,NaN,0.9415412197377706,-0.08624243151879796,-1.0277836512565686,84.07012195121948,92.31544058794691,5305624948,13498717151.39017,20.406525243633936,20.594785177981706,19.7260242141893,92.85714285714286,7.142857142857143
2018-04-20,164.49,164.61,161.73,162.3,154.73412947584703,161.02326462404056,163.11740972175355,162.68334760701848,154.30760000000006,162.3200999999999,164.16040000000038,160.71550000000008,160.71550000000008,166.8405288978878,154.59047110211236,49197140,48.897830410050496,47.928857250684025,NaN,NaN,NaN,NaN,NaN,NaN,0.7244624442315502,-0.12220559596713088,-0.846668040198681,63.734567901234676,81.1787990565091,5256427808,13468993879.306837,18.999984041534862,24.832406119885054,17.958431428639773,85.71428571428571,0
2018-04-23,163.08,163.73,161.02,161.89,154.80533216762964,161.04042770079224,163.06927600717498,162.60779069206433,154.43560000000008,162.37709999999993,164.32920000000038,160.88450000000006,160.88450000000006,166.94294691319305,154.82605308680706,33040646,48.176541673588225,48.533450801082616,NaN,NaN,NaN,NaN,NaN,NaN,0.5319778235574759,-0.18169576075183613,-0.713673584309312,60.57098765432091,69.45855916892502,5223387162,13457167522.62049,17.869602287293375,24.91372560604037,16.41644245863627,78.57142857142857,7.142857142857143
2018-04-24,162.62,162.905,157.39,158.46,154.84169702168307,160.98933012255873,162.88852008532498,162.21276300710582,154.53910000000005,162.3957999999999,164.3764000000004,160.58750000000006,160.58750000000006,166.50829682137157,154.66670317862855,70256751,42.525093098074365,48.426891241661394,NaN,NaN,42.525093098074365,NaN,NaN,NaN,0.17105687474846154,-0.4998524908737352,-0.6709093656221967,23.201438848920965,49.16899813482552,5153130411,13414172684.066545,15.808399527414963,29.632192946982894,16.80978226286118,71.42857142857143,0
2018-04-25,158.8,159.31,156.47,158.65,154.87959058365638,160.94300675379517,162.72230361139066,161.87345224452432,154.63905000000005,162.4436999999999,164.3720000000004,160.5660000000001,160.5660000000001,166.51160812700837,154.6203918729918,52089323,42.92450226730072,48.23912920332594,NaN,NaN,NaN,NaN,NaN,NaN,-0.045886559050277276,-0.7282675644350434,-0.6823810053847661,24.910071942446123,36.227499481896,5205219734,13442051476.658094,14.857964051502334,29.798260830265693,17.924074770578127,64.28571428571429,7.142857142857143
2018-04-26,160.72,162.53,160.18,161.99,154.95034092610757,160.96373929332398,162.69358582270868,161.8845520307601,154.75375000000008,162.5120999999999,164.4180000000004,160.80300000000005,160.80300000000005,166.5763841029316,155.0296158970685,43005532,49.56025488149465,48.901077917532575,NaN,NaN,NaN,NaN,NaN,NaN,0.03991508330879889,-0.6324871512487675,-0.6724022345575664,52.42165242165251,33.511054404339866,5248225266,13465292764.164478,20.394917524233293,27.376605136960396,16.873319066126516,57.142857142857146,0
2018-04-27,164.35,164.41,161.17,162.09,155.0213823099274,160.9860414855354,162.6699157904456,161.90411850402103,154.86070000000007,162.5880999999999,164.40620000000038,160.90100000000007,160.90100000000007,166.6918752360903,155.11012476390982,51043406,49.748631323949816,49.43613611901493,NaN,NaN,NaN,NaN,NaN,NaN,0.10411340506576627,-0.5422604782253586,-0.6463738832911249,53.37132003798674,43.56768146736179,5299268672,13443236971.44843,22.957734135258633,25.512091714467278,15.31429826601183,50,85.71428571428571
2018-04-30,162.48,163.48,160.54,160.94,155.08027402823657,160.98512977295053,162.60207595552617,161.81229769411425,154.96035000000006,162.67039999999992,164.31100000000038,161.17250000000007,161.17250000000007,166.4095903181046,155.93540968189555,35615273,47.54934985725126,49.3982991926617,NaN,NaN,NaN,NaN,NaN,NaN,0.07139642660379664,-0.5571283500363791,-0.6285247766401757,42.45014245014244,49.4143716365939,5263653399,13417312929.196728,21.52515317044235,25.257276783840858,14.277438215487475,42.857142857142854,78.57142857142857
2018-05-01,160.52,162.8,160.14,162.78,155.15688821701033,161.02067175764458,162.60905336903494,161.90445981848433,155.06365000000005,162.7700999999999,164.26740000000038,161.44850000000005,161.44850000000005,166.40608923268,156.49091076732012,36513529,51.26190484624022,49.722476578332326,NaN,NaN,NaN,NaN,NaN,NaN,0.17030198151578513,-0.41564729974544434,-0.5859492812612295,59.92402659069327,51.91516302627415,5300166928,13453277382.572668,20.291419083115162,24.671526200288174,13.473639779215025,35.714285714285715,71.42857142857143
2018-05-02,163.1,163.57,161.63,161.82,155.22318783674157,161.0365000396714,162.57811009966102,161.89641602624772,155.16180000000008,162.8532999999999,164.1980000000004,161.55250000000004,161.55250000000004,166.44925760069893,156.65574239930115,38646842,49.30117663754371,49.68101306104453,NaN,NaN,NaN,NaN,NaN,NaN,0.16744358641830726,-0.3766447982383454,-0.5440883846566527,50.80721747388408,51.06046217157327,5261520086,13422200540.55205,21.12710426032066,23.608723624057337,12.683275602376046,28.571428571428573,64.28571428571429
2018-05-03,161.08,162.4,159.22,161.8,155.2886287537889,161.05161885076703,162.54759597810568,161.88723354755746,155.25510000000008,162.9310999999999,164.13760000000042,161.61000000000007,161.61000000000007,166.48999590163362,156.73000409836652,60337134,49.25890482648288,49.73285236523409,NaN,NaN,NaN,NaN,NaN,NaN,0.16055832692930427,-0.34339047599502237,-0.5039488029243266,50.6172839506174,53.78284267173158,5201182952,13459768944.740728,19.634046941377388,27.296115306488588,12.662858421411213,21.428571428571427,57.142857142857146
2018-05-04,161.11,165.25,160.98,164.87,155.3839657811144,161.12723035867262,162.63867064563095,162.17130654302818,155.35955000000007,163.03279999999992,164.1390000000004,162.02200000000005,162.02200000000005,166.5276435722315,157.51635642776859,41543243,55.55802614951338,50.08431710176201,NaN,NaN,NaN,NaN,NaN,NaN,0.3483406798246955,-0.06852295314345724,-0.41686363296815276,79.77207977207982,60.39886039886044,5242726195,13493918074.232533,24.0020569901171,24.765273117613994,11.588047121002,14.285714285714286,50
2018-05-07,165.64,166.78,165.51,166.24,155.49198602209833,161.22847332186723,162.77989924776307,162.55880115797788,155.46990000000008,163.13619999999992,164.1004000000004,162.44750000000005,162.44750000000005,166.85779194045026,158.03720805954984,32500152,58.0601776293438,50.22191362028213,NaN,NaN,NaN,NaN,NaN,NaN,0.5390090922284066,0.2568977323173556,-0.2821113599110511,92.78252611585954,74.3906299461856,5275226347,13498780301.6971,26.4006762715376,23.706455820023695,11.816668115866042,7.142857142857143,42.857142857142854
2018-05-08,165.83,166.43,164.86,166.07,155.5972398925252,161.3243451372758,162.90892280667433,162.89320104769428,155.57970000000006,163.2399999999999,164.0138000000004,162.69050000000007,162.69050000000007,167.330833931945,158.05016606805515,26040170,57.62661047696296,50.29246312657305,NaN,NaN,NaN,NaN,NaN,NaN,0.6219835645461631,0.49536809577165286,-0.12661546877451027,93.11348205625599,88.55602931473179,5249186177,13512878482.90729,25.43793256995214,24.351726208853037,11.622086580810452,0,35.714285714285715
2018-05-09,166.4,168,165.78,167.88,155.71945641100754,161.4541600850525,163.10386701033417,163.3681342812472,155.69525000000007,163.35889999999992,164.0056000000004,163.07050000000007,163.07050000000007,168.08838590942,158.05261409058014,29122718,60.96860987929367,50.81554385407789,NaN,NaN,NaN,NaN,NaN,NaN,0.7580492506496798,0.8209460945375895,0.0628968438879097,98.95923677363395,94.95174831524984,5278308895,13538852798.961344,27.820229570845918,23.070598286235214,12.255931229668814,100,28.571428571428573
2018-05-10,168.43,169.74,168.29,169.62,155.85777027756467,161.6158598853485,163.35940163737988,163.96355006398556,155.82135000000005,163.4962999999999,164.05380000000042,163.44100000000006,163.44100000000006,169.19088660757595,157.69111339242417,27067597,63.91503123106701,51.888201055579074,NaN,NaN,NaN,NaN,NaN,NaN,0.9140637088558743,1.2054764799577526,0.29141277110187835,99.09570459683492,97.05614114224163,5305376492,13561440241.975136,30.798868073795756,22.02509549217985,12.49187858966911,100,21.428571428571427
2018-05-11,169.35,169.86,168.72,169.46,155.99311584694215,161.7711893925693,163.59864078885516,164.48702148646314,155.94430000000006,163.61439999999993,164.1534000000004,163.84550000000007,163.84550000000007,170.0740294412045,157.61697055879566,24688847,63.44078401182845,52.97850407973909,NaN,NaN,NaN,NaN,NaN,NaN,0.9510662379011565,1.480245568478324,0.5291793305771675,97.01269604182221,98.35587913743036,5280687645,13568803582.30847,30.210090424701797,21.385418565314332,12.537515750014846,100,14.285714285714286
2018-05-14,169.8398,170.82,169.47,169.75,156.13000026637556,161.9291856422214,163.83987056184122,164.98825753537142,156.07325000000006,163.72549999999993,164.2286000000004,164.20300000000006,164.20300000000006,170.9071572177241,157.49884278227603,21821749,63.96271910829907,54.50976308046943,NaN,NaN,NaN,NaN,63.96271910829907,NaN,0.9380849380570886,1.7017855031485283,0.7637005650914397,92.54355400696868,96.21731821520859,5302509394,13556033818.07884,31.66253013815589,20.61616501705069,11.873807212453503,100,7.142857142857143
2018-05-15,168.4,168.5,166.98,167.87,156.24681618412308,162.04682553049423,163.99791485353373,165.26270919866937,156.19340000000008,163.82719999999995,164.2294000000004,164.29150000000007,164.29150000000007,171.13869292849068,157.44430707150946,49361638,58.165379669943455,55.598397180658196,NaN,NaN,NaN,NaN,NaN,NaN,0.753832827988038,1.7059916000764872,0.9521587720884492,74.56896551724147,88.04173852201079,5253147756,13564477256.157787,29.347046593772735,25.682290593819562,9.959763906577981,92.85714285714286,0
2018-05-16,168.1,169.37,168.01,168.98,156.3735145305497,162.1841161140488,164.19329074163045,165.6167368940342,156.32215000000005,163.94169999999994,164.2382000000004,164.41850000000005,164.41850000000005,171.5102368112459,157.3267631887542,22941159,60.44495281226453,56.375875604284616,NaN,NaN,NaN,NaN,NaN,NaN,0.6609869695240518,1.778392483993514,1.1174055144694621,84.13793103448272,83.75015018623095,5276088915,13574260985.731316,30.51903738012001,24.631808728250064,9.678337259232956,85.71428571428571,35.714285714285715
2018-05-17,168.4,169.61,167.51,168.33,156.49248453522085,162.30581678505774,164.35551463411554,165.8751429041262,156.44600000000005,164.04949999999994,164.2262000000004,164.58950000000004,164.58950000000004,171.88247051961648,157.2965294803836,27480164,58.43687854648235,56.99646469160837,NaN,NaN,NaN,NaN,NaN,NaN,0.5164743007274113,1.7629983903787263,1.246524089651315,78.53448275862084,79.08045977011501,5248608751,13568241521.236078,28.746280490710635,24.584044729780068,9.8593827504677,78.57142857142857,28.571428571428573
2018-05-18,167.71,168.26,167.21,167.46,156.6016140423331,162.40787981901698,164.47725915826786,166.0260816751618,156.56355000000005,164.15039999999993,164.1782000000004,164.84750000000005,164.84750000000005,172.1632880641795,157.5317119358206,26217939,55.76643624556864,57.583399433631044,NaN,NaN,55.76643624556864,NaN,NaN,NaN,0.3319364336176376,1.661444631673362,1.3295081980557244,71.0344827586208,77.90229885057478,5222390812,13554508315.093222,27.81818936269313,24.65512696883175,9.720120349469877,71.42857142857143,21.428571428571427
2018-05-21,168.73,169.5,167.68,168.4,156.71901091753375,162.52653566418496,164.63109213245343,166.2521691346702,156.68860000000004,164.26919999999996,164.0830000000004,165.17300000000006,165.17300000000006,172.5127305127621,157.83326948723803,22954565,57.99970902564239,58.0646711607312,NaN,NaN,NaN,NaN,NaN,NaN,0.2467387487843289,1.6379316340361356,1.3911928852518067,79.13793103448286,76.23563218390818,5245345377,13549715603.719595,29.781576024549295,23.186724225936004,9.91361823646716,64.28571428571429,14.285714285714286
2018-05-22,169.15,169.45,167.88,168.18,156.8330506098966,162.63848545301298,164.77026499000428,166.4357720742254,156.81125000000003,164.38559999999995,163.96500000000037,165.65900000000005,165.65900000000005,172.42083377494583,158.89716622505426,19477721,57.270917202692274,58.633938343956096,NaN,NaN,NaN,NaN,NaN,NaN,0.15368091153713226,1.5832940246732221,1.4296131131360899,77.24137931034494,75.80459770114953,5225867656,13537681597.751442,28.380652315447254,22.09602198513624,10.406710269427764,57.142857142857146,7.142857142857143
2018-05-23,166.9,169.62,166.88,169.6,156.96008493218616,162.77633722622065,164.95966636294528,166.73712711477538,156.93645000000004,164.51429999999993,163.9228000000004,166.20650000000006,166.20650000000006,172.35503242651941,160.0579675734807,26557835,60.703215599611525,59.45138911346528,NaN,NaN,NaN,NaN,NaN,NaN,0.16488542740979328,1.6357198973983316,1.4708344699885383,87.60162601626018,81.32697878702932,5252425491,13563851727.131004,26.075327261070075,23.26574273137875,9.647258692071045,50,0
2018-05-24,169.56,169.85,167.84,169.55,157.08535771893057,162.9104691623351,165.13967944675136,167.00501977051107,157.06265000000005,164.65219999999994,163.88020000000037,166.58450000000008,166.58450000000008,172.57724052499725,160.5917594750029,27696539,60.51887598993314,59.805735530638124,NaN,NaN,NaN,NaN,NaN,NaN,0.1466644340299641,1.6541650125259935,1.5075005784960294,78.69127516778546,81.1780934981302,5224728952,13583280642.548916,25.19296232775344,21.862782352509342,10.040978711566128,42.857142857142854,0
2018-05-25,169.54,170.33,169.21,169.72,157.21107555257305,163.04531135714035,165.31929986060425,167.26358931617668,157.19065000000003,164.76449999999994,163.8440000000004,166.96600000000007,166.96600000000007,172.7328826934456,161.19911730655454,27460536,60.9530439294674,60.012368837789815,NaN,NaN,NaN,NaN,NaN,NaN,0.12466088422682353,1.6633266837795588,1.5386657995527353,81.54362416107385,82.61217511503982,5252189488,13580828808.977488,25.809828703090844,21.099292912275004,10.37418679740367,35.714285714285715,7.142857142857143
2018-05-29,168.91,169.92,167.96,168.97,157.32807977593052,163.1626319243257,165.4624645719531,167.42610461939793,157.33035000000004,164.85389999999995,163.80300000000037,167.36750000000006,167.36750000000006,172.48148034802094,162.2535196519792,41220468,57.926529311356425,60.033791611675056,NaN,NaN,NaN,NaN,NaN,NaN,0.04244358569395379,1.5917202816701774,1.5492766959762236,63.29365079365085,74.50951670750338,5210969020,13582090660.038712,24.216065078150955,23.73456041258072,10.2900851797624,28.571428571428573,0
2018-05-30,169.63,170.48,169.22,170.18,157.4559595791551,163.3015897080024,165.64746596128828,167.68838036993145,157.47075000000004,164.95259999999996,163.8646000000004,167.73750000000007,167.73750000000007,172.53105765584718,162.94394234415296,22665836,61.26791808529784,60.05517076924679,NaN,NaN,NaN,NaN,NaN,NaN,0.05178132620358822,1.614003353730709,1.5622220275271208,83.75634517766531,76.19787337746334,5233634856,13593963240.800617,24.843292600391997,22.57784420816708,9.964679157989867,21.428571428571427,0
2018-05-31,170.13,171.2,169.63,170.07,157.5814724191635,163.43561763457663,165.82089866868873,167.91520128708083,157.60145000000003,165.03409999999997,163.91300000000038,168.15000000000006,168.15000000000006,172.19750787521735,164.10249212478277,35670946,60.79522403965069,59.83232739843134,NaN,NaN,NaN,NaN,NaN,NaN,0.033657155325755195,1.604293471684315,1.5706363163585597,73.84259259259265,73.63086285463628,5197963910,13578286200.838833,25.930818721744302,21.409528748312635,9.4604756272836,100,64.28571428571429
2018-06-01,170.88,172.84,170.87,172.74,157.73230353937083,163.61986282993155,166.09223597579899,168.37470592640648,157.74500000000003,165.13599999999994,164.02940000000038,168.69700000000006,168.69700000000006,172.06369036294697,165.33030963705315,45543331,67.37486991812227,60.113333534595185,NaN,NaN,NaN,NaN,NaN,NaN,0.17660688335008645,1.7913949205461677,1.6147880371960812,98.32214765100682,85.30702847375493,5243507241,13619205843.412437,28.909547877748125,19.492976710890055,9.628414550044539,100,57.142857142857146
2018-06-04,173.16,174.34,173.07,174.3,157.89715624047162,163.83135069468537,166.41410907478726,168.9390196477011,157.89510000000004,165.25339999999997,164.2594000000004,169.16850000000008,169.16850000000008,172.88264741225422,165.45435258774594,20459634,70.49100310014464,60.57963953401271,NaN,NaN,NaN,NaN,NaN,NaN,0.34178082008137123,2.0420140622977954,1.7002332422164241,99.4638069705095,90.54284907136964,5263966875,13638376681.569918,32.32973666306125,18.4647658000029,10.068874499906725,100,50
2018-06-05,174.69,175.13,174.065,174.84,158.06574175051668,164.04934375023615,166.74453616989365,169.50101777649147,158.06265000000002,165.37999999999997,164.58600000000035,169.5985000000001,169.5985000000001,173.81433336956454,165.38266663043564,24779284,71.5055629804694,61.53250977047885,NaN,NaN,NaN,NaN,NaN,NaN,0.4463527648571497,2.258174198287861,1.8118214334307114,96.48484848484858,98.09026770212164,5288746159,13649661144.236586,33.8544272046987,17.792031021942208,11.814662551977472,100,42.857142857142854
2018-06-06,175.0248,175.89,174.14,175.86,158.24279904653145,164.2832181314196,167.10200533970175,170.10663513111132,158.2358,165.50569999999996,164.81520000000037,170.08800000000008,170.08800000000008,174.79608071298148,165.37991928701868,25036647,73.36814638122259,62.45559502540443,NaN,NaN,NaN,NaN,73.36814638122259,NaN,0.5370738713822649,2.4831637726585427,1.9460899012762778,99.66703662597145,98.53856402710984,5313782806,13673839391.910872,34.43430809766409,16.714414203621594,13.52674036243462,100,35.714285714285715
2018-06-07,175.91,175.93,173.55,174.43,158.40386572268537,164.48414450505487,167.38937767932129,170.51838416624358,158.4027,165.60509999999994,165.12220000000036,170.4155000000001,170.4155000000001,175.3685333130235,165.46246668697668,39600316,66.77779913861339,63.0513750676995,NaN,NaN,NaN,NaN,NaN,NaN,0.45678041416861337,2.5170654189870447,2.0602850048184314,83.4254143646409,93.19243315848696,5274182490,13663523343.204988,31.628600542095004,17.37240611815451,15.047386389723178,100,28.571428571428573
2018-06-08,173.57,174.8803,173.18,174.44,158.56342924783277,164.68129015842013,167.66587267228908,170.8918713885061,158.55890000000002,165.70929999999993,165.46600000000035,170.6565000000001,170.6565000000001,175.89223977580028,165.42076022419994,31780348,66.80025781245877,63.83950517962023,NaN,NaN,NaN,NaN,NaN,NaN,0.36436379814832165,2.5157397525038334,2.1513759543555118,83.53591160220986,88.87612086427407,5305962838,13678844375.526108,29.762828731756148,17.63128144281221,16.44518765807935,92.85714285714286,21.428571428571427
2018-06-11,174.3,175.34,174.28,174.91,158.72608169312798,164.88383886815438,167.9499560969052,171.27455030388649,158.72000000000003,165.80049999999994,165.76160000000036,170.9290000000001,170.9290000000001,176.44697752803503,165.41102247196514,22319709,67.89866005412445,64.54657311022609,NaN,NaN,NaN,NaN,NaN,NaN,0.2977189193325471,2.523524603521196,2.2258056841886487,88.7292817679557,85.23020257826882,5328282547,13683055641.375164,30.281123751471206,16.95960624848359,17.570091719991467,85.71428571428571,14.285714285714286
2018-06-12,175.15,176,174.96,175.83,158.8962699349874,165.10059453413152,168.25897742643832,171.7084026558973,158.88780000000003,165.90059999999994,166.1680000000004,171.2330000000001,171.2330000000001,177.11554740736636,165.35045259263381,22511832,69.99154335190136,65.45518926374102,NaN,NaN,NaN,NaN,NaN,NaN,0.2787602878664823,2.5742560440217517,2.2954957561552694,98.13596491228084,90.13371942748215,5350794379,13698207835.99055,31.506410933401995,16.273090070593017,18.958090399699763,100,7.142857142857143
2018-06-13,176.09,177.14,175.43,175.82,159.06466525901737,165.31285998890118,168.5554881155976,172.09998335533564,159.05705,165.99539999999993,166.5392000000004,171.6305000000001,171.6305000000001,177.62370440164574,165.63729559835446,37858584,69.93816895689993,66.11482878926162,NaN,NaN,NaN,NaN,NaN,NaN,0.23069853675829632,2.58386892710314,2.3531703903448435,85.80645161290327,90.89056609771326,5312935795,13677618079.780022,33.75708044858414,15.231421090209402,21.25252835457081,100,0
2018-06-14,176.62,177.89,176.5,177.6,159.24909645046995,165.55616969209126,168.9101748561624,172.62379446435128,159.23300000000003,166.09019999999992,166.89640000000037,172.06150000000008,172.06150000000008,178.4566083649881,165.66639163501205,35915978,73.77218705514923,67.06149386534848,NaN,NaN,NaN,NaN,73.77218705514923,NaN,0.2806228000937603,2.703948890462044,2.423326090368284,97.07955689828809,93.6739911411574,5348851773,13698547534.585777,33.947692819435446,14.058278593395897,23.706387636832034,100,0
2018-06-15,176.98,177.325,176.11,176.98,159.4255233514603,165.782384153634,169.22663858729328,173.03867118203212,159.40305000000004,166.16489999999993,167.22300000000038,172.49400000000009,172.49400000000009,178.99036021168172,165.99763978831845,49615730,70.40402789284082,67.73656414844659,NaN,NaN,NaN,NaN,NaN,NaN,0.23554369730997626,2.7177557120057543,2.482212014695778,90.83585095669689,91.24061982262943,5299236043,13719986430.26479,32.035039690951656,14.740920635778698,25.629987923783467,92.85714285714286,7.142857142857143
2018-06-18,175.53,176.65,174.94,176.5,159.5954186414955,165.99461417039373,169.51186844661513,173.36832154564812,159.56230000000002,166.24579999999995,167.62040000000036,172.94600000000008,172.94600000000008,179.23303873058777,166.6589612694124,31633192,67.82232161778883,68.4434064560489,NaN,NaN,NaN,NaN,NaN,NaN,0.14167906742403424,2.659310848975821,2.5176317815517866,83.96770472895054,90.62770419464518,5267602851,13746069939.457771,29.577941670907055,18.009276545767147,27.294722112838738,85.71428571428571,0
2018-06-19,174.26,176.04,173.71,176,159.75864830675425,166.19274062246515,169.76630497812042,173.61895758891973,159.71130000000002,166.32229999999996,167.98580000000038,173.32600000000008,173.32600000000008,179.38251847185617,167.26948152814398,38235994,65.14261076911009,68.72017021917834,NaN,NaN,NaN,NaN,NaN,NaN,0.020557884756020606,2.543329137496812,2.5227712527407915,77.11864406779675,83.9740665844814,5229366857,13782993109.629446,26.575731063930334,20.65610982389782,27.84870918213611,78.57142857142857,0
2018-06-20,176.79,177.98,176.65,177.25,159.93269160718455,166.41169625370347,170.05978321427256,173.96477115187975,159.86755000000002,166.38549999999995,168.3066000000004,173.7795000000001,173.7795000000001,179.57967749727453,167.97932250272567,33038042,68.49405840432757,69.2700869595124,NaN,NaN,NaN,NaN,NaN,NaN,0.00033625149322125125,2.523191567107318,2.522855315614097,89.7327707454291,83.60637318072547,5262404899,13779763827.328693,31.716102808521946,19.169078512123203,28.92777455693226,100,0
2018-06-21,177.69,177.88,175.37,175.71,160.08967975039664,166.5958210803628,170.28136034312462,174.1309834231293,160.02265,166.44159999999997,168.61520000000036,174.0850000000001,174.0850000000001,179.60953255940387,168.5604674405963,43469439,60.74508583616233,68.79653095365812,NaN,NaN,NaN,NaN,NaN,NaN,-0.13363549595765267,2.355810945667031,2.4894464416246835,53.76782077393109,73.539745195719,5218935460,13748070969.41236,28.87797749277347,22.017121897891926,28.50103703673559,92.85714285714286,0
2018-06-22,176.31,176.369,174.69,175.32,160.24122522551707,166.76857709857345,170.47895405515894,174.244223097117,160.1736,166.50779999999995,168.8774000000004,174.3735000000001,174.3735000000001,179.5095812882895,169.2374187117107,30073187,58.926919828578335,67.97052500568911,NaN,NaN,NaN,NaN,NaN,NaN,-0.2581856951792054,2.1667143226506766,2.424900017829882,44.58333333333321,62.69464161756448,5188862273,13740566106.188416,27.12914007577647,23.1364547737547,27.11867800530923,85.71428571428571,0
2018-06-25,173.76,173.99,169.81,171.37,160.35195930287512,166.8596943837502,170.513897033388,173.97048756405823,160.3031,166.52749999999997,169.07740000000038,174.4560000000001,174.4560000000001,179.33711626576434,169.57488373423587,77799725,44.42395543775205,66.0361244669236,NaN,NaN,NaN,NaN,NaN,NaN,-0.5969039490096959,1.6787700815677624,2.2756740305774583,19.09424724602209,39.148467117762145,5111062548,13720836989.322388,22.346408724267796,34.67139836308076,26.441203912466108,78.57142857142857,100
2018-06-26,171.99,173.0585,171.37,172.07,160.468556722747,166.9628687523888,170.57492067913748,173.78948874843363,160.4424,166.56859999999998,169.26680000000036,174.61100000000013,174.61100000000013,178.9524923701249,170.26950762987536,39008146,46.91729656425421,64.14677805142584,NaN,NaN,NaN,NaN,NaN,NaN,-0.7539898181800107,1.3331867578524452,2.087176576032456,27.662178702570312,30.446586427308546,5150070694,13714171990.73133,21.11777544115623,32.76512185455885,25.51064474686185,71.42857142857143,92.85714285714286
2018-06-27,172.77,173.58,169.61,169.73,160.56071038719728,167.0176634305593,170.54178653485758,173.40287077239233,160.5617,166.61979999999997,169.33940000000038,174.58850000000012,174.58850000000012,179.0252342719476,170.15176572805265,52843497,40.39340115443501,62.26217819541311,NaN,NaN,40.39340115443501,NaN,NaN,NaN,-0.9812845293089432,0.860570914396277,1.8418554437052201,1.4336917562721203,16.063372568288184,5097227197,13664523062.819492,18.53711529808737,34.17869193308897,25.55191864301337,64.28571428571429,100
2018-06-28,169.52,171.77,169.17,171.19,160.66647446294655,167.10028395668684,170.56720667074552,173.19212117502164,160.68655,166.75049999999996,169.43440000000038,174.64450000000014,174.64450000000014,178.87518067807702,170.41381932192326,46407708,45.48668934275352,60.73978044757702,NaN,NaN,NaN,NaN,NaN,NaN,-0.9959259496193278,0.5969480066810604,1.5928739563003882,22.92849035187298,17.341453603571818,5143634905,13690225793.404108,17.066202065472073,32.8094652736551,25.978194028492855,57.142857142857146,100
2018-06-29,172,172.92,171.395,171.65,160.77576327426053,167.19037734368314,170.6096691542457,173.04525249168626,160.81269999999998,166.84389999999996,169.5692000000004,174.59000000000015,174.59000000000015,178.94370646688938,170.2362935331109,36408464,47.022662739628224,59.24863778225586,NaN,NaN,NaN,NaN,NaN,NaN,-0.9380606267003664,0.4202981729249302,1.3583587996252966,28.14982973893323,17.504003949026124,5180043369,13665993274.741814,19.72435840637653,31.044304464810622,25.556614928890074,50,92.85714285714286
2018-07-02,170.04,172.85,169.67,172.8,160.8954074207853,167.30145898044188,170.69556448153017,173.02189511152565,160.94889999999998,166.96979999999996,169.77920000000037,174.51500000000016,174.51500000000016,178.9372460356486,170.09275396435172,31770026,50.758093469327775,57.87481993350061,NaN,NaN,NaN,NaN,NaN,NaN,-0.7916106597070354,0.36884547499150244,1.1604561346985378,41.20317820658369,30.76049943246331,5211813395,13696764243.32043,17.82589524491278,33.27739119885364,25.43899147691405,42.857142857142854,85.71428571428571
2018-07-03,173.41,173.45,170.63,170.8,160.99396058077747,167.37073702043313,170.6996599920584,172.81028605328513,161.0726,167.14329999999998,169.95740000000038,174.31300000000016,174.31300000000016,179.01748339350803,169.6085166064923,25512707,44.836975555817695,56.08187754770903,NaN,NaN,NaN,NaN,NaN,NaN,-0.7965361034503327,0.16478600538562205,0.9613221088359547,18.50170261066996,29.28490351872897,5186300688,13674327536.455183,18.116379600598904,30.476058095049325,24.554638112606177,35.714285714285715,78.57142857142857
2018-07-05,171.91,173.06,171.03,172.92,161.1126276396752,167.4806234160681,170.7867321492326,172.8207350005913,161.20945,167.31149999999994,170.24660000000037,174.16600000000014,174.16600000000014,178.85163506899707,169.4803649310032,31626198,51.319497686875756,54.478114021403776,NaN,NaN,NaN,NaN,NaN,NaN,-0.631338280283123,0.17214925848205098,0.803487538765174,42.56526674233824,34.09004918653064,5217926886,13701591500.248285,16.889304190368254,28.411825488223208,23.4120859435007,28.571428571428573,71.42857142857143
2018-07-06,173.31,175.74,173,175.61,161.25688010097196,167.64160117020538,170.97587990808623,173.08637928624927,161.3585,167.47889999999995,170.58580000000038,174.22500000000014,174.22500000000014,178.951980008401,169.49801999159928,37005574,58.05509688761122,53.596047521030236,NaN,NaN,NaN,NaN,NaN,NaN,-0.33035541609526053,0.39054326864609834,0.7208986847413589,73.0987514188425,44.721906923950236,5254932460,13735085596.423468,23.408605850115887,26.041584024783564,21.151533685213703,21.428571428571427,64.28571428571429
2018-07-09,176.49,177.23,175.82,177.19,161.41541860742996,167.83067837475576,171.21957089208286,173.47720030660648,161.5177,167.65389999999996,170.88980000000035,174.36250000000013,174.36250000000013,179.26328718164962,169.46171281835063,27362061,61.43070753587898,53.13950365803668,NaN,NaN,NaN,NaN,NaN,NaN,-0.03012779790061737,0.6832389373655872,0.7133667352662045,91.03291713961417,68.89897843359832,5282294521,13760895200.061766,26.773737823416898,24.763509340293876,19.693682895392136,14.285714285714286,57.142857142857146
2018-07-10,177.41,177.72,176.71,177.32,161.57367314864956,168.0185857336715,171.45880340611882,173.8431812297868,161.68200000000002,167.8003,171.1944000000004,174.48300000000015,174.48300000000015,179.54748852302018,169.41851147698011,23902488,61.70379379872899,52.89387387443803,NaN,NaN,NaN,NaN,NaN,NaN,0.1614210736986148,0.9151430773894731,0.7537220036908583,92.50851305334851,85.54672720393508,5306197009,13765865024.299389,27.467293904751923,23.97353681333968,19.283588747231704,7.142857142857143,50
2018-07-11,175.96,177.07,175.8,176.42,161.72139779393663,168.1849503726087,171.65336013529063,174.08859254123567,161.8425,167.90749999999997,171.5040000000004,174.51250000000013,174.51250000000013,179.61476175336253,169.41023824663773,30280553,58.60984856466205,52.187858885890485,NaN,NaN,NaN,NaN,NaN,NaN,0.2087107990090734,1.0146105024522,0.8058997034431267,83.23765786452346,88.92636268582874,5275916456,13765149735.645845,26.11699504240762,25.738138070397316,17.574523421950257,0,42.857142857142854
2018-07-12,177.21,179.46,177.08,179.46,161.89790129847458,168.408218682062,171.95950287508316,174.6001551563561,162.0258,168.05249999999995,171.83760000000038,174.69450000000012,174.69450000000012,180.2130341350623,169.17596586493795,27930119,64.99469403219491,52.49140232846424,NaN,NaN,NaN,NaN,NaN,NaN,0.4140685819592742,1.3234854308922195,0.9094168489329453,100,91.91539030595733,5303846575,13793079854.645845,31.1437809338452,23.273821971650765,17.644649931176495,100,35.714285714285715
2018-07-13,179.42,179.9,178.95,179.61,162.07414108654945,168.63003613390237,172.25952237017793,175.07728323670312,162.208,168.19569999999996,172.19340000000037,174.79500000000013,174.79500000000013,180.5879146377141,169.00208536228615,28067961,65.27930013252231,52.94514377874596,NaN,NaN,NaN,NaN,NaN,NaN,0.5223583723421856,1.5623648143606772,1.0400064420184916,97.29729729729739,93.51165172060696,5331914536,13804011586.824793,31.617394259819488,22.547300351050325,18.273380012806157,100,28.571428571428573
2018-07-16,179.64,179.95,178.88,179.18,162.24434863792706,168.83894630946867,172.5309136497788,175.46801816654093,162.3816,168.33929999999998,172.5410000000004,174.90500000000014,174.90500000000014,180.9382627988363,168.871737201164,21405310,63.680914748012434,54.32064087233599,NaN,NaN,NaN,NaN,NaN,NaN,0.5259262903441393,1.6974143049486656,1.1714880146045263,92.85714285714303,96.71814671814683,5310509226,13794609254.394886,30.463910865260253,21.963388111260837,17.887514925107023,100,21.428571428571427
2018-07-17,177.3,180.65,177.28,180.27,162.42370835297257,169.06530380829108,172.83440723214042,175.92534976972752,162.5609,168.49399999999997,172.8490000000004,175.09350000000015,175.09350000000015,181.53601278615872,168.65098721384157,31034075,65.95645004512393,55.680580406683816,NaN,NaN,NaN,NaN,65.95645004512393,NaN,0.5594736879833428,1.870830124583705,1.311356436600362,96.68989547038332,95.61477854160792,5341543301,13818644546.902304,27.109353387944928,24.772921542852906,16.665179037630416,100,14.285714285714286
2018-07-18,180.28,180.44,179.38,179.93,162.5979003096594,169.2804463071368,173.1126657720565,176.30674502975347,162.73329999999999,168.6116,173.12280000000035,175.29000000000013,175.29000000000013,182.06240872953146,168.5175912704688,23220839,64.59689308501441,57.409401258868066,NaN,NaN,NaN,NaN,NaN,NaN,0.51751861967739,1.9582547111970996,1.4407360915197096,93.72822299651568,94.42508710801401,5318322462,13819520804.977776,26.134532200096654,23.882115758617022,14.86745205756557,92.85714285714286,7.142857142857143
2018-07-19,179.34,179.88,178.82,179.03,162.76140378916526,169.4735067763024,173.34471809472095,176.56610264596742,162.90054999999998,168.69789999999998,173.38200000000037,175.37900000000016,175.37900000000016,182.29731164373172,168.4606883562686,31094145,61.011785870615356,58.51833672514391,NaN,NaN,NaN,NaN,NaN,NaN,0.39352200109551694,1.9326385928891057,1.5391165917935887,85.24590163934424,91.88800670208109,5287228317,13800746981.581549,25.116037618478632,24.917516152206083,12.641149128734725,85.71428571428571,0
2018-07-20,179.57,180.17,178.79,178.99,162.9228823584273,169.66195218667266,173.56610169884954,176.79695001301815,163.06605,168.80489999999998,173.60420000000033,175.54300000000015,175.54300000000015,182.63816765128243,168.44783234871787,35907619,60.8501438420136,59.50601394674287,NaN,NaN,NaN,NaN,NaN,NaN,0.27858971049177894,1.8873537299083125,1.6087640194165336,84.88160291438986,87.9519091834166,5251320698,13775247368.088797,24.91264126438781,23.68185200482977,11.229410722238276,78.57142857142857,7.142857142857143
2018-07-23,178.45,179.64,177.74,179.56,163.08842581754743,169.85795313347123,173.80115653418878,177.06009763082594,163.2337,168.9284,173.80300000000037,175.75500000000017,175.75500000000017,183.06108924115898,168.44891075884135,22184720,62.37968961070955,60.33612795684156,NaN,NaN,NaN,NaN,NaN,NaN,0.21365751827524337,1.8758359172605878,1.6621783989853445,89.12175648702592,86.41642034692,5273505418,13795563901.141428,23.206318649963087,25.844926399917878,9.453944396933457,71.42857142857143,0
2018-07-24,181.39,182.05,179.56,180.3,163.25968526214896,170.064726338749,174.0560131406912,177.36865976122346,163.39790000000002,169.0866,174.01980000000037,176.20150000000018,176.20150000000018,183.4724869343686,168.93051306563177,36900281,64.32818363095345,61.72835710506555,NaN,NaN,NaN,NaN,NaN,NaN,0.19383030602265494,1.9044662815136633,1.7106359754910083,84.11978221415609,86.04104720519062,5310405699,13780596317.28199,29.692099592079398,23.566825823699666,8.45862573774503,100,0
2018-07-25,180.36,182.93,180.29,182.82,163.45431525954052,170.31730601520943,174.39969889987978,177.8878350220593,163.5737,169.2549,174.28120000000035,176.73900000000017,176.73900000000017,184.29271934875405,169.1852806512463,36022078,70.02232399779956,63.06427327013153,NaN,NaN,NaN,NaN,70.02232399779956,NaN,0.31646705973219613,2.1062198001562535,1.7897527404240574,98.89224572004015,90.71126147374072,5346427777,13813616555.448656,30.025056967618713,21.411856098150086,7.83789570081033,100,0
2018-07-26,180.35,180.92,179.81,180.05,163.61944645098788,170.51003262876964,174.6212793351786,178.0937554961489,163.7365,169.37709999999998,174.52480000000037,177.25500000000017,177.25500000000017,184.20920592158208,170.30079407841825,40873485,58.89382441279489,63.12418237907322,NaN,NaN,NaN,NaN,NaN,NaN,0.18365191200476172,2.0193176304300096,1.8356657184252478,59.607293127629774,80.87310702060869,5305554292,13790418090.989197,26.99424797977062,20.860203248775715,8.373154424968615,92.85714285714286,0
2018-07-27,181.26,181.31,176.6,177.62,163.75875544152532,170.65082406186332,174.73887622399513,178.0486359250871,163.8866,169.4679,174.69760000000034,177.57650000000018,177.57650000000018,183.94967275772208,171.20332724227828,59456093,51.20555861114226,62.393814598734885,NaN,NaN,NaN,NaN,NaN,NaN,-0.08103372326556912,1.7343735643432865,1.8154072876088556,25.52594670406724,61.34182851724572,5246098199,13756713681.581554,23.06996160085977,27.73536988968239,8.75046696785994,85.71428571428571,14.285714285714286
2018-07-30,177.66,177.73,174.27,175.11,163.87170314857482,170.7391245754898,174.75343009756395,177.76876583698356,164.02195,169.52969999999996,174.83320000000037,177.74950000000018,177.74950000000018,183.63929278071276,171.8597072192876,60192990,44.71262541083448,61.18015971388528,NaN,NaN,44.71262541083448,NaN,NaN,NaN,-0.41941868785739245,1.291133927787115,1.7105526156445074,9.699769053117826,31.611002961604953,5185905209,13725747345.6856,20.69039376137863,31.82052536529779,9.779327305012517,78.57142857142857,100
2018-07-31,175.75,177.13,174.82,176.45,163.99686033117607,170.8522112175593,174.81996225060067,177.64316909060418,164.16535,169.5956,175.01300000000035,177.93200000000016,177.93200000000016,183.4087384454419,172.4552615545584,47285135,48.46931654066446,60.45583599788546,NaN,NaN,NaN,NaN,NaN,NaN,-0.539604319548816,1.0360472162084875,1.5756515357573035,25.173210161662578,20.13297530628255,5233190344,13745193613.326292,19.26192278424111,29.62362677139846,11.241129861700726,71.42857142857143,92.85714285714286
2018-08-01,176.87,177.65,176.0967,177.12,164.12743883534347,170.97632584691456,174.91015980940065,177.59334346292758,164.30925000000002,169.63519999999997,175.18740000000034,178.24800000000016,178.24800000000016,182.66999321570947,173.82600678429085,37101925,50.288154850037316,59.40536891344563,NaN,NaN,NaN,NaN,NaN,NaN,-0.5582544745540541,0.8778334425647358,1.43608791711879,32.90993071593528,22.59430331023857,5270292269,13756976513.991007,19.93877828966922,28.213099425355566,11.435532778091543,64.28571428571429,85.71428571428571
2018-08-02,175.87,179.74,175.79,179.53,164.28069815041468,171.14570553311427,175.09133001295356,177.77778694264876,164.46265,169.6897,175.41440000000034,178.57850000000016,178.57850000000016,182.28906478177765,174.86793521822267,47178229,56.26757019138474,58.76167391765009,NaN,NaN,NaN,NaN,NaN,NaN,-0.3999713779846441,0.9361236946379847,1.3360950726226288,60.73903002309461,39.60739030023083,5317470498,13799138323.704931,23.742352191669195,24.958561938783852,10.417811729994183,57.142857142857146,78.57142857142857
2018-08-03,179.8,180.09,179.08,180.08,164.43790513399264,171.3226222552308,175.28696413009263,177.99704532906316,164.61785000000003,169.77339999999995,175.62400000000034,178.80200000000016,178.80200000000016,182.30299757209139,175.30100242790894,28934445,57.523254319538616,58.32184102990196,NaN,NaN,NaN,NaN,NaN,NaN,-0.25687664759206164,1.0149992631325517,1.2718759107246134,67.09006928406471,53.57967667436488,5346404943,13827499809.398,24.078272107125688,24.190163893837052,9.276232219195093,50,71.42857142857143
2018-08-06,179.97,181.19,179.74,181.14,164.60409513265938,171.5170257749292,175.51649494852037,178.29637434534285,164.77925000000002,169.868,175.85580000000036,178.99950000000015,178.99950000000015,182.55962626177754,175.43937373822277,24808763,59.912255051448945,57.890112816068026,NaN,NaN,NaN,NaN,NaN,NaN,-0.09767047070390311,1.1497878223447344,1.2474582930486375,79.3302540415702,69.05311778290985,5371213706,13850597623.225586,26.431136035364755,23.091052443982505,9.436324138616795,42.857142857142854,64.28571428571429
2018-08-07,181.63,182.14,181.26,181.8,164.77519866367768,171.72064902691082,175.7629069113235,178.63005297911974,164.94670000000002,169.9707,176.09740000000033,179.22350000000014,179.22350000000014,182.89476830942743,175.55223169057285,29895664,61.36913004400281,57.659558313138625,NaN,NaN,NaN,NaN,NaN,NaN,0.0379837430812473,1.2949379719001968,1.2569542288189495,86.95150115473446,77.79060816012314,5401109370,13857392092.316496,28.669510808879433,22.337263824833535,10.001408996142972,35.714285714285715,57.142857142857146
2018-08-08,181.55,182.35,181.06,182.02,164.94678872672566,171.92459657093238,176.00828311087946,178.95290507634644,165.11325,170.0807,176.35840000000036,179.50350000000012,179.50350000000012,183.13072635078785,175.87627364921238,22680749,61.8666144308643,57.72061749601355,NaN,NaN,NaN,NaN,61.8666144308643,NaN,0.12359847991265727,1.411452328709771,1.2878538487971138,89.49191685912244,85.25789068514239,5423790119,13868468737.176962,28.131977778428297,21.368208964268465,10.949076939575335,28.571428571428573,50
2018-08-09,181.94,182.63,181.64,181.91,165.11557689859904,172.12232733190402,176.23972298888418,179.23453316431343,165.2841,170.2288,176.59300000000036,179.62600000000015,179.62600000000015,183.40152857224226,175.85047142775804,18852898,61.44057000195858,57.762790793152476,NaN,NaN,NaN,NaN,NaN,NaN,0.15201984104189625,1.477878650099484,1.3258588090575878,88.22170900692828,88.2217090069284,5404937221,13859899238.086054,28.137199291849434,20.628573453359703,11.867973549362636,21.428571428571427,42.857142857142854
2018-08-10,180.68,181.22,179.84,180.52,165.26885474040404,172.2886178797871,176.4075769893201,179.35695857723596,165.44675000000004,170.3575,176.80200000000033,179.67150000000012,179.67150000000012,183.46704093639516,175.87595906360508,33818464,56.17607485669312,57.319675453579876,NaN,NaN,NaN,NaN,NaN,NaN,0.061070513931580805,1.4021969514720638,1.341126437540483,72.17090069284068,83.29484218629715,5371118757,13859409115.419388,26.10271149394639,25.424480823089755,11.577757102508242,14.285714285714286,35.714285714285715
2018-08-13,180.85,182.01,180.241,180.32,165.418617379803,172.4476551494943,176.5610053426801,179.4486768079754,165.61120000000003,170.4915,176.95360000000034,179.7285000000001,179.7285000000001,183.52704327339924,175.92995672660098,26089195,55.43999563312678,56.68480488230654,NaN,NaN,NaN,NaN,NaN,NaN,-0.02412650607052602,1.3109683049523255,1.3350948110228515,69.86143187066958,76.75134719014618,5345029562,13835650102.901014,27.260434955080694,23.838166510601123,11.234646244904003,7.142857142857143,28.571428571428573
2018-08-14,181.01,181.66,180.04,181.45,165.5781336247801,172.62591940395976,176.7527306233593,179.63927901673964,165.78365000000002,170.67800000000003,177.09660000000034,179.7875000000001,179.7875000000001,183.65390336745867,175.92109663254155,20913021,58.73031079167394,55.87823251044042,NaN,NaN,NaN,NaN,NaN,NaN,-0.016319440782896155,1.3146955100442312,1.3310149508271274,85.88516746411473,75.97250000920833,5365942583,13851141229.56768,25.680248837419086,23.17556788079341,10.404753715392417,0,21.428571428571427
2018-08-15,180.09,180.58,178.12,179.23,165.7139730912002,172.75669327714868,176.84987844205108,179.60030006276443,165.92360000000005,170.8852,177.18440000000035,179.7525000000001,179.7525000000001,183.62577703629506,175.87922296370516,58528016,50.79486548915456,55.299735444466116,NaN,NaN,50.79486548915456,NaN,NaN,NaN,-0.1643804543696905,1.1255393828650142,1.2899198372347047,59.33014354066972,71.69224762515134,5307414567,13845431179.226215,22.75975111391668,27.09705888084161,10.110568102267631,71.42857142857143,14.285714285714286
2018-08-16,180.57,180.99,179.47,179.82,165.85433156790467,172.89656073700712,176.96635379726476,179.6212238663107,166.06480000000002,171.03940000000003,177.26360000000034,179.79200000000012,179.79200000000012,183.65108590211102,175.9329140978892,27711761,52.62686295507083,55.40125718331816,NaN,NaN,NaN,NaN,NaN,NaN,-0.2226726655031248,1.0115790053557987,1.2342516708589235,66.38755980861235,70.53429027113226,5335126328,13830481413.423584,22.792319436125254,25.4496814466456,9.848102988612002,64.28571428571429,7.142857142857143
2018-08-17,179.36,180.31,178.2679,179.86,165.99369145280113,173.03445062340302,177.07983011894066,179.64396445047157,166.20335000000003,171.24720000000002,177.37220000000033,179.8355000000001,179.8355000000001,183.67701779898317,175.99398220101705,36092641,52.75529112248471,55.97573330557889,NaN,NaN,NaN,NaN,NaN,NaN,-0.25623595539159316,0.913956726619432,1.170192682011025,64.53265044814366,63.41678459914191,5371218969,13850667205.150778,21.183119885361375,27.808955200025736,9.300135697221654,57.142857142857146,0
2018-08-20,180.28,180.3251,179,179.7,166.13007263237526,173.16644170016733,177.1825818789822,179.64930116947428,166.34135000000003,171.47170000000003,177.47740000000033,179.84250000000011,179.84250000000011,183.68249414060756,176.00250585939267,24938956,52.14632030191464,56.23837643138247,NaN,NaN,NaN,NaN,NaN,NaN,-0.28471971259585116,0.814293041266211,1.0990127538620622,57.1637426900584,62.694650982271476,5346280013,13852076855.595573,20.24071429099488,26.501438742936482,8.742873545472236,50,0
2018-08-21,180.26,181.44,180.13,180.36,166.27166394946605,173.30888839917392,177.30718651117897,179.7169867723815,166.48410000000004,171.674,177.58640000000037,179.84550000000013,179.84550000000013,183.68701259270048,176.00398740729977,26258657,54.48051171464451,56.53783049314013,NaN,NaN,NaN,NaN,NaN,NaN,-0.25554713335235957,0.7795788371716128,1.0351259705239724,66.8128654970763,62.83641954509278,5372538670,13835038795.710077,22.973481276369917,24.849245021548473,7.795625661966743,42.857142857142854,7.142857142857143
2018-08-22,179.96,181.27,179.75,181.06,166.4188115718594,173.4623757576061,177.45435566760332,179.84489279405943,166.62305000000003,171.92950000000002,177.69100000000034,179.7575000000001,179.7575000000001,183.39779051037203,176.11720948962818,18042380,56.882723206709784,56.581769994234776,NaN,NaN,NaN,NaN,NaN,NaN,-0.18863080406010313,0.7993374654488434,0.9879682695089466,65.18847006651893,63.05502608455121,5390581050,13848095781.236393,21.700726288732675,24.857597005665575,8.101565737257395,35.714285714285715,0
2018-08-23,180.77,182.045,180.5,180.8,166.56190797412947,173.6076752475545,177.5855574061287,179.9358553851014,166.7581,172.16490000000002,177.79060000000035,179.79500000000013,179.79500000000013,183.46192514238433,176.12807485761593,25776166,55.70679175079406,56.45202266789588,NaN,NaN,NaN,NaN,NaN,NaN,-0.16240031751718176,0.7849678726124694,0.9473681901296511,59.42350332594262,63.80827962984595,5364804884,13832329776.789791,23.328033013874037,23.436325351963365,8.101548504405326,28.571428571428573,57.142857142857146
2018-08-24,181.4,182.63,181.36,182.48,166.72029694951127,173.78336484661284,177.77749633137853,180.17815487223461,166.9011,172.39230000000003,177.88820000000032,180.03800000000012,180.03800000000012,183.740143163069,176.33585683693124,23136113,61.27722212444314,56.54952031596689,NaN,NaN,NaN,NaN,NaN,NaN,-0.03886956346207138,0.8987812358020619,0.9376507992641333,96.67405764966728,73.76201034737628,5387940997,13850000666.246483,23.915285800992336,21.843228874978408,7.943235867464181,21.428571428571427,50
2018-08-27,183.43,184.34,183.11,184.34,166.89561737787434,173.99240712687794,178.0348494164225,180.57452107487893,167.05030000000002,172.62920000000003,178.03540000000032,180.49950000000013,180.49950000000013,183.91978346776474,177.0792165322355,29343552,66.32648933411431,56.90361740811766,NaN,NaN,NaN,NaN,NaN,NaN,0.15074719808262693,1.126084796867417,0.9753375987847901,100,85.36585365853664,5417284549,13879344218.246483,28.62580933155799,20.330545193974324,8.266784555360879,100,42.857142857142854
2018-08-28,184.8,185.02,184.22,184.61,167.07187989152735,174.20265649070214,178.29269845891574,180.95885240108095,167.2049,172.90900000000005,178.1976000000003,180.9075000000001,180.9075000000001,184.24397044043351,177.5710295595667,20277036,66.99919014399543,57.2702299590556,NaN,NaN,NaN,NaN,NaN,NaN,0.270031696028491,1.3128772188204039,1.042845522791913,94.05797101449281,96.91067622138671,5437561585,13878837292.346483,30.377918872097187,19.698671959496714,8.814048747920893,100,35.714285714285715
2018-08-29,184.91,186.84,184.86,186.74,167.26758257917385,174.45092071860904,178.62396518601707,181.5094378866923,167.3702,173.19910000000004,178.41240000000033,181.38850000000014,181.38850000000014,185.14897483701876,177.62802516298152,29175591,71.78743781384797,58.009291945619125,NaN,NaN,NaN,NaN,71.78743781384797,NaN,0.4570656010661833,1.614177524124642,1.1571119230584588,98.85321100917437,97.63706067455571,5466737176,13905065853.952543,34.750321164533325,18.01763140076701,9.979235836523133,100,28.571428571428573
2018-08-30,186.41,187.5199,185.79,186.41,167.45805439430646,174.6877341697257,178.92929988460463,181.9761580879597,167.5329,173.45110000000005,178.59560000000033,181.73250000000013,181.73250000000013,185.97751060067554,177.48748939932472,29315453,70.09063634710142,59.003189194934,NaN,NaN,NaN,NaN,NaN,NaN,0.5187256976328227,1.8055190450994871,1.2867933474666644,88.1924275790167,93.70120320089462,5437421723,13896763847.810743,35.053282223653824,16.81859652623418,12.39616860125325,100,21.428571428571427
2018-08-31,186.18,187.18,185.98,186.65,167.64901902719893,174.92461072082025,179.23207243814954,182.4212858891064,167.6996,173.71480000000003,178.81440000000035,182.06100000000015,182.06100000000015,186.73846469786997,177.38353530213033,28653248,70.63426880927028,60.08849442180139,NaN,NaN,NaN,NaN,NaN,NaN,0.5337653833773219,1.9540000766883168,1.4202346933109948,90.74564623027904,92.59709493949003,5466074971,13900106726.744078,33.39317273571288,16.022074491894944,14.428735362229101,92.85714285714286,14.285714285714286
2018-09-04,186.1,186.4,184.85,185.85,167.8301233154855,175.14095506298224,179.4915990092025,182.74783009014388,167.8659,173.95120000000003,179.02500000000038,182.29650000000015,182.29650000000015,187.2319321999009,177.3610678000994,29063537,66.30786846155229,60.62974854107842,NaN,NaN,NaN,NaN,NaN,NaN,0.4512089639786099,1.9842458982842572,1.5330369343056474,82.2349173927381,87.05766373401127,5437011434,13908544527.808594,31.02001813268972,19.34486485232721,15.718339603395664,85.71428571428571,7.142857142857143
2018-09-05,185.55,185.55,182.82,183.45,167.98554497403788,175.30549060628954,179.64683042060634,182.81470341489208,168.01045000000002,174.17200000000005,179.26660000000032,182.37900000000016,182.37900000000016,187.3336014975782,177.42439850242212,42623326,55.35402785460464,60.95540299575343,NaN,NaN,NaN,NaN,NaN,NaN,0.20867228194242227,1.7938772867336752,1.585205004791253,56.01059230436647,76.33038530912786,5394388108,13885593506.116285,27.479751615742675,24.783294789871334,15.465472847272435,78.57142857142857,0
2018-09-06,183.54,183.75,180.58,181.81,168.12310174046536,175.43429277250164,179.7316606001904,182.71901737537854,168.14974999999998,174.36410000000004,179.4614000000003,182.36850000000015,182.36850000000015,187.3269887818572,177.4100112181431,46091403,49.35415114451786,60.721637866428225,NaN,NaN,NaN,NaN,NaN,NaN,-0.07339693757617516,1.4934588328210339,1.566855770397209,38.28469520103763,58.84340163271407,5348296705,13875270195.034266,24.348822782174498,30.010576499068154,15.815973538004073,71.42857142857143,7.142857142857143
2018-09-07,180.53,182.67,180.44,181.11,168.25232460871945,175.5466830146303,179.7857131256731,182.5657776253425,168.28615,174.51420000000005,179.68900000000033,182.32850000000013,182.32850000000013,187.31397199368973,177.34302800631053,46629495,47.011867544980184,60.311393325177896,NaN,NaN,47.011867544980184,NaN,NaN,NaN,-0.3053019606757954,1.1852283195524649,1.4905302802282603,24.765548891419055,39.68694546560772,5301667210,13856660217.209154,22.414127734242943,28.124848939112297,15.65706906487073,64.28571428571429,0
2018-09-10,182.12,182.25,180.725,181.72,168.3863313290307,175.6689269153307,179.86156751290162,182.48522737530988,168.41725,174.66700000000003,179.89960000000036,182.38850000000014,182.38850000000014,187.3139899248567,177.46301007514356,26131977,49.27123345565296,60.10602997901634,NaN,NaN,NaN,NaN,NaN,NaN,-0.40931120826042244,0.9788912699027321,1.3882024781631546,25.354251663470535,29.468165251975744,5327799187,13864628328.228827,21.17502275820441,26.570042047495235,15.507459452096459,57.142857142857146,0
2018-09-11,180.97,183.42,180.52,183.12,168.53293499739854,175.81647291700733,179.98934917906234,182.54568191099466,168.5544,174.84910000000002,180.12900000000033,182.52850000000015,182.52850000000015,187.36929859112163,177.68770140887867,30116460,54.10772497104175,60.079402354473295,NaN,NaN,NaN,NaN,NaN,NaN,-0.37635666742494567,0.9177566438819724,1.294113311306918,43.37250157659689,31.1641007104955,5357915647,13888513796.504688,23.124590065578428,23.867871326608054,15.340272031222531,50,7.142857142857143
2018-09-12,182.87,182.98,181.01,182.58,168.6727067884692,175.95040414637353,180.09094332890302,182.54895030042374,168.68599999999998,175.05190000000002,180.32460000000032,182.58500000000015,182.58500000000015,187.40043975144863,177.76956024855167,36203973,52.046533466055294,59.73396023014083,NaN,NaN,NaN,NaN,NaN,NaN,-0.3822318837547547,0.8163234566134747,1.1985553403682294,30.226415627339538,32.98438962246899,5321711674,13910015648.48946,21.417856653576024,22.106279300501917,14.968931917088215,42.857142857142854,0
2018-09-13,183.67,184.88,183.6401,184.53,168.83049080052425,176.12029713357404,180.26502398267152,182.7376217003834,168.8277,175.27830000000003,180.5992000000003,182.85000000000016,182.85000000000016,187.47741396460106,178.22258603539927,31133188,58.23393331653928,59.91447034197977,NaN,NaN,NaN,NaN,58.23393331653928,NaN,-0.2523596843833835,0.8831057348889999,1.1354654192723834,57.76917753075606,43.78936491156417,5352844862,13923572232.247183,26.29675951757468,20.343688835055893,15.864087683871109,35.714285714285715,71.42857142857143
2018-09-14,184.66,184.945,183.26,183.99,168.9813316880812,176.2761328338993,180.41110147354715,182.8568958241564,168.96470000000002,175.53360000000004,180.8206000000003,183.05850000000015,183.05850000000015,187.49277682940354,178.62422317059676,31224132,56.07613868682374,59.54296438214981,NaN,NaN,NaN,NaN,NaN,NaN,-0.20254255414782096,0.8822872265876072,1.0848297807354281,50.14195115750232,46.045848105199305,5321620730,13919402837.766472,24.740436050252452,20.47473053210639,16.214515725112868,28.571428571428573,64.28571428571429
2018-09-17,183.66,183.81,181.17,181.34,169.1043035120804,176.37640743124783,180.44752886674138,182.71242955518912,169.10209999999998,175.76050000000004,180.9352000000003,183.13250000000014,183.13250000000014,187.3969431054749,178.86805689452538,33071197,46.893218282305014,58.154873592734866,NaN,NaN,46.893218282305014,NaN,NaN,NaN,-0.3397075218122231,0.6601953784701493,0.9999029002823724,12.712043955423162,40.20772421456052,5288549533,13890590810.077078,22.35580184449265,25.644760073022642,15.493638082541734,21.428571428571427,57.142857142857146
2018-09-18,181.52,183.73,181.4,182.84,169.24097710897513,176.50439936330233,180.54135126412407,182.7245791213616,169.24055,175.96900000000002,181.04820000000032,183.28950000000015,183.28950000000015,187.25782193752153,179.32117806247877,31877347,51.7133596610508,57.06302855823882,NaN,NaN,NaN,NaN,NaN,NaN,-0.3212612647345229,0.5983263193642188,0.9195875840987416,33.8987838811283,32.250926331351266,5320426880,13898115505.720856,20.54812767981765,23.57114309583906,14.459787334493232,14.285714285714286,50
2018-09-19,182.86,183.3,181.51,182.7,169.37489773475647,176.62708452442504,180.62600415572706,182.72223825266047,169.3816,176.17510000000001,181.1558000000003,183.40650000000014,183.40650000000014,187.15429014885132,179.65870985114896,31843377,51.245850678623285,55.5957723342942,NaN,NaN,NaN,NaN,NaN,NaN,-0.31017663921004934,0.53186678508618,0.8420434242962294,31.921354821395614,26.177394219315698,5288583503,13908611367.413593,19.290061941190462,22.127992264229224,12.684213702289094,7.142857142857143,42.857142857142854
2018-09-20,183.95,184.97,183.5199,184.72,169.52758531948527,176.78734027641661,180.7865530123652,182.91250127621663,169.54165,176.4129,181.32180000000028,183.58950000000016,183.58950000000016,187.2165951186596,179.96240488134072,33295820,57.2509681420391,54.67865317678975,NaN,NaN,NaN,NaN,NaN,NaN,-0.16573410696188995,0.6348757905938669,0.8006098975557568,63.50148367952515,43.10720746068302,5321879323,13930426661.932592,23.478372134875794,20.420513729174946,10.670811502692358,0,35.714285714285715
2018-09-21,185.27,185.48,183.48,183.71,169.66870387352023,176.92442264718065,180.90119799227244,182.98845353562456,169.69615000000002,176.62220000000002,181.4068000000003,183.73500000000013,183.73500000000013,187.12878549702555,180.3412145029747,38605353,53.690077454095814,53.468353794277284,NaN,NaN,NaN,NaN,NaN,NaN,-0.13826711838492922,0.6277759995745953,0.7660431179595245,54.86577181208064,50.096203437667135,5283273970,13900700540.122593,23.616288692435255,19.027415124971096,8.928500603626981,0,28.571428571428573
2018-09-24,182.05,183.96,181.3,183.89,169.81020930761454,177.06235487198896,181.01840591414413,183.07431510366033,169.84810000000002,176.84290000000001,181.49240000000032,183.80550000000014,183.80550000000014,187.15030178781927,180.460698212181,34945602,54.23637846821469,52.60610450903889,NaN,NaN,NaN,NaN,NaN,NaN,-0.10929984064207321,0.629418317156933,0.7387181577990062,67.5146771037178,61.960644198441194,5318219572,13933806899.912066,21.514086749089305,24.628898738536538,7.754872693930959,0,21.428571428571427
2018-09-25,183.78,184.28,183.18,184.14,169.95279428962832,177.20250626066243,181.1408213684914,183.17580890331172,169.99869999999999,177.0663,181.59160000000028,183.79550000000012,183.79550000000012,187.13504173500763,180.4559582649926,25277520,55.02985561136102,52.5829493488072,NaN,NaN,NaN,NaN,NaN,NaN,-0.07619437036775589,0.6434751948393114,0.7196695652070673,73.4126984126983,65.26438244283224,5343497092,13952650142.093884,21.802996161739166,23.689782002290745,7.682590243567484,0,14.285714285714286
2018-09-26,184.25,185.99,183.905,184.27,170.09525404794047,177.34245663173843,181.26353425600155,183.2800175791868,170.14655,177.2603,181.6716000000003,183.77850000000012,183.77850000000012,187.10471872399972,180.45228127600052,36210571,55.46229958798098,53.01924566619743,NaN,NaN,NaN,NaN,NaN,NaN,-0.04971506191630848,0.6575257378116817,0.7072407997279901,69.00900900900909,69.9787948418084,5379707663,13929117612.738968,26.151092896255886,21.979051527809084,7.5577931969342185,100,7.142857142857143
2018-09-27,185.04,186.49,184.92,185.83,170.25181868427939,177.51052679744657,181.44261134400148,183.52287304783567,170.2962,177.4562,181.78960000000032,183.73300000000012,183.73300000000012,186.9178208740627,180.54817912593754,33113269,60.385279824957216,53.9744894004815,NaN,NaN,NaN,NaN,NaN,NaN,0.06259557751230393,0.78548527161837,0.7228896941060661,88.9447236180905,77.12214367993262,5412820932,13934390426.274,25.873609013326355,20.298270412140752,7.6131892461107205,100,0
2018-09-28,185.25,186.28,184.97,185.79,170.40642745359003,177.67447676185358,181.61309717364847,183.73878990042274,170.4467,177.6534,181.92480000000032,183.7020000000001,183.7020000000001,186.7926672418539,180.61133275814632,28076843,60.20152958921778,54.75522483859327,NaN,NaN,NaN,NaN,NaN,NaN,0.12056519297364565,0.8735961853231231,0.7530309923494775,88.2747068676714,82.07614649825699,5384744089,13941463218.78545,24.67451340014844,19.357560247054742,7.668585295287223,92.85714285714286,7.142857142857143
2018-10-01,186.82,187.53,185.7,186.17,170.5632789217135,177.8427049447872,181.79179924527008,183.9703337194301,170.59759999999997,177.83629999999997,182.06840000000028,183.6780000000001,183.6780000000001,186.6829931780085,180.67300682199172,27371297,61.40312229757964,55.276324647631704,NaN,NaN,NaN,NaN,61.40312229757964,NaN,0.167964670680944,0.9629868307006575,0.7950221600197135,79.14110429447835,85.45351159341341,5412115386,13928151495.107855,27.51826088393289,18.09590258315228,9.031081527763394,100,0
2018-10-02,185.95,187.175,185.32,185.75,170.71439057423376,177.9992850448904,181.9470228042791,184.13982574615105,170.74695,177.99759999999998,182.1922000000003,183.67300000000012,183.67300000000012,186.66381995443297,180.68218004556726,25618608,59.27303006110689,55.79250297584967,NaN,NaN,NaN,NaN,NaN,NaN,0.15481727536190337,0.9885437542220927,0.8337264788601894,72.01257861635224,79.80946325950066,5386496778,13914409977.609203,25.690415145793338,18.25460526397646,10.126724939393474,92.85714285714286,0
2018-10-03,186.52,186.97,185.66,185.95,170.86598867797272,178.15672494499157,182.10400230215052,184.31222329413666,170.88844999999998,178.1625,182.30520000000033,183.79800000000012,183.79800000000012,186.94593646693136,180.65006353306887,29128683,59.98489451744467,55.9175716330572,NaN,NaN,NaN,NaN,NaN,NaN,0.14362357288553929,1.0132559449671135,0.8696323720815742,75.15723270440238,75.43697187174432,5415625461,13898177963.418364,24.455039621424664,17.37679568316006,10.42365065193623,85.71428571428571,14.285714285714286
2018-10-04,185.22,185.32,181.06,182.38,170.9805559548088,178.24035415400164,182.11482574128186,184.1282020280284,171.00714999999997,178.28879999999998,182.29640000000032,183.8265000000001,183.8265000000001,186.91162090522852,180.74137909477167,80557283,44.89890342289697,55.11919768563386,NaN,NaN,NaN,NaN,NaN,NaN,-0.10667874015306789,0.7362839468902393,0.8429626870433072,20.401854714064815,55.857222011606474,5335068178,13867543503.685968,20.493482805101095,29.800518061919483,11.071580886176815,78.57142857142857,100
2018-10-05,182.39,182.97,178.43,180.15,171.07179420401468,178.27816892322932,182.03777375142766,183.74932564440664,171.11939999999998,178.4116,182.29840000000033,183.7785000000001,183.7785000000001,187.05511578460073,180.50188421539946,83325630,38.401990913913146,54.51268144503444,NaN,NaN,NaN,NaN,NaN,NaN,-0.407969625190739,0.33300065555488345,0.7409702807456224,18.9010989010989,38.15339543985536,5251742548,13847354474.390814,17.63687379060281,33.721449812847226,12.819182818559748,71.42857142857143,100
2018-10-08,179.37,180.6427,176.93,179.05,171.15117933631305,178.29345270692775,181.92060615333247,183.30177082112982,171.22699999999998,178.51229999999998,182.3270000000003,183.6450000000001,183.6450000000001,187.42510317317885,179.86489682682134,66864481,35.660825861556546,53.36607188792771,NaN,NaN,NaN,NaN,NaN,NaN,-0.6523811878778198,-0.07450620410165243,0.5778749837761674,20.000000000000053,19.767651205054587,5184878067,13856850970.426395,15.70851101238581,34.4518662102743,14.99882127941983,64.28571428571429,100
2018-10-09,179.2,181.02,178.75,179.63,171.2355457110761,178.3199189899589,181.83077846104493,182.9520783619746,171.33739999999997,178.62530000000004,182.4174000000003,183.47050000000007,183.47050000000007,187.63418814873665,179.3068118512635,49097949,38.16705829586247,52.43187243201622,NaN,NaN,NaN,NaN,NaN,NaN,-0.7396288513600991,-0.3466610804239565,0.39296777093614266,25.471698113207452,21.4575990047688,5233976016,13845820153.690712,15.769801467678299,32.13815695991531,16.949845524157848,57.142857142857146,92.85714285714286
2018-10-10,178.53,178.62,171.5,171.73,171.24046565424948,178.18942554461316,181.43466950178828,181.8833089941675,171.40919999999997,178.66800000000003,182.3230000000003,182.92800000000008,182.92800000000008,189.52863209093744,176.32736790906273,114471052,24.288784993974872,50.077430778583064,NaN,NaN,NaN,NaN,NaN,NaN,-1.2632835863118803,-1.1861367119537078,0.07714687435817258,1.4348097317528992,15.635502614986796,5119504964,13738744703.364868,12.525385655653437,43.87287213963712,20.4224656001279,50,100
2018-10-11,171.04,173.4,167.81,169.6,171.22414261291365,178.01933791006635,180.97056481544365,180.713470042342,171.47459999999998,178.68000000000004,182.17260000000027,182.18150000000009,182.18150000000009,190.91952786674,173.44347213326017,143084463,21.969258478190085,47.811657994589794,NaN,NaN,21.969258478190085,NaN,NaN,NaN,-1.6619117734890851,-2.0002428425031837,-0.3383310690140987,9.077079107505032,11.994528984155124,4976420501,13687295728.296888,10.869515048219734,46.79952325181449,24.104097484275776,42.857142857142854,100
2018-10-12,173.99,174.86,170.9328,174.32,171.25494716402895,177.94608369402545,180.70975835209293,180.10456813354753,171.56349999999998,178.74140000000003,182.06840000000028,181.6980000000001,181.6980000000001,191.03205292463443,172.36394707536576,102078388,36.45177558509685,46.54132921722424,NaN,NaN,NaN,NaN,NaN,NaN,-1.5203401641612722,-2.238756274215689,-0.7184161100544167,33.01217038539549,14.50801974155114,5078498889,13761302039.743618,12.864547819972238,41.27066588299627,27.36996788304365,35.714285714285715,92.85714285714286
2018-10-15,173.69,174.04,171.56,172.21,171.2644501773222,177.83249787830218,180.37643449514812,179.3527045017811,171.6409,178.76750000000004,181.91100000000029,181.2415000000001,181.2415000000001,191.45275707246208,171.0302429275381,64885255,33.46189408230548,45.00076053657741,NaN,NaN,NaN,NaN,NaN,NaN,-1.4800126865975725,-2.5684319683013825,-1.08841928170381,22.31237322515216,21.46720757268423,5013613634,13730429216.80007,12.059483314112992,38.68794407259624,30.82176023959247,28.571428571428573,85.71428571428571
2018-10-16,174.02,177.65,173.7,177.22,171.32370937953792,177.8203692074447,180.25265275024034,179.14958978732574,171.7482,178.84420000000003,181.83260000000027,180.96050000000008,180.96050000000008,191.28897418546975,170.6320258145304,71979688,44.99787900034958,44.25330192317517,NaN,NaN,NaN,NaN,NaN,NaN,-1.047502087740415,-2.397796891379329,-1.350294803638914,47.7180527383367,34.347532116294786,5085593322,13786737377.792475,18.42671319182379,34.15145502646572,32.33883947752584,21.428571428571427,78.57142857142857
2018-10-17,178.14,178.2585,175.47,177.29,171.3830754553634,177.80986684690126,180.1364702894466,178.9724859980566,171.84219999999996,178.9199,181.74240000000032,180.69000000000008,180.69000000000008,191.10508713357217,170.274912866428,66987639,45.14099137833709,43.164424176988014,NaN,NaN,NaN,NaN,45.14099137833709,NaN,-0.7047234167015428,-2.2311990745158425,-1.5264756578142997,48.073022312373176,39.36781609195401,5152580961,13807192810.680586,18.633112503588006,32.0752479364169,33.36980619677566,14.285714285714286,71.42857142857143
2018-10-18,176.6,176.68,172.44,173.18,171.4009553015787,177.71818631527944,179.8636675329977,178.42082066490838,171.90794999999997,178.96200000000005,181.5656000000003,180.11300000000008,180.11300000000008,190.84492266091732,169.38107733908285,82486208,38.7635084597497,41.63313695345459,NaN,NaN,NaN,NaN,NaN,NaN,-0.701307631513898,-2.403110197206672,-1.7018025656927742,27.231237322515238,41.00743745774171,5070094753,13753498958.303228,16.728233821188507,35.18296098224633,35.04661981399453,7.142857142857143,64.28571428571429
2018-10-19,174.39,176.07,172.39,173.02,171.41706519907544,177.62515292289766,179.59528841405663,177.90645679205997,171.9715,178.99040000000002,181.3878000000003,179.5785000000001,179.5785000000001,190.6014692460741,168.55553075392612,82923733,38.535264444329506,39.99971853536529,NaN,NaN,NaN,NaN,NaN,NaN,-0.6570987956980723,-2.5231760603153646,-1.8660772646172923,26.904208623805864,34.06948941956475,4987171020,13698967590.40649,15.43856113852817,32.575260045402906,36.120514717237526,0,57.142857142857146
2018-10-22,174.06,175.2485,172.59,173.91,171.44187052047766,177.55158553828582,179.37233592723086,177.52584185948282,172.03145,179.02880000000002,181.25560000000033,179.0795000000001,179.0795000000001,190.17987922775086,167.97912077224936,52909281,40.62938917536308,38.6680299006693,NaN,NaN,NaN,NaN,NaN,NaN,-0.5211329581849753,-2.5174934623485115,-1.9963605041635362,31.837160751565737,28.657535565962277,5040080301,13698599404.700829,14.564961812582819,30.731971350115106,37.46126244132661,0,50
2018-10-23,170.79,174.13,168.82,173.27,171.4600608635575,177.46680166624057,179.13302863596692,177.12052358715113,172.08504999999997,179.03410000000002,181.1146000000003,178.53600000000012,178.53600000000012,189.65648452181162,167.4155154781886,77566972,39.58495438979777,37.2108913201231,NaN,NaN,NaN,NaN,NaN,NaN,-0.4312364217268372,-2.5354060313220828,-2.1041696095952456,31.182181610508344,29.97451699529331,4962513329,13751041105.167871,12.98453493385861,35.10120343795567,39.5379428783232,0,42.857142857142854
2018-10-24,173.12,173.36,165.04,165.34,171.3991647355619,177.22666697978036,178.59212555220353,175.9985689598034,172.09895,178.94450000000003,180.79240000000036,177.5895000000001,177.5895000000001,189.76869779788072,165.41030220211948,102997449,29.474591808639275,36.10915477624756,NaN,NaN,29.474591808639275,NaN,NaN,NaN,-0.8391756498428666,-3.153139171898829,-2.3139635220559622,1.6731734523146193,21.56417193812956,4859515880,13655471356.81691,10.975048832315712,36.70010423784833,42.07035586119855,0,100
2018-10-25,167.99,172.08,167.16,171.06,171.3957899620737,177.10455476235896,178.2967480795681,175.52822905886975,172.14335,178.90670000000003,180.6290000000003,176.85100000000008,176.85100000000008,188.7294273369803,164.97257266301986,83481070,41.15041503293036,36.305470784748785,NaN,NaN,NaN,NaN,NaN,NaN,-0.6647400799221672,-3.144888621958671,-2.480148542036504,37.672090112640824,23.50914839182126,4942996950,13704338324.621788,9.669524476782119,32.33448539959273,43.68754856680213,0,92.85714285714286
2018-10-26,165.24,169.96,164.23,166.66,171.34866767389386,176.89773189577758,177.84040501762425,174.68363581516786,172.1602,178.81470000000002,180.36580000000032,175.8945000000001,175.8945000000001,187.8204221446351,163.9685778553651,130970908,36.18745000735445,36.343086795162925,NaN,NaN,NaN,NaN,NaN,NaN,-0.7787471506126726,-3.4535824803023445,-2.674835329689672,14.472900536033377,17.939388033662937,4812026042,13684452689.375715,8.558504447807872,33.54833616258799,45.25767516018929,7.142857142857143,100
2018-10-29,169.16,169.86,160.09,163.23,171.26788491096954,176.62708373942556,177.26744795810959,173.59281335658045,172.1539,178.7027,180.03320000000033,174.7475000000001,174.7475000000001,186.90997980470738,162.5850201952928,111871933,32.860353816007375,35.96403647517328,NaN,NaN,NaN,NaN,NaN,NaN,-1.003889985158616,-3.9296978111379417,-2.9258078259793256,16.94549379384774,23.030161480840647,4700154109,13644490248.621365,7.2714514679313185,34.875658016138,47.495435367903895,0,100
2018-10-30,162.8,166.035,162.015,165.92,171.21467212578577,176.41506227923892,176.82244999896804,172.8620692273823,172.1634,178.61750000000004,179.7576000000003,173.75600000000009,173.75600000000009,185.39075723854688,162.1212427614533,92583965,37.69818715698036,36.92185091538796,NaN,NaN,NaN,NaN,NaN,NaN,-0.8940360331074948,-4.043352867363694,-3.1493168342561995,32.088504829787745,21.16896638655629,4792738074,13731777121.096489,6.817176060351364,32.69684215939028,48.20347334567832,0,92.85714285714286
2018-10-31,168.55,171.25,168.54,169.82,171.20079479120082,176.28446698658072,176.54784411665557,172.572348348584,172.18355,178.56660000000002,179.5468000000003,172.94950000000009,172.94950000000009,183.25122310829192,162.64777689170825,73828635,43.99858358884249,38.495374137577414,NaN,NaN,NaN,NaN,NaN,NaN,-0.5007142486914158,-3.7752096451204693,-3.2744953964290535,53.55422847235596,34.19607569866381,4866566709,13727690665.284681,14.271985086165307,30.01902715958526,46.29274287085376,28.571428571428573,85.71428571428571
2018-11-01,170.08,172.24,168.78,172.06,171.20934409676101,176.20081417496527,176.3718502297279,172.5235532677665,172.21475,178.52890000000002,179.3668000000003,172.43350000000007,172.43350000000007,181.78400004010183,163.0829999598983,52706823,47.29532174175128,39.26991314876701,NaN,NaN,NaN,NaN,NaN,NaN,-0.05513498938648187,-3.343414133162156,-3.288279143775674,65.88325948757466,50.50866426323946,4919273532,13774913541.382948,15.048590064172828,28.393383053522964,44.73889493410042,21.428571428571427,78.57142857142857
2018-11-02,171.53,172.55,168.22,169.38,171.19114166793753,176.06574854773825,176.09766002464053,172.2241672422649,172.22995000000003,178.46450000000004,179.13840000000025,171.89500000000007,171.89500000000007,180.62585448280655,163.1641455171936,75966781,43.9608789634956,40.019840640280584,NaN,NaN,NaN,NaN,NaN,NaN,0.08598299953626398,-3.1808003943553445,-3.2667833938916084,51.132454522938026,56.856647494289554,4843306751,13739649516.02267,14.02499527887059,27.34178011920725,43.29028411496775,14.285714285714286,71.42857142857143
2018-11-05,169.61,169.66,167.08,168.96,171.16894125333118,175.92504065570384,175.81775178838012,171.91329417157303,172.23415,178.37810000000005,178.86800000000028,171.3905000000001,171.3905000000001,179.55712592506458,163.2238740749356,39573533,43.44394682013687,39.908845484551115,NaN,NaN,NaN,NaN,NaN,NaN,0.1729048719920634,-3.050652303901529,-3.2235571758935926,48.820761207584596,55.2788250726991,4803733218,13757749038.867632,13.438454681771042,28.046225708746846,43.66921891817894,7.142857142857143,64.28571428571429
2018-11-06,168.93,171.19,168.72,170.24,171.15969805678063,175.81246559321465,175.59901642412993,171.7539328218994,172.23780000000002,178.31070000000003,178.58600000000027,170.9210000000001,170.9210000000001,178.1666135695948,163.6753864304054,34410390,45.54552759973188,39.937740928936456,NaN,NaN,NaN,NaN,NaN,NaN,0.3293970237256105,-2.8118108962365795,-3.14120791996219,61.18143459915614,53.711550109892926,4838143608,13765689898.098402,15.443430784215698,26.88691906747234,43.7067225589329,0,57.142857142857146
2018-11-07,172.25,175.58,171.87,175.58,171.20368116069326,175.8078623141411,175.59827068200718,172.1183201721947,172.27365,178.3015,178.4054000000003,171.1135000000001,171.1135000000001,178.63420814484226,163.59279185515794,51169614,53.33601744041079,40.9786344275551,NaN,NaN,NaN,NaN,53.33601744041079,NaN,0.779639854177792,-2.16665810223995,-2.946297956417742,96.93366708385494,68.9786209635319,4889313222,13816859512.098402,21.304877701589913,24.526503225046792,41.669488820236964,0,50
2018-11-08,174.76,175.302,173.63,174.46,171.23608234317393,175.78117197128682,175.55363261604612,172.34133729865235,172.3042,178.28610000000003,178.15980000000027,171.35650000000007,171.35650000000007,178.97926400001603,163.7337359999841,40296538,51.66645999672882,41.91657696701219,NaN,NaN,NaN,NaN,NaN,NaN,0.976358380796436,-1.725849980422197,-2.702208361218633,92.76952872821172,83.62821013707428,4849016684,13816570302.495531,20.593887121813303,23.707999923027483,39.622211783496816,0,42.857142857142854
2018-11-09,172.83,173.25,170.16,171.52,171.23890739448564,175.69679232829105,175.3954509448286,172.2631146987807,172.30715,178.22880000000004,177.86200000000025,171.21650000000008,171.21650000000008,178.71830051720528,163.71469948279488,50602710,47.46617277664576,42.4049186528181,NaN,NaN,NaN,NaN,NaN,NaN,0.885487008731896,-1.5953496003037628,-2.480836609035659,73.78954163976759,87.83091248394476,4798413974,13810511078.320774,19.081652066210832,27.892823461673604,38.41265326375153,85.71428571428571,35.714285714285715
2018-11-12,170.33,170.64,166.18,166.33,171.19006254478927,175.51131129208727,175.03994306463926,171.69805615603968,172.28830000000002,178.13500000000005,177.45560000000026,170.92250000000007,170.92250000000007,178.70128107417403,163.1437189258261,62578371,41.11219542375124,42.51400729810049,NaN,NaN,NaN,NaN,NaN,NaN,0.47351553959813053,-1.8889421845379957,-2.362457724136126,40.28405422853457,68.94770819883796,4735835603,13752142014.787142,17.375292389093346,32.06347539186141,37.24948265077945,78.57142857142857,28.571428571428573
2018-11-13,167.15,169.48,166,166.47,171.1430967483237,175.3322754249172,174.70386686602595,171.20014604594067,172.27715,178.04650000000004,177.0680000000003,170.38500000000008,170.38500000000008,177.82724831619598,162.94275168380418,64128079,41.34030661715548,43.36155835585164,NaN,NaN,NaN,NaN,NaN,NaN,0.22094988597761311,-2.0862703666641096,-2.3072202526417227,41.18786313750802,51.75381966860338,4799963682,13705335888.160706,16.349228194200645,30.475475900902676,35.550148658677244,71.42857142857143,21.428571428571427
2018-11-14,168.09,168.7,164.25,165.2,171.0839614572956,175.13163630759212,174.33116620461317,170.62870356537488,172.25615,177.98480000000006,176.7030000000003,169.78050000000007,169.78050000000007,176.83503180586317,162.72596819413698,75270714,39.832923041279415,43.26745178501943,NaN,NaN,NaN,NaN,NaN,NaN,-0.008949877241881232,-2.3184075991940745,-2.3094577219521932,32.989025177533776,38.15364751452545,4724692968,13662203231.823627,15.119667157318121,31.141077117356698,34.16970579177403,64.28571428571429,14.285714285714286
2018-11-15,164.84,168.54,163.46,168.09,171.05417079602898,174.99219796486753,174.08641458874598,170.3869222734344,172.2568,177.94500000000008,176.4286000000003,169.5260000000001,169.5260000000001,176.43740911825495,162.61459088174524,73254349,44.76826841509336,43.88036738557221,NaN,NaN,NaN,NaN,NaN,NaN,0.05291050607209602,-2.2433195893620734,-2.2962300954341694,51.646223369916044,41.941037228319274,4797947317,13722479448.126778,13.840053165792632,29.821666520572563,32.54503682509779,57.142857142857146,7.142857142857143
2018-11-16,166.49,168.31,165.78,167.5,171.0188059124864,174.84383760912758,173.82812382055985,170.11197729501208,172.27125,177.92270000000008,176.15640000000027,169.25000000000009,169.25000000000009,176.02068681892118,162.479313181079,65390675,43.97520958144027,44.67428565453171,NaN,NaN,NaN,NaN,NaN,NaN,0.07219160955567139,-2.20599058348958,-2.2781821930452515,40.43494286767418,41.690063805041326,4732556642,13745999414.233498,13.239105192959851,28.526782040914078,30.48134846021616,50,0
2018-11-19,166.74,166.9,161.54,162.06,170.92966356509848,174.59069230993694,173.36662876877318,169.34512231453473,172.29095,177.83140000000006,175.76320000000032,168.65750000000008,168.65750000000008,175.7591952201507,161.55580477984947,67280478,37.39705487223437,44.65277620562127,NaN,NaN,NaN,NaN,NaN,NaN,-0.24590611076254332,-2.5855648314984307,-2.3396587207358874,3.703703703703771,31.928289980431327,4665276164,13691773357.337975,11.925442025075112,32.755213524489754,29.133085457971582,42.857142857142854,100
2018-11-20,158.37,161.38,157.13,159.16,170.81255248484874,174.28513404637383,172.80950607195854,168.37511066553142,172.2752,177.7065000000001,175.2840000000003,167.95200000000008,167.95200000000008,175.84051215375305,160.0634878462471,102652794,34.43947507957918,43.9699827406739,NaN,NaN,34.43947507957918,NaN,NaN,NaN,-0.5961337977301095,-3.0848259678985244,-2.488692170168415,11.002710027100267,18.380452199492737,4562623370,13687184173.60621,10.956941057721608,37.359756870617126,30.496781152907626,35.714285714285715,100
2018-11-21,161.29,161.97,159.2323,160.37,170.70864648997463,174.00958683753475,172.32168230443077,167.61271917357604,172.276,177.58220000000009,174.83980000000028,167.7035000000001,167.7035000000001,176.19552278611528,159.21147721388493,42965839,36.68929758320456,43.212409586491994,NaN,NaN,NaN,NaN,NaN,NaN,-0.6844911034568595,-3.3443060494894894,-2.65981494603263,17.56097560975613,10.755796446853386,4605589209,13679928774.048298,11.43365108280306,35.58578702764753,31.971610949448802,28.571428571428573,92.85714285714286
2018-11-23,159.09,160.84,159.09,159.21,170.59423209703957,173.71652571203902,171.80749868464918,166.81246020466403,172.3048,177.46630000000005,174.33340000000032,167.11100000000008,167.11100000000008,176.21511533318443,158.00688466681572,23503729,35.433897756768445,42.60333950029719,NaN,NaN,NaN,NaN,NaN,NaN,-0.7537690610892773,-3.6020262723942267,-2.8482572113049494,11.273712737127429,13.279132791327939,4582085480,13659648413.596869,11.080769868797262,34.73845249980346,33.360230710863746,21.428571428571427,85.71428571428571
2018-11-26,161.44,162.97,160.76,162.89,170.51757307119837,173.50213906427587,171.45779285387863,166.4388925661246,172.33875,177.36600000000007,173.91140000000033,166.92250000000007,166.92250000000007,176.21042091912588,157.63457908087426,42012633,42.191726459217215,42.51389518880292,NaN,NaN,NaN,NaN,NaN,NaN,-0.4968613029095348,-3.469333839941868,-2.972472537032333,31.219512195121872,20.018066847335145,4624098113,13698619408.008633,14.118034766310208,32.42302287128456,33.65440152712986,14.285714285714286,78.57142857142857
2018-11-27,162,163.85,161.18,163.44,170.44714945854963,173.30288878577537,171.14336960470692,166.15328375030322,172.3616,177.24430000000004,173.5534000000003,166.93300000000008,166.93300000000008,176.2046602612432,157.66133973875696,36608063,43.14944278236447,42.34274627327668,NaN,NaN,NaN,NaN,NaN,NaN,-0.24759102686516465,-3.2819613206137888,-3.034370293748624,34.20054200542003,25.564588979223114,4660706176,13723984545.293278,15.031804489680969,30.850519105293706,34.18604012964189,7.142857142857143,71.42857142857143
2018-11-28,164.62,168.7,163.4719,168.7,170.42976488682277,173.21174247318575,171.04755118883605,166.39582815503624,172.40665,177.15940000000006,173.27060000000031,167.0720000000001,167.0720000000001,176.36208202331392,157.78191797668626,70140986,51.43591761196268,42.20702485695896,NaN,NaN,NaN,NaN,NaN,NaN,0.28497057018351013,-2.6781570810192363,-2.9631276512027465,63.669381465991606,43.029811888844506,4730847162,13794125531.293278,22.23178306598326,27.972289884241896,34.50068614756192,0,64.28571428571429
2018-11-29,168,169.26,166.82,168.15,170.4070806590932,173.11150994896425,170.93392173045032,166.5628921402709,172.43399999999997,177.0677000000001,172.9796000000003,166.9885000000001,166.9885000000001,176.20803637662283,157.76896362337737,44885711,50.60531583072225,42.13122884510135,NaN,NaN,NaN,NaN,NaN,NaN,0.5957457876854559,-2.2184454165959266,-2.8141912042813826,68.36228287841195,55.4107354499412,4685961451,13798172603.596558,22.26380289512586,26.726639892068533,34.6492794914796,0,57.142857142857146
2018-11-30,168.38,169.47,167.54,169.37,170.39676144855497,173.03742064304416,170.8725914665111,166.83023574595938,172.45235,176.99720000000008,172.6726000000003,166.8540000000001,166.8540000000001,175.8494308401489,157.8585691598513,36722760,52.43995413010868,42.48649894177726,NaN,NaN,NaN,NaN,NaN,NaN,0.8628176885706669,-1.735669093568049,-2.598486782138716,90.5995558845301,74.2104067429779,4722684211,13831089896.239044,21.84779029423943,25.749863603896706,33.8950421524244,0,50
2018-12-03,173.1,173.31,169.5101,172.33,170.41599765304696,173.02341231347893,170.92974474233418,167.35402281777277,172.4892,176.92590000000007,172.44500000000028,167.0015000000001,167.0015000000001,176.25092868505374,157.75207131494648,50771695,56.64725356471856,43.59614595184637,NaN,NaN,NaN,NaN,56.64725356471856,NaN,1.1975730459150853,-1.1015204747448593,-2.2990935206599445,93.94313967861565,84.30165948051923,4773455906,13855673396.233913,27.471381375940933,23.834789175716427,32.27919733971725,100,42.857142857142854
2018-12-04,171.38,171.91,165.52,165.72,170.3692713082405,172.87879028746946,170.72544102694852,167.1984015970325,172.49134999999998,176.7870000000001,172.0816000000003,166.8395000000001,166.8395000000001,176.0594923535703,157.6195076464299,70594743,46.71001727168363,43.97969671288409,NaN,NaN,NaN,NaN,NaN,NaN,0.9437380995818843,-1.1194208961825893,-2.0631589957644736,53.0902348578492,79.21097680699832,4702861163,13789497729.478045,24.130827280767033,28.061282039375968,30.662224485722337,92.85714285714286,35.714285714285715
2018-12-06,162.46,166.91,161.77,166.89,170.33465169323316,172.7602003807869,170.57503157491132,167.16903001636274,172.50169999999997,176.66410000000005,171.7366000000003,166.67200000000008,166.67200000000008,175.7595664509215,157.58443354907865,71715526,48.4343318235421,44.594083054474275,NaN,NaN,NaN,NaN,NaN,NaN,0.8286430555956759,-1.0273551762698787,-1.8559982318655546,60.32138442521624,69.11825298722704,4774576689,13860655157.999445,21.96024668809699,32.099693309045634,29.528159701739614,85.71428571428571,28.571428571428573
2018-12-07,166.13,167.12,160.86,161.38,170.24555068136019,172.53484987819706,170.21444210138537,166.6176938243282,172.4846,176.47520000000003,171.2788000000003,165.9620000000001,165.9620000000001,174.3463916893179,157.5776083106823,80432176,41.60650401523566,44.36824274019874,NaN,NaN,41.60650401523566,NaN,NaN,NaN,0.3783503275103377,-1.3830603224776326,-1.7614106499879703,26.266996291718158,46.55953852492788,4694144513,13793585516.031393,19.642832243091927,30.24631527281809,28.431790137777572,78.57142857142857,21.428571428571427
2018-12-10,161.11,163.78,159.41,163.07,170.1741521671178,172.34742710833177,169.93426790133105,166.27981822201122,172.4591,176.30660000000003,170.82360000000028,165.3925000000001,165.3925000000001,172.89118221755726,157.89381778244294,73960758,44.204555643366305,44.38462460176488,NaN,NaN,NaN,NaN,NaN,NaN,0.2001921163279614,-1.5111705045780184,-1.7113626209059798,36.711990111248426,41.10012360939428,4768105271,13843513258.846039,18.199033661854248,30.46200581662677,27.617328749462104,71.42857142857143,14.285714285714286
2018-12-11,165.66,165.77,162.23,163.61,170.1088372201813,172.17440874975094,169.6862573953965,166.02554981991491,172.42515,176.15240000000006,170.38000000000028,164.9970000000001,164.9970000000001,171.97774236739133,158.01625763260887,59058296,45.04590258031447,44.93097086662774,NaN,NaN,NaN,NaN,NaN,NaN,0.12809530432324978,-1.5512434905019177,-1.6793387948251675,40.04944375772568,34.3428100535641,4827163567,13830500413.964684,20.48979558894008,28.62641460981259,25.470674454730954,64.28571428571429,7.142857142857143
2018-12-12,166.06,167.6,164.96,165.05,170.05850053142328,172.03333134876578,169.50444337989074,165.93264031325634,172.40895,176.01300000000006,169.9576000000003,164.93300000000008,164.93300000000008,171.88710411195626,157.9788958880439,53779992,47.326869180041555,45.85149901666078,NaN,NaN,NaN,NaN,NaN,NaN,0.18339909891827544,-1.450089921177323,-1.6334890200955985,41.91279887482425,39.558077581266126,4880943559,13780387239.601048,22.219285437745434,26.67530703162236,22.21840324447269,57.142857142857146,0
2018-12-13,166.06,166.82,164.03,165.1,170.00916221767778,171.89603765869123,169.3317201100911,165.85334123580336,172.3984,175.86840000000007,169.5446000000003,164.86450000000008,164.86450000000008,171.7835966895912,157.94540331040895,46377864,47.40849482818267,46.617155962730635,NaN,NaN,NaN,NaN,NaN,NaN,0.22653145292145171,-1.3503247039437838,-1.5768561568652355,42.26441631504917,41.408886315866376,4927321423,13769582360.89137,21.134551363071623,27.000348447548,19.41982346319969,50,7.142857142857143
2018-12-14,163.19,163.81,160.7,161.08,169.92031483242727,171.68185869515278,169.0081232430287,165.398737308584,172.38139999999999,175.67620000000002,169.04720000000026,164.6585000000001,164.6585000000001,171.7680802267018,157.54891977329837,56547419,41.79990663251898,47.071870882427106,NaN,NaN,NaN,NaN,NaN,NaN,-0.00048028824973966877,-1.57745651717741,-1.5769762289276703,12.014388489208743,32.0638678930274,4870774004,13726853603.769186,19.51637619547288,30.727664163548944,17.32560979816252,42.857142857142854,0
2018-12-17,160.41,161.67,156.17,157.43,169.7960330928011,171.3996436714864,168.55407919428248,164.6398099458617,172.3386,175.42230000000004,168.5482000000003,164.12550000000007,164.12550000000007,171.7087037424771,156.54229625752305,74834076,37.465940436902294,46.73431473797604,NaN,NaN,NaN,NaN,NaN,NaN,-0.3612991538374839,-2.028600171224525,-1.6673010173870413,7.351225204200807,20.543343336152915,4795939928,13686307140.772823,17.692800573758692,35.55243794145107,16.912137377098222,35.714285714285715,100
2018-12-18,158.67,159.95,157.04,158.42,169.68283873366877,171.14262102452625,168.15666432391845,164.0474470938749,172.29155,175.20600000000002,168.11360000000025,163.6715000000001,163.6715000000001,171.47621722741513,155.86678277258505,63642120,39.30415492159607,46.45965131934973,NaN,NaN,NaN,NaN,NaN,NaN,-0.49013357760684784,-2.279967989395601,-1.7898344117887532,13.127187864644096,10.830933852684558,4859582048,13683026619.123339,16.798448043257025,33.75529945532583,16.84538856391595,28.571428571428573,92.85714285714286
2018-12-19,158.24,160.72,153.34,154.53,169.5320642189059,170.81365823196137,167.62228533082362,163.1410235611249,172.2215,174.97510000000003,167.62320000000028,163.2950000000001,163.2950000000001,172.0437496249407,154.54625037505951,81856456,34.95604120539262,45.28251729030901,NaN,NaN,NaN,NaN,NaN,NaN,-0.7771240200101999,-2.761239436801503,-1.9841154167913033,5.958938407611406,8.81245049215211,4777725592,13627568315.600304,14.760631217143366,35.74237891411673,18.99618813734668,21.428571428571427,100
2018-12-20,154.16,155.87,150.39,152.29,169.36050139085708,170.44685311845717,167.02101923941876,162.10759274577967,172.13830000000002,174.7469,167.0764000000003,162.9515000000001,162.9515000000001,172.79380719902076,153.10919280097943,99002139,32.711894579408025,44.004415772358,NaN,NaN,NaN,NaN,NaN,NaN,-1.0411287095452915,-3.285526303722918,-2.2443975941776264,8.289703315881345,9.125276529378956,4678723453,13597217294.884975,13.455361578302453,37.34203852720741,21.704317911500063,14.285714285714286,100
2018-12-21,153.06,154.09,146.72,147.57,169.14368048149532,169.99384612601247,166.25823417120625,160.72306010332446,172.02685000000002,174.4581,166.59320000000028,162.31150000000008,162.31150000000008,174.195013411442,150.42798658855816,141129408,28.55231885459348,42.2981561098212,NaN,NaN,NaN,NaN,NaN,NaN,-1.4327816757581795,-4.035374688875351,-2.602593013117171,3.1966904851447695,5.815110736212514,4537594045,13488641481.674664,11.92771100545379,38.756049038957435,24.89965878289785,7.142857142857143,100
2018-12-24,146.14,147.98,143.46,143.5,168.88851948167945,169.46921550965578,165.3657543997864,159.0827686649126,171.87855,174.1219,166.0712000000003,161.5260000000001,161.5260000000001,175.93434813571287,147.11765186428732,56163290,25.536894033284383,40.07598757186162,NaN,NaN,25.536894033284383,NaN,NaN,NaN,-1.8391639324274145,-4.901547928651439,-3.0623839962240247,0.1405975395430301,3.8756637801897216,4481430755,13433472232.205637,11.095682321364121,41.08365439082774,28.49844099986839,0,100
2018-12-26,145.12,152.54,144.09,152.46,168.72505162614036,169.13239936094973,164.8596463841085,158.4520287920638,171.77044999999998,173.85120000000003,165.63400000000027,161.0045000000001,161.0045000000001,175.92358237794414,146.08541762205604,98982064,40.44777756273259,39.628684735507974,NaN,NaN,NaN,NaN,NaN,NaN,-1.3977390074207419,-4.809557755499952,-3.4118187480792104,37.282518641259344,13.539935555315715,4580412819,13530580079.609188,16.235117909690295,35.71735219269955,30.639110031796257,0,92.85714285714286
2018-12-27,150.57,153.18,147.08,153.05,168.5690809631937,168.81393600726756,164.3965229964964,157.9375498594863,171.67715,173.58090000000004,165.25080000000028,160.48500000000007,160.48500000000007,175.74828863646135,145.2217113635388,85824343,41.281584006945174,39.117774177179626,NaN,NaN,NaN,NaN,NaN,NaN,-0.9790333059054568,-4.635610380461031,-3.6565770745555746,39.72659486329747,25.716570348033283,4666237162,13612746335.858368,15.737228543943072,32.62100609781524,31.79325517368147,28.571428571428573,85.71428571428571
2018-12-28,154.01,155.59,151.72,152.97,168.41386622724153,168.50019470019296,163.94842405545734,157.46444987286856,171.58360000000002,173.2992,164.76580000000027,159.69850000000008,159.69850000000008,174.80781669533494,144.58918330466523,77856625,41.19735546725145,39.08854928089504,NaN,NaN,NaN,NaN,NaN,NaN,-0.6370432380974735,-4.452881122177416,-3.8158378840799427,39.39519469759733,38.801436067384714,4588380537,13585184688.248549,18.339433107392004,30.796927903636277,32.08602783835902,21.428571428571427,78.57142857142857
2018-12-31,154.47,154.98,152.71,154.26,168.27303173741822,168.2182106467238,163.5684858572041,157.1592641706906,171.49724999999998,173.02380000000005,164.30520000000027,159.00400000000008,159.00400000000008,173.76855268539887,144.23944731460128,53015313,43.20951720092744,39.01747510643512,NaN,NaN,NaN,NaN,NaN,NaN,-0.2721825779042981,-4.156066106460315,-3.883883528556017,44.73902236951113,41.28693731013531,4641395850,13604569141.90053,17.713747555031702,29.746230603804243,32.09689232739,14.285714285714286,71.42857142857143
2019-01-02,150.99,155.75,150.88,154.88,168.13976774003098,167.95408766362036,163.22776092162746,156.9421913925296,171.41655,172.75240000000005,163.93920000000028,158.2795000000001,158.2795000000001,172.34374896679157,144.21525103320863,58576672,44.197850925812034,38.956899988256374,NaN,NaN,NaN,NaN,NaN,NaN,0.04574885220203395,-3.826697463303475,-3.872446315505509,47.307373653686795,43.81386357359842,4699972522,13642216982.426197,16.419498392223925,30.318383354727036,33.037741429601134,7.142857142857143,64.28571428571429
2019-01-03,152.6,153.26,149.49,149.82,167.9574814938615,167.5949968187962,162.70196637568128,156.26388745038392,171.33015,172.43150000000006,163.47520000000026,157.15400000000005,157.15400000000005,170.09870609940376,144.20929390059635,74820225,38.33431872699053,38.31457495589559,NaN,NaN,38.33431872699053,NaN,NaN,NaN,-0.04498914223530992,-3.928682743299646,-3.883693601064336,27.22602739726023,39.757474473486056,4625152297,13580495258.354578,15.104129325333837,29.955493334601197,34.741015378839386,0,57.142857142857146
2019-01-04,152.18,157,151.74,156.23,167.84079013571363,167.36994737683983,162.4481637727134,156.26066007415687,171.27305,172.18860000000004,163.12160000000029,156.67950000000008,156.67950000000008,169.01482727575254,144.3441727242476,74709320,47.784677979264586,38.34144518097287,NaN,NaN,NaN,NaN,NaN,NaN,0.34497456421573736,-3.4524753957946643,-3.7974499600104017,62.75184275184268,45.761747934263234,4699861617,13633331507.480053,18.91644465683702,26.867761433049253,35.11107110169092,0,50
2019-01-07,156.54,158.86,156.11,158.09,167.7437673482936,167.18618604264498,162.27725538946973,156.43488292423717,171.22889999999998,171.96630000000005,162.81800000000027,156.23950000000008,156.23950000000008,167.68209319384903,144.79690680615113,52059331,50.170986918567344,38.93937948711918,NaN,NaN,NaN,NaN,NaN,NaN,0.724633604984096,-2.891657953780282,-3.616291558764378,80.3404722679847,56.77278080569587,4751920948,13656237613.120052,20.903361636909782,25.772028670638413,34.26230258719236,0,42.857142857142854
2019-01-08,159.56,160.11,157.2,159.52,167.6619388174648,167.03438037843418,162.16912772713758,156.72870359811935,171.2125,171.74700000000004,162.70160000000027,156.1465000000001,156.1465000000001,167.44985043250105,144.84314956749913,49388694,51.9877106882232,39.97664879078496,NaN,NaN,NaN,NaN,NaN,NaN,1.048838344657523,-2.305243627942474,-3.354081972599997,93.0475086906142,78.71327457014718,4801309642,13685599276.56335,21.882708714166647,24.627470298833305,32.28795950691924,0,35.714285714285715
2019-01-09,160.15,161.5229,159.47,160.82,167.59385982425619,166.91132334123745,162.11622075744592,157.11835087448893,171.22404999999998,171.56290000000004,162.49680000000026,156.03400000000008,156.03400000000008,167.10181170782747,144.9661882921727,46491747,53.642411379381805,41.00080996634108,NaN,NaN,NaN,NaN,NaN,NaN,1.310603243514445,-1.7158279182069407,-3.0264311617213857,96.10859828709677,89.83219308189855,4847801389,13700254062.224464,23.414846674952894,23.823653293486423,29.953901325116096,100,28.571428571428573
2019-01-10,159.59,161.37,158.7,161.28,167.53103534839295,166.79981198794562,162.0834277865657,157.5146984102519,171.20845,171.37750000000008,162.38920000000027,155.91750000000008,155.91750000000008,166.70949309673313,145.12550690326702,38943414,54.24333675436334,42.378473934124706,NaN,NaN,NaN,NaN,NaN,NaN,1.4629159437576464,-1.1977862320243275,-2.660702175781974,98.65525469332171,95.93712055701089,4886744803,13736572077.527836,22.391216172558877,24.04290785878209,27.240438862645153,92.85714285714286,21.428571428571427
2019-01-11,160.32,160.86,159.79,160.69,167.46296534492635,166.6788256119467,162.02878355964154,157.817108085466,171.21650000000002,171.18580000000006,162.3384000000003,155.69950000000009,155.69950000000009,165.90498181125807,145.4940181887421,30176643,53.28918458055153,43.848280362777814,NaN,NaN,NaN,NaN,NaN,NaN,1.468298814557826,-0.8253286575846914,-2.2936274721425174,95.38889104185931,96.71758134075925,4856568160,13757159880.69606,21.81798959130125,23.427397125949625,24.135698873453915,85.71428571428571,14.285714285714286
2019-01-14,159.32,159.96,158.59,159.27,167.38144330169325,166.53211619388836,161.92059596906736,157.95547874399304,171.2266,170.98150000000004,162.2054000000003,155.40800000000007,155.40800000000007,164.82541917936925,145.9905808206309,30710234,50.965544129094454,45.44922502524218,NaN,NaN,NaN,NaN,NaN,NaN,1.3249915248114914,-0.6373880661281532,-1.9623795909396446,87.52747344003463,93.85720639173854,4825857926,13756935718.404089,21.001923341880982,24.688468815819988,20.931107884271785,78.57142857142857,7.142857142857143
2019-01-15,159.97,162.6,159.9096,162.38,167.3316776967013,166.4498960712371,161.93861181341765,158.3768617207556,171.23785,170.8017,162.0566000000003,155.4730000000001,155.4730000000001,165.0624902888478,145.88350971115239,40874224,55.538248727251954,47.592178931954145,NaN,NaN,NaN,NaN,NaN,NaN,1.3820746213650044,-0.23478631423338925,-1.6168609355983936,98.81145326850351,93.9092725834658,4866732150,13791125189.742775,24.500812473808033,23.206208444975704,17.019870955576696,100,0
2019-01-16,162.63,163.78,162.29,162.35,167.28210876439582,166.36871001042053,161.9547446834797,158.7552558425884,171.27204999999998,170.61460000000005,161.8624000000003,155.7190000000001,155.7190000000001,165.7394249410841,145.6985750589161,33812190,55.484497424858596,48.66623035067743,NaN,NaN,NaN,NaN,NaN,NaN,1.3582286475831533,0.08092487388054792,-1.2773037737026054,91.43712574850295,92.59201748568036,4832919960,13760036129.138748,26.038645671832793,22.553716467055388,14.853560362080666,100,0
2019-01-17,161.84,164.36,161.57,163.63,167.24576937370531,166.31447812902607,162.02044097040206,159.21951719091334,171.3039,170.44290000000004,161.74740000000028,155.9795000000001,155.9795000000001,166.52441246999857,145.4345875300016,39328959,57.37982983112765,49.81610505240475,NaN,NaN,NaN,NaN,NaN,NaN,1.3654134074928774,0.4294629856634913,-0.935950421829386,95.09078681909874,95.1131219453684,4872248919,13778784342.568855,24.64150286995096,22.72824687669052,12.648204418436142,100,0
2019-01-18,164.84,166.02,163.82,165.25,167.2259109719769,166.29339935419387,162.14709034411177,159.79384888701682,171.33145000000002,170.27060000000006,161.67320000000026,156.5155000000001,156.5155000000001,167.7766819539479,145.25431804605228,57183243,59.717484821853745,51.138971434876346,NaN,NaN,NaN,NaN,59.717484821853745,NaN,1.410256945476144,0.8268707600157938,-0.58338618546035,95.34180278281906,93.95657178347358,4929432162,13795939315.468855,26.755175521785596,21.65627228900277,11.589599284016009,100,21.428571428571427
2019-01-22,164.05,164.14,160.76,161.94,167.1733148429025,166.20719342638805,162.1389691541466,159.99824423111045,171.33790000000002,170.04660000000004,161.50720000000027,156.99800000000008,156.99800000000008,168.32041423018742,145.67558576981273,56711694,53.286465523981335,51.85875345795163,NaN,NaN,NaN,NaN,NaN,NaN,1.1585181601571164,0.8647615147360455,-0.2937566454210709,75.31760435571681,88.58339798587821,4872720468,13778825135.622702,24.424521838259896,25.706484991206025,9.961336519138362,92.85714285714286,14.285714285714286
2019-01-23,162.77,163.51,160.32,162.15,167.1233316106348,166.12685296249919,162.13940173633694,160.20317335195708,171.3655,169.8220000000001,161.23860000000028,157.7270000000001,157.7270000000001,168.38544660351272,147.06855339648746,38106062,53.62766882024568,52.53231187898259,NaN,NaN,NaN,NaN,NaN,NaN,0.9560815628587545,0.9013453081523721,-0.05473625470638227,76.58802177858436,82.41580963904009,4910826530,13784439508.393862,22.898350921049694,24.962075067570677,8.14519508297872,85.71428571428571,7.142857142857143
2019-01-24,162.66,163.44,162.0626,163.2,167.08429348515585,166.06889547809325,162.18099382510803,160.48858541367545,171.39285,169.58660000000003,161.01340000000027,158.71200000000007,158.71200000000007,167.38557042975623,150.03842957024392,32413351,55.38248082321911,53.75003774299893,NaN,NaN,NaN,NaN,NaN,NaN,0.8465864171402799,1.0034967667189676,0.1569103495786877,80.25210084033598,77.38590899154572,4943239881,13805557368.991653,22.25180926579016,24.257263555661154,6.098952362028242,78.57142857142857,0
2019-01-25,164.48,165.65,163.95,165.15,167.06504678381103,166.050699528032,162.29742543980967,160.93252965999207,171.41255,169.37400000000005,160.8860000000003,159.34650000000008,159.34650000000008,167.95420184195208,150.73879815804807,36466069,58.521706537320945,54.51696835428867,NaN,NaN,NaN,NaN,NaN,NaN,0.8565914449120953,1.2276496557188068,0.37105821080671153,91.22098890010086,82.68703717300708,4979705950,13820572809.168125,25.738480737169876,23.012608949312664,5.25784267086725,71.42857142857143,0
2019-01-28,163.03,163.12,161.75,163.11,167.02569308446962,165.9924678542096,162.32929110883674,161.13990778761186,171.4267,169.13860000000005,160.8216000000003,159.8495000000001,159.8495000000001,168.09474705511744,151.60425294488275,33491216,54.223521732593724,54.80643512671912,NaN,NaN,NaN,NaN,NaN,NaN,0.6843875624301609,1.2265426638444126,0.5421551014142517,67.00680272108856,79.49329748717514,4946214734,13853575102.306812,23.90532558799287,25.982101966650312,4.81012962409244,64.28571428571429,0
2019-01-29,163.2,163.24,160.99,161.57,166.97140758114156,165.90489423333415,162.29951498692157,161.18086895069644,171.42350000000002,168.89580000000007,160.7236000000003,160.2795000000001,160.2795000000001,167.91959286592106,152.63940713407914,30784175,51.16828942490982,54.74790503648245,NaN,NaN,51.16828942490982,NaN,NaN,NaN,0.4373548512641382,1.0888486654944245,0.6514938142302863,40.107671601614896,66.11182107426812,4915430559,13838661879.751257,22.750552770366415,26.358680586698018,4.913395786065896,57.142857142857146,0
2019-01-30,163.39,166.28,162.89,165.68,166.95855775446353,165.90044088217903,162.43208302665013,161.60935762205867,171.44505,168.71810000000005,160.7332000000003,160.8505000000001,160.8505000000001,168.31059778755636,153.39040221244383,41346533,57.974092809617325,55.05731085292785,NaN,NaN,NaN,NaN,NaN,NaN,0.5159437232717713,1.2964234683200004,0.7804797450482291,92.19765929778941,66.43737787349762,4956777092,13865372471.8663,26.854824602829595,23.77013074176661,5.2868113570834385,100,21.428571428571427
2019-01-31,166.65,168.99,166.4701,168.16,166.97051240367284,165.94518462708638,162.65670722168346,162.23322832471973,171.47285000000002,168.58160000000007,160.7346000000003,161.5145000000001,161.5145000000001,169.09380465147595,153.93519534852427,37258361,61.46418243797478,55.57308554461438,NaN,NaN,NaN,NaN,NaN,NaN,0.6893074046088798,1.642114000809329,0.952806596200449,92.01923076923066,74.774853889545,4994035453,13878086652.835346,30.66106951988147,22.125678615910978,6.187704712171434,100,14.285714285714286
2019-02-01,167.37,168.6,166.99,167.45,166.97528342453182,165.97498295130248,162.8446794874998,162.73006372236546,171.47960000000003,168.44500000000008,160.7336000000003,162.39600000000013,162.39600000000013,168.229648600993,156.56235139900727,32143672,59.92973095133173,56.047410285384395,NaN,NaN,NaN,NaN,NaN,NaN,0.7078366711089279,1.837602435086609,1.129765763977681,85.19230769230751,89.80306591977588,4961891781,13864310793.406775,29.5888104333645,21.351913697962463,7.08859806725943,92.85714285714286,7.142857142857143
2019-02-04,167.51,169.53,167.33,169.53,167.00070348995936,166.04537932850442,163.10684891936256,163.3776767011878,171.49505000000002,168.32310000000004,160.88300000000027,163.0610000000001,163.0610000000001,168.96332462678185,157.15867537321833,26718781,62.855345117555075,56.89668178456015,NaN,NaN,NaN,NaN,NaN,NaN,0.8047853703593026,2.1357474769268094,1.3309621065675068,100,92.40384615384608,4988610562,13891029574.406775,30.209612811857507,20.30686436683345,7.912488878631307,100,0
2019-02-05,169.75,171.23,169.69,171.03,167.04079599254683,166.14408468833602,163.4175607264464,164.10646939631278,171.52565,168.2022000000001,161.12040000000027,163.7080000000001,163.7080000000001,170.10501680472152,157.3109831952787,28156368,64.84854435950074,57.56170290114934,NaN,NaN,NaN,NaN,64.84854435950074,NaN,0.9069551261412283,2.464656014244042,1.5577008881028138,98.16681943171413,94.45304237467388,5016766930,13911872600.069113,32.94090763259407,19.512141258033225,9.547334811910845,100,0
2019-02-06,171.06,171.37,169.75,170.52,167.07541493789464,166.2307364766858,163.69608775678182,164.71728183475918,171.56675000000004,168.08160000000007,161.3234000000003,164.2580000000001,164.2580000000001,171.0022289403547,157.51377105964548,27970006,63.59895317292528,58.141306883154115,NaN,NaN,NaN,NaN,NaN,NaN,0.8767007931187103,2.653576879501202,1.7768760863824915,92.30769230769236,96.82483724646885,4988796924,13910491365.204916,32.00267694733762,18.758738210554455,10.898677608867432,100,28.571428571428573
2019-02-07,169.03,169.4499,166.95,168.23,167.0869033464728,166.2703258533851,163.87388823690802,165.05182642192497,171.59845,167.91860000000008,161.5038000000003,164.62850000000012,164.62850000000012,171.39066910464996,157.86633089535027,42036193,58.177990379387445,58.19831835088696,NaN,NaN,58.177990379387445,NaN,NaN,NaN,0.6494379688031546,2.588673547386435,1.9392355785832802,71.58371040723972,87.35274071554875,4946760731,13911501955.708256,29.316285656067382,23.767820590687705,11.356765651040366,92.85714285714286,21.428571428571427
2019-02-08,166.73,168.59,166.57,168.56,167.10156102461735,166.31566593549627,164.05765732565672,165.38593819126544,171.64895000000004,167.76430000000008,161.61720000000028,164.99250000000012,164.99250000000012,171.77820519547296,158.20679480452728,29020747,58.72398375660187,58.127353989083254,NaN,NaN,NaN,NaN,NaN,NaN,0.4763296103220558,2.53464759148585,2.0583179811637944,74.57013574660634,79.48717948717949,4975781478,13939660700.322117,27.889710031757282,23.526656944303326,11.210572452742431,85.71428571428571,14.285714285714286
2019-02-11,169.14,169.58,167.98,168.4,167.11448081541718,166.35693987736764,164.22794527367017,165.6729916968592,171.69770000000005,167.6349000000001,161.71640000000028,165.3780000000001,165.3780000000001,172.01661913351808,158.73938086648212,21434088,58.32639114138127,58.487348676040384,NaN,NaN,NaN,NaN,NaN,NaN,0.31388254127506476,2.4506711577576255,2.1367886164825607,73.1221719457014,73.09200603318249,4954347390,13929479508.522118,29.24417328711904,22.589016206727226,11.945025377790959,78.57142857142857,7.142857142857143
2019-02-12,169.59,171.14,169.33,170.89,167.15204817048766,166.44670344415243,164.48920232176152,166.16984963049165,171.74220000000003,167.51540000000008,161.76020000000025,165.95900000000012,165.95900000000012,172.38830136172407,159.52969863827616,29722073,62.57325997442654,59.12631947276759,NaN,NaN,NaN,NaN,NaN,NaN,0.3350349130057122,2.555582257739701,2.2205473447339887,95.37572254335242,81.02267674522005,4984069463,13950991064.118803,31.140068034029824,21.042385978272875,13.019222467693096,71.42857142857143,0
2019-02-13,171.62,172.16,170.82,171.01,167.19043575088082,166.53706575218902,164.74491987777088,166.63081633234958,171.7868,167.39850000000007,161.81740000000025,166.39050000000012,166.39050000000012,172.95798193753683,159.8230180624634,26094136,62.77016889205533,59.65401147768447,NaN,NaN,NaN,NaN,NaN,NaN,0.3181435394395846,2.6182267690334697,2.300083229593885,89.7045658012533,86.0674867634357,5010163599,13932296757.730743,32.70557908022389,20.310003258005473,14.381296835346589,100,21.428571428571427
2019-02-14,170.38,171.83,169.83,171.22,167.23053091753872,166.6297971234328,164.99884458844653,167.06788144355437,171.83820000000003,167.2635000000001,161.85440000000023,166.83400000000012,166.83400000000012,173.4479803446849,160.22001965531533,30326830,63.13568980379103,59.983581711003765,NaN,NaN,NaN,NaN,NaN,NaN,0.28331103332864904,2.6542220212546965,2.3709109879260475,91.58460161145928,92.221629985355,5040490429,13944124221.430742,30.972836804818577,21.856489906345512,15.214498049824709,92.85714285714286,14.285714285714286
2019-02-15,172.51,172.5623,171.1392,171.94,167.27739130641893,166.73494965564205,165.27104676144862,167.53189273464443,171.88400000000001,167.1458000000001,161.84660000000022,167.2495000000001,167.2495000000001,174.0476835073729,160.45131649262729,32521685,64.42530525983429,60.71228053437809,NaN,NaN,NaN,NaN,NaN,NaN,0.2709606358385752,2.7096117827242665,2.4386511468856913,94.6225037373729,91.97055705002849,5073012114,13948203429.337776,31.77204616280111,21.00378304349219,16.37455896412428,100,7.142857142857143
2019-02-19,171.39,172.8,171.38,172.28,167.32716850735008,166.84475263275806,165.54590767276434,167.98409342658306,171.93630000000002,167.02970000000008,161.97780000000023,167.6010000000001,167.6010000000001,174.67084271394242,160.5311572860578,19487679,65.04713009331553,61.70362629640708,NaN,NaN,NaN,NaN,NaN,NaN,0.24848073037621665,2.749252059855962,2.5007713294797456,94.75277497477286,93.65329344120168,5092499793,13953418442.027916,31.167185253505586,20.158662489145105,17.381784275914274,100,0
2019-02-20,172.43,173.08,171.32,172.25,167.3761519052869,166.95178723408958,165.80881325422456,168.39037024309897,171.98855,166.91080000000008,162.08500000000024,168.11650000000012,168.11650000000012,174.9599619163024,161.27303808369783,32592995,64.93926987312022,62.20113894380014,NaN,NaN,NaN,NaN,NaN,NaN,0.19665140588910024,2.746585586841121,2.549934180952021,87.44307780753095,92.27278550655889,5059906798,13955270316.743824,30.389487908434198,19.131185666409564,18.570450138649058,100,0
2019-02-21,171.77,172.26,170.71,171.62,167.4183792495129,167.04422709084028,166.0367029305295,168.6979540294705,172.02230000000003,166.78430000000012,162.28980000000024,168.5900000000001,168.5900000000001,175.01426960828354,162.16573039171664,25207401,62.59203675392782,62.281699966368215,NaN,NaN,62.59203675392782,NaN,NaN,NaN,0.09040460636042624,2.6629399389025536,2.5725353325421274,77.57296466973881,86.58960581734755,5034699397,13959661283.36963,28.988175658584403,20.063733553745873,18.715043119170954,92.85714285714286,0
2019-02-22,171.98,173.01,171.9,172.89,167.47282323707992,167.15998497022957,166.30545967835187,169.09719650285427,172.05555000000004,166.65490000000008,162.48620000000025,169.0745000000001,169.0745000000001,175.25672120276275,162.89227879723748,27735358,65.3138177618489,62.66627759569087,NaN,NaN,NaN,NaN,NaN,NaN,0.07666713138186498,2.6683692467694584,2.5917021153875934,97.08141321044508,87.36581856257162,5062434755,13981399807.207468,30.05269237331749,19.20833399721089,19.132507532833596,85.71428571428571,35.714285714285715
2019-02-25,174.2,174.66,173.4,173.52,167.5329941501438,167.2859258619082,166.58838282822043,169.51841588353483,172.0928,166.53220000000013,162.68440000000027,169.4930000000001,169.4930000000001,175.68908295618232,163.2969170438179,32608754,66.6116126858818,62.93458242199993,NaN,NaN,NaN,NaN,NaN,NaN,0.08061480522246489,2.6924706219156747,2.6118558166932098,85.90852904820784,86.8543023094639,5095043509,13955002244.445564,33.54183214325819,18.14733892044249,19.859637110288425,100,28.571428571428573
2019-02-26,173.04,174.25,172.81,173.7,167.5943573924309,167.4129372309793,166.86726977613336,169.91666198986485,172.1219,166.4075000000001,162.85740000000024,170.02250000000012,170.02250000000012,175.73749737531682,164.30750262468342,21939717,66.9916186707568,63.087659158518214,NaN,NaN,NaN,NaN,NaN,NaN,0.06653855797294295,2.6950290141593882,2.6284904561864453,88.133498145859,90.37448013483731,5116983226,13960182455.403896,31.993516313936993,19.20095244899443,19.81582836795742,92.85714285714286,21.428571428571427
2019-02-27,172.92,173.8,171.76,173.59,167.6540155278296,167.5352553056134,167.13090625550066,170.2665037051158,172.14175000000003,166.2859000000001,163.02720000000025,170.62350000000012,170.62350000000012,175.03630534352794,166.2106946564723,25162014,66.49356120967705,63.29441687542906,NaN,NaN,NaN,NaN,NaN,NaN,0.02324438896610781,2.65754594239408,2.634301553427972,86.77379480840553,86.93860733415745,5091821212,13980164054.756838,29.888618699365022,21.324016344915723,19.1467604730968,85.71428571428571,14.285714285714286
2019-02-28,173.04,173.81,172.7,173.19,167.7090999504383,167.6472304480765,167.36851777489278,170.54493192367622,172.1604,166.15830000000014,163.26940000000022,170.99900000000014,170.99900000000014,174.91545196572642,167.08254803427386,25085470,64.61239652070071,63.75401731409429,NaN,NaN,NaN,NaN,NaN,NaN,-0.05465355664482363,2.5659846076219424,2.620638164266766,81.82941903584674,85.57890399670374,5066735742,13977226116.82891,28.812569101021623,20.53245008976784,19.59874868440487,78.57142857142857,7.142857142857143
2019-03-01,174.41,174.65,173.18,174.39,167.77557656784685,167.7807506372235,167.64387001901463,170.91112888332609,172.1836,166.0784000000001,163.60860000000022,171.3105000000001,171.3105000000001,175.26502386513013,167.35597613487008,31431156,67.57599786012656,64.38630403577461,NaN,NaN,NaN,NaN,NaN,NaN,-0.04792411139638997,2.5607330250212783,2.6086571364176683,95.95808383233518,88.18709922552915,5098166898,13997538768.665646,30.237008567478135,19.500083874227638,20.534579463594504,71.42857142857143,0
2019-03-04,175.37,175.79,172.47,174.42,167.84169023383842,167.9122209216349,167.90960060650426,171.2453070849141,172.21635000000003,166.0211000000001,163.9286000000002,171.6590000000001,171.6590000000001,175.41473641246213,167.90326358753808,38063458,67.64894055926928,65.05220042276662,NaN,NaN,NaN,NaN,NaN,NaN,-0.06306206362483469,2.529829556886625,2.59289162051146,78.79256965944259,85.5266908425415,5136230356,14004188408.918657,30.683807871645246,17.375230290783588,21.595477752350433,100,0
2019-03-05,174.52,175.085,173.685,174.55,167.9084395847455,168.04366209150353,168.17000842585702,171.5600397434937,172.2442,165.97610000000012,164.3290000000002,171.91000000000014,171.91000000000014,175.73342778143416,168.08657221856612,22319863,67.98504548744408,65.4387565308393,NaN,NaN,NaN,NaN,67.98504548744408,NaN,-0.08458702289889919,2.4871578418878357,2.571744864786735,79.19463087248347,84.64842812142041,5158550219,14009449519.482943,29.23703456663771,16.55597019574519,22.19129347813324,92.85714285714286,0
2019-03-06,174.68,174.75,173.28,173.56,167.9646740167381,168.15289650553316,168.38138064445087,171.75051214887523,172.27035000000004,165.91540000000012,164.75440000000017,172.0365000000001,172.0365000000001,175.90227430793541,168.1707256920648,27194581,62.64721624967757,65.42997419924089,NaN,NaN,NaN,NaN,NaN,NaN,-0.18026985305922194,2.3464075484627074,2.5266774015219293,62.583892617449706,73.52369771645859,5131355638,13992614778.863895,27.75711038324571,17.112519139513065,22.21574861905697,85.71428571428571,7.142857142857143
2019-03-07,173.09,173.18,170.79,171.43,167.99915487229293,168.21778964403745,168.50093434466848,171.7199871823157,172.29020000000003,165.91240000000008,165.23160000000018,172.0820000000001,172.0820000000001,175.89638645130228,168.26761354869794,39407443,53.004617770469174,64.70632619686077,NaN,NaN,NaN,NaN,NaN,NaN,-0.3897588132411496,2.0394788849704923,2.429237698211642,14.173228346456716,51.98391727879662,5091948195,13974312577.303226,25.171503904363906,23.891982511654394,21.16943900239324,78.57142857142857,0
2019-03-08,169.51,171.26,169.3375,171.17,168.03070557008107,168.27624925504662,168.60560358605403,171.66760745066657,172.30405000000002,165.9281000000001,165.7850000000002,172.2290000000001,172.2290000000001,175.643948901506,168.8140510984942,39303225,51.953418947328274,63.81547717453891,NaN,NaN,51.953418947328274,NaN,NaN,NaN,-0.539370122958148,1.7550250445139568,2.294395167472105,28.39984502130935,35.05232199507193,5052644970,14009935916.477478,23.398360034052125,27.098708167537573,20.235443952138873,71.42857142857143,100
2019-03-11,171.86,174.85,171.85,174.73,168.0973652161499,168.40404629950115,168.84577599444407,171.95926388393642,172.33680000000004,165.93220000000008,166.23040000000015,172.53750000000014,172.53750000000014,175.6743575039092,169.40064249609108,30518408,62.8248210638291,63.65674081528988,NaN,NaN,NaN,NaN,NaN,NaN,-0.39859559991317717,1.7961506675806334,2.1947462674938105,83.57225881441295,42.04844406072633,5083163378,14038012851.837479,32.12725858738541,23.908920241251906,19.751003041646307,64.28571428571429,92.85714285714286
2019-03-12,175.17,176.14,174.7715,175.69,168.17291382096434,168.54832261040212,169.11417693583843,172.31457208546627,172.36725,165.96700000000007,166.68320000000017,172.9020000000001,172.9020000000001,175.7077626413996,170.0962373586006,33953500,65.11697177039144,63.66943380795211,NaN,NaN,NaN,NaN,NaN,NaN,-0.2482099416444825,1.8844838404382074,2.13269378208269,93.38478500551282,68.4522962804117,5117116878,14049636684.318296,34.876931271192014,22.801450973197035,19.622527042320876,100,85.71428571428571
2019-03-13,176.6,177.93,176.35,177.01,168.2608450267259,168.71588057851298,169.42381705600164,172.76175569637425,172.40455000000003,165.96490000000009,167.16400000000016,173.20800000000014,173.20800000000014,176.38026480607112,170.03573519392916,42426135,68.03538607837615,64.05824447398415,NaN,NaN,NaN,NaN,NaN,NaN,-0.07614359508403945,2.0375142882276407,2.11365788331168,89.29298807099197,88.75001063030591,5159543013,14042655168.43222,38.183691519062,21.127176092767623,20.377095026152173,100,78.57142857142857
2019-03-14,177.115,177.34,176.66,176.71,168.3449162204898,168.87417997299787,169.70954972047215,173.13777896338624,172.4395,165.95910000000012,167.61300000000017,173.4930000000001,173.4930000000001,176.8433617714904,170.1426382285098,23751477,66.67018558254972,64.15512788974848,NaN,NaN,NaN,NaN,NaN,NaN,-0.002719284069103267,2.110258778225301,2.1129780622944043,85.80157113762003,89.4931147380416,5135791536,14022396555.696928,37.28856278264398,20.631898090886658,20.858791576842723,92.85714285714286,71.42857142857143
2019-03-15,177.43,178.88,177.28,178.35,168.44446929292275,169.06181997353255,170.0483909079046,173.63418096687326,172.48640000000003,166.01080000000013,168.08240000000015,173.84950000000012,173.84950000000012,177.64440961682152,170.05459038317872,38191958,70.19153029626935,64.41083629049045,NaN,NaN,NaN,NaN,NaN,NaN,0.12884155197310587,2.274030002260787,2.145188450287681,94.44589992140422,89.84681971000539,5173983494,14035286341.521929,39.79960457261395,19.093631434282308,21.24276802223264,100,64.28571428571429
2019-03-18,177.95,178.99,177.5915,178.45,168.54402681239614,169.2477245285121,170.3778657742613,174.0928303985996,172.52775000000003,166.06510000000014,168.65500000000017,174.17500000000013,174.17500000000013,178.3560548907952,169.99394510920504,32935125,70.39690812316323,64.65407125137662,NaN,NaN,NaN,NaN,NaN,NaN,0.19137174095333975,2.3844031264793557,2.193031385526016,94.4055944055942,91.55102182153946,5206918619,14042787119.006733,38.22843655586285,18.15421667904904,22.001008242117166,100,57.142857142857146
2019-03-19,179.16,180,178.29,179.05,168.64856385903897,169.44182899329402,170.71794946938832,174.56494178920917,172.57264999999998,166.11650000000012,169.11140000000017,174.5135000000001,174.5135000000001,179.1023790570112,169.924620942989,36893341,71.6586495078862,65.02300612982013,NaN,NaN,NaN,NaN,NaN,NaN,0.2388295788690784,2.491568359112364,2.2527387802432854,91.09026963657689,93.31392132119176,5243811960,14038687858.895622,39.49619509158568,17.049624452487585,23.641911054465478,100,50
2019-03-20,179.06,180.86,178.24,179.76,168.75912541268036,169.6461492112486,171.07253968627504,175.0597092378559,172.60775,166.1814000000001,169.54480000000018,174.88900000000012,174.88900000000012,179.88642693791863,169.89157306208162,50104996,73.11872375395032,65.63060093219511,NaN,NaN,NaN,NaN,NaN,NaN,0.28082814295311653,2.6037739589346813,2.322945815981565,90.45346062052488,91.98310822089866,5293916956,14046719957.491041,38.887490707869524,15.494087486789452,25.51598936662669,100,42.857142857142854
2019-03-21,179.24,182.83,179.2,182.57,168.89654705036514,169.90206704864963,171.5234204828917,175.77497502472679,172.6491,166.35370000000015,170.00580000000016,175.4365000000001,175.4365000000001,181.21901943359236,169.65398056640785,42428481,77.95852665404261,66.37221013176054,NaN,NaN,NaN,NaN,77.95852665404261,NaN,0.45058033570813105,2.886171235616729,2.435590899908598,98.07300352047419,93.20557792585866,5336345437,14083070529.367073,40.730611141046545,13.637594515385787,27.533496882858422,100,35.714285714285715
2019-03-22,181.76,182.27,178.37,178.56,168.99270081105803,170.07351126550805,171.79936477768027,176.04021549856233,172.6677,166.4287000000001,170.36060000000015,175.7200000000001,175.7200000000001,181.5312270649021,169.9087729350981,70794543,61.06278879707632,65.90177072017532,NaN,NaN,NaN,NaN,NaN,NaN,0.25524390650404527,2.7546457830386544,2.499401876534609,68.35278858625156,85.62641757575021,5265550894,14019173916.197842,35.43954922758097,14.433165801546682,28.56405750233676,92.85714285714286,28.571428571428573
2019-03-25,177.92,178.84,176.93,178.22,169.08451473333605,170.23482787411186,172.05115439424182,176.24781402250878,172.67950000000002,166.5443000000001,170.69940000000017,175.9550000000001,175.9550000000001,181.77148175445186,170.13851824554834,46336524,59.87784184939377,65.32268474602888,NaN,NaN,NaN,NaN,NaN,NaN,0.07494593411234707,2.5930842941750427,2.5181383600626956,65.83287011302568,77.41955407325048,5219214370,14035428089.538155,33.319760638162215,18.079410309896407,28.703973377695434,85.71428571428571,21.428571428571427
2019-03-26,179.58,180.69,178.14,179.05,169.1836737907158,170.40938573799082,172.32561892780097,176.51468887750795,172.70260000000002,166.7025000000001,171.0666000000002,176.22250000000014,176.22250000000014,182.0914040714472,170.3535959285531,33248121,61.825358150424655,65.26398059608223,NaN,NaN,NaN,NaN,NaN,NaN,-0.011978857528790687,2.5031647881517074,2.515143645680498,71.98443579766537,68.7233648323142,5252462491,14025909999.996979,36.426296289367535,16.647715341508896,29.671306273287133,78.57142857142857,14.285714285714286
2019-03-27,179.27,179.72,176.6,177.9,169.27040340473852,170.55771473327812,172.5442221071029,176.64662327012624,172.71990000000002,166.8223000000001,171.43920000000017,176.43800000000013,176.43800000000013,182.22030611433118,170.65569388566908,37096697,57.64993881437061,65.5957892420752,NaN,NaN,57.64993881437061,NaN,NaN,NaN,-0.16215407931995474,2.3124510465305548,2.4746051258505095,63.461182138224906,67.09282934963865,5215365794,14019727217.163645,32.984571204644666,19.738426508489066,31.279602437916132,71.42857142857143,7.142857142857143
2019-03-28,178.36,178.98,177.24,178.31,169.36034963951724,170.71122533261914,172.77033104407926,176.8050401015428,172.7369,166.90720000000007,171.75780000000017,176.69400000000013,176.69400000000013,182.32994677049302,171.05805322950724,30368235,58.72032483383845,66.07913966254021,NaN,NaN,NaN,NaN,NaN,NaN,-0.24417587458290813,2.1693852826218745,2.4135611572047826,58.834244080145695,64.75995400534532,5245734029,14026708420.611921,31.213318822235454,18.678484429471,32.550758730548,64.28571428571429,0
2019-03-29,179.63,179.83,178.59,179.66,169.4628337227061,170.88842879137914,173.04051414038986,177.076941044253,172.75605,166.9832000000001,172.10400000000018,176.95750000000015,176.95750000000015,182.63058690219125,171.28441309780905,35205511,62.11564604563786,66.02848430409799,NaN,NaN,NaN,NaN,NaN,NaN,-0.21863557420847446,2.1402666894441893,2.3589022636526638,60.66265434013759,60.98602685283606,5280939540,14052260807.62805,32.40148702045732,17.78025631347575,33.584360501667284,57.142857142857146,0
2019-04-01,181.42,182.26,180.77,182.04,169.5879796558135,171.10925198362906,173.3934351544922,177.54961332575272,172.78715,167.1098000000001,172.47220000000019,177.33850000000012,177.33850000000012,183.2951644189383,171.38183558106195,30969472,67.23262997390074,66.17960274720579,NaN,NaN,NaN,NaN,NaN,NaN,-0.060785792430360974,2.2829200231147126,2.3437058155450736,87.80864197530836,69.10184679853054,5311909012,14074084932.191809,37.37031925584419,16.333367412488023,34.88695919298014,50,0
2019-04-02,182.23,182.905,181.78,182.73,169.71874602739746,171.3393658057354,173.75957495235525,178.04298348520484,172.81279999999998,167.24750000000006,172.8218000000002,177.74750000000012,177.74750000000012,183.99819876092678,171.49680123907345,22645151,68.55853892865372,66.2169708079399,NaN,NaN,NaN,NaN,NaN,NaN,0.06400495390056848,2.423712007920784,2.3597070540202156,97.22442505947643,81.89857379164079,5334554163,14089684925.102919,38.099648327076466,15.736643909774187,35.799893241060715,100,0
2019-04-03,183.74,184.92,183.2089,183.78,169.85865900224923,171.58571499770105,174.15253279736092,178.58936601042342,172.8468,167.3829000000001,173.2586000000002,178.25850000000014,178.25850000000014,184.7236319398629,171.79336806013737,31633476,70.51384671143884,66.49151803143198,NaN,NaN,NaN,NaN,NaN,NaN,0.18436167888112642,2.5901591526216237,2.4057974737404972,86.29807692307708,90.44371465262061,5366187639,14079167547.686987,41.93485177207974,14.617114907578143,37.196159111347285,100,64.28571428571429
2019-04-04,183.81,184.5,182.65,183.71,169.99648329078406,171.82579984923171,174.52733543275852,179.07704543800213,172.88285,167.46420000000006,173.6898000000002,178.87250000000014,178.87250000000014,184.94769835065716,172.79730164934313,28530828,70.20041314673094,66.49215252075068,NaN,NaN,NaN,NaN,NaN,NaN,0.22373396574249238,2.685464930918613,2.4617309651761206,85.456730769231,89.65974425059483,5337656811,14083331506.368069,39.38581905686962,15.564986172854494,37.781222540961664,92.85714285714286,57.142857142857146
2019-04-05,184.3,184.77,184.0183,184.66,170.14238892968172,172.07994242647464,174.92469482755232,179.60875539628765,172.92615,167.56620000000007,174.1190000000002,179.54700000000014,179.54700000000014,185.0170606943475,174.0769393056528,25674660,72.01825515607656,66.60796302310162,NaN,NaN,NaN,NaN,NaN,NaN,0.27486689751251214,2.8053145870667606,2.5304476895542485,96.87500000000011,89.5432692307694,5363331471,14101491964.957932,38.88280095927362,15.002286612783172,38.403647096032785,85.71428571428571,50
2019-04-08,184.37,185.28,183.63,185.13,170.29151938809284,172.3383594081286,175.32490287353065,180.13458821568884,172.96555,167.70230000000006,174.5186000000002,180.06700000000015,180.06700000000015,185.58363339364027,174.55036660636003,22697543,72.89907863913267,66.69656510390494,NaN,NaN,NaN,NaN,72.89907863913267,NaN,0.29943174500138126,2.904737370805975,2.605305625804594,98.2718894009216,93.53454005671756,5386029014,14120062681.957932,38.42718556644392,14.145060470196032,38.867351051810196,100,42.857142857142854
2019-04-09,184.5,185.11,184.09,184.48,170.4326982996541,172.57878793470033,175.68392629025493,180.5484369570518,173.00940000000003,167.88380000000004,174.94600000000017,180.50650000000013,180.50650000000013,185.95846212384654,175.05453787615372,25631886,69.63441669629373,66.44768602835804,NaN,NaN,NaN,NaN,NaN,NaN,0.2338982530838587,2.8976784421594175,2.663780189075559,90.78341013824873,95.31009984639013,5360397128,14114031649.957932,36.992407834215946,13.61691828428019,39.09384820136963,92.85714285714286,35.714285714285715
2019-04-10,184.75,185.53,184.52,185.47,170.58232319219485,172.83405946074586,176.06769388671552,181.01715724685639,173.06015000000002,168.07380000000003,175.4240000000002,180.92950000000013,180.92950000000013,186.54112534386132,175.31787465613894,24562958,71.71229635680817,66.00152672141272,NaN,NaN,NaN,NaN,NaN,NaN,0.21945610868602383,2.938100324933089,2.718644216247065,99.32810750279953,96.12780234732328,5384960086,14135676236.710407,37.10974169242327,13.085687495290282,38.953032151527644,100,28.571428571428573
2019-04-11,185.77,185.78,184.6899,185.03,170.72608117038197,173.0755632338004,176.4191568715502,181.39933274715577,173.12845000000004,168.27210000000005,175.81100000000018,181.34550000000013,181.34550000000013,186.8772356227345,175.81376437726576,20654094,69.43804524517046,66.59975932484802,NaN,NaN,69.43804524517046,NaN,NaN,NaN,0.14603466806113863,2.9011875513234884,2.7551528832623498,91.83006535947713,93.9805276668418,5364305992,14127909872.954239,36.51725271334297,12.538770904417209,39.43587495814258,100,21.428571428571427
2019-04-12,185.86,185.95,185.0601,185.83,170.8763689199304,173.3281263380816,176.7882095432541,181.82130105695046,173.19725000000003,168.44950000000009,176.16440000000017,181.71950000000015,181.71950000000015,187.40000517118148,176.03899482881883,24989136,71.22487818795189,67.4102619204593,NaN,NaN,NaN,NaN,NaN,NaN,0.11829608100634159,2.903022984520277,2.7847269035139353,98.71657754010721,96.62491680079462,5389295128,14146159608.30248,35.85708963899202,12.079896394104873,40.86087279009259,100,14.285714285714286
2019-04-15,185.81,186.07,184.62,185.86,171.0254597764485,173.576282252179,177.14396603175396,182.2059390515266,173.27790000000005,168.6331000000001,176.53260000000017,182.09000000000015,182.09000000000015,187.83542252578735,176.34457747421294,21073046,71.29265977445183,68.08649775074697,NaN,NaN,NaN,NaN,NaN,NaN,0.07123550227749398,2.8737712813608027,2.8025357790833088,97.78247096092947,96.10970462017127,5410368174,14161128737.530067,33.76004878944531,13.14849313635186,41.33757563324236,100,7.142857142857143
2019-04-16,186.51,186.91,185.93,186.5,171.17943530106098,173.83219745510615,177.51086932462636,182.6148972370955,173.35445000000004,168.87750000000008,176.87200000000016,182.46250000000015,182.46250000000015,188.3358427449621,176.5891572550382,27195709,72.76647107613377,69.16625005515861,NaN,NaN,NaN,NaN,NaN,NaN,0.05329768160707271,2.86915788109215,2.815860199485077,95.7600827300931,97.4197104103766,5437563883,14165568853.28517,35.77695843465866,12.57497776852692,42.970546584843284,100,0
2019-04-17,187.75,187.93,186.6,187.15,171.3383463925927,174.09591631738127,177.88887444915082,183.04681178594356,173.43195000000003,169.15740000000008,177.19440000000017,182.83200000000016,182.83200000000016,188.90520870708164,176.7587912929187,29651575,74.2143904978578,70.27296903116,NaN,NaN,NaN,NaN,NaN,NaN,0.05507047212728011,2.8846982896441773,2.829627817516897,91.64882226980727,95.06379198694329,5467215458,14160441137.307726,37.91457690311825,11.818881858363373,44.92390864111105,100,0
2019-04-18,187.48,187.7905,186.29,187.39,171.49806433893508,174.3591654992153,178.26146760800765,183.46044875871084,173.50490000000002,169.4276000000001,177.53180000000015,183.07300000000015,183.07300000000015,189.45993071825757,176.68606928174273,28580864,74.74823500681069,71.1752968141009,NaN,NaN,NaN,NaN,NaN,NaN,0.04281380036445359,2.883145067972464,2.8403312676080104,92.45810055865893,93.2890018528531,5495796322,14173764905.630285,35.502385090456386,12.38135529292554,46.29170934906676,92.85714285714286,0
2019-04-22,186.54,187.99,186.43,187.92,171.6614666838213,174.62769687546844,178.6402335841642,183.88516792454791,173.59050000000002,169.71470000000008,177.92560000000014,183.54100000000014,183.54100000000014,189.90826283420324,177.17373716579704,17936033,75.93319874749699,71.79676601221493,NaN,NaN,NaN,NaN,NaN,NaN,0.04081578962122645,2.8913510046345436,2.850535215013317,98.87278582930722,94.32656955259115,5513732355,14190091294.643105,33.992001430044795,11.558045454562414,47.01163486269951,100,0
2019-04-23,188.37,190.54,188.13,190.31,171.8470242292559,174.93823753139975,179.09787148282444,184.4970566936386,173.67745000000002,169.98890000000006,178.36060000000015,184.14550000000014,184.14550000000014,190.67095929416706,177.62004070583322,33665561,80.39982811580875,72.642572382726,NaN,NaN,NaN,NaN,80.39982811580875,NaN,0.16396027514662626,3.0554855589466,2.891525283799974,97.08491761723714,96.13860133506778,5547397916,14217331063.916964,40.7916454052286,10.317198340649442,48.30361070324488,100,0
2019-04-24,190.44,190.71,189.65,189.71,172.02476528170112,175.23074767929282,179.5140333854588,184.99352748472063,173.74795000000003,170.25160000000008,178.78680000000014,184.67850000000016,184.67850000000016,191.19349585570072,178.1635041442996,24977108,76.55840239020225,73.07432635978053,NaN,NaN,NaN,NaN,NaN,NaN,0.16789770205469212,3.101397411368339,2.933499709313647,87.59305210918114,94.51691851857517,5522420808,14195181553.04904,39.68549756732324,9.856166251481719,49.15397138130264,100,7.142857142857143
2019-04-25,191.15,191.22,189.45,190.48,172.2083994580026,175.53271307178207,179.94407129191137,185.516048676652,173.81440000000003,170.46940000000006,179.17860000000016,185.30750000000015,185.30750000000015,191.50463441840554,179.11036558159475,29517497,78.01044047810437,73.63218545487862,NaN,NaN,NaN,NaN,NaN,NaN,0.18395957422610865,3.1634491770962825,2.979489602870174,90.25032938076404,91.64276636906078,5551938305,14200017753.122486,38.876846221215914,9.123067706687177,50.4852407108426,100,0
2019-04-26,190.2,190.69,188.59,190.65,172.39189797085828,175.83206528818243,180.36391163340505,186.00499642173276,173.88105000000004,170.69440000000006,179.57140000000015,185.92450000000014,185.92450000000014,191.65138213601804,180.19761786398223,26359537,78.32959478787964,74.08299542857885,NaN,NaN,NaN,NaN,NaN,NaN,0.16806894454736065,3.1895757835543748,3.021506839007014,92.4901185770752,90.1111666890068,5578297842,14225373117.284391,35.50282393116925,11.885452591427125,50.87956369175284,92.85714285714286,7.142857142857143
2019-04-29,190.62,191.32,190.34,191.02,172.57725221990447,176.13281647059466,180.7817974517029,186.48261581013915,173.95405000000002,170.91090000000008,179.96740000000017,186.49250000000012,186.49250000000012,191.8637861588137,181.12121384118655,21716242,79.04254660225756,74.52181456880206,NaN,NaN,NaN,NaN,NaN,NaN,0.14536458843962485,3.203212574556545,3.0578479861169203,95.85062240663923,92.86369012149282,5600014084,14233793700.917046,36.70575835448031,11.388719293181367,51.34042895979238,100,0
2019-04-30,189.48,189.85,188.21,189.54,172.7460357799054,176.39830525335518,181.12525637516552,186.77379525679257,174.00445000000002,171.08300000000006,180.31940000000017,186.86750000000012,186.86750000000012,191.98420939177512,181.75079060822512,31495277,69.23098110544235,74.49299774088409,NaN,NaN,NaN,NaN,NaN,NaN,0.001185727110389223,3.059330145004907,3.0581444178945176,73.82352941176462,87.38809013182636,5568518807,14253382226.85607,32.5101798709254,18.75120359329428,49.9584799948311,92.85714285714286,0
2019-05-01,190.76,191.32,188.795,188.93,172.9070702497571,176.64645762457587,181.43132475261,186.979148089479,174.05105000000003,171.3151000000001,180.65240000000017,187.17750000000015,187.17750000000015,191.99655748044543,182.35844251955487,34797109,65.61573249593513,74.05752889367888,NaN,NaN,NaN,NaN,NaN,NaN,-0.15605424157489,2.8630766159259053,3.0191308575007954,64.32835820895536,78.00083667578642,5533721698,14222305996.83825,35.070520557007114,16.883686158647787,49.04022780031166,85.71428571428571,0
2019-05-02,188.88,189.85,186.87,188.11,173.05834318259534,176.8734584636932,181.693233585841,187.08684827143338,174.09570000000002,171.52730000000008,180.96960000000018,187.39400000000015,187.39400000000015,191.96577602249457,182.82222397750573,44110122,61.00399420879045,73.4550966767946,NaN,NaN,NaN,NaN,NaN,NaN,-0.3262839105486228,2.6112759693150167,2.9375598798636395,52.08955223880619,63.41381328650874,5489611576,14214904969.657042,31.12999513617851,22.244791899371762,46.73787253118356,78.57142857142857,14.285714285714286
2019-05-03,189.69,191.25,189.33,191.11,173.23796165839042,177.15537017728343,182.062518543259,187.47000557891593,174.14990000000006,171.82460000000006,181.35940000000016,187.76400000000015,187.76400000000015,192.2807351040141,183.2472648959862,30386180,69.46080086407447,73.32909115366049,NaN,NaN,NaN,NaN,NaN,NaN,-0.25120440865600635,2.6235543690436316,2.874758777699638,96.86567164179135,71.09452736318431,5519997756,14240859831.740376,32.65162556535544,19.729306461327774,44.95708371633584,71.42857142857143,7.142857142857143
2019-05-06,187.1,190.2,186.76,189.94,173.40415109462535,177.40853116387188,182.3714393846998,187.7052431428287,174.19995000000006,172.09330000000008,181.70040000000014,188.02800000000016,188.02800000000016,192.40317359653417,183.65282640346615,38371777,63.6622735144614,72.78406356366118,NaN,NaN,NaN,NaN,NaN,NaN,-0.2918527749038491,2.509942809069827,2.801795583973676,74.3970315398887,74.45075180682876,5481625979,14273431223.845026,27.938204443745974,25.409837030750026,42.15704834656661,64.28571428571429,0
2019-05-07,187.86,188.67,184.51,186.24,173.53187098423106,177.58341173488432,182.52314764412336,187.565696176845,174.23600000000005,172.3196000000001,181.95480000000015,188.08350000000013,188.08350000000013,192.33667892873456,183.8303210712657,58818134,49.56958754423752,71.12714331138288,NaN,NaN,NaN,NaN,NaN,NaN,-0.5636997703027453,2.097170871095244,2.6608706413979895,25.40381791483139,65.55550703217048,5422807845,14263533941.681564,23.397737165757043,28.01445594526552,39.37091863742753,57.142857142857146,100
2019-05-08,185.68,187.17,184.96,185.77,173.65364341224867,177.7455223935995,182.65047518749105,187.39467749333596,174.26990000000006,172.52680000000007,182.19620000000018,188.14800000000014,188.14800000000014,192.21571483757702,184.08028516242325,37165319,48.112614863192455,69.26273076604964,NaN,NaN,NaN,NaN,NaN,NaN,-0.7587910787547552,1.7123817929545453,2.4711728717093004,18.502202643172083,39.4343506992974,5385642526,14253611978.690615,21.84188174270581,26.15160729039386,36.26439782362159,50,92.85714285714286
2019-05-09,183.76,185.4121,182.09,184.77,173.76425392555961,177.88462096006288,182.73359380758944,187.14470820825636,174.29595000000006,172.72350000000006,182.41980000000018,188.1130000000001,188.1130000000001,192.28304124678345,183.94295875321677,55351668,45.07679525983975,67.14334221269458,NaN,NaN,NaN,NaN,NaN,NaN,-0.9276403243383022,1.3116224662864227,2.239262790624725,29.035752979415058,24.313924512472852,5330290858,14287566755.553804,19.51485709383884,31.67435462114929,34.51213067726098,42.857142857142854,100
2019-05-10,184.06,185.89,181.0302,185,173.876052393962,178.0255195549131,182.8224724818016,186.9404502836605,174.31945000000005,172.96270000000007,182.65600000000018,188.11150000000015,188.11150000000015,192.28599529881393,183.93700470118637,58526402,45.92197742144242,64.99968354654781,NaN,NaN,NaN,NaN,NaN,NaN,-0.9905801904082552,1.001037552614406,1.9916177430226611,38.57995296312851,28.705969528571895,5388817260,14324656679.59998,16.947060731199528,30.376055584357665,33.021131849530306,35.714285714285715,100
2019-05-13,180.3,181.26,178.06,178.58,173.92285784277828,178.0364993657069,182.65610101192703,186.1442169233119,174.29825000000005,173.17420000000004,182.73980000000017,187.74900000000014,187.74900000000014,193.58249260733638,181.9155073926639,67185766,31.397937175451474,61.499548479379435,NaN,NaN,31.397937175451474,NaN,NaN,NaN,-1.405968429181919,0.2341572065452624,1.6401256357271814,3.92156862745106,23.84575818999822,5321631494,14279306287.54998,14.094851037843343,32.46672862077984,31.58046027754227,28.571428571428573,100
2019-05-14,179.51,181.63,178.86,180.54,173.9887000532979,178.0860736356929,182.57311665851813,185.61048197823456,174.30070000000003,173.39540000000008,182.8622000000002,187.48300000000012,187.48300000000012,194.07290773834285,180.8930922616574,43360636,37.85963155971103,58.73535056291577,NaN,NaN,NaN,NaN,NaN,NaN,-1.4824926327932708,-0.21299015526440712,1.2695024775288637,18.702865761689228,20.401462450756274,5364992130,14288541946.481388,13.949972818587487,30.071396619200048,29.89554720158066,21.428571428571427,92.85714285714286
2019-05-15,179.39,183.55,179.31,183.09,174.07926025177252,178.18516128647127,182.59338659347821,185.37043607554554,174.32805000000005,173.6810000000001,183.0330000000002,187.3125000000001,187.3125000000001,194.16647950098147,180.45852049901876,40944547,45.10426822955364,56.3849096880193,NaN,NaN,NaN,NaN,NaN,NaN,-1.3015805766086175,-0.3574732432319081,0.9441073333767094,37.93363499245856,20.186023127199626,5405936677,14320602299.32101,17.066567210354698,27.08029432073748,27.088090867337545,14.285714285714286,85.71428571428571
2019-05-16,183.11,186.07,182.95,184.93,174.18722781145638,178.3187224491154,182.68501849177318,185.32848978263644,174.37715000000003,174.00740000000005,183.2604000000002,187.20150000000012,187.20150000000012,194.13386835431393,180.26913164568631,39281157,49.664428587785345,54.33739781658399,NaN,NaN,NaN,NaN,49.664428587785345,NaN,-1.0111401449749589,-0.3198178478419891,0.6913222971329697,51.80995475113129,36.148818501759706,5445217834,14331177995.436396,21.720912727289708,25.101710703860686,24.04397890236376,7.142857142857143,78.57142857142857
2019-05-17,183.1,185.5813,182.88,183.04,174.27531509691454,178.41221309368737,182.69893933523306,185.1105383747663,174.41010000000006,174.36210000000005,183.49260000000015,186.9840000000001,186.9840000000001,194.1481479604976,179.8198520395026,44702276,45.48481058390676,51.94041667241608,NaN,NaN,NaN,NaN,NaN,NaN,-0.9030101100002521,-0.43744034036734547,0.46556976963290664,37.5565610859728,42.433383609854225,5400515558,14291771217.278175,20.33556086916726,23.66600781817477,20.82460085288037,0,71.42857142857143
2019-05-20,180.51,181.1799,179.34,179.95,174.3317796233134,178.44266431955495,182.5911377926749,184.61905852955044,174.42425000000006,174.72660000000008,183.66820000000018,186.5855000000001,186.5855000000001,194.35788824299576,178.81311175700446,38608294,39.614904884537346,49.824982656637154,NaN,NaN,NaN,NaN,NaN,NaN,-0.9893401087022081,-0.7711053662448535,0.2182347424573546,14.253393665158278,34.539969834087465,5361907264,14278763292.146048,18.586911112502086,29.858101018194567,20.56925255739541,7.142857142857143,64.28571428571429
2019-05-21,181.5,182.33,180.92,181.83,174.4063887812904,178.50974027362318,182.5612892517857,184.3534339076885,174.43575000000004,175.02030000000005,183.81020000000018,186.1615000000001,186.1615000000001,193.9998347083346,178.32316529166562,31613790,44.32279394993482,48.304058474779985,NaN,NaN,NaN,NaN,NaN,NaN,-0.8735996326058509,-0.873764798299959,-0.00016516569410809923,28.582259287338974,26.79740467949003,5393521054,14287955954.486473,20.25865482664461,28.179527745636634,19.23689760531139,0,57.142857142857146
2019-05-22,180.81,182.07,180.75,181.02,174.47219585809347,178.55944838701677,182.5008465360294,184.03596401171816,174.44045000000006,175.30000000000007,183.9168000000002,185.72700000000015,185.72700000000015,193.69273687739081,177.76126312260948,24332550,42.77539482854766,47.002015661905496,NaN,NaN,NaN,NaN,NaN,NaN,-0.8069510100663408,-1.0088539282770341,-0.2019029182106933,22.44124336618657,21.758965439561283,5369188504,14273577629.486473,19.60050167481693,27.682444881308545,19.26874803745785,7.142857142857143,50
2019-05-23,179,179.023,177.14,178.25,174.50978594905772,178.55332069618476,182.3341466718714,183.48491982012595,174.42600000000004,175.55280000000005,183.9416000000002,185.1155000000001,185.1155000000001,193.39922736151198,176.83177263848825,45351309,37.90214735552271,44.747826125580374,NaN,NaN,NaN,NaN,NaN,NaN,-0.897809457695438,-1.3241647403299908,-0.4263552826345528,8.49923430321603,19.840912318913865,5323837195,14281694140.975056,17.772764196863662,33.77712123491639,19.72420924471795,0,100
2019-05-24,179.3,179.85,177.94,178.16,174.54610648687805,178.54553216754744,182.1704546455235,182.97778459916157,174.40780000000007,175.79180000000005,183.97060000000016,184.49100000000013,184.49100000000013,192.8939635248424,176.08803647515785,25903267,37.75165727148012,42.89706782251029,NaN,NaN,NaN,NaN,NaN,NaN,-0.9095497071323907,-1.5632924165500413,-0.6537427094176506,8.846487424111103,13.26232169783791,5297933928,14261758118.728983,18.97517965947696,32.18601155528596,21.230109016979018,0,92.85714285714286
2019-05-28,178.67,179.66,177.47,177.49,174.57539895964544,178.52463054046729,181.98690740452258,182.45513844686047,174.38515000000007,176.01790000000005,183.95340000000016,183.81450000000012,183.81450000000012,192.18447126636985,175.4445287336304,24763823,36.587026760201574,41.969742052221996,NaN,NaN,NaN,NaN,NaN,NaN,-0.9060259566901142,-1.7862751552802933,-0.8802491985901791,3.4895314057828783,6.9450843777033455,5273170105,14237446602.99839,17.932130433195677,31.59647723037875,22.55932212987393,0,85.71428571428571
2019-05-29,176.45,177,175.09,176.03,174.589872601838,178.47523191590358,181.75330319258052,181.84322049954042,174.35575000000009,176.2800000000001,183.90500000000014,183.13900000000015,183.13900000000015,191.72938043394086,174.54861956605944,42178772,34.117084559548516,40.97006131624743,NaN,NaN,NaN,NaN,NaN,NaN,-0.941470685647686,-2.0570875556497867,-1.1156168700021007,8.56102003642986,6.965679622107956,5230991333,14236784109.197344,16.839673356973115,35.71297258302917,24.48313037729154,0,100
2019-05-30,176.54,177.27,175.77,176.77,174.61156541176996,178.4414649472718,181.5578795379695,181.36005664244132,174.33700000000007,176.48540000000008,183.85940000000014,182.53100000000012,182.53100000000012,191.11713277324966,173.94486722675057,30354790,36.45851146303563,40.354469616475704,NaN,NaN,NaN,NaN,NaN,NaN,-0.8569373687552109,-2.1867885809461143,-1.3298512121909034,15.300546448087507,9.117032630100091,5261346123,14246902372.530678,16.885378453220422,34.306243832126995,25.217178395485856,35.714285714285715,92.85714285714286
2019-05-31,174.71,175.29,173.87,173.95,174.60498267135435,178.35252504732583,181.25953132079422,180.65433696220882,174.30515000000005,176.64400000000006,183.74320000000014,181.82300000000012,181.82300000000012,190.77946604414146,172.86653395585878,45446206,31.817842453329718,39.34703140446766,NaN,NaN,NaN,NaN,NaN,NaN,-0.9268732628280072,-2.4884427907259123,-1.5615695278979052,0.655737704917903,8.172434729811766,5215899917,14206576865.798283,15.605541546465973,36.67189922256863,26.068605776018508,28.571428571428573,100
2019-06-03,173.52,173.95,169.27,170.12,174.56035597810705,178.18950474935897,180.82268695527287,179.6510667753318,174.2485000000001,176.75000000000009,183.49420000000012,180.77350000000013,180.77350000000013,190.04468390497377,171.5023160950265,75842290,26.82395431013235,39.02031834265915,NaN,NaN,26.82395431013235,NaN,NaN,NaN,-1.1523046194397097,-3.0019503021975424,-1.8496456827578327,5.059523809523781,7.005269320843073,5140057627,14158284125.584608,13.789133764087852,43.84401075704669,26.97513698750127,21.428571428571427,100
2019-06-04,171.98,174.97,171.37,174.91,174.563835023101,178.12456406125287,180.5908168785955,179.1995366062526,174.22690000000006,176.89090000000007,183.42120000000014,180.0220000000001,180.0220000000001,188.61077313706016,171.43322686294005,47797848,39.59344497365157,39.14416215794061,NaN,NaN,NaN,NaN,NaN,NaN,-0.9106454378786273,-2.9879524801061166,-2.0773070422274893,33.57142857142853,13.095563361956737,5187855475,14204488711.984608,14.621703383732662,38.803382564364796,27.592348891239688,14.285714285714286,92.85714285714286
2019-06-05,176.6,176.61,174.38,176.21,174.58021477411492,178.0866519016241,180.41902013825842,178.91481883422853,174.2088500000001,177.04020000000008,183.38100000000014,179.52050000000014,179.52050000000014,187.76274356591307,171.2782564340872,34412697,42.52485928098023,38.95991866161393,NaN,NaN,NaN,NaN,NaN,NaN,-0.6095392312246979,-2.8392310812583617,-2.2296918500336638,41.30952380952384,26.64682539682538,5222268172,14226556046.832142,17.795260708777036,36.71338115279091,28.451197695147606,7.142857142857143,85.71428571428571
2019-06-06,176.52,178.04,175.73,177.61,174.6103618907904,178.07721325010678,180.3088624857777,178.79055037382582,174.19760000000005,177.2094000000001,183.35220000000012,179.11250000000013,179.11250000000013,186.87055871335542,171.35444128664483,29913205,45.58726720226533,38.66869284836251,NaN,NaN,NaN,NaN,NaN,NaN,-0.2791862362431714,-2.578674645337628,-2.2994884090944567,51.13019808353724,42.00371682149653,5252181377,14245332733.953354,20.295376347845753,34.63247577198963,29.799858857642466,0,78.57142857142857
2019-06-07,178.5,181.7666,178.33,181.04,174.67433838938948,178.13588229465913,180.33753454515897,179.0047836715567,174.20430000000007,177.4271000000001,183.4150000000001,178.9260000000001,178.9260000000001,186.30095328798032,171.55104671201988,45888345,52.29394264439387,39.155059424111585,NaN,NaN,NaN,NaN,NaN,NaN,0.1823666086340543,-2.071530148301889,-2.2538967569359434,90.12251148545161,60.854077792837565,5298069722,14271816742.413168,27.159536750666767,31.20508049408785,29.754328339670206,0,71.42857142857143
2019-06-10,182.23,184.85,182.21,183.15,174.75867333078858,178.23517175417084,180.4478273080939,179.3995661790275,174.21825000000007,177.6348000000001,183.5118000000001,178.83350000000013,178.83350000000013,185.9430324037418,171.72396759625846,41385280,55.89528792513872,40.31794392701168,NaN,NaN,NaN,NaN,NaN,NaN,0.6173026482246988,-1.4822684466550697,-2.0995710948797686,89.08857509627734,76.7804282217554,5339455002,14259902798.170744,31.944834658589173,28.42794221451162,28.50856763206709,100,64.28571428571429
2019-06-11,185.07,185.4,182.78,183.4,174.844656680731,178.3374455808209,180.56359878620788,179.78055987626297,174.22995000000006,177.8453000000001,183.58660000000015,179.0745000000001,179.0745000000001,186.45493758864268,171.69406241135755,41260320,56.316068027037694,41.174606361090454,NaN,NaN,NaN,NaN,NaN,NaN,0.8926479117182264,-0.9837612052319855,-1.876409116950212,87.60074395536267,88.93727684569721,5380715322,14238170263.208912,31.267620884528995,26.670183725485558,27.907323734768642,100,57.142857142857146
2019-06-12,182.88,183.28,182,182.34,174.919237211271,178.416704084171,180.6332615789056,180.02431607852364,174.23765000000006,178.03240000000008,183.59260000000012,179.1645000000001,179.1645000000001,186.65727111620936,171.67172888379082,27758120,53.96516740035331,41.97387583050514,NaN,NaN,NaN,NaN,NaN,NaN,0.9678950500863024,-0.6665403043423339,-1.6344353544286363,81.02913825170488,85.9061524344483,5352957202,14225158644.458912,30.193295768258533,27.66811088986178,26.998143176748915,92.85714285714286,50
2019-06-13,183.12,183.87,182.74,183.42,175.00382191563645,178.51577925082105,180.74254543855636,180.34771454723568,174.24235000000007,178.21410000000006,183.60640000000015,179.1810000000001,179.1810000000001,186.70964370254654,171.65235629745365,23715829,55.981400505603155,43.26525105551089,NaN,NaN,NaN,NaN,NaN,NaN,1.0481437528030062,-0.32425566342487855,-1.3723994162278847,87.72473651580894,85.45153957429216,5376673031,14229985760.096079,30.518559589108428,26.592754799368702,25.27154348945233,85.71428571428571,42.857142857142854
2019-06-14,182.44,183.11,181.94,182.64,175.07980378712264,178.59744698842857,180.81695542135807,180.56602744749895,174.23385000000005,178.42110000000008,183.5836000000001,179.06650000000008,179.06650000000008,186.30602836861001,171.82697163139014,22844089,54.137210853518866,44.435647739942226,NaN,NaN,NaN,NaN,NaN,NaN,1.0062307832247535,-0.11461093719694304,-1.1208417204216965,82.88902665840038,83.8809671419714,5353828942,14234476478.446505,29.3310020534635,27.661346282963557,23.636374576958694,78.57142857142857,35.714285714285715
2019-06-17,183.01,184.25,182.835,183.74,175.16597489371844,178.69927972133098,180.9315846205205,180.86831054773714,174.22950000000003,178.63700000000009,183.58420000000012,179.10150000000007,179.10150000000007,186.42382551857145,171.7791744814287,20379476,56.32246861762995,45.84532215832997,NaN,NaN,NaN,NaN,NaN,NaN,1.0076301957227447,0.13869602423173433,-0.8689341714910104,89.70861748295104,86.77412688572012,5374208418,14240165448.77866,31.139345664369962,26.455331371454715,22.246654883003036,71.42857142857143,28.571428571428573
2019-06-18,185.88,187.72,185.4291,186.41,175.27785574054712,178.85196725160165,181.14642443932362,181.39609049557168,174.22785000000005,178.86910000000003,183.61920000000012,179.42450000000008,179.42450000000008,187.40810689161933,171.44089310838083,48177301,61.16000886019944,47.77695960837646,NaN,NaN,NaN,NaN,NaN,NaN,1.134000749845351,0.5485667658156785,-0.5854339840296725,92.89972899728996,88.49912437954713,5422385719,14233244522.610298,36.96814126078836,23.704000103092316,21.24300257174607,100,21.428571428571427
2019-06-19,186.73,187.53,185.57,187.11,175.39558851924815,179.01549265256003,181.38029014758544,181.9402723531363,174.23135000000005,179.08870000000002,183.65880000000016,179.68850000000006,179.68850000000006,188.2975238122512,171.07947618774892,31672855,62.33773523375552,49.62547559199931,NaN,NaN,NaN,NaN,NaN,NaN,1.2037708263658788,0.9192795489276762,-0.28449127743820274,96.69376693766947,93.10070447263683,5454058574,14251343296.896013,35.03573433497695,22.46493932247267,20.373809716264894,92.85714285714286,14.285714285714286
2019-06-20,189.72,189.76,187.1585,188.85,175.52946326035016,179.2102353723113,181.67321994571935,182.5983416528376,174.24235000000007,179.34610000000004,183.74620000000013,180.0800000000001,180.0800000000001,189.5633664908551,170.5966335091451,40921964,65.1653041153791,52.007437139288506,NaN,NaN,NaN,NaN,65.1653041153791,NaN,1.2980340905174184,1.3380513357085704,0.04001724519115191,95.55880917520743,95.05076837005562,5494980538,14263636402.744947,38.509532024255726,20.87604953049654,19.616379753762143,100,7.142857142857143
2019-06-21,188.57,189.77,188.1736,188.57,175.6592198448243,179.39557724612692,181.94368190863233,183.16707101923402,174.2559500000001,179.61610000000005,183.80820000000014,180.59600000000006,180.59600000000006,190.7259287263005,170.4660712736996,39980418,64.32834811545133,54.686322411097,NaN,NaN,NaN,NaN,NaN,NaN,1.2708376109254116,1.6285642588479163,0.3577266479225048,93.47826086956513,95.24361232748068,5455000120,14243510955.548254,36.84753224248752,19.960180209812087,18.0148525318571,100,0
2019-06-24,188.52,188.72,188.06,188.16,175.7836057170151,179.5691301719462,182.18745908868596,183.64258806502124,174.27950000000007,179.84090000000006,183.87080000000017,181.09600000000006,181.09600000000006,191.67293036754694,170.51906963245318,19375205,63.05134757095681,56.36188688233308,NaN,NaN,NaN,NaN,NaN,NaN,1.1577454091458546,1.804908409354823,0.6471630002089686,89.53866146848594,92.8585771710862,5435624915,14230007024.790678,36.14157377354325,19.90753040114071,16.85065151015518,92.85714285714286,0
2019-06-25,188.06,188.14,184.65,184.93,175.87461461535324,179.6752860101255,182.29500971265907,183.76519872549542,174.29510000000005,180.0086000000001,183.85280000000014,181.46800000000007,181.46800000000007,192.0347962978343,170.90120370216584,33921112,53.96294286371378,57.17889285252834,NaN,NaN,53.96294286371378,NaN,NaN,NaN,0.8141393649280596,1.664837206369043,0.8506978414409835,65.52706552706556,82.84799595503888,5401703803,14201528841.93681,32.56794849248973,27.54524997868645,14.968419813456235,85.71428571428571,0
2019-06-26,186.13,187.33,185.49,185.79,175.97327516644424,179.79636945546955,182.43206815529987,183.95803694211492,174.31850000000009,180.1920000000001,183.85140000000013,181.95600000000007,181.95600000000007,192.37358974042937,171.53841025957078,22595721,55.790170831495466,57.90767168318764,NaN,NaN,NaN,NaN,NaN,NaN,0.6032227634032377,1.6047262956950306,1.001503532291793,65.20979020979004,73.42517240178053,5424299524,14186301290.828114,30.35761212984719,25.675796406564476,13.700827483368988,78.57142857142857,0
2019-06-27,186.47,186.94,185.99,186.5,176.0780186971264,179.92911461476717,182.59159489430772,184.20012866191348,174.34240000000008,180.3617000000001,183.8514000000001,182.44250000000005,182.44250000000005,192.75414948007509,172.13085051992502,19709228,57.29708086571365,58.26503869899619,NaN,NaN,NaN,NaN,NaN,NaN,0.4755824144419418,1.59598155034422,1.1203991359022782,58.237547892720244,62.99146787652529,5444008752,14187753549.733377,29.3304066394726,24.80700873888648,13.80253462868349,71.42857142857143,0
2019-06-28,186.95,187.15,186.07,186.74,176.18410806332415,180.06398363229653,182.75427744747213,184.44202117030267,174.36050000000012,180.51880000000008,183.8432000000001,183.08200000000005,183.08200000000005,192.77547533137482,173.38852466862528,21179248,57.820449880895254,58.402550267264516,NaN,NaN,NaN,NaN,NaN,NaN,0.3757508747493692,1.5900877293389897,1.2143368545896205,61.30268199233721,61.58334003161584,5465188000,14192852257.58523,29.003287719428727,23.986163812707716,14.062738971238504,64.28571428571429,28.571428571428573
2019-07-01,190.3,190.5699,188.38,189.26,176.3142164408035,180.24608296631047,183.00940382208108,184.9008762969405,174.39390000000012,180.70620000000005,183.88060000000013,184.03900000000004,184.03900000000004,192.05965558417444,176.01834441582565,31193393,62.95449774607285,58.876723818624164,NaN,NaN,NaN,NaN,NaN,NaN,0.4432305534888408,1.7683750464506716,1.3251444929618308,84.82137684098309,68.12053557534686,5496381393,14186728672.192883,35.76740130342951,21.2951507843831,15.30752152964798,100,21.428571428571427
2019-07-02,189.19,190.03,188.66,190.01,176.45049289412884,180.4394278580667,183.28393700552888,185.3874595067557,174.42130000000012,180.92400000000006,183.9224000000001,184.79400000000004,184.79400000000004,192.04063066534633,177.54736933465375,18035768,64.34546884349487,59.61817392170571,NaN,NaN,NaN,NaN,NaN,NaN,0.4980727892752004,1.9477354795558313,1.4496626902806309,93.51209168124777,79.87871683818936,5514417161,14204237848.426458,34.28561765277767,20.412928282312787,16.807370476998155,92.85714285714286,14.285714285714286
2019-07-03,190.45,191.44,190.29,191.44,176.59964221856538,180.65726096978815,183.6037826131552,185.96389193468374,174.45855000000012,181.15280000000007,183.9450000000001,185.55550000000005,185.55550000000005,192.2106468052873,178.9003531947128,15792067,66.89759219300703,60.397901899377416,NaN,NaN,NaN,NaN,66.89759219300703,NaN,0.5843800027835655,2.180137693760088,1.5957576909765223,100,92.77782284074362,5530209228,14220029915.426458,37.147469956884,19.50461643447931,18.5408353001412,100,7.142857142857143
2019-07-05,190.15,191.4,189.39,191.05,176.743426873107,180.8630577822676,183.8957911381295,186.4482831789996,174.5071000000001,181.37930000000003,183.97180000000012,186.22750000000005,186.22750000000005,192.2188566910965,180.2361433089036,21415620,65.52014476590618,61.210968607405086,NaN,NaN,NaN,NaN,NaN,NaN,0.5684044196197566,2.306263215501218,1.7378587958814615,95.46775130737959,96.32661432954247,5508793608,14233987359.307056,34.75961916482389,21.072915973141836,20.082566356148693,92.85714285714286,0
2019-07-08,189.86,189.87,188.93,189.71,176.8724475012353,181.03824475687614,184.1237993287911,186.75892287623773,174.5414500000001,181.56750000000002,183.95640000000012,186.66100000000006,186.66100000000006,192.3344641974649,180.9875358025352,17598826,60.881662273153545,61.53662529708534,NaN,NaN,NaN,NaN,NaN,NaN,0.42723513824123804,2.271902718683009,1.844667580441771,74.52135493372619,89.99636874703526,5491194782,14245595095.604929,32.43746257029537,21.11468299808733,21.01190528149744,85.71428571428571,0
2019-07-09,188.79,190.9,188.65,190.66,177.00963707833745,181.22877456367067,184.38012092374046,187.13045403088176,174.58125000000015,181.76400000000004,183.9566000000001,187.03650000000005,187.03650000000005,192.7248364000341,181.348163599966,19193497,62.88762698294047,61.66002659156685,NaN,NaN,NaN,NaN,NaN,NaN,0.3601658940693664,2.294874948028479,1.9347090539591125,88.5125184094256,86.16720821684379,5510388279,14260693979.911596,33.38382536545377,19.616806065633313,21.305705466098516,78.57142857142857,35.714285714285715
2019-07-10,191.79,193.09,191.47,192.56,177.16436705765747,181.45315526538016,184.7009004953585,187.64755364698826,174.62045000000012,181.97740000000005,183.9874000000001,187.49450000000004,187.49450000000004,193.40847489003338,181.58052510996671,28374513,66.57891643642856,61.9629681060435,NaN,NaN,NaN,NaN,NaN,NaN,0.4028628879686367,2.4382876639199083,2.0354247759512716,93.72037914691941,85.58475083002374,5538762792,14270502453.541225,37.708516548554975,18.121614325706616,22.250065117200258,100,28.571428571428573
2019-07-11,192.88,193.34,191.81,192.42,177.31616440036734,181.67032050764985,185.00361027985423,188.10207234727508,174.66400000000016,182.18220000000008,184.04500000000007,187.99850000000004,187.99850000000004,193.786191335928,182.21080866407206,23736122,66.05755251562402,62.02670013463243,NaN,NaN,NaN,NaN,NaN,NaN,0.38101474619133935,2.5116932086904455,2.130678462499106,89.41311852704239,90.5486720277958,5515026670,14265693173.92031,36.65841556855323,17.231079481623514,22.704144846842535,100,21.428571428571427
2019-07-12,192.63,193.54,192.45,193.53,177.47749609787613,181.90516564611224,185.33797850417366,188.6190178380108,174.71220000000017,182.39470000000009,184.13700000000009,188.50400000000005,188.50400000000005,194.36934022883236,182.63865977116774,20211883,68.18480237204344,62.30216115296042,NaN,NaN,NaN,NaN,NaN,NaN,0.39875994960752825,2.6291283995085166,2.2303684499009884,99.8875140607425,94.34033724490143,5535238553,14285534196.681778,35.95720978495376,16.588435083255572,23.213690508629785,100,14.285714285714286
2019-07-15,193.97,194.19,193.44,194.15,177.6433916590913,182.14763761351597,185.6835479745982,189.14577804391453,174.76225000000017,182.61370000000005,184.2578000000001,189.07950000000005,189.07950000000005,194.78700199298854,183.37199800701157,15606074,69.3406271728178,62.75139541023621,NaN,NaN,NaN,NaN,69.3406271728178,NaN,0.40821175199812787,2.740633139898648,2.3324213879005202,99.58071278826004,96.293781792015,5550844627,14299475622.788445,37.28536460210315,16.153959714761914,23.969321488658437,100,7.142857142857143
2019-07-16,193.86,194.09,192.56,193.15,177.7976862694486,182.36550617562457,185.97635001481004,189.52713251592266,174.80665000000016,182.82900000000006,184.29860000000008,189.55000000000004,189.55000000000004,194.96311740127362,184.13688259872646,20190891,65.22474648080245,63.55580995431398,NaN,NaN,NaN,NaN,NaN,NaN,0.3076549196559002,2.7169900374703957,2.4093351178144955,88.04597701149433,95.83806795349896,5530653736,14294856791.513935,35.181605804354604,18.36529424762873,25.615709123339077,92.85714285714286,0
2019-07-17,193.2,193.49,192.18,192.2,177.9409928737327,182.56024862759242,186.2204147201116,189.78169132393003,174.83850000000018,183.02210000000002,184.34380000000007,189.83950000000004,189.83950000000004,195.16858800827518,184.5104119917249,16765069,61.49059447954734,63.96298307203197,NaN,NaN,NaN,NaN,NaN,NaN,0.14590783699502285,2.591719914058274,2.445812077063251,75.73170731707303,87.7861323722758,5513888667,14278603633.017752,33.50428269689048,18.87267989091027,27.014265347951405,85.71428571428571,0
2019-07-18,191.3,192.79,190.69,192.42,178.08506259638213,182.75549122902623,186.46353571147975,190.03295881688908,174.87165000000016,183.21110000000004,184.46740000000005,190.10500000000008,190.10500000000008,195.3926251758147,184.81737482418546,29066336,62.03268675248783,64.30124063537298,NaN,NaN,NaN,NaN,NaN,NaN,0.028621053426070908,2.48158839384584,2.452967340419769,78.20197044334964,80.65988492397234,5542955003,14297427545.855846,30.956374119095713,22.833197961509804,27.496148707420172,78.57142857142857,0
2019-07-19,193.82,193.83,190.81,191.01,178.2136689387067,182.91894684825343,186.64182842867663,190.12601035813773,174.89585000000014,183.38420000000005,184.57220000000004,190.21300000000005,190.21300000000005,195.48188261398505,184.94411738601505,29387945,56.5393257195779,64.20973176670745,NaN,NaN,56.5393257195779,NaN,NaN,NaN,-0.1587385342022749,2.2545441726669253,2.4132827068692,45.26678141135963,66.40015305726077,5513567058,14271932043.902205,31.32312338656601,20.427351488186485,28.323740317275337,71.42857142857143,0
2019-07-22,191.5,192.94,191.44,192.53,178.35611999404293,183.10926473244643,186.87273711774813,190.35496175260081,174.92975000000015,183.57360000000006,184.72740000000005,190.41100000000006,190.41100000000006,195.71553730309532,185.1064626969048,18953596,60.590895100206424,64.04090300628842,NaN,NaN,NaN,NaN,NaN,NaN,-0.19284914648402784,2.1722212737641655,2.3650704202481934,70.0361010830325,64.50161764591392,5532520654,14280524340.755537,29.205262947238435,19.046190386748435,28.01605158652367,64.28571428571429,0
2019-07-23,193.58,193.81,192.29,193.79,178.50969093937584,183.3207644407148,187.14400232881684,190.68210825235312,174.96895000000015,183.77960000000002,184.90320000000008,190.69250000000005,190.69250000000005,196.08613282027306,185.29886717972704,23786726,63.61862783191633,63.988985791175665,NaN,NaN,NaN,NaN,NaN,NaN,-0.14527118566203878,2.183481438170645,2.328752623832684,92.77978339350169,69.36088862929795,5556307380,14303685100.281853,30.72557826401899,18.013204881078025,28.067521870568754,57.142857142857146,28.571428571428573
2019-07-24,193.07,195.16,193.03,195.15,178.6752661539094,183.5550067290175,187.4579630218044,191.107621752129,175.03280000000018,183.9872,185.23460000000006,191.20350000000005,191.20350000000005,196.24129425938878,186.16570574061132,20422872,66.60128772278148,63.967821186159554,NaN,NaN,NaN,NaN,66.60128772278148,NaN,-0.04227365631513669,2.275910553438763,2.3181842097538996,99.84639016897096,87.55409154850172,5576730252,14323916208.225515,33.19608702562002,16.650406392220244,28.21400820318203,100,21.428571428571427
2019-07-25,194.48,194.52,192.93,193.3,178.8207858936715,183.74797689279933,187.6870625111454,191.31641968049766,175.09855000000013,184.17600000000002,185.48980000000006,191.57900000000004,191.57900000000004,196.03245214411785,187.12554785588222,23434744,59.46013892975576,63.53496362643453,NaN,NaN,NaN,NaN,NaN,NaN,-0.11469786639691337,2.174811876757758,2.2895097431546714,71.42857142857162,88.0182483303481,5553295508,14311388200.426773,30.59779015166637,15.699732329887418,28.761515625431436,92.85714285714286,14.285714285714286
2019-07-26,194.52,195.55,194.43,195.29,178.98465867084892,183.9765318058132,187.98521692247303,191.69485590140263,175.17975000000015,184.38340000000005,185.7338000000001,192.01850000000005,192.01850000000005,196.09963354350495,187.93736645649514,20431243,63.93919872069173,63.75335908697297,NaN,NaN,NaN,NaN,NaN,NaN,-0.04795517880254785,2.2295657696514866,2.2775209484540344,96.23188405797073,89.16894855183777,5573726751,14322333509.176773,31.79256274475668,14.46405214564682,29.927103212523576,100,7.142857142857143
2019-07-29,195.18,195.18,193.39,194.62,179.14023420646237,184.18729355223275,188.24540449414076,191.97344105365,175.25470000000016,184.59400000000002,185.9276000000001,192.41250000000005,192.41250000000005,195.84990527140775,188.97509472859235,20451652,61.476451677776794,63.652560850889856,NaN,NaN,NaN,NaN,NaN,NaN,-0.0671298240285596,2.193608668418335,2.2607384924468947,80.86419753086412,82.84155100580216,5553275099,14329988596.796885,29.66896618086738,17.154088776637934,29.98087645757484,92.85714285714286,0
2019-07-30,193.16,194.54,192.99,193.78,179.28590351784086,184.37724813535684,188.46244745515486,192.1454942866357,175.36495000000016,184.8175,186.1424000000001,192.63850000000005,192.63850000000005,195.80043152991843,189.47656847008167,18705006,58.43743602918223,63.07102653608655,NaN,NaN,NaN,NaN,NaN,NaN,-0.14984662278474525,2.0734302139659633,2.2232768367507085,63.58024691358014,80.22544283413835,5534570093,14330350629.171078,27.944474473304698,17.58338351463992,29.10049528576554,85.71428571428571,42.857142857142854
2019-07-31,194.31,194.43,189.32,191.1,179.40345671666833,184.5103719346567,188.56588088828605,192.0459234021942,175.4724500000002,185.01680000000005,186.36540000000008,192.69300000000004,192.69300000000004,195.70589296190653,189.68010703809355,41627473,49.95295105402662,61.920697860258166,NaN,NaN,NaN,NaN,NaN,NaN,-0.3851372317440638,1.7418552970706287,2.1269925288146925,28.571428571428505,57.67195767195761,5492942620,14317723900.570295,23.360353355509556,26.480564236651798,26.972639479258415,78.57142857142857,100
2019-08-01,191.51,194.98,189.23,190.15,179.51038749560695,184.6220477379308,188.62800320639246,191.8653592686519,175.55160000000018,185.17100000000002,186.53180000000012,192.62850000000003,192.62850000000003,195.79713551073826,189.4598644892618,63251648,47.32969014246953,60.43104698671717,NaN,NaN,NaN,NaN,NaN,NaN,-0.5924414625109162,1.3864407006760473,1.9788821631869635,14.556962025316658,35.56954583677512,5429690972,14274712779.930296,21.072779640070465,22.08943370521381,24.50796589049234,71.42857142857143,100
2019-08-02,188.82,188.99,186.21,187.35,179.58839359017801,184.67606659460546,188.57788543359277,191.4353250525898,175.6273000000002,185.28760000000003,186.6584000000001,192.44350000000003,192.44350000000003,196.31358152367935,188.5734184763207,55214006,40.56762926768915,58.37583285063656,NaN,NaN,NaN,NaN,NaN,NaN,-0.8880495274132247,0.8688202539204326,1.7568697813336573,12.205567451819977,18.444652682855065,5374476966,14264782203.31159,18.77531231725919,28.037891251101936,23.096784001012686,64.28571428571429,100
2019-08-05,183.51,183.51,179.2,180.73,179.59975285793743,184.59792666203901,188.2701252205107,190.4157702856765,175.6448500000002,185.32479999999998,186.7080000000001,191.99450000000004,191.99450000000004,198.3283723542476,185.6606276457525,75039971,29.746621590517222,55.841681072759044,NaN,NaN,29.746621590517222,NaN,NaN,NaN,-1.4652678928672755,-0.0747150847504372,1.3905528081168383,9.35779816513761,12.040109214091425,5299436995,14243018870.654978,15.106418793959877,39.366694676040034,24.034741953911766,57.142857142857146,100
2019-08-06,182.38,183.8,181.07,183.26,179.6361732275102,184.57143306477093,188.07364972166712,189.7342683537073,175.67470000000014,185.3903,186.81000000000012,191.6245,191.6245,199.00504598251257,184.24395401748745,41897249,36.696295352589374,54.07065970654776,NaN,NaN,NaN,NaN,NaN,NaN,-1.6014641326311003,-0.6112773576720372,0.9901867749590632,24.831804281345544,15.465056632767721,5341334244,14268341383.786846,14.690688166892144,36.475269873722695,25.080537074190783,50,92.85714285714286
2019-08-07,181.32,184.51,179.89,184.25,179.68208195161458,184.56506805358734,187.9237026737586,189.21195708192565,175.73005000000015,185.4493,186.9452000000001,191.20900000000003,191.20900000000003,199.23916288751042,183.17883711248965,49990586,39.22960692171419,52.44186829006394,NaN,NaN,NaN,NaN,NaN,NaN,-1.5487257576667215,-0.9457204221243387,0.6030053355423828,30.886850152905225,21.692150866462807,5391324830,14312705323.743557,13.128008109188304,35.312181453187556,27.27305658500862,42.857142857142854,85.71428571428571
2019-08-08,185.15,188.32,184.57,188.26,179.76743437000647,184.63823502282324,187.93689080419946,189.12129450269464,175.80625000000018,185.5474,187.1898000000001,191.00100000000003,191.00100000000003,199.11003668754506,182.891963312455,38418084,48.26129438856903,51.85058033784901,NaN,NaN,NaN,NaN,NaN,NaN,-1.1840722552180338,-0.8770849834801595,0.3069872717378743,55.41284403669719,37.04383282364933,5429742914,14349894029.055557,20.505670847976496,32.075239208167595,27.340836887356268,35.714285714285715,78.57142857142857
2019-08-09,187.32,188,185.03,186.49,179.8343255703049,184.67490363623267,187.8801499883485,188.87069502624752,175.86915000000016,185.6218,187.38420000000008,190.64900000000006,190.64900000000006,198.89833427616384,182.39966572383628,33608926,45.07677930015023,50.74242920927356,NaN,NaN,NaN,NaN,NaN,NaN,-1.009199489505312,-0.9545120901437656,0.05468739936154632,44.58715596330281,43.62895005096842,5396133988,14349328222.220541,19.015898050644154,29.74491706486783,27.40861718970392,28.571428571428573,71.42857142857143
2019-08-12,185.34,185.9,183.5,184.35,179.87925765418248,184.66846990086174,187.74171273390346,188.44015264279537,175.92455000000015,185.6677,187.59220000000008,190.15900000000005,190.15900000000005,198.67810769974793,181.63989230025217,24642870,41.51040814069148,49.16327065990036,NaN,NaN,NaN,NaN,NaN,NaN,-0.9837570980929558,-1.1750089732546485,-0.19125187516169267,31.498470948012223,43.83282364933742,5371491118,14342140718.470541,17.731650985661012,31.191907892074553,27.51077204760084,21.428571428571427,64.28571428571429
2019-08-13,184.27,189.68,184.02,188.39,179.96394165762345,184.7421635661912,187.76713576394647,188.43537620062438,176.03980000000013,185.72590000000002,187.9576000000001,189.92100000000005,189.92100000000005,198.35813671810035,181.48386328189974,40473043,49.61493649516146,47.94995985792751,NaN,NaN,NaN,NaN,NaN,NaN,-0.656673158730704,-1.0120933235750726,-0.35542016484436867,56.2079510703363,44.09785932721712,5411964161,14364164918.548279,23.66782291014585,27.41718916142525,25.66407171773551,14.285714285714286,57.142857142857146
2019-08-14,185.31,185.95,182.42,182.76,179.991763133667,184.70291280250424,187.57077749869367,187.89486418151728,176.09830000000017,185.76790000000005,188.1146000000001,189.44900000000004,189.44900000000004,198.36591404017759,180.5320859598225,51000548,41.07363572251698,46.6366382002676,NaN,NaN,NaN,NaN,NaN,NaN,-0.773292539620041,-1.3220358393694198,-0.5487432997493789,21.77370030581038,36.49337410805298,5360963613,14322988838.71825,20.807557447510465,27.34268258668618,24.33502956912258,7.142857142857143,50
2019-08-15,183.11,183.59,181.16,182.55,180.01721822686434,184.660280865821,187.37388426345078,187.38582949756326,176.17775000000017,185.8112,188.24140000000006,188.95550000000006,188.95550000000006,198.2447980897318,179.6662019102683,36848178,40.791552411613395,44.98323489247628,NaN,NaN,40.791552411613395,NaN,NaN,NaN,-0.8142489570201947,-1.5665544960246223,-0.7523055390044275,20.963704630788605,32.98178533564511,5324115435,14328296189.458992,19.760747077156143,28.575717873036616,22.96181507061704,0,42.857142857142854
2019-08-16,184.11,185.95,184.1,185.48,180.07157426440799,184.67651292788395,187.29961429233506,187.20432192636676,176.28900000000016,185.87550000000002,188.39880000000005,188.67900000000006,188.67900000000006,198.03618312313603,179.3218168768641,34785006,46.329893643518766,43.90133789002929,NaN,NaN,NaN,NaN,NaN,NaN,-0.6033909891969393,-1.5065442755006018,-0.9031532863036624,39.79721166032954,27.51153886564286,5358900441,14345406651.869802,23.25938006197328,26.56214486103873,21.52618424423048,0,35.714285714285715
2019-08-19,188.03,188.83,187.5,188.43,180.1547426796875,184.7508394045595,187.34394314361603,187.3210531714747,176.40155000000016,185.98080000000002,188.54660000000007,188.47400000000007,188.47400000000007,197.66285934160877,179.28514065839138,22568634,51.27201667639563,43.3895222219731,NaN,NaN,NaN,NaN,NaN,NaN,-0.24310256287641374,-1.2070314898991796,-0.9639289270227659,58.491761723700996,39.7508926716064,5381469075,14354400167.674314,27.622004775885756,24.714285695558733,20.297480129685425,14.285714285714286,28.571428571428573
2019-08-20,188,188.635,186.92,186.97,180.22255618536227,184.79478317872665,187.3292787066115,187.28761953609614,176.48730000000015,186.06740000000002,188.62300000000008,188.1330000000001,188.1330000000001,197.00827148879685,179.25772851120334,19939552,48.873356175812376,43.31240830210066,NaN,NaN,NaN,NaN,NaN,NaN,-0.08892275229546653,-1.075082367392099,-0.9861596150966325,49.2395437262358,49.176172370088786,5361529523,14335623271.767609,26.601724435032377,25.050597559207876,20.064814046977524,7.142857142857143,21.428571428571427
2019-08-21,188.66,189.23,187.96,188.63,180.30621234272184,184.87072806627663,187.3802873847836,187.41546529456318,176.57015000000018,186.1571,188.72760000000008,187.80700000000007,187.80700000000007,196.0863166384597,179.52768336154045,20745478,51.64338441726387,43.62052932172882,NaN,NaN,NaN,NaN,51.64338441726387,NaN,0.12730359453744922,-0.8270301219248211,-0.9543337164622703,89.98091603053426,65.9040738268237,5382275001,14336766723.310915,26.588062391531214,23.802862144067785,20.291368338323878,0,14.285714285714286
2019-08-22,188.98,189.46,186.54,188.02,180.3829664487644,184.9330898867464,187.40537415400777,187.47304002841432,176.66335000000018,186.2169,188.8412000000001,187.54300000000006,187.54300000000006,195.43240834282958,179.65359165717055,24270520,50.55934571487578,44.33422335367072,NaN,NaN,NaN,NaN,NaN,NaN,0.2259283183449592,-0.6719233185310713,-0.8978516368760305,84.16030534351151,74.4602550334272,5358004481,14337099196.187628,24.864810880066653,25.411991770266233,18.955802881806584,50,7.142857142857143
2019-08-23,186.76,188.45,181.56,182.07,180.39975285225927,184.8763950375039,187.19614379502707,186.95846478761294,176.72890000000018,186.21030000000002,188.81420000000008,186.88200000000006,186.88200000000006,194.2632345850752,179.50076541492493,55442893,41.42522439498917,45.16840926827586,NaN,NaN,41.42522439498917,NaN,NaN,NaN,-0.09562870895387887,-1.017387523068379,-0.9217588141145002,22.26762002042903,65.46961379815828,5302561588,14289864104.473549,21.348756269783916,32.03926041625642,17.204940415269057,42.857142857142854,0
2019-08-26,184.19,184.87,183.08,184.82,180.44373541094325,184.87527830408797,187.10296168541817,186.75480147450693,176.80180000000016,186.22070000000002,188.8578000000001,186.39200000000008,186.39200000000008,192.90331814611173,179.88068185388843,27689838,46.25782578436346,45.8513757276883,NaN,NaN,NaN,NaN,NaN,NaN,-0.10825933446905978,-1.057082982200825,-0.9488236477317652,50.35750766087841,52.26181100827301,5330251426,14316007024.149527,20.104561019747678,30.172027725001204,15.594072191419889,35.714285714285715,7.142857142857143
2019-08-27,186.08,186.42,183.71,184.43,180.48339973521246,184.86646091192782,186.99813965853903,186.53339181026817,176.84605000000013,186.2279,188.87160000000011,185.92450000000008,185.92450000000008,191.52596579029918,180.32303420970098,28080093,45.68220823447009,46.31227582145658,NaN,NaN,NaN,NaN,NaN,NaN,-0.12673947745017167,-1.1072479945444798,-0.9805085170943081,38.38028169014092,37.00180312381614,5302171333,14302847718.573881,22.22863432887486,28.444180541662046,13.1990004952044,28.571428571428573,0
2019-08-28,183.84,185.4,182.91,185.09,180.52923655376756,184.8708874285233,186.92331065232182,186.39592592357596,176.89920000000018,186.2322,188.84520000000012,185.62400000000008,185.62400000000008,190.70310779565398,180.54489220434618,21848789,46.88673328296245,46.21409288534182,NaN,NaN,NaN,NaN,NaN,NaN,-0.08061981310845501,-1.081283283479877,-1.000663470371422,46.12676056338031,44.95484997146656,5324020122,14319256246.859022,21.036593876618703,28.641757888249526,12.720818090441243,21.428571428571427,35.714285714285715
2019-08-29,187.37,188.4562,186.675,187.92,180.60277648855595,184.9312658952852,186.9623965090935,186.54107583561634,176.98120000000017,186.26010000000002,188.86140000000012,185.5125000000001,185.5125000000001,190.2774758656118,180.7475241343884,25427207,51.8203412101309,46.695775878911874,NaN,NaN,NaN,NaN,NaN,NaN,0.14224016928915317,-0.8228632587599805,-0.9651034280491336,79.34272300469463,54.6165884194053,5349447329,14329374596.466927,26.08815396833592,26.56753808738722,11.214178804959271,14.285714285714286,28.571428571428573
2019-08-30,188.94,188.97,186.41,187.47,180.67110707075938,184.9815378577548,186.98230252834475,186.6295448036529,177.08690000000016,186.29,188.8338000000001,185.51850000000007,185.51850000000007,190.2930084563633,180.74399154363684,26332749,51.008971210087765,47.374244669583035,NaN,NaN,NaN,NaN,NaN,NaN,0.2545487390393195,-0.6469175042499842,-0.9014662432893037,74.0610328638497,66.5101721439749,5323114580,14324848655.232552,25.751210654390412,25.08000233663018,9.343295389326673,7.142857142857143,21.428571428571427
2019-09-03,186.26,187.18,185.03,185.65,180.7206482939359,184.99477473185866,186.93005537037044,186.53625482235262,177.18280000000016,186.29180000000005,188.7754000000001,185.76450000000008,185.76450000000008,190.003766328016,181.52523367198415,28026617,47.752422043383376,47.24120792302745,NaN,NaN,NaN,NaN,NaN,NaN,0.20366805677507305,-0.6468811723204624,-0.8505492290955354,54.09638554216871,69.16671380357103,5295087963,14312986226.641853,24.351688662334904,26.79072882454678,9.159698931259529,0,14.285714285714286
2019-09-04,187.43,188.49,186.9,188.33,180.7963632362848,185.06081879657432,186.98495515976768,186.70708769641428,177.29845000000014,186.32480000000004,188.77880000000007,186.0180000000001,186.0180000000001,190.2341812105117,181.80181878948846,21676335,52.555755123809696,48.06135930883408,NaN,NaN,NaN,NaN,NaN,NaN,0.3398860487702343,-0.4256916681327425,-0.7655777169029768,86.38554216867477,71.51432019156441,5316764298,14330300028.811665,25.74046883504431,25.08205786478849,8.28278090068112,42.857142857142854,7.142857142857143
2019-09-05,190.39,192.325,190.34,191.78,180.90565315433173,185.19387188971146,187.17299613389443,187.19022220151768,177.4169000000002,186.38430000000005,188.9158000000001,186.39450000000008,186.39450000000008,191.21364297358497,181.5753570264152,34060994,57.91904326780658,49.284751512847876,NaN,NaN,NaN,NaN,NaN,NaN,0.6345980249401879,0.02766981427225801,-0.6069282106679299,94.93729679516964,78.47307483533773,5350825292,14345657504.695795,31.930260852197627,22.87219705154596,8.16077255366492,100,0
2019-09-06,192.03,192.17,191.17,191.59,181.01196506324385,185.32052789189538,187.34621197178092,187.609248658516,177.53735000000017,186.44160000000002,189.0318000000001,186.5610000000001,186.5610000000001,191.8350758432008,181.2869241567994,19487821,57.533310842845964,50.084995598514105,NaN,NaN,NaN,NaN,NaN,NaN,0.7794589975117665,0.36739553622177823,-0.4120634612899883,93.17231769623794,91.49838555336079,5331337471,14342539453.335796,31.18949992497309,22.34157721182738,8.86787110009692,92.85714285714286,35.714285714285715
2019-09-09,192.18,192.27,190.215,191.19,181.11323904271407,185.4367550623529,187.49694875720127,187.9502725958002,177.68300000000016,186.48850000000002,189.12560000000008,186.7960000000001,186.7960000000001,192.44219305371638,181.14980694628383,24407580,56.67752185264826,50.471103111103574,NaN,NaN,NaN,NaN,NaN,NaN,0.8076241584452639,0.5974667367665916,-0.2101574216786723,89.45657222480267,92.52206223873675,5306929891,14341292350.70806,29.666371441512773,23.5199790458512,9.296478028612501,85.71428571428571,28.571428571428573
2019-09-10,190.19,190.74,188.91,190.64,181.2080326840801,185.53978961557362,187.62020566868358,188.2064371104859,177.84040000000016,186.5234,189.20360000000008,187.1105000000001,187.1105000000001,192.87613431027796,181.3448656897222,23744687,55.45604950859934,50.941295492016934,NaN,NaN,NaN,NaN,NaN,NaN,0.749756792745415,0.7270385692530965,-0.0227182234923185,84.34742220157915,88.99210404087326,5283185204,14362441989.948496,28.030793572476657,25.378870186010268,9.436637693089946,78.57142857142857,21.428571428571427
2019-09-11,190.98,192.53,190.56,192.43,181.31969405040766,185.6762294251662,187.8088250542254,188.6086811952015,178.00070000000014,186.5738,189.26700000000008,187.31250000000009,187.31250000000009,193.51018626181494,181.11481373818523,25063617,58.58437564445928,51.43708057967375,NaN,NaN,NaN,NaN,NaN,NaN,0.7886238949525245,0.9630616451983371,0.17443775024581262,99.08842297174117,90.96413913270767,5308248821,14384961077.303825,31.096833811768988,24.140449465289016,9.94138435718487,100,14.285714285714286
2019-09-12,193.64,194.71,192.97,193.23,181.43820455736878,185.82580904050945,188.0214201501381,189.04880679565852,178.17080000000016,186.62689999999998,189.33140000000006,187.8360000000001,187.8360000000001,194.17425023171702,181.49774976828317,28689878,59.93854098366879,52.10702309887325,NaN,NaN,NaN,NaN,59.93854098366879,NaN,0.8211078893048029,1.2008226118768164,0.37971472257201344,88.74524714828883,90.72703077386973,5336938699,14364845185.832561,34.79582152724348,22.756396464660444,11.357869812361205,100,7.142857142857143
2019-09-13,192.95,193.4,192.29,192.54,181.5486701836636,185.958763316935,188.19861935993663,189.3813013865482,178.31905000000017,186.6492,189.35340000000008,188.33550000000008,188.33550000000008,194.50093421016373,182.17006578983643,27669795,58.17183598144074,53.30320964076265,NaN,NaN,NaN,NaN,NaN,NaN,0.7509284205927239,1.3183752483129183,0.5674468277201944,81.61016949152531,89.81461320385178,5309268904,14349639262.454184,33.780403164183184,23.880052842510583,11.154007135003786,92.85714285714286,0
2019-09-16,191.3,192.08,191.11,191.68,181.64947943556746,186.07205513244125,188.3351440909195,189.60022506401978,178.46025000000012,186.6689,189.36600000000007,188.6455000000001,188.6455000000001,194.82890836431042,182.4620916356898,20318987,55.95795754680054,53.996076195222436,NaN,NaN,NaN,NaN,NaN,NaN,0.6075198852529486,1.3268466842863802,0.7193267990334316,74.3220338983051,81.55915017937309,5288949917,14353200322.031504,32.465953898666584,26.161728581945503,10.491779974900497,85.71428571428571,14.285714285714286
2019-09-17,191.7,192.6,191.29,192.6,181.75843983919364,186.2013213674424,188.502393342256,189.8859179150655,178.57975000000013,186.69010000000003,189.42380000000006,188.8540000000001,188.8540000000001,195.27108469632833,182.43691530367187,21113675,57.80785095552668,54.86219353244076,NaN,NaN,NaN,NaN,NaN,NaN,0.5379412829158643,1.3917534026782619,0.8538121197623976,82.11864406779651,79.35028248587565,5310063592,14374313997.031504,32.73319269669872,25.194552409769273,10.545196476471663,78.57142857142857,7.142857142857143
2019-09-18,192.2,192.6,190.11,192.52,181.86552003979867,186.32644371660197,188.65994654452047,190.13678287553546,178.70160000000016,186.70879999999997,189.46100000000007,189.13150000000007,189.13150000000007,195.67741254141728,182.58558745858286,31173056,57.58136147999422,55.62609554651446,NaN,NaN,NaN,NaN,NaN,NaN,0.453241536753317,1.4203640407040439,0.9671225039507269,77.37603305785127,77.93890367465097,5278890536,14403483965.09576,30.43037680598646,26.75599533339777,9.910658304966587,71.42857142857143,0
2019-09-19,192.86,194.035,192.47,192.84,181.97471884537282,186.4554250291445,188.82387020944122,190.39423212548445,178.81895000000011,186.72699999999998,189.46660000000008,189.3420000000001,189.3420000000001,196.07787588958095,182.60612411041924,26214873,58.28539607588708,56.08788517978276,NaN,NaN,NaN,NaN,NaN,NaN,0.38799828762322996,1.4521203634797644,1.0641220758565344,80.68181818181814,80.05883176915533,5305105409,14389664623.098955,33.21499242665844,25.53984092979643,10.778701179254796,64.28571428571429,14.285714285714286
2019-09-20,193.11,193.31,190.16,190.8,182.06253258820493,186.54145621668619,188.9013654953455,190.4328766849621,178.91130000000013,186.7396,189.43420000000006,189.48100000000008,189.48100000000008,196.21675207381574,182.74524792618442,30131528,52.3233208929275,56.1817672999856,NaN,NaN,NaN,NaN,NaN,NaN,0.18687613963566907,1.2977172504011207,1.1108411107654517,59.60743801652899,72.55509641873282,5274973881,14371777017.587845,30.23597853260232,29.82638346717571,10.733092948001035,57.142857142857146,7.142857142857143
2019-09-23,190.36,191.07,189.72,190.5,182.14648748782477,186.61984322229637,188.96405704454762,190.43926938163239,179.03520000000015,186.75529999999998,189.37360000000004,189.9025000000001,189.9025000000001,195.72339297272057,184.0816070272796,22917563,51.48919884413585,56.44867992861077,NaN,NaN,NaN,NaN,NaN,NaN,0.021747692111441896,1.138025725904754,1.116278033793312,46.09475032010235,62.12800217281651,5252056318,14375341971.832289,29.03411578682919,29.93633868794925,10.501724631998758,50,0
2019-09-24,191.37,191.79,187.151,187.97,182.20443288595587,186.64657900007268,188.92507441534968,190.20410086909598,179.14060000000015,186.75390000000004,189.25000000000003,190.0600000000001,190.0600000000001,195.47886704024637,184.6411329597538,41096614,44.97724778809953,55.90735797606005,NaN,NaN,NaN,NaN,NaN,NaN,-0.2545272528980074,0.7981189676708027,1.05264622056881,10.834766503505605,38.845651613379,5210959704,14348756298.494501,25.310933532742247,33.198883783963936,11.372146283443538,42.857142857142854,0
2019-09-25,187.79,190.58,186.21,190.08,182.2827967378369,186.7145675347247,188.97036561474775,190.1922817387059,179.28410000000014,186.74360000000004,189.18860000000004,190.34250000000011,190.34250000000011,195.1075388245852,185.57746117541504,36499191,50.589774799393474,55.38383879974482,NaN,NaN,NaN,NaN,NaN,NaN,-0.28928980091674783,0.6910339694228753,0.9803237703396231,45.529411764705934,34.15297619610464,5247458895,14376903271.874363,22.39725143950178,31.855979939288453,11.436848683802271,35.714285714285715,100
2019-09-26,189.87,190,187.98,189.38,182.35341567576887,186.76734837562122,188.98642970828706,190.11492157311486,179.41565000000017,186.73800000000003,189.13220000000004,190.5570000000001,190.5570000000001,194.7029720211149,186.4110279788853,27030029,48.81094807442167,54.760812887714515,NaN,NaN,NaN,NaN,NaN,NaN,-0.3495230325188683,0.5434199796910377,0.892943012209906,37.29411764705868,31.219431971756748,5220428866,14387340609.805056,21.13797816174996,30.064894797323543,11.501551084161006,28.571428571428573,92.85714285714286
2019-09-27,189.7,189.83,185.75,187.03,182.3999488531244,186.77254939788614,188.90970697462873,189.8211195185325,179.53275000000016,186.7459,189.0244,190.5125000000001,190.5125000000001,194.7878192863074,186.2371807136928,40804222,43.30577226528554,53.80568791718861,NaN,NaN,NaN,NaN,NaN,NaN,-0.5270657812174202,0.23411078568813082,0.761176566905551,14.285714285714286,32.36974789915964,5179624644,14372139036.903095,18.913066541529695,32.653361623829014,12.57937114770631,21.428571428571427,100
2019-09-30,187.75,189.11,187.4,188.81,182.46373045657592,186.81289495436363,188.90579689719232,189.7248224215294,179.65155000000013,186.77630000000002,188.98040000000003,190.5795000000001,190.5795000000001,194.70123980254073,186.4577601974595,26559841,48.08223870184575,53.27898714527764,NaN,NaN,NaN,NaN,NaN,NaN,-0.5040605372099579,0.13110089539310366,0.6351614326030616,34.15178571428571,28.5772058823529,5206184485,14389379635.446955,17.87982819440847,30.86947822670394,14.127982930166615,14.285714285714286,92.85714285714286
2019-10-01,189.54,190.5898,186.955,187.27,182.5115540341224,186.82194653942574,188.84164799926322,189.4910298099552,179.76240000000016,186.8013,188.87520000000006,190.6605000000001,190.6605000000001,194.4411162195961,186.8798837804041,32665025,44.582633845935895,52.2788627310974,NaN,NaN,NaN,NaN,NaN,NaN,-0.5672874574892309,-0.07394788925847706,0.49333956823075387,16.964285714285815,21.80059523809528,5173519460,14362376260.537745,20.00839166951852,27.991625577672195,14.416418058354376,7.142857142857143,85.71428571428571
2019-10-02,186.01,187.204,183.02,184.05,182.5268619541809,186.76705650894206,188.65374023458622,188.97283649472138,179.87725000000017,186.7918,188.68040000000005,190.4465000000001,190.4465000000001,195.11162282795036,185.78137717204984,48931982,38.30483047156985,50.733597694518906,NaN,NaN,38.30483047156985,NaN,NaN,NaN,-0.787169280457819,-0.4906220323415198,0.2965472481162991,9.350885156604653,20.155652195058735,5124587478,14337536028.75763,17.9063582006095,34.77798991143723,15.209622306920581,0,100
2019-10-03,184.07,186.2065,181.82,186.07,182.56211705911443,186.7532534097551,188.55241708813188,188.6963758761765,180.02045000000015,186.8667,188.49880000000005,190.16100000000012,190.16100000000012,195.15223591907252,185.1697640809277,39612315,43.664120348951826,49.69733229219827,NaN,NaN,NaN,NaN,NaN,NaN,-0.7575141166020797,-0.6503453976363005,0.10716871896577918,34.79328694228407,20.369485937724846,5164199793,14374683015.592806,16.03402209900919,34.00199631728663,16.548193249343203,28.571428571428573,100
2019-10-04,186.99,189.08,186.88,188.81,182.62428504857598,186.79398106500747,188.56251837879336,188.70719722130255,180.17240000000015,186.94940000000003,188.40900000000008,190.0220000000001,190.0220000000001,195.0011348645981,185.0428651354021,32752668,50.00781255491631,49.27232193563511,NaN,NaN,NaN,NaN,NaN,NaN,-0.5253333305820079,-0.5494979442617307,-0.024164613679722807,57.22472370036846,33.78963193308573,5196952461,14399396392.356441,21.7314083466761,31.56312136269787,17.097828963210993,21.428571428571427,92.85714285714286
2019-10-07,188.23,189.74,187.91,188.24,182.68016280928668,186.82261510332415,188.54987059923283,188.66270224784517,180.34095000000016,187.00090000000003,188.26800000000006,189.87450000000013,189.87450000000013,194.88119741444754,184.8678025855527,21404580,48.77730633712955,48.62728303432103,NaN,NaN,NaN,NaN,NaN,NaN,-0.38842383493840205,-0.5096944073527254,-0.12127057241432335,52.55832992222689,48.192113521626474,5175547881,14385711496.946606,22.374385494868257,30.147317570723164,17.225371743450605,14.285714285714286,85.71428571428571
2019-10-08,187.01,187.8562,185.27,185.42,182.70742487088583,186.79484054682268,188.4271305757335,188.3538734623361,180.5066000000002,187.00580000000002,188.08400000000006,189.6135000000001,189.6135000000001,194.965681891518,184.26131810848221,33201939,43.1237536142021,47.59459675819303,NaN,NaN,NaN,NaN,NaN,NaN,-0.4611100074848946,-0.6976580817704416,-0.236548074285547,29.47196070405234,46.41833810888256,5142345942,14356360993.141098,20.747771080577667,34.41782084984658,18.536425637328936,7.142857142857143,78.57142857142857
2019-10-09,186.96,188.08,186.43,187.23,182.75242561843922,186.80345756569747,188.3801842786459,188.24683789449458,180.7049000000002,187.0477,187.95300000000006,189.3535000000001,189.3535000000001,194.63792343116836,184.06907656883186,20829012,47.34245144914936,46.812957856283184,NaN,NaN,NaN,NaN,NaN,NaN,-0.36482960858117264,-0.6925850850120128,-0.32775547643084013,47.0844212358572,43.03823728737881,5163174954,14355729810.95928,19.93956317963992,32.16257359060097,19.279046884642906,0,71.42857142857143
2019-10-10,187.25,189.43,187.12,188.68,182.81140645805675,186.84061682182227,188.3919417579147,188.28809142835223,180.93080000000018,187.13500000000005,187.90460000000007,189.12600000000012,189.12600000000012,194.10629878620267,184.14570121379757,26693780,50.50942271905291,46.68339370100643,NaN,NaN,NaN,NaN,NaN,NaN,-0.1898342522242027,-0.5650482917110935,-0.3752140394868908,68.80641925777347,48.454267065894335,5189868734,14365089967.582657,22.162763872080053,30.305426827404403,20.338853136564516,0,64.28571428571429
2019-10-11,190.8,192.63,190.72,191.11,182.89397952812584,186.9251590629743,188.49853227721218,188.55684462565202,181.12405000000018,187.22780000000003,187.92380000000009,189.05450000000013,189.05450000000013,193.8751948669102,184.23380513309007,41428907,55.355339645489686,46.959546615388845,NaN,NaN,NaN,NaN,NaN,NaN,0.0882985499575959,-0.26484085203989594,-0.35313940199749183,85.93894542090673,67.2765953048458,5231297641,14340579671.81826,27.818971265022796,27.39269807667471,20.284718372500404,100,57.142857142857146
2019-10-14,190.82,191.7,190.645,191.09,182.97553197063206,187.0076311607372,188.60015846241956,188.79809751844707,181.31425000000013,187.32850000000002,187.99860000000007,189.02500000000012,189.02500000000012,193.78794236789187,184.26205763210837,15372774,55.30733927201885,47.697410292811654,NaN,NaN,NaN,NaN,NaN,NaN,0.2599411973854416,-0.02821290526568987,-0.28815410265113145,85.75393154486594,80.16643207451538,5215924867,14338175399.107359,27.070599223713508,26.847036310696982,19.35137727254068,92.85714285714286,50
2019-10-15,191.65,193.97,191.56,193.52,183.08045205052628,187.13658895953446,188.7930934246776,189.2478025166902,181.51700000000017,187.48120000000003,188.2544000000001,189.0710000000001,189.0710000000001,193.9864893957651,184.15551060423513,23735826,59.86148910011594,48.35967560000612,NaN,NaN,NaN,NaN,59.86148910011594,NaN,0.5116009054501524,0.351347029161559,-0.16025387628859336,96.2962962962964,89.32972442068969,5239660693,14353047223.696571,30.863274740588047,24.879415644343823,18.872833076931023,100,42.857142857142854
2019-10-16,192.88,193.53,192.43,193.04,183.17955203012303,187.25348818805853,188.9596387805726,189.60896418176733,181.71090000000015,187.63,188.4500000000001,189.09700000000012,189.09700000000012,194.09007560525873,184.1039243947415,20689207,58.59142737232559,49.05828126414212,NaN,NaN,NaN,NaN,NaN,NaN,0.613345895530154,0.6064284931240991,-0.006917402406054873,92.34567901234564,91.46530228450267,5218971486,14355304228.096571,29.960097210902138,24.151348731465756,18.394288881321366,92.85714285714286,35.714285714285715
2019-10-17,194.18,194.5,192.81,193.55,183.28274056713673,187.3781715902752,189.13965294604034,189.98430092636093,181.90425000000016,187.7906,188.63600000000008,189.1325000000001,189.1325000000001,194.2402974705231,184.0247025294771,19161821,59.57286763737663,50.22021664786291,NaN,NaN,NaN,NaN,NaN,NaN,0.6775751520188764,0.8400515376175406,0.16247638559866423,92.50788643533133,93.71662058132445,5238133307,14352923173.416098,31.227170074603343,23.035984777493926,17.569251996860334,100,28.571428571428573
2019-10-18,193.26,193.67,190.705,191.69,183.3663948898518,187.46355433106183,189.23966655599955,190.1467484571837,182.11360000000016,187.9472,188.7046000000001,189.1770000000001,189.1770000000001,194.35712779763986,183.99687220236035,27719069,54.49952942865544,50.67859455692074,NaN,NaN,NaN,NaN,NaN,NaN,0.5621310756554988,0.8651402301680378,0.30300915451253896,77.8391167192429,87.56422738897328,5210414238,14343621158.692657,28.721069477045187,26.88487561535751,15.901847625315513,92.85714285714286,21.428571428571427
2019-10-21,192.65,193.52,192.14,193.39,183.46613225413188,187.5809096908428,189.40242473027408,190.45562955649953,182.29940000000013,188.11340000000004,188.84260000000012,189.3215000000001,189.3215000000001,194.79416032199083,183.84883967800937,15868946,58.018561950870044,51.63830370727318,NaN,NaN,NaN,NaN,NaN,NaN,0.5660326771186293,1.0105500009108255,0.4445173237921963,91.24605678233428,87.19768664563617,5226283184,14356500303.272367,27.26658943711674,25.523383314740038,14.949734948628045,85.71428571428571,14.285714285714286
2019-10-22,194.06,194.42,191.79,191.85,183.5495538237425,187.66544613260828,189.4984080741849,190.58842674159482,182.46820000000014,188.29240000000001,188.99260000000012,189.51550000000012,189.51550000000012,195.05741474130488,183.97358525869535,22988988,53.948131988203194,52.75568238703271,NaN,NaN,53.948131988203194,NaN,NaN,NaN,0.43647397520061426,0.9901097927929641,0.5536358175923498,79.10094637223972,82.72870662460564,5203294196,14334560242.481493,27.772014101542585,23.66829941985391,13.232137179509596,78.57142857142857,7.142857142857143
2019-10-23,191.43,192.2582,191.15,192.22,183.63582692002367,187.75563531810118,189.6051371693149,190.74381467096674,182.63170000000017,188.51340000000005,189.06920000000014,189.6225000000001,189.6225000000001,195.28519856163308,183.9598014383671,15198327,54.76918913641396,53.54890158613714,NaN,NaN,NaN,NaN,NaN,NaN,0.3509535473317793,0.9923277517570739,0.6413742044252946,75.29794149512455,81.88164821656618,5218492523,14348710787.32773,26.885292756553614,24.756521954904688,10.961573207573428,71.42857142857143,0
2019-10-24,193.62,194.21,192.74,194.09,183.73984854271,187.8810682820992,189.78101414306727,191.06249898801752,182.79805000000016,188.70520000000005,189.29580000000013,189.85800000000012,189.85800000000012,195.84333741737927,183.87266258262096,19264220,58.77013448599149,54.17478172407108,NaN,NaN,NaN,NaN,NaN,NaN,0.3924451802200982,1.1319306797004174,0.7394854994803192,95.557963163597,83.31895034365375,5237756743,14364829828.55222,31.025570493616776,23.316832097388637,10.657116797455812,64.28571428571429,14.285714285714286
2019-10-25,193.09,195.74,193.05,195.64,183.85825800994672,188.03471049433486,190.01077829431952,191.49845146534918,182.96985000000015,188.89950000000005,189.55760000000012,190.28850000000008,190.28850000000008,196.62645952968654,183.95054047031363,21507115,61.78737475872479,55.10407232561359,NaN,NaN,NaN,NaN,NaN,NaN,0.4900543378298987,1.3520534217676925,0.8619990839377938,99.04489016236846,89.96693160703,5259263858,14384737901.544785,33.043289798184624,21.496962381856942,11.112175308364622,100,7.142857142857143
2019-10-28,196.57,197.83,196.55,197.57,183.99469325362884,188.22352810830841,190.30721836120895,192.07669418293497,183.15425000000013,189.09910000000002,189.79940000000013,190.7265000000001,190.7265000000001,197.76704053322172,183.68595946677848,18842303,65.20213968680139,56.681099902227835,NaN,NaN,NaN,NaN,NaN,NaN,0.6408538187116013,1.6630663573272955,1.0222125386156942,97.71929824561387,97.44071719052643,5278106161,14395925518.951035,37.03923585877933,20.12013895634281,11.45644918691765,100,0
2019-10-29,197.24,197.535,196.01,196.04,184.1145470521002,188.37830972992606,190.53203332743604,192.4541518797983,183.33810000000017,189.24910000000003,189.9516000000001,191.16500000000008,191.16500000000008,198.38007172521137,183.9499282747888,18569675,60.58040595128639,57.62666808095191,NaN,NaN,NaN,NaN,NaN,NaN,0.5948170534868693,1.7657338554742807,1.1709168019874114,83.28664799253016,93.35027880017083,5259536486,14378086454.11497,35.30464076476239,20.798969969558396,11.627551769900405,92.85714285714286,0
2019-10-30,196.42,197.32,195.29,196.99,184.2426610117808,188.54883825012556,190.78528692243856,192.8861374150556,183.51115000000016,189.38750000000005,190.15200000000013,191.81200000000007,191.81200000000007,198.6708850405823,184.95311495941783,21764311,62.36426420690595,58.473442472941414,NaN,NaN,NaN,NaN,NaN,NaN,0.5847325637434027,1.9018325066666648,1.3170999429232622,88.30897703549056,89.77164109121152,5281300797,14392774683.706102,33.13034708224526,21.70238481218871,12.007713198744995,85.71428571428571,0
2019-10-31,197.56,197.65,195.94,197.08,184.3703957280815,188.71777214616267,191.03213841567626,193.285552899336,183.68480000000017,189.52430000000007,190.32100000000014,192.36250000000007,192.36250000000007,199.05491025340942,185.67008974659072,26801803,62.53722660892702,58.986434398901224,NaN,NaN,NaN,NaN,NaN,NaN,0.5414949947012373,1.9939686862998087,1.4524736915985714,89.5615866388309,87.05240388895054,5308102600,14401708618.039436,32.39845124699787,20.55404989753505,13.550277665871558,78.57142857142857,7.142857142857143
2019-11-01,197.93,198.88,197.63,198.87,184.5146703974538,188.91880636109013,191.33950553663013,193.81740500416115,183.86100000000016,189.68960000000007,190.5380000000001,192.86550000000008,192.86550000000008,199.91686717239486,185.8141328276053,22131875,65.89438890723228,59.742652229987904,NaN,NaN,NaN,NaN,NaN,NaN,0.5870001545163506,2.1862238847440096,1.599223730227659,99.87767584097871,92.58274650510005,5330234475,14423486383.039436,34.431930993116026,19.390939244578917,15.516757409366903,100,0
2019-11-04,200.19,200.5251,198.8658,200.1,184.66974830394682,189.14021613611806,191.68305433911522,194.41574738471724,184.0352500000002,189.85640000000006,190.8986000000001,193.4585000000001,193.4585000000001,200.84116422099024,186.07583577900996,19015855,68.01543279230316,60.32507677942984,NaN,NaN,NaN,NaN,NaN,NaN,0.648666298047673,2.4100566027872503,1.7613903047395774,95.67112351198038,95.03679533059665,5349250330,14432758804.108864,37.87392921585039,18.3595496572144,17.228731388662656,100,21.428571428571427
2019-11-05,200.35,200.55,199.55,200.21,184.8243776740568,189.359419776987,192.01744436503228,194.96758096712512,184.2266000000002,190.0321,191.20640000000014,194.1980000000001,194.1980000000001,201.16286496637983,187.23313503362036,15048864,68.20586617146506,61.0118224079398,NaN,NaN,NaN,NaN,NaN,NaN,0.6442749667589287,2.5667340131882384,1.9224590464293096,96.54647028948702,97.36508988081538,5364299194,14437574440.588863,36.69319974377068,17.746908216459044,18.947823954148827,100,14.285714285714286
2019-11-06,199.98,200,198.785,199.76,184.97299083152888,189.56537186061104,192.3210739977761,195.4240018273989,184.41465000000022,190.19230000000005,191.5130000000001,194.82450000000009,194.82450000000009,201.41357421417888,188.2354257858213,19725486,66.46251890871179,61.50394035589232,NaN,NaN,NaN,NaN,NaN,NaN,0.5615039661308403,2.6243390040928603,2.06283503796202,91.9756221432197,94.73107198156235,5344573708,14449507141.996271,34.905722483985194,19.497562591260788,19.892596408073214,92.85714285714286,7.142857142857143
2019-11-07,200.76,201.72,199.85,200.43,185.12679191778233,189.78051301188606,192.63907109590252,195.90076355812283,184.6008000000002,190.33250000000004,191.81980000000013,195.4120000000001,195.4120000000001,201.79703124502396,189.02696875497622,17832355,67.78288918429448,62.45275176700939,NaN,NaN,NaN,NaN,NaN,NaN,0.5041411022092781,2.6930114157236176,2.1888703135143395,87.79564806054879,92.10591349775183,5362406063,14442736568.7075,38.46254487660047,18.18535480741272,22.21352336797035,100,0
2019-11-08,200.02,201.25,199.54,201.23,185.28702284397355,190.00723552650217,192.97597026861223,196.40830988592066,184.78120000000018,190.47369999999998,192.08600000000013,195.9180000000001,195.9180000000001,202.46115397953622,189.37484602046396,15272516,69.33529056236974,63.261089524973656,NaN,NaN,NaN,NaN,NaN,NaN,0.47285787899948284,2.779942662263693,2.30708478326421,95.36423841059593,91.71183620478813,5377678579,14457651832.871243,36.175069722121265,18.181982709491955,24.342059564356173,92.85714285714286,14.285714285714286
2019-11-11,200.23,201.0363,199.94,200.96,185.44297286542655,190.22412195171995,193.2890694737647,196.84180418249966,184.9704500000002,190.59480000000002,192.35580000000013,196.4115000000001,196.4115000000001,202.91235617437584,189.91064382562436,10187222,68.14187966703838,64.27492864489045,NaN,NaN,NaN,NaN,NaN,NaN,0.39019814855447965,2.79483246895731,2.40463432040283,92.80983916745514,91.98990854619994,5367491357,14466421039.658983,34.50777047644894,17.34398001069341,26.136633623845338,85.71428571428571,7.142857142857143
2019-11-12,201.13,202.21,200.82,201.54,185.60314228965117,190.4481987447552,193.61263537675433,197.28925140321397,185.1703000000002,190.7245,192.67360000000016,196.81250000000009,196.81250000000009,203.53604631128078,190.08895368871939,14778283,69.36184416398419,65.31726114685975,NaN,NaN,NaN,NaN,NaN,NaN,0.3330254520969711,2.820916135524044,2.487890683427073,92.92502639915506,93.69970132573538,5382269640,14466952632.572653,37.04265077831881,16.463468019868372,28.589432123248343,100,0
2019-11-13,200.84,201.775,200.71,201.59,185.76221550069943,190.66882847258182,193.9254732051169,197.69884650766977,185.34985000000017,190.8588,192.93880000000013,197.24000000000007,197.24000000000007,204.03658737896973,190.4434126210304,16110341,69.47038049328344,66.08156443309488,NaN,NaN,NaN,NaN,NaN,NaN,0.26024222780577766,2.813193468184295,2.5529512403785173,93.23144104803488,92.98876887154836,5398379981,14477465953.69472,35.553336462923966,16.216814790740052,30.24409075115329,92.85714285714286,0
2019-11-14,200.83,201.56,200.22,201.43,185.9181138539263,190.88192097807524,194.2197683735437,198.05419445932026,185.51620000000017,191.02380000000002,193.1318000000001,197.63400000000007,197.63400000000007,204.44286598487415,190.825134015126,17055686,68.63250970244586,66.57050264336068,NaN,NaN,NaN,NaN,NaN,NaN,0.1674951899000705,2.762320227753605,2.5948250378535347,88.72832369942198,91.6282637155373,5381324295,14491212327.485764,33.67756210323551,17.248241321693747,31.03630526817014,85.71428571428571,0
2019-11-15,202.61,202.91,202,202.91,186.08718734791708,191.12010076068762,194.56056177065963,198.51665212986117,185.69350000000017,191.195,193.3582000000001,198.19500000000008,198.19500000000008,204.7982401137592,191.59175988624096,18434519,71.99692440396431,67.05584440887232,NaN,NaN,NaN,NaN,NaN,NaN,0.17137638661078336,2.8090455211170138,2.6376691345062304,100,93.98658824915229,5399758814,14509646846.485764,37.0050379413039,16.250770888436595,31.70566489324012,100,14.285714285714286
2019-11-18,202.61,203.39,201.77,203.07,186.25617055838558,191.3567324287928,194.89426523063378,198.95030430796962,185.86120000000017,191.36070000000004,193.59580000000008,198.67900000000006,198.67900000000006,205.221268413936,192.13673158606412,18408797,72.34229773360178,67.89597953618055,NaN,NaN,NaN,NaN,NaN,NaN,0.15098891234382172,2.8264052749360076,2.675416362592186,96.04938271604946,94.92590213849047,5418167611,14520783032.32527,36.53434369201865,15.213656185033464,32.80179646250658,100,7.142857142857143
2019-11-19,203.84,203.84,202.59,203.37,186.42645741850114,191.59461891535136,195.2266469862952,199.3712277072106,186.0229000000002,191.52700000000002,193.85040000000012,199.25500000000005,199.25500000000005,205.30051238523234,193.20948761476777,16997568,73.01434826885347,68.65669982631967,NaN,NaN,NaN,NaN,73.01434826885347,NaN,0.12504938902143437,2.831728098868979,2.7066787098475444,94.05063291139243,96.70000520914728,5435165179,14524998429.18927,36.507433803367405,14.447486770041268,34.40547989926455,100,0
2019-11-20,202.85,203.45,200.62,202.15,186.58291057851605,191.80363636257212,195.49815102604833,199.63587268747625,186.18105000000017,191.6559,194.0448000000001,199.75150000000005,199.75150000000005,204.98027911179807,194.52272088820203,36706275,65.99173664598274,68.90345054325222,NaN,NaN,NaN,NaN,NaN,NaN,-0.0002981202675242933,2.706306059513139,2.7066041797806633,72.7858293075685,87.62861497833678,5398458904,14527981624.68397,32.51501347631868,20.480152885900328,34.42986431942535,92.85714285714286,0
2019-11-21,201.94,202.07,201.07,201.7,186.73332937872982,191.99960395935287,195.7413607897327,199.83245624104995,186.3484000000002,191.77280000000002,194.21420000000012,200.13200000000006,200.13200000000006,204.72654284994232,195.5374571500578,17934353,63.563259805878594,68.73694132172696,NaN,NaN,63.563259805878594,NaN,NaN,NaN,-0.13224142512778592,2.541302398370931,2.6735438234987168,57.66567754698295,74.83404658864795,5380524551,14532644556.46397,31.116496792706847,19.59927256534586,34.05586439121675,85.71428571428571,0
2019-11-22,202.17,202.32,200.74,201.83,186.88354500680217,192.19426526708847,195.98013095484123,200.0226985038071,186.51475000000016,191.87669999999997,194.40000000000012,200.44150000000008,200.44150000000008,204.59694113180885,196.2860588681913,17197019,63.975694834565765,68.44838861046,NaN,NaN,NaN,NaN,NaN,NaN,-0.22408651083177222,2.3934356849590017,2.617522195790774,60.23738872403584,63.562965192862414,5397721570,14539175070.008274,29.14172470811769,19.680938037460123,32.96125268451601,78.57142857142857,14.285714285714286
2019-11-25,202.67,204.26,202.67,204.22,187.05604704653547,192.4323986281362,196.3032630742592,200.42244150344453,186.69385000000017,192.0084,194.65080000000012,200.77400000000006,200.77400000000006,205.02038387336336,196.52761612663676,17794718,70.57094875426557,68.61732308066003,NaN,NaN,NaN,NaN,NaN,NaN,-0.1412454797266527,2.440965346132458,2.5822108258591108,99.26940639269421,72.39082422123765,5415516288,14556074456.285004,33.96349827932668,17.808967948743767,32.70417087413055,100,7.142857142857143
2019-11-26,204.32,204.87,204.05,204.61,187.2307132450774,192.67353924936123,196.62901746350394,200.82125659835458,186.86245000000017,192.15740000000002,194.89100000000013,201.20250000000004,201.20250000000004,205.17215426706383,197.23284573293625,14812921,71.48824833894298,68.97630375424798,NaN,NaN,NaN,NaN,NaN,NaN,-0.08057063919291352,2.481497526867969,2.5620681660608824,95.12195121951238,84.87624877874747,5430329209,14561493817.626467,35.314189505280176,17.213955503866142,33.142460181045074,100,0
2019-11-27,205.13,206.05,204.89,206.04,187.41787032721592,192.93822164046298,196.99807560219006,201.31827977946367,187.03760000000017,192.31119999999999,195.1614000000001,201.65500000000006,201.65500000000006,205.66378784671394,197.64621215328617,17060233,74.6129162355634,69.4641628293386,NaN,NaN,NaN,NaN,74.6129162355634,NaN,0.029584194274832498,2.599048408904423,2.5694642146295905,99.84639016897052,98.07924926039236,5447389442,14578259908.67819,38.08546164120706,16.19091680722624,33.46702177478317,100,7.142857142857143
2019-11-29,205.59,205.83,205,205.1,187.59381191599985,193.17904893471123,197.31579812759438,201.67844360999092,187.2070000000002,192.4366,195.4066000000001,202.05600000000007,202.05600000000007,205.74580433085035,198.3661956691498,9854553,69.2411083048465,69.4574355252298,NaN,NaN,NaN,NaN,NaN,NaN,0.013662338723361422,2.586542138033792,2.5728797993104306,84.45171849427145,93.1400199609181,5437534889,14570779946.762527,36.4027818129372,15.475574838435765,33.98397413203258,92.85714285714286,0
2019-12-02,205.11,205.18,201.78,203,187.74710731982074,193.3735232132318,197.53870800494363,201.80430612332512,187.36230000000018,192.5424,195.6506000000001,202.26250000000007,202.26250000000007,205.66723126692065,198.8577687330795,28121020,59.01831877059084,68.80575260405497,NaN,NaN,NaN,NaN,NaN,NaN,-0.15450692227840568,2.3797461464624234,2.534253068740829,47.68439108061741,77.32749991461976,5409413869,14562839894.056644,31.502534283789974,26.14091686165304,32.28395173246577,85.71428571428571,0
2019-12-03,200.32,201.49,199.23,201.41,187.88305650071806,193.53266136742525,197.69052337729877,201.7667531591989,187.5079500000002,192.62119999999996,195.8688000000001,202.32800000000003,202.32800000000003,205.61206820879374,199.04393179120632,31425404,52.67687788125107,67.61396929814548,NaN,NaN,52.67687788125107,NaN,NaN,NaN,-0.3763870358693948,2.063769273904086,2.4401563097734806,31.964809384164223,54.70030631968435,5377988465,14592040490.693811,27.1399865637323,31.887708177243905,30.11122651436401,78.57142857142857,100
2019-12-04,202.49,202.91,202.14,202.43,188.02780220717858,193.70884629084256,197.87638520564,201.8299195249895,187.65885000000017,192.70399999999995,196.15800000000013,202.43900000000005,202.43900000000005,205.57599155242363,199.30200844757647,15336754,55.947002548564825,66.64801373066557,NaN,NaN,NaN,NaN,NaN,NaN,-0.4528787843631412,1.874057829319554,2.326936613682695,46.9208211143696,42.19000719305041,5393325219,14588256096.849657,30.922411687039464,30.101556861194602,27.539399376207367,71.42857142857143,92.85714285714286
2019-12-05,203.15,203.15,201.84,202.83,188.1750877573559,193.8894631959744,198.07064460934038,201.9251652845143,187.81490000000016,192.80079999999995,196.41300000000012,202.59250000000006,202.59250000000006,205.48068887885833,199.70431112114179,15038785,57.19616271749286,65.83113180316893,NaN,NaN,NaN,NaN,NaN,NaN,-0.4727688476113525,1.7359755541685047,2.208744401779857,52.785923753665855,43.89051808406657,5408364004,14595947689.177902,29.37489282302055,29.74119157359428,25.279280582300167,64.28571428571429,85.71428571428571
2019-12-06,204.25,205.145,204.1501,205,188.34249981947175,194.10947382575708,198.34238403642507,202.2180066859891,187.97545000000017,192.92879999999994,196.72540000000015,202.82100000000005,202.82100000000005,205.71179850560023,199.93020149439988,16562247,63.27942525343927,65.20845329241713,NaN,NaN,NaN,NaN,NaN,NaN,-0.34210460033000656,1.781113651367349,2.1232182516973555,84.60410557184738,61.436950146627616,5424926251,14607682263.41682,34.31438470953748,27.154912506419603,23.32759020197042,57.142857142857146,78.57142857142857
2019-12-09,204.63,205.5937,203.98,204.07,188.4989923585815,194.3067119678213,198.5669964271535,202.3943870016092,188.12820000000022,193.04529999999994,197.06620000000018,202.96300000000005,202.96300000000005,205.8058513854908,200.1201486145093,14032175,59.384199272327756,64.28287483089757,NaN,NaN,NaN,NaN,NaN,NaN,-0.3209804959353302,1.7219926317781926,2.042973127713523,70.9677419354837,69.45259042033231,5410894076,14595215305.929369,33.915538217390015,25.49089248091972,21.397617447455133,50,71.42857142857143
2019-12-10,204.17,204.88,203.44,203.9,188.65223621571002,194.4966780674684,198.77613382216708,202.53777871574167,188.2792000000002,193.17419999999996,197.36800000000014,203.11000000000007,203.11000000000007,205.82450916372994,200.3954908362702,21849714,58.67321389886897,63.258508090184385,NaN,NaN,NaN,NaN,NaN,NaN,-0.3203883874357527,1.642487643418832,1.9628760308545847,68.47507331378301,74.68230694037136,5389044362,14587325131.429369,32.0293597832443,26.15876687732871,19.025897615070004,42.857142857142854,64.28571428571429
2019-12-11,204.37,205.19,204.04,204.98,188.8147015269965,194.70426860078584,199.019422691886,202.77037121900437,188.4361500000002,193.29869999999994,197.72220000000016,203.28200000000007,203.28200000000007,206.0126819660948,200.55131803390535,18897759,61.802093423252344,62.95924785998937,NaN,NaN,NaN,NaN,NaN,NaN,-0.2521940657833599,1.6476334486253847,1.8998275144087446,84.31085043988243,74.58455522971639,5407942121,14599321100.18589,31.622074450467963,24.826732224321336,18.2636623683437,35.714285714285715,57.142857142857146
2019-12-12,204.77,207.32,204.491,206.51,188.9907741486184,194.93804546017623,199.31317082161596,203.12652634100397,188.60275000000019,193.42589999999993,198.17140000000015,203.52800000000008,203.52800000000008,206.4819776573226,200.57402234267755,32704625,65.7573685577076,63.11596991369144,NaN,NaN,NaN,NaN,NaN,NaN,-0.11591009561857635,1.7549398948855242,1.8708499905041005,89.98763906056858,80.924520938078,5440646746,14613297732.078785,36.31005185450814,22.161553285413568,18.369937889347376,100,50
2019-12-13,206.36,207.91,205.96,207.19,189.17186097301027,195.18065842136085,199.62206608351337,203.51352383233692,188.7667500000002,193.54629999999995,198.59380000000016,203.8160000000001,203.8160000000001,207.009107577254,200.62289242274616,32534393,67.37432672659449,63.35872933455063,NaN,NaN,NaN,NaN,NaN,NaN,0.00192608451252263,1.8732575961447537,1.871331511632231,91.70506912442399,88.66785287495833,5473181139,14621806727.171093,35.86325349129728,20.525885634186096,18.928601710899233,100,42.857142857142854
2019-12-16,208.5,209.53,208.48,209.27,189.37184245586587,195.4596552843042,200.0004164331795,204.06175965782865,188.9410000000002,193.70599999999996,199.00300000000013,204.13400000000007,204.13400000000007,208.08070698177173,200.18729301822842,21366177,71.76611504865566,63.4440983555785,NaN,NaN,NaN,NaN,NaN,NaN,0.19136271937461813,2.110534910850504,1.9191721914758857,97.4757281553399,93.05614544677748,5494547316,14632591559.371094,38.76874467211853,18.738585070538644,19.187721895664133,100,35.714285714285715
2019-12-17,209.5,209.71,209.04,209.39,189.5710281030712,195.735503694516,200.36863539658424,204.56921111898782,189.11520000000021,193.84699999999992,199.42600000000016,204.4500000000001,204.4500000000001,208.97501491709306,199.92498508290714,16034647,72.00028871982356,63.480672668498535,NaN,NaN,NaN,NaN,NaN,NaN,0.290227775273304,2.2819569105675157,1.9917291352942117,96.94656488549599,95.37578738841995,5510581963,14633309528.63975,38.457507445309695,18.24861535962311,19.271991413968326,100,28.571428571428573
2019-12-18,209.6,210.13,209.33,209.55,189.76982384333914,196.00905807680283,200.72868891044368,205.0435719647985,189.2951500000002,193.99629999999993,199.90860000000015,204.75900000000007,204.75900000000007,209.76525169163423,199.7527483083659,15490828,72.32982463598364,63.317594697099985,NaN,NaN,NaN,NaN,NaN,NaN,0.3290328692896729,2.403020221906303,2.07398735261663,94.67889908256896,96.36706404113494,5526072791,14626338656.03975,38.9142952275793,17.655006745828313,19.074989232317908,100,21.428571428571427
2019-12-19,209.64,210.93,209.62,210.86,189.9796763424104,196.30313613468792,201.1259952276812,205.59751749196056,189.49230000000023,194.16709999999995,200.38120000000015,205.19450000000012,205.19450000000012,210.7069385710761,199.68206142892413,17892062,74.9312853158227,63.72403591216971,NaN,NaN,NaN,NaN,NaN,NaN,0.40079969652697134,2.574986973275344,2.1741872767483725,99.40170940170945,97.0090577899248,5543964853,14642318589.27639,40.000247345671696,16.64893158127446,19.137984357562917,100,14.285714285714286
2019-12-20,211.81,212.5186,211.27,211.71,190.19589846835655,196.60822254786243,201.54105423836035,206.1796586832024,189.69500000000022,194.3731999999999,200.84180000000012,205.6950000000001,205.6950000000001,211.64756415336373,199.74243584663648,27690934,76.47666955038436,64.97106096786925,NaN,NaN,NaN,NaN,NaN,NaN,0.4591945349615094,2.7481804454502594,2.28898591048875,93.915085110546,95.99856453160812,5571655787,14634143931.041246,43.83181590397252,15.505290601850922,21.883480925603436,100,7.142857142857143
2019-12-23,212.03,212.15,211.63,211.81,190.41096415523856,196.90924784394437,201.94375799371878,206.71588166575455,189.88040000000024,194.5897999999999,201.25580000000014,206.1940000000001,206.1940000000001,212.43323200401338,199.95476799598683,23798671,76.65897101820207,66.68406762050861,NaN,NaN,NaN,NaN,NaN,NaN,0.4572370708553519,2.8605322490579397,2.4032951782025878,93.36429869083972,95.56036440103172,5595454458,14626821263.041246,42.838284102227355,15.153833583916986,24.71884440299774,92.85714285714286,0
2019-12-24,211.97,212.09,211.44,211.92,190.62498441240035,197.20649046089596,202.3349831704357,207.21151198330173,190.0615500000002,194.8354999999999,201.67240000000012,206.5790000000001,206.5790000000001,213.22077656955616,199.93722343044402,7089020,76.87130516938265,68.17866066485273,NaN,NaN,NaN,NaN,NaN,NaN,0.4171506071022426,2.9247334370803912,2.5075828299781486,94.39439626917381,93.89126002351985,5602543478,14630202180.272015,41.56985693334555,15.570646908803152,27.872798422274794,85.71428571428571,7.142857142857143
2019-12-26,212.26,213.81,212.23,213.79,190.85548207993867,197.53487678840298,202.78419951669312,207.8380346515587,190.2454500000002,195.1660999999999,202.07780000000014,207.0380000000001,207.0380000000001,214.3108800347536,199.76511996524658,17159310,80.17334890573976,69.81988824972751,NaN,NaN,NaN,NaN,80.17334890573976,NaN,0.46663534142618257,3.090877006760877,2.6242416653346945,99.80713596914167,95.85527697638507,5619702788,14646927077.360622,45.76451571690103,14.249457926693685,31.579458434909444,100,0
2019-12-27,214.55,214.56,213.04,213.61,191.0818951935711,197.85319605991975,203.20874071211693,208.38774563712454,190.42995000000016,195.46959999999993,202.48920000000012,207.4165000000001,207.4165000000001,215.21141956340253,199.62158043659767,18142239,79.00412670183104,70.94308121032694,NaN,NaN,NaN,NaN,NaN,NaN,0.4377777287194924,3.17146382623406,2.7336860975145676,91.4568345323742,95.21945559022988,5601560549,14642391517.610622,46.00943191144826,13.273962285104968,34.691700065462946,100,14.285714285714286
2019-12-30,213.51,213.63,211.16,212.21,191.29212509214256,198.13748920724808,203.56173127242607,208.7517698621603,190.59925000000018,195.74919999999992,202.86240000000012,207.77200000000008,207.77200000000008,215.75808439724716,199.785915602753,21829913,70.40400479993774,71.73021017658479,NaN,NaN,NaN,NaN,NaN,NaN,0.2824740805258985,3.0867786981719405,2.804304617646042,78.8669064748202,90.0436256587787,5579730636,14639121449.67135,41.08710371422086,19.996847746034245,36.14493597027404,92.85714285714286,7.142857142857143
2019-12-31,211.62,212.76,211.2,212.61,191.50424325042968,198.42407357938177,203.91656534017406,209.11922035147836,190.7700500000002,195.9926999999999,203.2808000000001,208.2525000000001,208.2525000000001,216.18854907998085,200.31645092001938,18201585,71.36317640500309,72.63663606988007,NaN,NaN,NaN,NaN,NaN,NaN,0.17028576012494145,3.0171618178022186,2.846876057677277,81.46387832699632,83.92920644473026,5597932221,14653822729.863659,38.30010966152517,18.640434402117542,37.89048490034056,85.71428571428571,0
2020-01-02,214.4,216.16,213.98,216.16,191.74957416336073,198.77528004315639,204.39670003271624,209.7897707941947,190.9556000000002,196.2893999999999,203.73620000000014,208.9900000000001,208.9900000000001,216.9866868139186,200.9933131860816,31014904,78.13571739992504,73.80332349678527,NaN,NaN,NaN,NaN,NaN,NaN,0.2916399143725932,3.2114259506430187,2.9197860362704255,100,86.77692826727218,5628947125,14684837633.863659,46.49246672190399,15.9834475154588,40.51871260885552,100,0
2020-01-03,213.29,215.47,213.28,214.18,191.97276248014322,199.08032400269784,204.78035885496266,210.20788786141426,191.12770000000017,196.5876999999999,204.18280000000013,209.5775000000001,209.5775000000001,217.28119229654672,201.87380770345348,27532657,68.41693353539709,73.9932924237631,NaN,NaN,68.41693353539709,NaN,NaN,NaN,0.19943599469726037,3.169081029642001,2.9696450349447407,80.58823529411772,87.35070454037135,5601414468,14679934557.959549,41.34382308084836,16.90504990960825,41.78718222437594,92.85714285714286,0
2020-01-06,212.49,215.59,212.24,215.56,192.2074613609378,199.4066542204662,205.20308988025823,210.71761282699387,191.29265000000018,196.85939999999988,204.64960000000013,210.2140000000001,210.2140000000001,217.68251096269495,202.74548903730528,21726989,71.11375382874705,74.26039435963114,NaN,NaN,NaN,NaN,NaN,NaN,0.1921842888772458,3.209875396041298,3.017691107164052,92.18750000000009,90.92524509803928,5623141457,14701272406.858057,36.307194362791314,18.627593830001146,42.14316323536416,85.71428571428571,0
2020-01-07,215.64,216.14,214.85,215.53,192.439526422023,199.72592839431837,205.6080667476991,211.17593541489921,191.4775000000002,197.18709999999984,205.07840000000016,210.7405000000001,210.7405000000001,218.1489181172406,203.3320818827596,23120994,70.97187720093227,74.20366308479375,NaN,NaN,NaN,NaN,NaN,NaN,0.14813819845368448,3.2028638552311577,3.054725656777473,91.15168539325849,87.9758068957921,5600020463,14702527034.439453,36.61153022485351,17.731792837537146,42.13680431711669,78.57142857142857,0
2020-01-08,215.47,218.14,215.16,217.15,192.68540178100784,200.07095951522297,206.06069158112265,211.74489394681356,191.6721500000002,197.53309999999988,205.50860000000014,211.3945000000001,211.3945000000001,218.6395685986997,204.14943140130052,26464212,73.98962106717384,74.34575825246161,NaN,NaN,NaN,NaN,NaN,NaN,0.18830057780861953,3.290101379038248,3.1018008012296283,88.76276958002289,90.70065165776049,5626484675,14711407642.493145,39.870835686394265,15.837088846730953,42.672838854921814,100,0
2020-01-09,218.91,219.41,217.7125,218.99,192.9471390767192,200.44559398026806,206.56772328382374,212.43490404711704,191.8718500000002,197.8681999999999,205.93700000000015,212.14900000000011,212.14900000000011,219.25665474681074,205.0413452531895,23641291,76.9239715287869,74.67391160194757,NaN,NaN,NaN,NaN,NaN,NaN,0.2927485272743646,3.467736460322584,3.1749879330482194,95.70990806945875,91.87478768091337,5650125966,14723350150.317888,41.18107565451502,14.565919302483572,43.39868179315454,100,0
2020-01-10,219.76,219.87,218.04,218.43,193.20069988192597,200.80172083214393,207.03291060602672,213.00586556643924,192.0745000000002,198.16819999999984,206.38480000000015,212.8215000000001,212.8215000000001,219.62745408446733,206.01554591553287,21914631,74.18105131949065,74.62032345935242,NaN,NaN,NaN,NaN,NaN,NaN,0.27818446629105065,3.5227185159120324,3.244534049620982,83.4672789896671,89.31331887971623,5628211335,14710776181.71133,40.131534021111115,13.613096005502682,43.978727010615124,100,0
2020-01-13,219.31,220.98,218.98,220.95,193.4768123209118,201.20069665724998,207.57867881755507,213.76244979820694,192.2877000000002,198.5079999999999,206.86400000000012,213.54350000000008,213.54350000000008,220.57794176889135,206.5090582311088,22846102,77.98524432632675,74.72807880049116,NaN,NaN,NaN,NaN,NaN,NaN,0.38571382083558703,3.7266763256654656,3.3409625048298786,99.69450101832993,92.95722935915192,5651057437,14732936900.65133,40.43526503932158,12.396242480227198,44.35974417293095,100,35.714285714285715
2020-01-14,220.75,221.21,219.74,220.08,193.7415206560271,201.57454424819554,208.06892670706273,214.36412124599676,192.4898000000002,198.82249999999985,207.32400000000015,214.1880000000001,214.1880000000001,221.1373614095015,207.2386385904987,24573340,73.93503325616595,74.53351181748859,NaN,NaN,NaN,NaN,NaN,NaN,0.34691109627991334,3.7746013751797705,3.427690278899857,88.75621890547269,90.63933297115655,5626484097,14719730819.97106,39.13195801790281,11.744497528678629,44.794958964089155,100,28.571428571428573
2020-01-15,220.18,221.2,219.45,220.17,194.0044905997482,201.94277109476593,208.5434786009034,214.91706207971134,192.6804500000002,199.14399999999983,207.75000000000014,214.73300000000012,214.73300000000012,221.76329473065385,207.70270526934638,25742084,74.08497576690857,74.33448828874043,NaN,NaN,NaN,NaN,NaN,NaN,0.2788986391110506,3.7763135777886703,3.4974149386776197,89.65174129353214,92.70082040577825,5652226181,14715170793.662489,36.660829687370864,12.049311462185596,45.15395793124717,92.85714285714286,21.428571428571427
2020-01-16,221.24,222.32,220.8,222.28,194.28583895198952,202.34548849882998,209.08216571459346,215.61829426259598,192.87820000000022,199.54609999999985,208.19360000000015,215.37750000000014,215.37750000000014,222.68813848099663,208.06686151900365,18804959,77.3715737454057,74.13436149157371,NaN,NaN,NaN,NaN,NaN,NaN,0.3244194273145711,3.9029392228208337,3.5785197955062626,99.64157706093197,92.68317908664558,5671031140,14732986017.97828,37.85077592167897,11.12021264439001,45.30193088934406,100,14.285714285714286
2020-01-17,223.24,223.56,222.1221,223.38,194.57533309177072,202.76201347905118,209.64286509833488,216.35750433282493,193.0762000000002,199.93169999999986,208.65700000000015,216.06900000000013,216.06900000000013,223.65509227467243,208.48290772532783,24325167,78.87566091907496,74.12518536423399,NaN,NaN,NaN,NaN,NaN,NaN,0.3735191213218889,4.045418697158624,3.671899575836735,98.54838709677415,95.94723515041274,5695356307,14751221011.725618,40.396563301258055,10.535133487560751,45.545625876169375,100,7.142857142857143
2020-01-21,222.73,223.84,222.66,223.28,194.860951667972,203.16831024184225,210.17765470232175,217.01678963446065,193.27405000000022,200.32019999999986,209.12740000000016,216.69000000000014,216.69000000000014,224.498917978813,208.88108202118727,21146264,78.36570026005944,74.69387789709982,NaN,NaN,NaN,NaN,NaN,NaN,0.3448555948449874,4.1029690693929695,3.758113474547982,95.56962025316456,97.9198614702902,5674210043,14752296245.48833,39.65597324579809,10.067031001344487,47.329974348216865,100,0
2020-01-22,224.38,225.15,223.59,223.87,195.14959891505686,203.57824469249883,210.71460941987775,217.6694763359406,193.4701000000002,200.70799999999986,209.59620000000018,217.29800000000014,217.29800000000014,225.35100838195652,209.24499161804377,20736403,79.21936845161386,75.25503447185773,NaN,NaN,NaN,NaN,NaN,NaN,0.31220237009109786,4.1483664371618545,3.8361640670707566,90.08520526723468,94.73440420572445,5694946446,14739003679.46269,41.79856362917821,9.357448900715404,49.393500218215856,100,0
2020-01-23,223.71,224.69,222.7,224.59,195.4425382293349,203.9943190550236,211.2587423838041,218.32857382775578,193.66740000000019,201.07469999999986,210.06340000000014,217.93700000000013,217.93700000000013,226.17281714220658,209.70118285779367,26496113,80.24387152802247,75.40561690957898,NaN,NaN,NaN,NaN,80.24387152802247,NaN,0.2863449396917854,4.194095241685488,3.907750301993703,95.66227730441517,93.77236760827145,5721442559,14762836866.533043,38.67448511821132,12.000761961926692,49.6651675397395,92.85714285714286,14.285714285714286
2020-01-24,225.62,225.88,221.6701,222.7,195.71375675441615,204.36472857868648,211.7074191530667,218.74490012987428,193.8585000000002,201.42699999999985,210.49820000000017,218.4760000000001,218.4760000000001,226.47368566523255,210.47831433476767,37436483,70.42829743856038,75.54928575980493,NaN,NaN,NaN,NaN,NaN,NaN,0.09888573016312296,4.0313574646976065,3.9324717345344835,76.68621700879758,87.47789986014914,5684006076,14743717129.223772,37.16011420288404,10.254606288160335,50.7215436177366,100,7.142857142857143
2020-01-27,217.72,219.2845,217.18,218.1,195.93650544342694,204.63671415138575,211.95810859804448,218.68348106988626,194.02165000000022,201.75149999999988,210.82940000000016,218.69150000000008,218.69150000000008,226.3995328878362,210.98346711216396,42264418,53.32990285871893,74.27901069051721,NaN,NaN,NaN,NaN,NaN,NaN,-0.35320667177938603,3.490963394810251,3.844170066589637,29.465095194922934,67.27119650271187,5641741658,14738405207.835793,30.82651534510436,22.370863830384693,49.55811349871606,92.85714285714286,0
2020-01-28,219.6,221.96,219.06,221.45,196.19037106090528,204.96965050482365,212.3303396334153,218.94695906323042,194.20375000000018,202.08269999999985,211.2266000000002,219.0835000000001,219.0835000000001,226.51025238579498,211.65674761420522,26731876,60.79479494367842,73.5520762435705,NaN,NaN,NaN,NaN,NaN,NaN,-0.43931114437111507,3.2950311361257434,3.7343422804968585,58.67537313432829,54.94222844601625,5668473534,14755734837.794413,35.20450726416428,19.82611956245526,49.07265266227665,85.71428571428571,0
2020-01-29,222.66,222.93,220.83,221.81,196.4452927418913,205.30312277205485,212.7020910203402,219.21962962863705,194.3836500000002,202.3829999999999,211.63420000000016,219.56350000000006,219.56350000000006,226.36591214570055,212.76108785429957,29063128,61.50732839926677,72.66048391014857,NaN,NaN,NaN,NaN,NaN,NaN,-0.481321270329361,3.1326906925851574,3.6140119629145184,53.21839080459772,47.11961971128297,5697536662,14753797295.927746,35.890936658711134,18.58733658948735,48.259793165729334,78.57142857142857,0
2020-01-30,220.37,222.7,219.6891,222.6,196.70553858525557,205.6456351924102,213.09024431366018,219.54156966400495,194.56735000000023,202.69309999999987,212.02800000000016,220.0630000000001,220.0630000000001,226.18252972048532,213.94347027951488,39568093,63.092532022793186,71.67252394543473,NaN,NaN,NaN,NaN,NaN,NaN,-0.4649530498680301,3.032820650579481,3.497773700447511,62.29885057471258,58.064204837879515,5737104755,14790737065.635708,32.73298924003066,20.28593079142426,46.526498237800716,71.42857142857143,78.57142857142857
2020-01-31,223.5,223.56,218.285,219.07,196.92807053963114,205.91146419850108,213.3247445366539,219.49665826743305,194.73020000000022,202.9718999999999,212.34800000000018,220.2085000000001,220.2085000000001,226.08340348856242,214.33359651143778,52015832,52.65738469964342,70.13511918687422,NaN,NaN,52.65738469964342,NaN,NaN,NaN,-0.6874850476525589,2.6384173908818127,3.3259024385343716,21.724137931034356,45.74712643678154,5685088923,14754202722.970304,28.072679473544216,21.18745090411404,44.00047867317547,64.28571428571429,71.42857142857143
2020-02-03,220.14,222.885,219.99,222.38,197.18132356908754,206.23757381833275,213.67985259404003,219.77126224196323,194.9063500000002,203.28929999999986,212.7282000000002,220.6185000000001,220.6185000000001,225.86412779845395,215.37287220154624,25468307,59.432769418874706,68.80994240777049,NaN,NaN,NaN,NaN,NaN,NaN,-0.6100098409263417,2.5633901373764445,3.173399978302786,59.770114942528686,47.93103448275853,5710557230,14770785713.88395,25.270478124980155,19.07252975623804,41.20796047771571,57.142857142857146,64.28571428571429
2020-02-04,225.39,227.86,224.6523,227.47,197.48270343407174,206.65801790113804,214.2206426883914,220.50447536177626,195.1067500000002,203.6396999999999,213.23460000000017,221.21400000000008,221.21400000000008,226.7248126442421,215.70318735575808,30691211,67.20526252307101,68.3292444982637,NaN,NaN,NaN,NaN,NaN,NaN,-0.2335715314612714,2.881435563976197,3.1150070954374685,96.34831460674143,59.280855826768146,5741248441,14794013900.106071,34.03362419896201,16.521397618904718,39.837148243827805,100,57.142857142857146
2020-02-05,230.22,230.25,226.85,228.22,197.7885471809964,207.08498784368976,214.7696370927682,221.23928723208329,195.3082500000002,203.98959999999988,213.76500000000019,221.84850000000006,221.84850000000006,227.51541547492738,216.18158452507274,38534817,68.17289467539997,67.90695299172738,NaN,NaN,NaN,NaN,NaN,NaN,0.03408123650397776,3.1576086410674407,3.123527404563463,84.46824789594488,80.19555914840498,5779783258,14786533612.10019,37.00847155151273,15.165965541363127,39.2184272273597,100,50
2020-02-06,228.77,230.25,227.98,230.19,198.11094969660837,207.54251283688401,215.3743572067773,222.09173606712298,195.50765000000018,204.3660999999999,214.33220000000017,222.50050000000005,222.50050000000005,228.81828909112934,216.18271090887075,22467077,70.62465886149906,67.42503050001977,NaN,NaN,NaN,NaN,NaN,NaN,0.2972984060369628,3.495150412109666,3.1978520060727034,99.54093343534811,93.45249864601146,5802250335,14807813002.210321,34.94702172303372,14.321189311670835,38.30984829113213,92.85714285714286,42.857142857142854
2020-02-07,229.16,230.44,228.54,229.2,198.4202934807217,207.9713739688269,215.91653927709976,222.76871358453982,195.70510000000021,204.74129999999985,214.83180000000016,223.01100000000005,223.01100000000005,229.7477615365231,216.27423846347702,25884933,67.7981331344244,66.63377851540187,NaN,NaN,NaN,NaN,NaN,NaN,0.35435926132682116,3.6408010827312296,3.2864418214044084,90.64856711915527,91.55258281681608,5776365402,14799911285.820848,33.75433358895194,13.636509883897782,37.154171218645494,100,35.714285714285715
2020-02-10,228.43,231.98,228.38,231.97,198.75412140628666,208.44659428627588,216.5460867564292,223.64502657648842,195.91255000000018,205.13499999999988,215.37900000000016,223.68800000000005,223.68800000000005,231.13153840589212,216.24446159410797,21478925,71.2635747000147,66.12648383254154,NaN,NaN,NaN,NaN,NaN,NaN,0.5183608679560741,3.934392906349501,3.416032038393427,99.93243243243249,96.70731099564527,5797844327,14821270883.459738,34.556359704324585,12.42446304008097,36.26851493588435,100,28.571428571428573
2020-02-11,233.21,234.02,231.3999,232.01,199.08502567090073,208.91319637961695,217.1525147267653,224.44169071206096,196.1193500000002,205.5298999999999,215.89840000000015,224.24100000000004,224.24100000000004,232.39788886769813,216.08411113230196,30197983,71.31158660809609,65.56164227229027,NaN,NaN,NaN,NaN,NaN,NaN,0.5653899590249791,4.122769487174651,3.5573795281496716,88.06413301662697,92.88171085607156,5828042310,14805136325.083454,37.37661852925821,11.6152815069116,35.49471597710432,100,21.428571428571427
2020-02-12,233.34,234.38,232.8,234.27,199.43512491795644,209.41531130279284,217.82378865904903,225.37772016805516,196.3356000000002,205.9441999999999,216.48180000000013,224.95050000000006,224.95050000000006,233.96019805265,215.94080194735014,24471275,73.95891838804665,65.11271704800629,NaN,NaN,NaN,NaN,NaN,NaN,0.6770241764011038,4.403659748651052,3.726635572249948,99.36046511627916,95.78567685511285,5852513585,14826200207.361935,36.052999852324334,10.922336081023145,35.556214474043216,100,14.285714285714286
2020-02-13,232.62,234.93,232.36,233.97,199.77875551578774,209.9015427621435,218.4569734175177,226.1960325330023,196.5577500000002,206.37589999999992,217.10120000000015,225.64050000000006,225.64050000000006,235.17831416258258,216.10268583741754,22773159,72.99598047075114,65.29612297887705,NaN,NaN,NaN,NaN,NaN,NaN,0.6583832907765208,4.549614685720599,3.8912313949440778,94.5915492957746,94.0053824762269,5829740426,14831959955.747149,35.09868237680349,10.210950705469807,35.42643392101198,100,7.142857142857143
2020-02-14,234.28,234.86,233.5501,234.64,200.12563357035702,210.3914132024971,219.09160191094838,227.0002199108116,196.78630000000018,206.81729999999988,217.76580000000013,226.25850000000005,226.25850000000005,236.42618464302328,216.09081535697683,23438530,73.81592267868491,66.75941010887463,NaN,NaN,NaN,NaN,NaN,NaN,0.6194682256724668,4.665566677034661,4.0460984513621945,98.25773505557213,97.40324982254195,5853178956,14847525401.389563,33.887206236845955,9.85850661616876,38.214523897438085,92.85714285714286,0
2020-02-18,233.47,235.17,233.25,234.73,200.46995562438332,210.87336541630904,219.7048724242445,227.73638944311526,197.01940000000016,207.2848999999999,218.41180000000014,226.82600000000008,226.82600000000008,237.53999533320354,216.11200466679662,24521242,73.93043205607594,67.6976699026173,NaN,NaN,NaN,NaN,NaN,NaN,0.531459551257595,4.710422890434188,4.178963339176593,97.3941368078176,96.74780705305477,5877700198,14860807740.806229,32.970523811283726,9.349125532389104,40.20534370965205,100,21.428571428571427
2020-02-19,236.07,237.47,235.85,236.98,200.8332396480213,211.39032847737224,220.38232840760747,228.6167333056757,197.24875000000017,207.75389999999987,219.09480000000013,227.51100000000002,227.51100000000002,238.9573407253157,216.06465927468435,22230464,76.67656174552694,68.78118657020731,NaN,NaN,NaN,NaN,76.67656174552694,NaN,0.5539283637938279,4.8713737939188775,4.3174454301250496,97.44592129267652,97.69926438535542,5899930662,14869590146.337093,36.720286754631935,8.661343302168559,42.35294874523258,100,14.285714285714286
2020-02-20,236.46,236.95,231.88,234.78,201.17101835799124,211.8534902897015,220.94694297985816,229.20371108608754,197.47295000000017,208.2078999999999,219.69040000000015,228.0565,228.0565,239.79297012521408,216.32002987478592,42604016,69.02074231288202,69.20463016235651,NaN,NaN,NaN,NaN,NaN,NaN,0.35921335378745756,4.766462122359371,4.407248768571914,85.9786291373469,93.60622907928034,5857326646,14875724452.388376,32.00127046134366,17.552069429754706,42.758823678135705,92.85714285714286,7.142857142857143
2020-02-21,233.64,234.01,229.3211,230.27,201.46056046388188,212.21817365030148,221.31255305907942,229.30526241122206,197.69310000000016,208.64029999999988,220.21440000000018,228.34050000000002,228.34050000000002,240.00234800964319,216.67865199035685,66058611,56.554518847843624,69.48299688722797,NaN,NaN,NaN,NaN,NaN,NaN,-0.10965850937640997,4.2701756318514015,4.3798341412278115,58.810068649885615,80.74487302663634,5791268035,14836402609.490873,27.87233237189186,21.33553289623478,42.709307225421824,85.71428571428571,0
2020-02-24,221.84,224.25,220.26,221.39,201.65886334483827,212.3997939740579,221.3155901940175,228.5514278958676,197.87120000000013,208.9660999999999,220.56420000000014,228.27500000000003,228.27500000000003,240.07671089291645,216.47328910708362,84522551,40.89322205291436,68.15874350394508,NaN,NaN,NaN,NaN,NaN,NaN,-1.0044207959161735,3.124308146332595,4.1287289422487685,6.565950029052847,50.45154927209512,5706745484,14799754987.127464,22.212721788672557,35.383867671006286,43.34435309948834,78.57142857142857,0
2020-02-25,223.19,223.9879,214.74,215.37,201.79529256528764,212.45860993496765,221.0824297942521,227.29605381054688,198.02420000000012,209.24709999999993,220.77200000000016,228.13850000000002,228.13850000000002,240.45951988473354,215.8174801152665,97742982,34.01601564105164,65.78808301237227,NaN,NaN,NaN,NaN,NaN,NaN,-1.9344102346884808,1.7107161488881673,3.645126383576648,2.771667399911992,22.71589535961682,5609002502,14715329207.662094,18.479404220379607,39.46889718210347,43.457291101873466,71.42857142857143,100
2020-02-26,216.67,220.28,214.9,216.48,201.94140905717532,212.53824142140394,220.90194235134027,226.26595344763766,198.18160000000012,209.5713999999999,220.9714000000002,227.89000000000004,227.89000000000004,240.92063467372049,214.8593653262796,80400053,36.14829640253761,63.50061170716781,NaN,NaN,NaN,NaN,NaN,NaN,-2.3782989316659573,0.6722527189942014,3.0505516506601587,7.65508139023309,5.664232939732643,5689402555,14682152977.613766,16.718945401286774,35.70885344392526,43.054197109991314,64.28571428571429,92.85714285714286
2020-02-27,211.05,216.4235,205.5,205.64,201.97821095710393,212.40164258137614,220.30343480815046,224.30157692881502,198.31690000000015,209.76709999999989,220.94040000000015,227.08150000000006,227.08150000000006,243.1688233012805,210.99417669871963,121822562,26.97920996290044,60.383079642982196,NaN,NaN,26.97920996290044,NaN,NaN,NaN,-3.2514401803112527,-1.0137485747289077,2.237691605582345,0.4379105411322689,3.621553110425784,5567579993,14563453070.198833,13.824352724228914,44.34839797882877,43.81183979679817,57.142857142857146,100
2020-02-28,198.92,207.17,198.17,205.8,202.01623870877452,212.27091698570533,219.73467265881123,222.5395219832136,198.4432000000001,209.93699999999987,220.87100000000018,226.2415000000001,226.2415000000001,244.74942400567613,207.73357599432404,149247073,27.272442809677003,57.48838747692882,NaN,NaN,NaN,NaN,NaN,NaN,-3.638452113422639,-2.3103735361959536,1.3280785772266852,19.414758269720156,9.169250067028505,5716827066,14667262700.97439,11.991685319550438,49.266148310880155,45.125955319000056,50,100
2020-03-02,208.88,216.57,205.94,216.42,202.1595597166474,212.35307704539434,219.6046854957206,221.95671036576468,198.6098500000001,210.2187999999999,221.01160000000016,226.10900000000007,226.10900000000007,244.85678162876684,207.3612183712333,112933945,43.4927617258532,55.50475797877443,NaN,NaN,NaN,NaN,NaN,NaN,-3.0246542725242374,-2.4527392634286116,0.5719150090956258,46.437659033078866,22.096775947977097,5829761011,14777009422.691229,22.977258124157554,42.07750822516786,43.85823382514792,42.857142857142854,92.85714285714286
2020-03-03,217.11,219.61,207.62,209.48,202.2323999184718,212.29618443063407,219.20763900569233,220.76845223569185,198.73260000000013,210.4593999999999,221.0102000000001,225.46400000000008,225.46400000000008,245.52238617635712,205.40561382364305,131953546,37.59238307422427,53.09624344064073,NaN,NaN,NaN,NaN,NaN,NaN,-2.9294889289829653,-3.0899461521330807,-0.16045722315011557,28.77862595419847,31.543681085665828,5697807465,14685995592.38097,23.331204495684695,35.81250874969754,41.60969808548726,35.714285714285715,85.71428571428571
2020-03-04,213.32,218.33,211.37,218.22,202.39148051629795,212.41348770923537,219.16890806429262,220.5257424989593,198.90850000000012,210.7692999999999,221.15740000000014,225.00150000000008,225.00150000000008,245.2789143075466,204.72408569245357,73086209,47.2905193055506,51.191357791891,NaN,NaN,NaN,NaN,47.2905193055506,NaN,-2.157043245260879,-2.8567612797262143,-0.6997180344653354,51.01781170483462,42.07803223070399,5770893674,14756771605.119476,20.862108393254122,32.02254043543867,39.29582507802834,28.571428571428573,78.57142857142857
2020-03-05,212.69,216.36,210.1,211.59,202.4830080733497,212.39718102192379,218.87169598333998,219.67471940382032,199.06670000000014,210.9983999999999,221.15500000000014,224.17000000000002,224.17000000000002,245.2011644946253,203.13883550537474,78705458,41.96322904755088,48.97473269023384,NaN,NaN,NaN,NaN,NaN,NaN,-1.976545399557323,-3.1703997839119893,-1.1938543843546663,34.147582697201045,37.98134011874471,5692188216,14715532962.589125,18.88712219213501,30.471665884808697,37.04882141357574,21.428571428571427,71.42857142857143
2020-03-06,204.67,209.15,202.91,208.02,202.53810252038105,212.3105041700045,218.44613927811096,218.564746127266,199.19765000000015,211.1674999999999,221.07920000000013,223.06150000000008,223.06150000000008,245.02308489271456,201.0999151072856,89828392,39.39011577331618,46.515746482707506,NaN,NaN,NaN,NaN,NaN,NaN,-1.9767439880571138,-3.6647843694260587,-1.6880403813689449,25.063613231552214,36.7430025445293,5602359824,14772827353.640408,17.031046889172508,35.61742723169519,35.64701181780082,14.285714285714286,64.28571428571429
2020-03-09,193.48,201.16,192.11,193.57,202.448867669432,211.93940507752916,217.47060440445955,216.18429411514543,199.26040000000012,211.19229999999993,220.71220000000017,221.28000000000006,221.28000000000006,246.49962965628038,196.06037034371974,116423986,31.082290784936987,43.455164963340444,NaN,NaN,NaN,NaN,NaN,NaN,-2.780019973439793,-5.163065348168686,-2.3830453747288933,3.218694885361508,20.809963604704922,5485935838,14693967791.852562,14.264054687981645,40.859346072477756,35.10631219298815,7.142857142857143,100
2020-03-10,201.11,204.3,193.6802,204.11,202.46539634933814,211.78436735322165,216.94665913369644,215.03436134227445,199.38970000000012,211.29819999999992,220.51860000000016,219.88700000000009,219.88700000000009,245.6624628280442,194.11153717195597,100599233,40.877434263415466,40.89808442890391,NaN,NaN,NaN,NaN,NaN,NaN,-2.443400611826599,-5.437296139512142,-2.993895527685543,26.76181980374667,18.348042640220132,5586535071,14790967361.154564,15.847202534331348,36.54683175375253,33.51193715408656,0,92.85714285714286
2020-03-11,199.35,200.75,192.73,195.22,202.39330285332483,211.45636007890045,216.09463328531618,213.1472793096769,199.4750000000001,211.31999999999994,220.15080000000017,218.04750000000007,218.04750000000007,245.3080611644354,190.78693883556474,89168783,36.20355947318992,38.553999940354466,NaN,NaN,NaN,NaN,NaN,NaN,-2.644371277065598,-6.299359624017541,-3.6549883469519426,7.422434367541735,12.467649685549972,5497366288,14757167722.710674,14.14234606452772,33.513362573679416,34.33257689558598,0,85.71428571428571
2020-03-12,182.09,190.78,176.94,177.32,202.14381725279424,210.7803925525856,214.57405943099005,209.73515747066006,199.47415000000012,211.15769999999992,219.45300000000017,215.2000000000001,215.2000000000001,246.66135915690586,183.73864084309434,137820698,29.010885392171232,36.586597550663576,NaN,NaN,29.010885392171232,NaN,NaN,NaN,-3.7407278358813727,-8.330898141803658,-4.590170305922285,0.8032128514056128,11.662489007564673,5359545590,14626915213.329172,11.923369010784594,41.80807196438092,37.35647671210058,0,100
2020-03-13,187.07,194.48,178.13,192.34,202.04626683236842,210.4152362644156,213.70213553173554,208.07847580678768,199.55570000000012,211.1641999999999,219.04760000000016,213.1185000000001,213.1185000000001,244.84451284434988,181.39248715565031,134881981,39.8158389812759,36.50964161697512,NaN,NaN,NaN,NaN,NaN,NaN,-3.2314187355403305,-8.629443725347699,-5.398024989807368,32.73259805432337,13.65274842442357,5494427571,14726488639.058224,13.242905117554448,36.08437862208694,39.030622122634746,0,92.85714285714286
2020-03-16,174.15,184.68,169.16,169.3,201.72043333154883,209.60107317007075,211.96087531480472,204.38528763471265,199.5183500000001,210.92329999999995,218.11040000000014,209.85150000000007,209.85150000000007,245.2806395746482,174.42236042535194,92054386,31.81610739260276,36.352505313514484,NaN,NaN,NaN,NaN,NaN,NaN,-4.163943559539325,-10.602954439231524,-6.4390108796922,0.273865414710514,11.269892106813165,5402373185,14636095028.06338,11.043506109346026,36.51831156232216,40.26922186286014,0,100
2020-03-17,175.47,184.39,169.78,182.14,201.52560314914535,209.05728954294062,210.79142922402806,202.26668881235906,199.55930000000012,210.82619999999994,217.46960000000013,207.22200000000007,207.22200000000007,242.68133366548065,171.76266633451948,121257108,39.15320782374267,36.56714184360056,NaN,NaN,NaN,NaN,NaN,NaN,-3.6520292147223516,-11.004047398095139,-7.352018183372787,25.728444003964295,19.57830249099939,5523630293,14720003950.847773,9.891764594527041,32.7097696861307,41.50782160308554,0,92.85714285714286
2020-03-18,171.605,179.22,166.8,176.6,201.27758719741257,208.4145709381299,209.4505888623015,199.82224225880105,199.59170000000012,210.66999999999996,216.69040000000015,204.20300000000006,204.20300000000006,239.29346257888133,169.1125374211188,114156320,37.28876080085869,37.30353833202614,NaN,NaN,NaN,NaN,NaN,NaN,-3.4262487258408143,-11.634829090673804,-8.20858036483299,18.557091459950733,14.853133626208512,5409473973,14785997701.057112,8.878111304580402,31.348556957254324,41.74983546111614,21.428571428571427,100
2020-03-19,175.69,183.49,171.63,177.66,201.04258632977664,207.80556953341446,208.20389910299554,197.7115525198676,199.60545000000013,210.50569999999996,215.93300000000013,201.34700000000007,201.34700000000007,235.29739328196192,167.3966067180382,120896481,37.89811285518797,38.062514763848355,NaN,NaN,NaN,NaN,NaN,NaN,-2.962641485735748,-11.911882222002674,-8.949240736266926,20.564287066843374,21.616607510252802,5530370454,14788036427.549522,11.010542887876284,28.88411423657266,40.60365214768056,14.285714285714286,92.85714285714286
2020-03-20,181.74,182.87,170.1,170.7,200.7406700478883,207.07080578027754,206.73315796170158,195.13902370845165,199.5779000000001,210.25629999999998,215.00400000000013,198.36850000000007,198.36850000000007,232.09805812043646,164.63894187956367,118983891,35.46159698517185,37.48886013951397,NaN,NaN,NaN,NaN,NaN,NaN,-2.8793373076254873,-12.548412370798786,-9.669075063173299,7.384964968755874,15.50211449851666,5411386563,14680233481.6709,10.090700570740868,27.472012173881843,41.81168915228037,7.142857142857143,85.71428571428571
2020-03-23,170.92,174.21,164.93,170.46,200.4393698484068,206.34583932918292,205.31068117888975,192.78864049812293,199.5421500000001,209.98519999999996,214.03340000000014,195.82200000000006,195.82200000000006,229.90313002821168,161.74086997178844,124639782,35.37713505445326,37.33062813810175,NaN,NaN,NaN,NaN,NaN,NaN,-2.6033493707402364,-12.923261776598594,-10.319912405858357,10.355805243445694,12.768352426348313,5286746781,14704140681.235556,9.471454724222554,29.204994330912708,43.94874336203929,0,100
2020-03-24,179.91,183.83,177.95,183.66,200.27241094444256,205.896614788011,204.46163485814898,191.91924616496837,199.55525000000011,209.86139999999995,213.3380000000001,194.23650000000004,194.23650000000004,227.47241688219125,161.00058311780882,94881785,43.36668105554738,37.05035397738724,NaN,NaN,NaN,NaN,NaN,NaN,-1.3574157689307675,-12.016682117021816,-10.659266348091048,36.418432821310496,18.05306767783735,5381628566,14793536104.517868,14.903405764290984,26.66596775234464,44.46251996164296,0,92.85714285714286
2020-03-25,184.42,189.51,179.98,182.3,200.09358098479635,205.4293550892385,203.59255113822158,191.00312748259043,199.55100000000013,209.71449999999996,212.5650000000001,192.5275000000001,192.5275000000001,224.50381615742901,160.55118384257116,88754909,42.77983437394005,37.10868292927218,NaN,NaN,NaN,NaN,NaN,NaN,-0.49494427360228066,-11.277946690093898,-10.783002416491618,39.28086838534601,28.6850354833674,5292873657,14747994498.535707,17.69972181233199,24.99773386946955,44.006970561338925,0,85.71428571428571
2020-03-26,183.87,192.72,183.61,191.9,200.0120528157934,205.16144706766943,203.13401972103642,191.08854391281992,199.59350000000012,209.66269999999997,212.00140000000013,191.84050000000008,191.84050000000008,223.24572470863518,160.43527529136497,79887564,48.116998607742204,37.73203170315975,NaN,NaN,NaN,NaN,NaN,NaN,0.7825380948858243,-9.804829797884338,-10.587367892770162,68.50393700787401,48.06774607151018,5372761221,14813500547.17237,18.598959554623427,23.282627426515784,42.284136934299376,0,78.57142857142857
2020-03-27,186.93,190.5149,184.66,185.3,199.86566423056163,204.7681510861314,202.43464639864283,190.5372540163609,199.6083000000001,209.52699999999996,211.30400000000012,190.8155000000001,190.8155000000001,221.6646124507636,159.9663875492366,58844975,45.00874969037962,38.72677876783422,NaN,NaN,NaN,NaN,NaN,NaN,1.217543785422425,-9.06543816099213,-10.282981946414555,51.73990347980696,53.17490295767567,5313916246,14767520278.315943,17.690737771692735,22.14569343133622,39.63672930144555,7.142857142857143,71.42857142857143
2020-03-30,187.1,192.49,186.3406,192.04,199.7877969247849,204.51610849036643,202.02701320653918,190.68037268146938,199.6514000000001,209.44639999999995,210.6992000000001,189.59650000000008,189.59650000000008,218.14305304935922,161.04994695064093,49356936,48.65632962101803,39.28241415052012,NaN,NaN,NaN,NaN,NaN,NaN,1.9502503053506555,-7.845169064726235,-9.79541937007689,75.68397543271912,65.3092719734667,5363273182,14809653543.32365,18.176115762419784,21.046538411346546,37.33749146683779,0,64.28571428571429
2020-03-31,191.53,195.25,189.2,190.4,199.69438601011043,204.2365815895671,201.57105190432196,190.65367052132945,199.69020000000012,209.34829999999994,210.0396000000001,188.64250000000007,188.64250000000007,215.70397880290164,161.5810211970985,62659265,47.82507228067229,40.112522208197426,NaN,NaN,NaN,NaN,NaN,NaN,2.291903213470338,-6.9305403532389676,-9.222443566709305,84.00395778364118,70.4759455653891,5300613917,14771850846.257534,19.357299553279876,20.140690699088317,34.57574353713332,0,57.142857142857146
2020-04-01,184.81,187.66,180.86,182.31,199.5214070448357,203.80239185512022,200.815716535525,189.8590352335838,199.68305000000012,209.17379999999997,209.22020000000012,186.84700000000007,186.84700000000007,210.35195190379957,163.34204809620056,53715375,43.84571728032275,41.17215305735111,NaN,NaN,NaN,NaN,NaN,NaN,1.9536936410257137,-6.780326515427163,-8.734020156452877,57.321899736147756,72.33661098416935,5246898542,14741043498.831064,18.03885699113341,24.723237399372074,31.719522369134808,92.85714285714286,50
2020-04-02,181.59,190.1,180.97,186.01,199.38696518369306,203.45006726392972,200.23510020079854,189.49246044943297,199.68105000000014,209.02959999999996,208.4630000000001,185.5680000000001,185.5680000000001,206.15042706776518,164.98557293223502,56465348,46.05644129597038,41.61791036554357,NaN,NaN,NaN,NaN,NaN,NaN,1.9550463349515361,-6.2902122377634555,-8.245258572714992,69.52506596306064,70.28364116094987,5303363890,14746918863.628435,18.608615154975894,23.10155869630864,29.181369110391707,85.71428571428571,42.857142857142854
2020-04-03,185.5,187.0716,181.29,183.37,199.22759239579563,203.05244216959449,199.57372372233584,188.9093689780584,199.66235000000015,208.85099999999994,207.6386000000001,184.33550000000008,184.33550000000008,202.1598613910806,166.51113860891957,47487621,44.70410127887701,42.5384813574203,NaN,NaN,NaN,NaN,NaN,NaN,1.7600992339066837,-6.045134530331637,-7.805233764238321,60.8179419525066,62.55496921723833,5255876269,14733599725.982525,17.81184979259742,22.112418900956914,26.124965803224523,78.57142857142857,35.714285714285715
2020-04-06,190.38,197.65,189.19,196.48,199.20025316797677,202.92229479989953,199.4524012234207,189.63038145633857,199.70050000000015,208.80619999999996,207.1142000000001,184.48100000000005,184.48100000000005,202.6487119087658,166.3132880912343,64763518,52.20870506411859,43.47101687459001,NaN,NaN,NaN,NaN,NaN,NaN,2.4534512564474635,-4.738419693678992,-7.1918709501264555,96.42420537897306,75.5890710981801,5320639787,14780449930.493162,23.56479067713706,19.851548679604978,22.910049663966713,100,28.571428571428573
2020-04-07,202.14,202.66,196,196.4,199.172389952375,202.79314044742628,199.3326992146591,190.27510703192536,199.73965000000015,208.75479999999996,206.68020000000007,184.09550000000007,184.09550000000007,200.85331307330748,167.33768692669267,69904478,52.1621826137813,44.53340414694162,NaN,NaN,NaN,NaN,NaN,NaN,2.8198784042558582,-3.6670229448066323,-6.4869013490624905,83.4084283063875,80.21685854595572,5250735309,14718942386.787457,26.088151604308713,18.881897093818715,20.064691828077084,100,21.428571428571427
2020-04-08,198.0835,201.17,196.1733,200.57,199.18629652001306,202.74911786430894,199.38122081408423,191.25557302888484,199.80170000000012,208.7445999999999,206.2626000000001,184.36300000000003,184.36300000000003,201.971776334543,166.75422366545706,45940439,54.44107530664509,45.7150443220457,NaN,NaN,NaN,NaN,NaN,NaN,3.22698465552803,-2.4531705296524535,-5.6801551851804835,94.4606413994169,91.43109169492583,5296675748,14753849838.65595,25.097665525957712,18.165010114321298,18.009166626057304,92.85714285714286,14.285714285714286
2020-04-09,202.27,203.22,199.0281,200.86,199.20295028598306,202.71170958976816,199.43921215470837,192.17028035946723,199.88135000000014,208.73889999999992,205.84360000000007,185.54000000000002,185.54000000000002,204.22253515987578,166.85746484012427,68323929,54.603042067585214,47.08229039936094,NaN,NaN,NaN,NaN,NaN,NaN,3.383279111968899,-1.4510562952193595,-4.8343354071882585,93.83651083833904,90.5685268480478,5364999677,14745242317.745409,25.88717923200071,17.56258130063912,16.072477607705014,100,7.142857142857143
2020-04-13,199.92,203.42,198.75,203.03,199.24103038263996,202.7180123701688,199.58002736432766,193.20453937285131,199.96755000000016,208.7400999999999,205.4522000000001,186.07450000000003,186.07450000000003,206.07015900389325,166.0788409961068,42853948,55.86736696542413,48.54587839300172,NaN,NaN,NaN,NaN,NaN,NaN,3.4864424112844707,-0.47628239308266984,-3.9627248043671406,98.46878680800948,95.58864634858848,5407853625,14780938647.02164,24.896574630438177,17.11840422254807,13.750387817912085,100,0
2020-04-14,207.17,212.5,206.42,211.86,199.36659226937985,202.89904182818526,200.06159491866777,194.98124990877025,200.09435000000013,208.82799999999992,205.30800000000008,188.20250000000004,188.20250000000004,209.61311594162976,166.79188405837033,63959563,60.667656324008156,49.78166234074892,NaN,NaN,NaN,NaN,NaN,NaN,3.9679754735516206,0.9972445375723851,-2.9707309359792355,98.03198031980324,96.77909265538392,5471813188,14831433038.863747,30.371084962284016,15.798200330098409,13.98380233824602,100,0
2020-04-15,208.48,211.8338,207.12,209.43,199.46672567963478,203.02836773257764,200.42898335322982,196.35732134603023,200.20780000000013,208.88859999999994,205.0490000000001,189.56700000000004,189.56700000000004,212.66976182624114,166.46423817375893,47035953,58.77306235016879,50.92403576762241,NaN,NaN,NaN,NaN,NaN,NaN,3.9337899008466497,1.9465064400790766,-1.9872834607675731,90.29709228824274,95.59928647201848,5424777235,14830497069.499031,29.158918699146437,15.167664888831967,15.017491134242587,92.85714285714286,0
2020-04-16,211.78,214.369,209.69,213.25,199.6038726877976,203.23077629232858,200.93176831976984,197.96614788450356,200.32775000000012,208.99959999999993,204.76460000000006,191.39950000000005,191.39950000000005,215.8709866528366,166.9280133471635,64657362,60.84323927612377,51.83305295822108,NaN,NaN,NaN,NaN,NaN,NaN,3.9680484390340567,2.9727770880249977,-0.995271351009059,96.66059864514011,94.99655708439536,5489434597,14864228341.275478,30.109328819055314,14.517477680866103,16.714290326351684,100,28.571428571428573
2020-04-17,215.96,216.51,212.0801,215.29,199.75995355657574,203.4695728013914,201.49483622879848,199.61603856216988,200.4541500000001,209.13549999999992,204.50600000000006,193.28100000000003,193.28100000000003,218.992668868434,167.56933113156606,62863223,61.94229686461988,53.04259204209539,NaN,NaN,NaN,NaN,61.94229686461988,NaN,3.9207711041230424,3.905692529144744,-0.015078574978298231,96.57784011220195,94.51184368186159,5552297820,14892466343.81452,30.8337973254677,13.940272093604008,18.610538973010403,100,21.428571428571427
2020-04-20,213.27,215.88,212.57,212.74,199.88910824755507,203.65314561720544,201.9358230433554,200.86593965148703,200.5606500000001,209.24459999999996,204.15700000000007,195.38300000000004,195.38300000000004,220.22583647251258,170.5401635274875,38249128,59.68707794474632,53.83050263664741,NaN,NaN,NaN,NaN,NaN,NaN,3.523007712224598,4.38868106530245,0.8656733530778515,89.42496493688644,94.22113456474283,5514048692,14858146129.264671,29.877906533323014,13.508104184033515,20.782847759022825,92.85714285714286,14.285714285714286
2020-04-21,210.63,211.16,203.63,204.89,199.93886836449482,203.67763778320136,202.05167312008658,201.24918349420255,200.62985000000012,209.25129999999993,203.6708000000001,197.10450000000003,197.10450000000003,219.44633741324793,174.76266258675213,72932771,53.25863766164528,54.21861444957405,NaN,NaN,53.25863766164528,NaN,NaN,NaN,2.580154598684886,4.090866601433959,1.510712002749073,67.40532959326785,84.46937821411875,5441115921,14809621138.200926,27.363539868203357,20.629765367614034,21.643368055765965,85.71428571428571,7.142857142857143
2020-04-22,209.14,212.35,208.33,210.97,200.0486308683307,203.8220409954152,202.40141142910278,202.17497554237374,200.73615000000012,209.31489999999994,203.25080000000008,198.47000000000003,198.47000000000003,220.6960846754442,176.24391532455584,40188772,57.11151031403126,55.166171094838944,NaN,NaN,NaN,NaN,NaN,NaN,2.2281750887038703,4.295930863628911,2.0677557749250406,84.41193021947103,80.41407491654176,5481304693,14822217618.977045,26.575139216617416,19.204527947546644,21.676841635222367,78.57142857142857,0
2020-04-23,211.8,214.435,210.095,210.52,200.152823596009,203.95467384699114,202.7197874514909,202.96973977643339,200.83545000000012,209.35969999999998,202.82100000000005,199.88100000000003,199.88100000000003,221.39336565327076,178.3686343467293,43278542,56.738726975264484,55.92919150050282,NaN,NaN,NaN,NaN,NaN,NaN,1.843187247371275,4.3717398341391345,2.5285525867678595,82.99261783077802,78.26995921450562,5438026151,14787415289.119902,27.465741554826145,18.40776421747869,22.31782277870997,71.42857142857143,0
2020-04-24,210.94,214.3,209.5,213.84,200.28901440599896,204.150422879724,203.15587421809911,204.0050026548683,200.94185000000013,209.44709999999995,202.41240000000008,200.97800000000004,200.97800000000004,222.98253825918644,178.97346174081363,34303365,58.87169298420431,56.94116233659763,NaN,NaN,NaN,NaN,NaN,NaN,1.6940837182474744,4.646157234577203,2.9520735163297283,90.22693997071747,85.8771626736555,5472329516,14815143842.494902,26.172421486774756,18.124671520174946,22.84609804932089,64.28571428571429,0
2020-04-27,216.18,216.63,214.5,215.56,200.4409645114119,204.37635509992748,203.6423105232717,205.10547859249988,201.0575500000001,209.57269999999997,202.0442000000001,202.49100000000004,202.49100000000004,224.13378253829708,180.848217461703,36451698,59.97276389476638,57.49573796735818,NaN,NaN,NaN,NaN,NaN,NaN,1.5946747379761104,4.945416938799866,3.3507422008237557,94.81337857489096,89.34431212546214,5508781214,14814972707.762508,27.81416349384449,17.605732374631447,23.84060121031013,100,0
2020-04-28,217.27,217.32,211.21,211.5,200.5510046655272,204.51741737517645,203.9504552086336,205.7144806313094,201.14740000000012,209.67359999999996,201.58140000000006,203.46400000000003,203.46400000000003,224.8885386414746,182.03946135852544,46862816,56.15140890433698,57.78068270239787,NaN,NaN,NaN,NaN,NaN,NaN,1.1591238380299762,4.799646998361226,3.6405231603312496,72.4779752869242,85.83943127751088,5461918398,14772558407.847614,26.054799446540695,19.89809304944533,23.65297979329663,100,0
2020-04-29,216.21,219.97,215.14,219,200.7345767584075,204.80420118952938,204.540633435746,206.97976819023233,201.27165000000016,209.83929999999992,201.26680000000007,204.89400000000006,204.89400000000006,226.45718844697922,183.3308115530209,48716406,61.08436605106274,58.25520346985627,NaN,NaN,NaN,NaN,61.08436605106274,NaN,1.2708083089104258,5.229033546469282,3.958225237558856,95.42884071630537,87.57339819270686,5510634804,14801707561.748236,26.50624324842788,18.181214827991028,23.83904315693732,100,0
2020-04-30,220.01,220.04,217.35,218.91,200.91542674091093,205.08352393825157,205.1041380068932,208.11598074354353,201.40045000000012,210.00009999999995,200.90540000000007,206.72400000000007,206.72400000000007,226.44347605794712,187.00452394205303,43359476,60.99568787295699,58.711821027382825,NaN,NaN,NaN,NaN,NaN,NaN,1.232362126430525,5.498677895597012,4.2663157691664875,94.69234382339128,87.5330532755403,5467275328,14808638630.402512,25.82103674688795,17.660051844669976,23.81117961253065,100,7.142857142857143
2020-05-01,214.54,216.67,211.68,212.74,201.033084186275,205.23513732561292,205.40358357525034,208.55636352987273,201.50315000000012,210.07749999999996,200.46460000000008,208.06050000000005,208.06050000000005,225.47133854959307,190.64966145040702,48794968,55.09102776234955,58.65636822716322,NaN,NaN,55.09102776234955,NaN,NaN,NaN,0.7110121727746179,5.155080985134759,4.4440688123601415,55.514929920780105,81.87870482015893,5418480360,14780574189.889486,23.84279850835905,22.31532795100925,22.72520544851869,92.85714285714286,0
2020-05-04,211.61,215.45,211.12,215.22,201.1742475277051,205.43285737857107,205.78854108210328,209.19099557464676,201.61715000000015,210.18899999999996,200.1636000000001,209.65300000000008,209.65300000000008,223.1185339292552,196.18746607074496,32841020,56.89717322028098,58.38704800546842,NaN,NaN,NaN,NaN,NaN,NaN,0.46471976826490113,5.0249685226912675,4.560248754426366,70.62766605728218,73.61164660048453,5451321380,14809926325.547686,22.72013376772765,21.87355177898841,20.606234729470064,85.71428571428571,35.714285714285715
2020-05-05,217.4,220.14,216.85,217.66,201.33828486573788,205.67497901463898,206.25408849064826,209.9975674246804,201.75040000000016,210.32659999999996,200.08900000000008,210.71200000000005,210.71200000000005,223.15995179939247,198.26404820060762,37783075,58.65884517315697,58.37888963568186,NaN,NaN,NaN,NaN,NaN,NaN,0.40012726472537175,5.060407835333081,4.660280570607709,84.97880072683228,70.37379890163153,5489104455,14790747682.614555,26.675557756195868,20.68191086418541,19.255674454208766,100,28.571428571428573
2020-05-06,219.37,221.04,218.11,219,201.51402332478526,205.9388408163293,206.75392815768166,210.8549419556632,201.88275000000013,210.46679999999998,200.1616000000001,211.84200000000004,211.84200000000004,222.91518490769434,200.76881509230574,36455218,59.63457256682076,58.292556299303065,NaN,NaN,NaN,NaN,NaN,NaN,0.38169538359834565,5.137399800105641,4.755704416507295,88.2825962090753,81.29635433106326,5525559673,14776439320.600903,26.673684929397297,19.8806162549481,17.802346028553853,100,21.428571428571427
2020-05-07,221.75,222.73,220.42,221.82,201.71607284394162,206.25331921600596,207.34475450443924,211.899233197981,202.0229000000001,210.61989999999997,200.2684000000001,212.90450000000004,212.90450000000004,223.51582880463064,202.29317119536944,38624836,61.68410081813671,58.274113724554276,NaN,NaN,NaN,NaN,NaN,NaN,0.48674249744739573,5.3641325383165395,4.877390040869144,95.23560209424086,89.49899967671615,5564184509,14784632467.631207,27.49393989624562,19.005515559480394,16.411223838008485,100,14.285714285714286
2020-05-08,223.55,225,222.48,224.86,201.94636067634022,206.6217683404415,208.03162687681416,213.13359194103043,202.1714500000001,210.79659999999996,200.6528000000001,214.10450000000006,214.10450000000006,224.42017249382903,203.7888275061711,31964416,63.81694321881544,58.5691041012735,NaN,NaN,NaN,NaN,NaN,NaN,0.6766076113020407,5.723149554996695,5.046541943694654,99.34487599438472,94.28769143256697,5596148925,14813045281.85343,29.19879583781907,18.267263525627065,15.361195823561072,100,7.142857142857143
2020-05-11,223.5,227.93,223.25,226.87,202.19435708752093,207.02272342280898,208.77038660713518,214.4418212799799,202.33930000000015,210.97259999999997,201.0742000000001,215.29650000000007,215.29650000000007,225.7268562259372,204.86614377406292,35714128,65.1964090783191,59.42180205960733,NaN,NaN,NaN,NaN,65.1964090783191,NaN,0.842407642014992,6.099551496213394,5.257143854198402,94.59183673469386,96.39077160777316,5631863053,14832581215.118387,31.136257686187935,17.207874100778348,16.4169283044084,100,0
2020-05-12,227.48,228.095,222.09,222.12,202.39262219112769,207.32167939463454,209.29390085783575,215.1730763961723,202.47345000000016,211.0999,201.1882000000001,215.80950000000007,215.80950000000007,226.51883139835968,205.10016860164046,41054123,59.430142575146604,59.587418649686995,NaN,NaN,NaN,NaN,NaN,NaN,0.5511052084262031,5.946025364731156,5.394920156304953,67.86770637268086,87.26813970058647,5590808930,14791937291.515556,28.826207131740876,17.364371128626637,17.039360014432418,100,0
2020-05-13,222.65,224.61,216.71,219.34,202.56125281609158,207.55966594127545,209.6878655300775,215.5699262632035,202.59705000000017,211.19779999999994,201.3854000000001,216.30500000000006,216.30500000000006,226.70023833300243,205.9097616669977,65521208,56.29213064013806,59.55551891146367,NaN,NaN,56.29213064013806,NaN,NaN,NaN,0.1130350781562548,5.536214004000271,5.423178925844017,52.91745092766875,71.7923313450145,5525287722,14770041596.690239,26.084412658970415,22.190192881804986,16.205163957259252,92.85714285714286,7.142857142857143
2020-05-14,218.12,221.87,215.99,221.83,202.75298164379217,207.84224681372544,210.1640276661529,216.16612376194604,202.73730000000015,211.30749999999998,201.4576000000001,216.73400000000007,216.73400000000007,227.2963546617189,206.17164533828122,51549345,58.41035643222128,59.52256630060775,NaN,NaN,NaN,NaN,NaN,NaN,-0.058000382414027385,5.350678447826482,5.408678830240509,63.09278350515471,61.29264693516813,5576837067,14820889590.057587,24.236615540165666,21.48567683446499,15.337232098635399,85.71428571428571,0
2020-05-15,218.77,223.33,218.33,223.27,202.95713108017236,208.14774687681998,210.67798736551944,216.84268340366546,202.89815000000016,211.42309999999995,201.69120000000012,217.1330000000001,217.1330000000001,228.04415777540945,206.22184222459074,55747208,59.62887266958023,59.49800264166588,NaN,NaN,NaN,NaN,NaN,NaN,-0.11957407627673255,5.259211234894593,5.378785311171326,71.57584683357884,62.52869375546745,5632584275,14875298865.065586,24.5389805289251,20.176788416266866,14.428638965942465,78.57142857142857,35.714285714285715
2020-05-18,226.28,228.68,225.47,227.43,203.200642213703,208.5295736713384,211.33492903745986,217.85099926998305,203.0845500000002,211.57929999999996,202.07940000000013,217.86750000000006,217.86750000000006,229.45375716096098,206.28124283903915,42597551,63.001339204822514,59.98728337741484,NaN,NaN,NaN,NaN,NaN,NaN,0.06454511847525879,5.459466709265399,5.39492159079014,92.88154897494306,75.85005977122556,5675181826,14884720753.293001,29.467025311452723,18.83947176743524,15.043095559160147,100,28.571428571428573
2020-05-19,227.66,229.85,226.71,226.86,203.43605870908902,208.8925524105198,211.94375534971633,218.70899933950847,203.28210000000018,211.7287,202.74520000000015,218.96600000000007,218.96600000000007,229.54449025144436,208.38750974855577,36237303,62.234203640555045,60.06941463380715,NaN,NaN,NaN,NaN,NaN,NaN,0.09100336227857575,5.508675793638361,5.417672431359785,84.03630539241867,82.83123373364687,5638944523,14851945613.000008,29.7770790488404,18.090028886963605,15.456393142816045,100,21.428571428571427
2020-05-20,229.48,231.76,229.48,231.39,203.71420737865031,209.3380464221927,212.70635317913923,219.91671368812672,203.53540000000018,211.90469999999996,203.29080000000013,219.98700000000008,219.98700000000008,231.20389101310604,208.77010898689412,37417000,65.79851272536564,60.41247355183634,NaN,NaN,NaN,NaN,65.79851272536564,NaN,0.3425184619664874,5.845820508817894,5.503302046851407,98.20736434108525,91.70840623614902,5676361523,14877218498.96492,30.35374296484668,16.956439927180156,16.138462209282117,100,14.285714285714286
2020-05-21,231.49,232.135,228.34,228.87,203.9645137728926,209.72481778016908,213.34022168191808,220.76940762259085,203.7634500000002,212.0573,203.9638000000001,220.90450000000004,220.90450000000004,231.87300668960654,209.93599331039354,43642908,62.27729044064605,60.92577802885752,NaN,NaN,NaN,NaN,NaN,NaN,0.27121480293863787,5.842320550524704,5.571105747586066,84.46347846776118,88.90238273375506,5632718615,14845765704.925394,28.846082415784352,17.606272545516823,17.63040604756093,100,7.142857142857143
2020-05-22,228.46,229.87,227.5,229.66,204.2201902527643,210.1195738637301,213.98021298850952,221.61613070615363,203.99050000000017,212.2318,205.01060000000012,221.6955000000001,221.6955000000001,232.79305554164233,210.59794445835786,28762389,62.94673570335163,61.35788963479114,NaN,NaN,NaN,NaN,NaN,NaN,0.21193076945583655,5.836019209405862,5.624088439950025,84.67017652524002,89.11367311136217,5661481004,14869430961.697546,27.91362541495036,18.182850555553966,19.002631083629694,92.85714285714286,0
2020-05-26,233.44,233.57,228.79,229.04,204.46715353383132,210.49423576741862,214.57079287131307,222.32316587699614,204.1944000000002,212.39610000000002,205.7446000000001,222.36950000000007,222.36950000000007,233.5318518579142,211.20714814208594,33055346,62.01655123073668,61.59772578176112,NaN,NaN,62.01655123073668,NaN,NaN,NaN,0.07282223232749896,5.715116230359399,5.6422939980319,74.23208191126277,81.12191230142135,5628425658,14839833287.873278,31.160561737511568,16.989965225021997,20.200745655881544,100,50
2020-05-27,228.51,230.41,223.94,230.29,204.72409727976336,210.88623109875687,215.1872323665557,223.08191198394888,204.4134000000002,212.53740000000002,206.9644000000001,223.30900000000005,223.30900000000005,233.79637889083537,212.82162110916474,55665565,63.19735547640646,61.85221027530296,NaN,NaN,NaN,NaN,NaN,NaN,0.010146596895108217,5.6549772441507855,5.644830647255677,81.34243458475538,80.08156434041943,5684091223,14893433978.746538,28.440750016092686,22.049927900934776,20.062582776625927,92.85714285714286,42.857142857142854
2020-05-28,229.05,233.47,229.05,229.99,204.97549929688014,211.26452355224683,215.7677330580633,223.7398251283347,204.6416000000002,212.69550000000004,207.9214000000001,223.85850000000005,223.85850000000005,234.53515542199125,213.18184457800885,43008478,62.69361971716498,61.92431876809069,NaN,NaN,NaN,NaN,NaN,NaN,-0.10027732119381483,5.519483995763409,5.619761316957224,79.63594994311725,78.40348881304517,5641082745,14868718699.533869,30.90202866388909,20.71943044658463,20.16762737469859,85.71428571428571,35.714285714285715
2020-05-29,230.43,233.6,228.76,233.36,205.25793213969726,211.70205773933105,216.4576258793157,224.6560322589695,204.86645000000019,212.87350000000004,209.05660000000012,224.58100000000007,224.58100000000007,235.76407274410224,213.3979272558979,50878596,65.97457812166161,62.078435546865414,NaN,NaN,NaN,NaN,NaN,NaN,-0.0004009550509520565,5.619260123143533,5.619661078194485,98.63713798977864,86.53850750588379,5691961341,14914551484.360315,28.84921888149733,19.741075384173637,19.861525319109294,100,28.571428571428573
2020-06-01,232.4,234.45,232,234.06,205.54451987960076,212.14478926924528,217.147915060519,225.55164823430573,205.1229500000002,213.05880000000002,210.1846000000001,225.64700000000008,225.64700000000008,236.1562399344509,215.13776006554926,26140125,66.63104532833447,62.180909564723656,NaN,NaN,NaN,NaN,NaN,NaN,0.05565962236824795,5.689235606154796,5.633575983786548,97.88732394366204,92.05347062551935,5718101466,14932369447.115417,29.053475975526055,19.051171162392553,19.28880354056474,100,21.428571428571427
2020-06-02,234.42,235.69,232.01,235.63,205.843877890749,212.609842947082,217.87270270520455,226.51149125960995,205.3883500000002,213.24360000000001,211.4832000000001,226.66750000000008,226.66750000000008,236.88836273265989,216.44663726734026,33383415,68.11683468891661,62.80138757285008,NaN,NaN,NaN,NaN,NaN,NaN,0.13671303214753827,5.804467273970971,5.667754241823433,99.69543147208121,98.73996446850735,5751484881,14964664272.495852,29.30186014332538,18.03181965729083,19.21705647704574,100,14.285714285714286
2020-06-03,236.23,237.47,235.35,236.69,206.15080447890077,213.0866777402091,218.61063593245143,227.480873044409,205.64440000000022,213.4206,212.8078000000001,227.61900000000009,227.61900000000009,237.85167882814122,217.38632117185895,37228701,69.11667265327645,63.71742628807425,NaN,NaN,NaN,NaN,NaN,NaN,0.19632390618199747,5.91315912455093,5.716835218368932,96.36871508379889,97.98382349984742,5788713582,14974498268.986418,31.058025806555523,17.45248141231044,20.644183953004895,100,7.142857142857143
2020-06-04,236.32,237.79,233.68,235.03,206.4381596582152,213.52119897307625,219.25453256255136,228.19983751637005,205.8774000000002,213.5866,213.83520000000007,228.4205000000001,228.4205000000001,238.33338348563944,218.50761651436073,38716097,65.64486346888009,64.23417679069274,NaN,NaN,NaN,NaN,NaN,NaN,0.06533860622490373,5.798508476150062,5.733169869925158,85.81706063720455,93.96040239769492,5749997485,14961216104.322184,29.105661906698444,18.90962597318097,21.73120921071314,100,0
2020-06-05,236.06,240.297,235.63,239.69,206.76902374121804,214.0393930528173,220.0559234424513,229.2941387052872,206.1410000000002,213.77399999999997,214.9830000000001,229.31400000000008,229.31400000000008,239.88560801391628,218.74239198608387,47365569,70.17413705879751,64.98740996135112,NaN,NaN,NaN,NaN,NaN,NaN,0.22493649816546402,6.0143404926319874,5.789403994466523,96.28905055939353,92.82494209346571,5797363054,14996260738.939068,30.58190997041834,17.400086386627354,22.99671343236592,100,0
2020-06-08,239.54,241.68,237.91,241.55,207.11510310697707,214.58415754682093,220.89882840549242,230.46136359049794,206.4056000000002,213.98870000000002,215.97600000000008,230.1485000000001,230.1485000000001,241.76528316057676,218.53171683942344,32937305,71.77370420467818,65.61400746134082,NaN,NaN,NaN,NaN,NaN,NaN,0.37909778556826446,6.2632762264268536,5.884178440858589,99.26719278466744,93.79110132708855,5830300359,15026926505.663206,30.935657466342143,16.39143463019615,23.620358175344585,100,42.857142857142854
2020-06-09,240.66,244.18,240.47,243.3,207.47515183228077,215.15278809044824,221.7773057229241,231.68409086759337,206.6820000000002,214.22,217.13600000000005,230.97000000000008,230.97000000000008,243.8032723808027,218.13672761919747,35046254,73.22846795420344,66.39931205517283,NaN,NaN,NaN,NaN,NaN,NaN,0.5138861415893654,6.526536117845296,6.012649976255931,95.6521739130435,97.06947241903488,5865346613,15045347043.479918,33.045301537360324,15.442729700323133,24.469451279551887,100,35.714285714285715
2020-06-10,245,247.815,244.51,246.22,207.8606727095715,215.76798040548886,222.73584275339766,233.06846316591782,207.0027500000002,214.4594,218.21960000000007,232.1750000000001,232.1750000000001,245.94935225336638,218.4006477466338,58084410,75.49768093481333,67.0921097844191,NaN,NaN,NaN,NaN,75.49768093481333,NaN,0.7029615073881912,6.89135186049117,6.188390353102979,93.31937172774869,96.07957947515327,5923431023,15047368134.902006,36.391829346139474,14.353917064428382,25.548743143364785,100,28.571428571428573
2020-06-11,242.29,243.59,233.96,234.02,208.1209645234066,216.12940653607325,223.17835872385265,233.1590857215447,207.24875000000023,214.56579999999997,219.09200000000007,232.9090000000001,232.9090000000001,245.37138805365268,220.44661194634753,72919442,54.65360973499217,66.54756116258667,NaN,NaN,54.65360973499217,NaN,NaN,NaN,-0.05037399229878847,6.1254228627294935,6.175796855028282,42.21989528795817,77.06381364291686,5850511581,14975357346.384872,30.17114370936076,26.609758583245373,24.26843790938343,92.85714285714286,21.428571428571427
2020-06-12,239.09,240.4,231.74,235.88,208.39717383163142,216.52050739674507,223.67646230330942,233.4182204147309,207.5060000000002,214.6918,220.16340000000002,233.61150000000006,233.61150000000006,245.03750590757437,222.18549409242576,72034787,56.620028438188335,66.09565350078931,NaN,NaN,NaN,NaN,NaN,NaN,-0.45751210742395276,5.603906720748341,6.061418828172294,50.01047120418847,61.849912739965184,5922546368,14972196466.585796,26.699397755548524,26.497606608003245,22.78770525574998,85.71428571428571,14.285714285714286
2020-06-15,232.44,239.45,231.47,238.75,208.69919200246096,216.96069536908675,224.26758142866984,233.9260089466613,207.77430000000018,214.84060000000002,221.21820000000002,234.3855000000001,234.3855000000001,244.97081147391867,223.8001885260815,45307371,59.53582738920342,65.91845894067978,NaN,NaN,NaN,NaN,NaN,NaN,-0.5608189530110854,5.360395136908437,5.9212140899195225,62.03141361256545,51.420593368237434,5967853739,15009555176.00685,23.963068936913,24.12871762541172,20.710180819009828,78.57142857142857,7.142857142857143
2020-06-16,243.78,244.39,239.1,242.85,209.03900103726235,217.47335486672858,224.99630372558474,234.77591285650308,208.0489500000002,215.02320000000003,222.40780000000007,235.15650000000005,235.15650000000005,245.84877810150584,224.46422189849426,48890095,63.328011510466936,65.92779151454125,NaN,NaN,NaN,NaN,NaN,NaN,-0.3885007831578431,5.435588110972219,5.824088894130062,73.94384675938073,61.99524385871155,6016743834,15029979960.496452,28.567100971654273,22.382731455785006,20.673089745225905,71.42857142857143,0
2020-06-17,244.4,245.5,242.73,243.62,209.38309057918013,217.99111021590227,225.72664475595397,235.61820687016944,208.3297000000002,215.2324,223.35060000000004,235.99450000000007,235.99450000000007,246.58107730335288,225.40792269664726,34749268,64.01017741397013,66.02183135002733,NaN,NaN,NaN,NaN,NaN,NaN,-0.2640867452188145,5.493980462606544,5.758067207825358,77.9847808974023,71.3200137564495,6051493102,15017560547.02353,28.99120345084359,21.557656409418748,20.31452924044139,64.28571428571429,7.142857142857143
2020-06-18,243.29,244.53,242.49,244.28,209.73032350874053,218.5116822908349,226.454227314544,236.44313954920094,208.62285000000017,215.4942,224.30820000000006,236.63900000000007,236.63900000000007,247.5890555249695,225.68894447503064,30578648,64.61772348234916,65.92491316150502,NaN,NaN,NaN,NaN,NaN,NaN,-0.18263811446787148,5.529769564740519,5.712407679208391,78.372591006424,76.76707288773568,6082071750,15040644428.356863,28.16769739623644,21.27948396082821,19.97064835697658,57.142857142857146,0
2020-06-19,246.74,247,242.45,244.24,210.0737033743252,219.02115392864016,227.15170859632659,237.18569768737228,208.9024000000002,215.72209999999998,225.18160000000003,237.40750000000003,237.40750000000003,248.22530546136727,226.58969453863278,49422112,64.5466064440121,65.77602466976771,NaN,NaN,NaN,NaN,NaN,NaN,-0.17664513584125618,5.491601259406821,5.668246395248077,78.12786784949532,78.16174658444054,6032649638,15030108285.798622,29.835875675929817,19.920346584634903,19.90889233442167,50,71.42857142857143
2020-06-22,243.77,246.87,243.38,246.74,210.43854214671995,219.57004196965718,227.9198768866667,238.09563124095587,209.17720000000017,215.9714,226.09920000000002,238.26150000000007,238.26150000000007,249.19411226788492,227.32888773211522,24068676,66.99177540939229,65.69566329265884,NaN,NaN,NaN,NaN,NaN,NaN,-0.055760983896676386,5.598545165377232,5.654306149273908,93.42306515754059,83.30784133781997,6056718314,15052383879.918966,28.340636794049217,18.922029086686848,19.631638684420434,42.857142857142854,64.28571428571429
2020-06-23,248.39,251.15,247.82,248.84,210.82064620496155,220.1496450989709,228.74027387150332,239.11890445610294,209.46345000000017,216.2338,227.0154,239.25150000000008,239.25150000000008,250.2503786246544,228.25262137534577,32767370,68.93021924134555,65.68234519180662,NaN,NaN,NaN,NaN,68.93021924134555,NaN,0.10539780770966356,5.786053408910988,5.680655601201324,88.26219512195121,86.6043760429957,6089485684,15039690214.06311,32.727433871995906,17.71397685547331,19.754321327026936,100,57.142857142857146
2020-06-24,247.99,249.325,242.16,243.71,211.14790345665347,220.6161867801794,229.32732195497377,239.5561516507598,209.72605000000013,216.4802,227.65240000000006,239.92250000000007,239.92250000000007,250.2708484189452,229.57415158105493,46032376,59.70596008685637,65.25813780737636,NaN,NaN,NaN,NaN,NaN,NaN,-0.17829017927695112,5.457792877105135,5.636083056382086,62.195121951219534,81.29346074357045,6043453308,15013574148.684185,29.438903040821508,23.87165219954053,18.983469698692343,92.85714285714286,50
2020-06-25,243.91,246.34,241.14,246.03,211.4949889943982,221.11943060631444,229.98232893713165,240.17270863640172,210.00300000000013,216.71670000000003,228.38440000000006,240.7245000000001,240.7245000000001,250.3289208050168,231.1200791949834,36940811,62.1714159113123,64.68651486827028,NaN,NaN,NaN,NaN,NaN,NaN,-0.2500801610968626,5.323482855011008,5.573563016107871,73.98373983739836,74.81368563685636,6080394119,15046110478.372646,27.295275728083197,23.561727219283373,17.545529023615973,85.71428571428571,42.857142857142854
2020-06-26,245.75,245.96,239.68,240.22,211.78080999942907,221.4976597032191,230.38380623371472,240.17721257579203,210.24195000000014,216.84420000000003,228.92380000000006,241.06750000000005,241.06750000000005,250.06627963947844,232.06872036052167,52824554,53.36523383508084,63.37162412758475,NaN,NaN,53.36523383508084,NaN,NaN,NaN,-0.7035608525149444,4.69411195046419,5.397672802979135,44.461382113821124,60.21341463414634,6027569565,15002370401.812136,24.90991046629466,23.51194911802322,15.556654915965249,78.57142857142857,35.714285714285715
2020-06-29,239.98,242.85,237.35,242.84,212.0898566661014,221.92028030315538,230.87228442062786,240.43081137809756,210.49000000000015,216.99040000000005,229.47480000000004,241.5065000000001,241.5065000000001,249.93350961194807,233.07949038805214,34377800,56.36664408492178,62.16720813692177,NaN,NaN,NaN,NaN,NaN,NaN,-0.8329192154643277,4.356523783648726,5.189442999113053,57.774390243902445,58.739837398373965,6061947365,15036623191.630318,23.032408475467133,24.93283260060291,13.246595252703376,71.42857142857143,28.571428571428573
2020-06-30,242.77,248.16,242.58,247.6,212.44319142564268,222.428789604083,231.52827326687776,241.11359124685018,210.76530000000017,217.16450000000003,230.17200000000005,242.10500000000008,242.10500000000008,250.47764474344174,233.7323552565584,38909219,61.24659815347777,61.149273652540664,NaN,NaN,NaN,NaN,NaN,NaN,-0.6138746111380655,4.422099735190471,5.035974346328537,81.96138211382109,61.399051490514886,6100856584,15067722674.917055,28.52030416065715,23.035828502599013,10.904436316529964,64.28571428571429,21.428571428571427
2020-07-01,247.66,251.52,247.0802,250.49,212.82176663533778,222.98445713667542,232.27187039366686,242.00658255667398,211.05935000000017,217.37740000000005,231.08400000000006,242.79500000000007,242.79500000000007,251.5353649809323,234.05463501906786,34689213,63.887375258794386,61.80882833281225,NaN,NaN,NaN,NaN,NaN,NaN,-0.3058803436495454,4.653623916766605,4.959504260416151,94.86284289276807,78.19953841683053,6135545797,15086316618.134632,31.406622410208264,21.625937671668005,11.773767664884797,100,14.285714285714286
2020-07-02,252.97,254.27,251.71,252.19,213.21349035040905,223.56278471812738,233.05297351548384,242.97643183699074,211.35730000000018,217.57960000000006,231.90840000000003,243.65300000000008,243.65300000000008,252.54364024690457,234.76235975309558,31956497,65.3817607799844,62.43466635722625,NaN,NaN,NaN,NaN,NaN,NaN,-0.033525575737039404,4.917597290744851,4.9511228664818905,90.8771929824561,89.23380599634841,6167502294,15066343807.509632,33.60348314275178,20.476838201038237,13.480422666214716,100,7.142857142857143
2020-07-06,255.46,258.928,255.43,258.39,213.6630078593602,224.2524325454912,234.04658239722957,244.44439070965828,211.68665,217.84340000000003,232.8658000000001,244.58800000000005,244.58800000000005,255.35096167418286,233.82503832581725,34589049,70.22161411392668,63.197936837563624,NaN,NaN,NaN,NaN,NaN,NaN,0.4894696560622993,5.562959936559764,5.073490280497465,97.506719807211,94.41558522747839,6202091343,15090293114.736048,36.89185368042159,18.581497538866167,15.81349686027043,100,0
2020-07-07,258.1,260.88,256.3,256.61,214.09034111449094,224.89317645548147,234.93142230322056,245.6030201658813,212.00549999999996,218.06680000000003,233.72120000000007,245.34100000000007,245.34100000000007,257.1998834212951,233.48211657870502,36578191,67.31201719484156,63.48250867216181,NaN,NaN,NaN,NaN,NaN,NaN,0.6317646430330015,5.863196084288717,5.231431441255715,81.85295367615817,90.07895548860841,6165513152,15058666556.578842,37.25534371443059,17.402392499134674,17.540936366394625,100,64.28571428571429
2020-07-08,258,260.02,256.5,259.99,214.54705413822734,225.5881630603234,235.9141116246629,246.97320872151167,212.35144999999997,218.32700000000006,234.60980000000006,246.17550000000006,246.17550000000006,259.58941288923137,232.76158711076874,30426273,69.86536153498592,63.90073610937723,NaN,NaN,NaN,NaN,NaN,NaN,0.8558439794709845,6.301236415594445,5.445392436123461,96.21759456013605,91.85908934783508,6195939425,15088574199.925434,35.39629220148587,16.534008506965442,19.084982136531977,92.85714285714286,57.142857142857146
2020-07-09,261.89,262.87,257.63,262.18,215.0210137985435,226.31275389081205,236.94414646291142,248.42147455755818,212.70984999999996,218.60240000000005,235.62340000000003,246.97350000000006,246.97350000000006,262.09349507274743,231.8535049272527,40312906,71.42294332211006,64.38682324078871,NaN,NaN,NaN,NaN,NaN,NaN,1.0415438911476214,6.747322300057988,5.7057784089103665,97.29623824451411,91.78892882693611,6236252331,15118270348.23841,36.8031411443362,15.309303250023437,21.03602988216976,100,50
2020-07-10,262,264.23,259.26,263.97,215.50806838761272,227.05844193257815,238.00398385652275,249.9022865044574,213.08984999999996,218.89480000000006,236.52280000000007,248.4710000000001,248.4710000000001,264.08707492297,232.85492507703023,32885298,72.66652228341829,64.96681722931773,NaN,NaN,NaN,NaN,72.66652228341829,NaN,1.1655526719545346,7.162719248853534,5.997166576899,99.03273809523813,97.5155236332961,6269137629,15147714930.954708,36.139226307068505,14.232481455360737,22.71902685847847,100,42.857142857142854
2020-07-13,266.87,269.79,257.69,258.54,215.93624681161657,227.68183912203204,238.80931782293362,250.72492588498528,213.43215,219.11040000000006,237.31540000000007,249.6040000000001,249.6040000000001,264.68038338593993,234.52761661406024,64108090,63.62183523660872,64.72610721697605,NaN,NaN,NaN,NaN,NaN,NaN,0.7809738388134679,6.973383875415834,6.192410036602366,65.32059186189892,87.21652273388372,6205029539,15092613762.690245,37.66685855897066,12.01643992218066,24.983286168038575,100,35.714285714285715
2020-07-14,256.07,260.79,252.76,260.37,216.37837370901343,228.32912943644726,239.65483477105388,251.64350437212954,213.78709999999998,219.36630000000005,238.26800000000006,250.68500000000012,250.68500000000012,265.5928026549787,235.7771973450215,72230512,65.19417724038725,64.45924707405045,NaN,NaN,NaN,NaN,NaN,NaN,0.5593186421116698,6.8915583392419535,6.332239697130284,70.96177558569664,78.4383685142779,6277260051,15157288405.439934,33.89505965456016,16.960975701331026,25.23570984497778,92.85714285714286,28.571428571428573
2020-07-15,261.68,262.69,257.49,260.9,216.82137496564016,228.974097170379,240.48797850552236,252.52507538430768,214.15645,219.67260000000005,239.18160000000012,251.5875000000001,251.5875000000001,266.67313406025266,236.50186593974755,54523869,65.65714641133764,64.88433181151339,NaN,NaN,NaN,NaN,NaN,NaN,0.36716259276673213,6.791192938088699,6.424030345321967,72.59556103575821,69.62597616111792,6331783920,15174274687.705318,34.067607188306035,15.853851376039477,27.09583610127033,85.71428571428571,21.428571428571427
2020-07-16,257.97,259.78,255.62,259.12,217.24225680677807,229.5710457412626,241.21864601510973,253.15316344294504,214.50799999999998,220.04990000000006,240.01080000000013,252.36250000000013,252.36250000000013,267.3232939294594,237.40170607054083,47594111,62.64341589588356,64.91804609612562,NaN,NaN,NaN,NaN,NaN,NaN,0.05531353388407734,6.493172262677064,6.437858728792986,67.10850801479653,70.2219482120838,6284189809,15206766821.176474,31.797951562741854,17.15716726584715,28.70764160345231,78.57142857142857,14.285714285714286
2020-07-17,259.71,260.31,257.17,259.42,217.66193584352655,230.1621141424257,241.9324246027525,253.75000501980742,214.86875,220.49040000000005,240.81920000000014,253.1195000000001,253.1195000000001,267.8988592215555,238.34014077844475,35137871,62.95207016857846,65.60282011994688,NaN,NaN,NaN,NaN,NaN,NaN,-0.1825944715569312,6.209615639346822,6.392210110903753,68.0332922318126,69.24578709412243,6319327680,15221985771.673288,31.187443077073617,16.455068144077643,30.710191935066145,71.42857142857143,7.142857142857143
2020-07-20,260.12,267.43,258.79,266.78,218.15067280030738,230.88722079307075,242.90683932421317,254.9909569226829,215.28240000000002,220.99340000000004,241.71840000000014,254.2465000000001,254.2465000000001,269.5730028953045,238.91999710469574,40610128,69.59037816358497,66.54737255413711,NaN,NaN,NaN,NaN,69.59037816358497,NaN,0.08928274988105134,6.503813548255067,6.414530798374016,88.93789048144048,74.69323024268319,6359937808,15256485579.488102,36.72673337411627,14.675500342745075,33.49142630856347,64.28571428571429,0
2020-07-21,268.41,268.41,263.125,264,218.6068850112496,231.54291939122777,243.73402209581266,255.84896102528452,215.67204999999998,221.577,242.50120000000018,255.1095000000001,255.1095000000001,270.591078052633,239.62792194736724,43442967,64.86277877186107,66.80567116973592,NaN,NaN,NaN,NaN,NaN,NaN,0.01911661758404115,6.438426570354068,6.419309952770027,74.50439898193726,77.1585272317301,6316494841,15227427700.898699,35.517457200356915,13.699530349070239,35.89801210831224,57.142857142857146,0
2020-07-22,264.46,265.89,262.55,264.93,219.0678115285506,232.20404970031237,244.5652369155847,256.71382188001934,216.05265,222.16830000000002,243.26240000000016,255.91400000000013,255.91400000000013,271.6784377000817,240.14956229991856,29865519,65.70220117580759,66.93530159237973,NaN,NaN,NaN,NaN,NaN,NaN,-0.025037475628941763,6.388013108233849,6.413050583862791,73.11946902654863,78.85391949664212,6346360360,15240125017.359777,33.97949172861499,13.851780714295419,37.58643063779825,50,0
2020-07-23,264.55,265.24,256.55,258.01,219.4552959909531,232.71505861713786,245.09248252673825,256.8372674152556,216.40150000000003,222.58419999999998,243.98020000000014,256.62900000000013,256.62900000000013,271.3790412202718,241.87895877972846,51363538,55.145442406143175,66.2041359942482,NaN,NaN,NaN,NaN,NaN,NaN,-0.5514846916507112,5.723694719299402,6.275179410950114,30.827950675278867,59.483939561254914,6294996822,15206020573.831583,30.30288867960066,19.82370977353082,37.345925485938665,42.857142857142854,0
2020-07-24,254.12,256.93,251.32,255.56,219.81454677711275,233.16743369402622,245.50297340804264,256.715622899517,216.75220000000002,223.045,244.70460000000014,257.1055000000002,257.1055000000002,271.0488245318192,243.16217546818118,54054536,51.962109040841725,64.899885631885,NaN,NaN,51.962109040841725,NaN,NaN,NaN,-1.0661047580708196,4.9425484633615895,6.008653221432409,22.95614510016244,42.30118826732998,6240942286,15233674142.159569,27.808319069764583,24.627370770213272,35.42156110640953,35.714285714285715,100
2020-07-27,257.36,260.52,256.445,260.12,220.21559606291262,233.70114787830292,246.076190137139,257.0398492900392,217.11665000000008,223.46400000000006,245.47040000000013,258.1005000000001,258.1005000000001,269.73018696912254,246.47081303087768,36445741,56.94395270898783,64.15930959718116,NaN,NaN,NaN,NaN,NaN,NaN,-1.096542870243205,4.637974633628403,5.734517503871608,47.64482945316729,33.80964174286954,6277388027,15262964891.061409,30.557193860337446,23.108490908849475,33.81852659271094,28.571428571428573,92.85714285714286
2020-07-28,259.33,259.85,256.51,256.81,220.5797194851722,234.15874891041574,246.4971238572512,257.01795888146404,217.45730000000006,223.91620000000006,246.14120000000014,258.79900000000015,258.79900000000015,268.1293009597625,249.46869904023782,31302390,52.6737523281689,62.93133751097995,NaN,NaN,NaN,NaN,NaN,NaN,-1.3216552687555296,4.082448417927196,5.404103686682726,29.72387655657824,33.441617036635996,6246085637,15237285684.893745,29.14814360073868,22.042914492936706,32.21549207901235,21.428571428571427,85.71428571428571
2020-07-29,258.33,260.66,257.91,259.77,220.96967252512073,234.6659023973382,247.01762880402566,257.2800580356103,217.8006000000001,224.43370000000007,246.78800000000012,259.40750000000014,259.40750000000014,267.19713895182144,251.61786104817887,27556884,55.86138142444236,61.81979737543226,NaN,NaN,NaN,NaN,NaN,NaN,-1.253835902729925,3.8368088082703196,5.090644711000245,45.74986464537074,41.03952355170543,6273642521,15247005749.431927,28.740278762466243,20.934229408315304,30.391869317374493,14.285714285714286,78.57142857142857
2020-07-30,257.78,261.71,256.55,261.13,221.36927777362698,235.18994393402457,247.57105512543643,257.646719175076,218.1508000000001,225.10930000000005,247.47340000000014,259.9395000000001,259.9395000000001,266.59047128243265,253.2885287175676,41774456,57.28495037201783,60.72111366747508,NaN,NaN,NaN,NaN,NaN,NaN,-1.1052183014174997,3.7091218342283696,4.814340135645869,53.11315646995121,42.86229922396674,6315416977,15279389048.656733,26.795063639628815,21.30122849878647,28.101326333809055,7.142857142857143,71.42857142857143
2020-07-31,265.83,265.95,260.85,265.79,221.8112750097103,235.7958856383013,248.2855235518899,258.42226972983065,218.51215000000008,225.72610000000003,248.16140000000013,260.61950000000013,260.61950000000013,266.7203637912768,254.51863620872348,53756159,61.82789619125027,60.59297516423519,NaN,NaN,NaN,NaN,NaN,NaN,-0.7006314051190241,3.9385508792470887,4.639182284366113,84.66939730836746,61.17747280789647,6369173136,15329772272.190067,30.58126770191961,19.86978261308468,25.930154303182114,0,64.28571428571429
2020-08-03,268.05,270.15,267.87,269.38,222.28459565637985,236.4609176058597,249.11275792240403,259.46586308889437,218.8938500000001,226.46770000000004,248.97160000000014,261.16900000000015,261.16900000000015,268.2660329011254,254.07196709887486,32081566,64.92298087955183,60.573603995604074,NaN,NaN,NaN,NaN,NaN,NaN,-0.22350504691423634,4.359800975723317,4.5833060226375535,95.91078066914507,77.89777814915459,6401254702,15340184710.277786,34.41206917042181,18.712089207883718,25.662675049005852,100,57.142857142857146
2020-08-04,268.74,270.48,268.09,270.38,222.7631568936298,237.13258260376347,249.94676741564308,260.50530469947586,219.27800000000008,227.39830000000006,249.78600000000017,261.85750000000013,261.85750000000013,269.685868603977,254.02913139602327,24911286,65.75589925128443,60.58065776988599,NaN,NaN,NaN,NaN,NaN,NaN,0.1092975525040778,4.719927963267651,4.610630410763573,99.47807933194143,93.35275243648466,6426165988,15363011369.83427,33.72693920590884,18.089885829878803,25.21215624869402,100,50
2020-08-05,270.83,271.52,269.96,271.05,223.2436229941907,237.80421463141172,250.77434516404924,261.50956139476386,219.67480000000006,228.18540000000007,250.62620000000013,262.4105000000001,262.4105000000001,271.143370032224,253.67762996777623,21685921,66.33272836375306,60.844180089019524,NaN,NaN,NaN,NaN,NaN,NaN,0.3128858134485686,5.001737677574283,4.688851864125715,97.67326732673281,97.68737577593977,6447851909,15371630133.30863,34.479267426574694,17.676721160114734,25.37711367053965,100,42.857142857142854
2020-08-06,270.78,274.98,270.19,274.64,223.75502973056692,238.53363612385903,251.71025319683162,262.7600793571673,220.08105000000006,229.23880000000008,251.51320000000015,263.0335000000001,263.0335000000001,273.2615013198943,252.80549868010593,28048224,69.31527954682858,61.29869504460881,NaN,NaN,NaN,NaN,69.31527954682858,NaN,0.610447045571421,5.4519106710899905,4.8414636255185695,98.56297548605227,98.57144071490883,6475900133,15395696563.504871,37.130405335723275,16.435455622249147,25.92795920099783,100,35.714285714285715
2020-08-07,274.04,274.8818,269.245,271.47,224.22980555414335,239.18584134912913,252.4851452283284,263.58959560886564,220.47915000000003,230.13210000000007,252.34280000000018,263.4085000000002,263.4085000000002,274.2762969708501,252.54070302915025,44969356,63.92970342239811,60.89436113452404,NaN,NaN,NaN,NaN,NaN,NaN,0.5185113242804409,5.48960278086912,4.971091456588679,85.16483516483522,93.80035932587344,6430930777,15386228490.892609,34.09616282398751,16.462371706190712,25.35500233900994,92.85714285714286,28.571428571428573
2020-08-10,271.74,271.98,266.67,270.31,224.68831495161456,239.8021613224137,253.18415914094297,264.229634122307,220.86960000000008,231.06920000000008,253.08180000000016,263.9970000000002,263.9970000000002,275.0201285939879,252.97387140601245,35088373,62.03041344652824,60.692049325571695,NaN,NaN,NaN,NaN,NaN,NaN,0.3143575929076192,5.364038447723203,5.049680854815584,80.26204564666098,87.9966187658495,6395842404,15399246211.19581,31.48590526784859,18.914531988238465,23.97021025743982,85.71428571428571,21.428571428571427
2020-08-11,269.1,270.44,264.63,265.19,225.09131679289203,240.30489080117778,253.65497642953343,264.32109753923015,221.22510000000005,231.9445000000001,253.70440000000016,264.23800000000017,264.23800000000017,275.1435336412108,253.3324663587895,43104323,54.35464437753278,59.88150955426635,NaN,NaN,54.35464437753278,NaN,NaN,NaN,-0.20286457047397466,4.796100141723116,4.998964712197091,58.622147083685505,74.68300929839391,6352738081,15364451155.280148,28.880645429155173,20.254759931048643,22.218402013826246,78.57142857142857,14.285714285714286
2020-08-12,267.37,272.84,267.37,271.86,225.55667682480356,240.9297444486792,254.36889892249292,265.03908824977964,221.60620000000006,232.95610000000008,254.42900000000012,264.7860000000002,264.7860000000002,276.06074948722073,253.51125051277964,38894272,61.10665446756284,60.30731041579632,NaN,NaN,NaN,NaN,NaN,NaN,-0.13632569561999386,4.828557592672098,4.964883288292092,86.8131868131868,75.23245984784444,6391632353,15389408905.685999,29.14231611107347,18.127841031153913,22.389522874447383,71.42857142857143,7.142857142857143
2020-08-13,272.64,274.83,271.51,272.48,226.0235755628652,241.55450198434892,255.07913818043437,265.7477465117054,221.98075000000006,233.97630000000012,255.14480000000012,265.4540000000002,265.4540000000002,276.88876698492703,254.01923301507335,31895717,61.67417108569281,61.001029133285684,NaN,NaN,NaN,NaN,NaN,NaN,-0.09317094136146586,4.848419611590259,4.941590552951725,86.51200431615864,77.31577940434367,6423528070,15376151047.414915,30.583077697912962,17.279786954925477,23.941538420771064,64.28571428571429,0
2020-08-14,273.01,273.4,270.72,272.16,226.4826444627372,242.16055145000539,255.7489758988487,266.3584373201144,222.36135000000004,234.86130000000009,255.88740000000013,266.0910000000002,266.0910000000002,277.5296658312754,254.652334168725,30799494,61.177988580530005,61.30346026696727,NaN,NaN,NaN,NaN,NaN,NaN,-0.12671139296118206,4.783201311750247,4.909912704711429,84.731997834326,86.01906298789049,6392728576,15378449517.116407,29.387913411593917,17.75646902522875,24.712405413602365,57.142857142857146,0
2020-08-17,273.91,275.84,272.1978,275.32,226.96858829892886,242.81717419356963,256.5164670400703,267.21191948010346,222.75300000000007,235.79150000000013,256.60000000000014,266.51800000000014,266.51800000000014,278.6445701663585,254.39142983364178,24802966,64.23773172711955,62.12945879546375,NaN,NaN,NaN,NaN,NaN,NaN,0.015809603117022064,4.929674708607706,4.913865105490684,97.30430274753768,89.51610163267412,6417531542,15396170201.901756,31.404722947169805,16.78640199096015,25.88770737467907,100,0
2020-08-18,276.41,278.465,274.91,277.97,227.47606503227286,243.513269754093,257.3577820581068,268.2364985772365,223.15745000000007,236.6522000000001,257.3284000000001,267.21650000000017,267.21650000000017,280.2573470200208,254.17565297997953,23529498,66.61409874932303,62.897510032955225,NaN,NaN,NaN,NaN,NaN,NaN,0.22862827577314526,5.199650450207116,4.971022174433971,97.74127310061627,93.25919122749333,6441061040,15413147181.471376,33.68683885681198,15.883643191241845,27.330601408079207,100,7.142857142857143
2020-08-19,277.93,279.02,275.57,276.1,227.95988528070797,244.15855154114064,258.0927709970046,268.98540347464257,223.54360000000005,237.56020000000007,257.9844000000001,267.77500000000015,267.77500000000015,281.3231991423062,254.22680085769412,31999359,63.411960652491516,63.33515362441763,NaN,NaN,NaN,NaN,NaN,NaN,0.1853749331860497,5.202740840916533,5.0173659077304835,83.92955421023684,92.99171001946361,6409061681,15390979509.584421,32.75027012883528,15.038403250653587,29.16205297762396,100,0
2020-08-20,275.3,280.43,274.86,279.93,228.47700085005417,244.86689705517745,258.9491329186907,270.02774600086707,223.94275000000005,238.4391000000001,258.65860000000015,268.87100000000015,268.87100000000015,282.6269658330347,255.11503416696556,27723379,66.9193924067958,63.69883192552802,NaN,NaN,NaN,NaN,NaN,NaN,0.3472262008654603,5.451398658812309,5.104172457946849,96.83544303797468,92.83542344960928,6436785060,15413725621.259466,32.12052551178664,13.764836455403213,30.502904712063224,100,0
2020-08-21,280.07,282.34,279.461,281.87,229.0082744734367,245.59963176695612,259.847990451291,271.1555797150702,224.35105000000007,239.3538000000001,259.61560000000014,270.18650000000014,270.18650000000014,283.62758221087984,256.74541778912044,34748934,68.56329021779425,63.95885402111677,NaN,NaN,NaN,NaN,NaN,NaN,0.5077417704612319,5.738849671023388,5.231107900562156,97.34613212874099,92.70370979231753,6471533994,15437128949.854813,33.66112994621124,13.145170852364421,31.522779470721748,100,42.857142857142854
2020-08-24,285.06,286,281.27,283.63,229.5517742299199,246.35270836563026,260.7806182767306,272.3436197422064,224.77040000000005,240.36700000000008,260.5706000000002,271.36200000000014,271.36200000000014,285.18278666355906,257.5412133364412,36418533,70.01889858776921,64.26335397372283,NaN,NaN,NaN,NaN,NaN,NaN,0.6463612332896513,6.039059442174221,5.392698208884569,88.90968647636872,94.36375388102813,6507952527,15437051955.070457,36.886358852419484,12.175390476936181,32.96488774017841,100,35.714285714285715
2020-08-25,282.78,286.06,282.37,285.86,230.11205508335354,247.13503097225146,261.764123442349,273.63089405247246,225.19755000000004,241.3655000000001,261.51280000000014,272.81450000000007,272.81450000000007,286.3149214378568,259.3140785621433,34866586,71.80055863770126,64.65391327900484,NaN,NaN,NaN,NaN,NaN,NaN,0.7925110932933297,6.383337075501231,5.590825982207901,99.06672888474107,95.10751582995027,6542819113,15468138965.3523,34.82844621449623,11.464793582746061,34.26866441553616,100,28.571428571428573
2020-08-26,287.11,292.22,285.829,291.96,230.7274575203351,248.02265412131578,262.94827546421766,275.3765231903322,225.65120000000007,242.4514000000001,262.4950000000001,274.4240000000001,274.4240000000001,288.955952931376,259.8920470686242,42216690,76.00170079673606,65.13151479685538,NaN,NaN,NaN,NaN,NaN,NaN,1.180887509080084,7.066935368558006,5.886047859477922,99.05762957593313,95.67801497901432,6585035803,15506920718.910429,40.87167483857814,10.339263411536963,35.76768518388655,100,21.428571428571427
2020-08-27,293.08,293.851,288.705,291.05,231.32768182361534,248.87468077237884,264.0503038773856,276.8692352674434,226.1016500000001,243.3971000000001,263.4436000000001,275.9200000000001,275.9200000000001,290.82517628207717,261.014823717923,49482715,74.22516371306497,65.86690481761728,NaN,NaN,NaN,NaN,NaN,NaN,1.250674198982316,7.449390608205817,6.198716409223501,90.41442797987753,96.17959548018393,6535553088,15502535931.10631,40.15172321642872,9.528143886094949,37.67938939850036,100,14.285714285714286
2020-08-28,292.27,293.18,290.93,292.53,231.93666011392762,249.73914253926242,265.1671547057234,278.36073667054404,226.55660000000006,244.3584000000001,264.4086000000001,277.2570000000001,277.2570000000001,293.05791908718084,261.4560809128194,28021022,75.2389020503065,66.81036828931573,NaN,NaN,NaN,NaN,NaN,NaN,1.2667903642464289,7.7822043645315375,6.515414000285109,95.47927860100603,94.98377871893892,6563574110,15514367029.284086,38.7213697032818,9.188716011286607,40.300735517183185,92.85714285714286,7.142857142857143
2020-08-31,293.16,296.745,292.62,294.88,232.56296200334128,250.63302090482156,266.3323643251068,279.93399984477793,227.02305000000007,245.3015000000001,265.4214000000001,278.5320000000001,278.5320000000001,295.64547843075,261.4185215692502,36321027,76.79925456261363,68.41355473110723,NaN,NaN,NaN,NaN,NaN,NaN,1.3010561444602757,8.141734180860453,6.840678036400178,93.6510638297872,93.18159013689028,6599895137,15517845042.778631,41.796106384482336,8.57261454939043,43.75825172285338,100,0
2020-09-01,297.6,300.04,295.79,299.92,233.23318128689013,251.6090006888845,267.64952650843594,281.8374284309896,227.51550000000006,246.29210000000006,266.4850000000001,280.00900000000007,280.00900000000007,299.04431759650424,260.9736824034959,36395774,79.74699745715759,69.74500780179257,NaN,NaN,NaN,NaN,NaN,NaN,1.5136056284275012,8.732685071934554,7.219079443507053,99.5907230559345,96.24035516224261,6636290911,15552185526.011572,43.58779346029607,7.876372184288032,47.05037534077422,100,0
2020-09-02,303.26,303.5,296.89,302.76,233.92499042831412,252.6218917643521,269.0264078218306,283.83005429470484,228.0147500000001,247.2894000000001,267.5634000000001,281.59450000000004,281.59450000000004,302.56488242378686,260.6241175762132,50836767,81.1967474906254,71.13947754500204,NaN,NaN,NaN,NaN,81.1967474906254,NaN,1.682909015010127,9.322715712269712,7.639806697259585,97.74252593044537,96.99477093872237,6687127678,15591639779.371632,44.47010983765799,7.082796497056745,50.24520566053072,100,7.142857142857143
2020-09-03,298.2,298.62,284.41,287.41,234.45717957828114,253.310765194761,269.7473330052882,284.17100150473294,228.43645000000006,248.0449000000001,268.43740000000014,282.23300000000006,282.23300000000006,303.0948600321212,261.37113996787895,110083282,57.315751937971804,70.86360349910503,NaN,NaN,NaN,NaN,NaN,NaN,0.6515524273769655,8.454247231480792,7.802694804103827,48.59786213109634,81.97703703915876,6577044396,15528037826.857908,34.17574770838318,21.18701065762282,50.15871869604701,92.85714285714286,0
2020-09-04,285.76,288.93,271.8,283.58,234.94596386108432,253.91015598298355,270.2897905344926,284.11471564713935,228.83750000000006,248.7864000000001,269.1884000000001,282.8385000000001,282.8385000000001,303.1102816434489,262.56671835655135,123958978,53.11787623706278,70.06932810695811,NaN,NaN,NaN,NaN,NaN,NaN,-0.34459468748389455,7.371951444748959,7.716546132232853,37.16088328075703,61.16709044743293,6453085418,15574567670.905777,27.723810418721666,31.084459136037403,48.400185350526556,85.71428571428571,100
2020-09-08,272.27,278.22,269.66,269.95,235.29426272813822,254.22777665658785,270.2764654154929,282.76569510931654,229.17650000000006,249.35340000000008,269.78300000000013,282.8205000000001,282.8205000000001,303.1373368354836,262.5036631645166,99568645,41.47576486567026,68.27373282955435,NaN,NaN,41.47576486567026,NaN,NaN,NaN,-1.8910812135318364,5.3526946153180575,7.243775828849894,0.8569739952717608,28.87190646904173,6353516773,15481745499.515589,23.79295514607166,28.856870030384286,46.52184181911736,78.57142857142857,100
2020-09-09,275.54,280.045,273,277.88,235.71800140746024,254.69613751487324,270.5746432423363,282.30039081319114,229.55740000000006,249.97930000000008,270.4838000000001,283.45500000000004,283.45500000000004,302.2666533032019,264.6433466967982,64837872,48.54225578965958,67.21161105363777,NaN,NaN,NaN,NaN,NaN,NaN,-2.321221453001592,4.342249012597904,6.663470465599496,24.290780141843904,20.769545805957588,6418354645,15506732699.299833,23.223225684855368,25.979971314762274,44.27469041039517,71.42857142857143,92.85714285714286
2020-09-10,280.97,282.195,270.56,272.34,236.0823994034059,255.0455209304203,270.6438729191074,281.3517821643158,229.90995000000007,250.57530000000008,270.9786000000001,283.47900000000004,283.47900000000004,302.2325552895939,264.7254447104062,69667462,44.49978208152186,65.61021031611821,NaN,NaN,NaN,NaN,NaN,NaN,-2.8834422035373173,3.0591677111778495,5.942609914715167,7.919621749408842,11.022458628841525,6348687183,15458381624.46958,20.665960890358924,25.428422818478374,42.15530564265257,64.28571428571429,85.71428571428571
2020-09-11,274.33,275.22,266.9,270.45,236.42436557849638,255.35056011991693,270.6362700595346,280.3135171962857,230.24110000000005,251.23090000000008,271.37780000000004,283.37750000000005,283.37750000000005,302.38828628042046,264.36671371957965,71809014,43.17868898154024,63.79702451352863,NaN,NaN,NaN,NaN,NaN,NaN,-3.2594694978388956,1.868273042416547,5.127742540255443,9.699453551912594,13.969951814388471,6276878169,15447851937.320541,19.05048385149516,26.879428326437004,40.242005460961245,57.142857142857146,100
2020-09-14,274.28,277.22,272.96,275.16,236.80979477672028,255.7428262561562,270.8136712336705,279.8227060347347,230.59385000000006,251.8728000000001,271.8372000000001,283.52750000000003,283.52750000000003,302.2266709709236,264.8283290290765,38525194,47.37181325025049,62.179375560848726,NaN,NaN,NaN,NaN,NaN,NaN,-3.0704567973116372,1.2896715436158956,4.360128340927533,22.568306010929078,13.395793770750194,6315403363,15449118023.508335,19.723092856160363,25.15620955786545,37.50907600185549,50,92.85714285714286
2020-09-15,278.9,280.45,275.1332,279.06,237.23019482869321,256.2045524689056,271.1370566754874,279.75006736476,230.95895000000004,252.5582000000001,272.2506000000001,283.71450000000004,283.71450000000004,302.15462524360413,265.27437475639596,41849926,50.62115783276805,60.666561217639206,NaN,NaN,NaN,NaN,50.62115783276805,NaN,-2.5818904483214298,1.1327652805257458,3.7146557288471755,33.224043715847046,21.83060109289624,6357253289,15469085841.044598,21.833239528766192,23.86237034714533,34.221341439024336,42.857142857142854,85.71428571428571
2020-09-16,279.77,280.36,274.25,274.61,237.60213318860673,256.56901677645203,271.27325053135064,279.2605371395448,231.30650000000006,253.16590000000008,272.6106000000001,283.54650000000004,283.54650000000004,302.2522170672454,264.8407829327547,42435626,47.05146689095676,58.5986873672264,NaN,NaN,NaN,NaN,NaN,NaN,-2.4581739734078942,0.641938262087308,3.100112235495202,21.06557377049189,25.619307832422674,6314817663,15431650812.54378,20.526679477392314,23.29940739518183,30.414611591487194,35.714285714285715,78.57142857142857
2020-09-17,267.52,274.3955,266.68,270.32,237.92768410215294,256.84131347394805,271.23586815757216,278.4090574119691,231.64310000000006,253.7135000000001,272.81720000000007,283.25750000000005,283.25750000000005,302.58281383962026,263.93218616037984,81570844,43.841738561551594,56.42844271354687,NaN,NaN,NaN,NaN,NaN,NaN,-2.553810251362028,-0.0921505787073329,2.461659672654695,9.885931558935326,21.39184968175809,6233246819,15427046561.029036,18.94229542621621,28.86925768314988,27.494672661193736,28.571428571428573,100
2020-09-18,271.62,272.09,262.63,266.87,238.2156673449176,257.0399013259491,271.06465764158895,277.31009956321014,231.97040000000004,254.2672000000001,272.9110000000001,282.60450000000003,282.60450000000003,303.1777277243955,262.0312722756046,86251117,41.39605348578663,54.01109638750974,NaN,NaN,NaN,NaN,NaN,NaN,-2.7224916857703914,-0.9414549345582941,1.7810367512120973,10.374357719598748,13.775287683008656,6146995702,15418111455.885273,17.233400448866877,30.127099312176842,25.036297904868665,21.428571428571427,100
2020-09-21,262.52,267.65,260.11,267.51,238.50715324198308,257.24723001256393,270.9252593027031,276.3767567476663,232.29580000000004,254.75230000000008,272.98180000000013,281.8865,281.8865,303.4887334724874,260.2842665275126,57168570,42.04196346153077,51.5284327374324,NaN,NaN,NaN,NaN,NaN,NaN,-2.660894495330352,-1.5450813679508428,1.1158131273795093,17.054620880387137,12.43830338630707,6204164272,15473157055.116043,15.994812595749503,30.363890371240025,22.53878817556394,14.285714285714286,100
2020-09-22,270.05,273.08,266.54,272.48,238.84519151818225,257.54886902221614,270.9862295261265,276.0056370574124,232.64405000000002,255.28800000000007,273.2606000000001,281.32900000000006,281.32900000000006,303.2949226075231,259.363077392477,41128886,46.933307875794114,49.184597767335,NaN,NaN,NaN,NaN,NaN,NaN,-2.175796949452114,-1.603933059435633,0.5718638900164809,28.508873012214817,18.645950537400235,6245293158,15506739356.528887,20.211918118900535,28.45366282502606,18.791975394244552,7.142857142857143,92.85714285714286
2020-09-23,272.15,272.34,263.2502,264.16,239.09708015979237,257.6797825069247,270.71853425059214,274.87748114718266,232.93985,255.80220000000006,273.33640000000014,280.244,280.244,303.32303325531336,257.1649667446867,48837270,40.735485851088704,46.294507650225235,NaN,NaN,40.735485851088704,NaN,NaN,NaN,-2.2938648710615497,-2.2954671988104565,-0.0016023277489066734,10.51674889639058,18.69341426299751,6196455888,15467678351.847376,18.44800821922858,29.081103068942728,15.209798935016158,0,85.71428571428571
2020-09-24,261.58,268.7,261.22,265.39,239.35870125272976,257.832460081045,270.50957212311795,273.9739115141177,233.24645000000004,256.30390000000006,273.4262000000001,278.9155,278.9155,302.2019222026444,255.6290777973556,70631704,41.955831891150495,45.19737050402371,NaN,NaN,NaN,NaN,NaN,NaN,-2.1691090353856497,-2.712988621980969,-0.5438795865953192,18.32061068702281,19.1154108652094,6267087592,15475799109.25914,17.142339637822985,28.943841476194056,15.363107368664558,0,78.57142857142857
2020-09-25,265.82,272.395,264.2999,271.56,239.67911218553843,258.1042925546877,270.5507653731918,273.7440151794398,233.58475000000007,256.84290000000004,273.6750000000001,277.94100000000003,277.94100000000003,300.7407876305856,255.14121236941446,55242376,47.766211776769545,44.815108756859914,NaN,NaN,NaN,NaN,NaN,NaN,-1.5784927824599928,-2.51699556467031,-0.9385027822103174,51.845143762734885,26.894167782049426,6322329968,15519645113.6368,19.31428878748766,26.73826558215296,16.106398587901314,0,71.42857142857143
2020-09-28,276.615,277.2,271.674,277.2,240.0524543528465,258.4824253753869,270.8115196722823,274.07315659092177,233.94585000000004,257.42490000000004,274.0306000000001,277.1745,277.1745,298.96950536819884,255.3794946318012,58438286,52.45174619130365,45.59910742297659,NaN,NaN,NaN,NaN,NaN,NaN,-0.7570709826195556,-1.8848415104847618,-1.1277705278652062,77.38283903101649,49.1828644935914,6380768254,15578083399.6368,22.877314583019054,25.292181030787464,15.777481818325521,14.285714285714286,64.28571428571429
2020-09-29,276.72,277.71,275.3719,275.95,240.4096438617734,258.82831794221096,271.0130287047418,274.25190358226257,234.29305000000005,257.9662000000001,274.2140000000001,276.22800000000007,276.22800000000007,296.4527804437961,256.00321955620404,27178921,51.35227739277269,45.79982325177038,NaN,NaN,NaN,NaN,NaN,NaN,-0.2720232112968941,-1.4677995419863237,-1.1957763306894296,71.72288883857817,66.98362387744318,6353589333,15564344566.08396,22.852212612664562,24.69589600560855,15.654248537629359,7.142857142857143,57.142857142857146
2020-09-30,276.09,281.09,275.8717,277.84,240.7820852163826,259.2047868938503,271.2807530692618,274.5936270506185,234.64630000000005,258.49600000000004,274.49080000000015,275.124,275.124,292.2244098196473,258.02359018035276,49380802,52.95790950628031,46.4039752106817,NaN,NaN,NaN,NaN,NaN,NaN,0.17777229023315866,-0.9735609678979813,-1.15133325813114,84.50905624404191,77.87159470454553,6402970135,15552215831.836523,25.100233667268956,23.371537546028513,15.17099274675875,0,50
2020-10-01,281.79,282.8794,279.84,282.25,241.19470128388127,259.66112774743743,271.7109196155652,275.3228054267501,235.01120000000006,259.04980000000006,274.8372000000001,274.0985,274.0985,286.1659641495191,262.0310358504809,50020223,56.5606142842165,47.35982701801572,NaN,NaN,NaN,NaN,56.5606142842165,NaN,0.7423086623766105,-0.22344743016037683,-0.9657560925369874,97.23576378824222,84.48923629028745,6452990358,15581519644.784409,25.650041387739194,22.136920040003954,14.47857959326355,100,42.857142857142854
2020-10-02,276.01,282.2412,273.44,274.31,241.52420674374315,259.951204425706,271.8128443365234,275.2263477670596,235.3358,259.5717000000001,275.16320000000013,273.4435,273.4435,283.8587451243344,263.02825487566554,75497391,49.2476394715126,47.49381460524872,NaN,NaN,NaN,NaN,NaN,NaN,0.5593284400972569,-0.2665955424154163,-0.8259239825126732,62.364401345665726,81.36974045931663,6377492967,15520948111.660608,23.3297769043061,26.70578045767592,14.095804284342197,92.85714285714286,35.714285714285715
2020-10-05,276.34,280.49,276.23,280.16,241.90864249753676,260.351378595494,272.1401837743068,275.69621940829205,235.68885000000003,260.17990000000003,275.6552000000001,273.27250000000004,273.27250000000004,283.1128716901245,263.43212830987557,28184581,53.96982092927794,47.733004826428,NaN,NaN,NaN,NaN,NaN,NaN,0.796182185239101,0.16930374903620304,-0.626878436202898,88.05677795638024,82.5523143634294,6405677548,15544766067.435257,21.837499444953178,24.997558627056453,14.260566503776925,85.71428571428571,28.571428571428573
2020-10-06,279.29,281.19,274.25,275.16,242.23950177616823,260.644618623306,272.2586079400203,275.6451508932166,236.01035000000005,260.71320000000003,275.95600000000013,273.533,273.533,283.2831899468604,263.78281005313966,49704236,49.712369421841345,47.92306929291976,NaN,NaN,NaN,NaN,NaN,NaN,0.589527150249521,0.1100305016090033,-0.47949664864051766,66.09748170790638,72.17288700331746,6355973312,15508096659.896353,20.26952746886359,25.25121293269381,14.590360060467102,78.57142857142857,21.428571428571427
2020-10-07,277.83,280.74,277.28,279.92,242.6144321067536,261.02630934363657,272.55905468747045,276.05227937957693,236.35140000000004,261.27970000000005,276.4182000000001,273.63500000000005,273.63500000000005,283.60515847415667,263.6648415258434,27539663,53.47512156460479,48.61116807885213,NaN,NaN,NaN,NaN,NaN,NaN,0.7372393497177635,0.4420525385066867,-0.2951868112110768,87.00273173645347,80.38566380024672,6383512975,15522582841.01196,19.083093482071387,23.773186507208795,13.88900902750286,71.42857142857143,14.285714285714286
2020-10-08,282.32,282.47,280.31,281.41,243.00045765793018,261.4299467823764,272.9061505820795,276.56253848628387,236.69940000000003,261.81950000000006,276.8510000000001,274.0885,274.0885,284.59260067544307,263.58439932455695,25443287,54.619777741292715,49.55571981138828,NaN,NaN,NaN,NaN,NaN,NaN,0.8889546706410859,0.8160065270902805,-0.07294814355080537,93.5466020184987,82.2156051542862,6408956262,15523054012.99344,20.44837120335834,23.107538993570248,12.380480372856876,64.28571428571429,7.142857142857143
2020-10-09,283.09,285.79,282.71,285.71,243.42542822849805,261.91073991539866,273.4082623239587,277.433725297114,237.06835000000007,262.4080000000001,277.3426000000001,274.8515,274.8515,286.35678448148536,263.3462155185146,30201144,57.843249068711096,50.68438306904402,NaN,NaN,NaN,NaN,NaN,NaN,1.2125274305348073,1.4427111446177037,0.23018371408289645,99.67439967439952,93.40791114311725,6439157406,15551686266.396038,23.17400982107803,21.969653060023944,10.357080703626037,100,0
2020-10-12,290.6,297.46,289.47,294.53,243.93393143020452,262.556665857668,274.2365657622348,279.06194193548407,237.47205000000005,263.03940000000006,277.9174000000001,275.82,275.82,290.1744153485924,261.4655846514076,79370657,63.56080907712725,51.8720617262821,NaN,NaN,NaN,NaN,63.56080907712725,NaN,1.912547130163604,2.620867626787401,0.7083204966237974,91.91501103752756,95.0453375768086,6518528063,15572845152.42983,32.65752536789867,19.23343708124588,10.9952471663643,100,14.285714285714286
2020-10-13,296.34,297.0496,293.11,294.52,244.43727539607315,263.18960316741715,275.03199455587264,280.53413794162844,237.87660000000002,263.69590000000005,278.42020000000014,276.59299999999996,276.59299999999996,293.0701843468468,260.1158156531531,64240031,63.55028516528436,53.50169024872465,NaN,NaN,NaN,NaN,NaN,NaN,2.2439512359588214,3.5132595415723245,1.2693083056135028,91.88741721854304,94.4922759768234,6454288032,15554588695.249506,31.252107622574993,18.40572544440153,11.245107757553402,92.85714285714286,7.142857142857143
2020-10-14,295.32,296.35,290.26,292.06,244.91113335233112,263.76129419380493,275.6997594752502,281.63183909004476,238.27585000000008,264.3199000000001,278.8538000000001,277.4655,277.4655,295.2281501119586,259.70284988804144,37181227,60.87985523961523,54.85340620218641,NaN,NaN,NaN,NaN,NaN,NaN,2.165473782840164,3.9761505341637076,1.8106767513235438,83.71536877150558,89.17259900919207,6417106805,15539386518.692856,29.16280521705926,20.303840925003726,10.6952150262004,85.71428571428571,0
2020-10-15,287.25,290.71,286.54,290.1,245.36077381648704,264.2828527246207,276.26447478994623,282.4383306052786,238.66330000000005,264.93050000000005,279.2348000000001,278.4545,278.4545,296.711381962698,260.197618037302,42514177,58.76120143647876,55.63876260645135,NaN,NaN,NaN,NaN,NaN,NaN,1.8611777062173793,4.137148884095268,2.2759711778778886,71.45737997362927,82.35338865455931,6374592628,15569462495.227629,27.376304154529983,23.18839893684656,10.135329855751918,78.57142857142857,0
2020-10-16,291.8,293.269,288.15,288.51,245.79011935065134,264.7625982152222,276.7446914648503,283.01658483334734,239.02505000000005,265.51270000000005,279.51220000000006,279.5365,279.5365,297.4812298948726,261.59177010512735,40570702,57.027414198127886,55.965596035510224,NaN,NaN,NaN,NaN,NaN,NaN,1.4506651295204191,4.089302589778413,2.6386374602579936,62.739383846794354,72.63737753064309,6334021926,15534598162.72167,28.680047023233456,21.85153656899686,10.74247858955504,71.42857142857143,0
2020-10-19,290.49,291.48,282.79,283.8,246.16832711830654,265.13957646838617,277.0213702309346,283.09119580159995,239.37315000000007,266.05080000000004,279.7588000000001,280.351,280.351,297.4994062233184,263.2025937766816,36756754,52.121390985503574,56.0205327207053,NaN,NaN,NaN,NaN,NaN,NaN,0.792680385562246,3.629487942210801,2.836807556648555,43.130724396336475,59.10916273892005,6297265172,15506385556.371843,25.94543213700069,25.64915100994152,10.506531231428145,64.28571428571429,21.428571428571427
2020-10-20,284.56,287.62,282.95,284.41,246.54884127633335,265.52116901356663,277.3111204179568,283.21679620144755,239.71740000000005,266.5613000000001,280.0408000000001,280.9475,280.9475,297.7864178690288,264.1085821309712,32195361,52.6890676434067,56.00132973050004,NaN,NaN,NaN,NaN,NaN,NaN,0.3517808216123486,3.2765335836639906,2.924752762051642,45.670274771024296,50.51346100471839,6329460533,15494320913.598824,24.588582878432582,24.307796148439348,10.29280629141172,57.142857142857146,14.285714285714286
2020-10-21,284.67,287.32,283.69,284.19,246.92338016910614,265.8908488350802,277.58088040156633,283.30948227750014,240.06070000000008,267.06260000000003,280.4208000000001,281.94899999999996,281.94899999999996,296.95819304959457,266.93980695040534,29306137,52.447542590546824,55.70753889523792,NaN,NaN,NaN,NaN,NaN,NaN,0.016288285927974044,2.9451131194616096,2.9288248335336355,44.754371357202366,44.518456841521065,6300154396,15473088092.576784,23.557316320678865,23.288306030423318,9.808707500944294,50,7.142857142857143
2020-10-22,285.05,285.98,280.82,284.18,247.2940928042394,266.25301024428654,277.8396694054265,283.392388727262,240.39585000000005,267.54810000000003,280.66720000000015,282.88849999999996,282.88849999999996,295.84614681568223,269.9308531843177,32196162,52.43577652187921,55.9352629702641,NaN,NaN,NaN,NaN,NaN,NaN,-0.2221855083140527,2.65109294814107,2.8732784564551226,42.783283067643325,44.40264306529,6267958234,15482821815.972134,22.136081190382793,25.238917000389332,9.794586993874672,42.857142857142854,0
2020-10-23,284.79,284.91,281.7818,284.74,247.6666888957395,266.61908924935017,278.1102706052137,283.52073265799896,240.72460000000004,268.0286,280.9124000000001,283.5475,283.5475,295.42950803735874,271.6654919626413,24658542,53.070702357468875,55.87104021513488,NaN,NaN,NaN,NaN,NaN,NaN,-0.3504661705389003,2.435195743281497,2.7856619138203973,45.19603619129693,44.244563538714225,6292616776,15504800253.029995,21.297215486840795,24.282466683638237,9.78046648680505,35.714285714285715,7.142857142857143
2020-10-26,282.32,285.3,276.76,280.47,247.99309000125453,266.89336470975906,278.2028090128524,283.2301866905705,241.03480000000002,268.483,281.07860000000016,283.71099999999996,283.71099999999996,295.3261296161521,272.0958703838478,38421094,47.82806377516471,55.736446954657985,NaN,NaN,NaN,NaN,NaN,NaN,-0.7103957610681553,1.897667212485203,2.6080629735533583,17.922705314009846,35.300674857650044,6254195682,15499761421.029995,19.16227041096587,27.743014737470613,10.305466334754154,28.571428571428573,0
2020-10-27,281.42,283.505,280.2,282.66,248.3380343793515,267.2055753095658,278.37760081627,283.1758831962305,241.34335000000007,268.91270000000003,281.2254000000001,284.0465,284.0465,295.1205819484034,272.97241805159655,30559123,50.52742215691115,55.52589699696558,NaN,NaN,NaN,NaN,NaN,NaN,-0.7827690642822511,1.6296016432005445,2.4123707074827956,28.502415458937378,30.540385654748064,6284754805,15514694245.128332,18.393789014110578,26.63041219814794,10.830466182703258,21.428571428571427,92.85714285714286
2020-10-28,278.13,278.6401,271.38,271.64,248.56989473378582,267.2933856994754,278.1133811764163,282.07722765373234,241.60115000000005,269.2136,281.0988000000001,283.7365,283.7365,295.7918312273024,271.68116877269756,53413523,39.462858408850906,54.443259901791166,NaN,NaN,NaN,NaN,NaN,NaN,-1.5123609793485135,0.5219194832971539,2.0342804626456674,0.996932515337389,15.807351096094886,6231341282,15465106431.410574,16.03078953540806,33.254321951888784,12.890576369700057,14.285714285714286,100
2020-10-29,273.04,279.49,272.52,276.39,248.84671170160885,267.4735166757234,278.04579760087057,281.53558692480544,241.88225000000006,269.5445,281.1046000000001,283.4435,283.4435,295.9070424739545,270.97995752604544,43246302,45.04862070156882,53.52935787556671,NaN,NaN,NaN,NaN,NaN,NaN,-1.605786839106451,0.027046913762603708,1.6328337528690546,19.21012269938648,16.236490224553762,6274587584,15469883999.924204,15.573747137286793,30.333775403399198,14.996563777957109,7.142857142857143,92.85714285714286
2020-10-30,274.375,275.24,267.07,269.38,249.051023027961,267.5112688207586,277.7059624008364,280.37791197958586,242.1177500000001,269.77610000000004,280.89360000000016,283.197,283.197,296.5375053877273,269.8564946122727,65935893,39.28730273870445,51.79553599425079,NaN,NaN,39.28730273870445,NaN,NaN,NaN,-2.0424144155063635,-0.9201842665138997,1.1222301489924638,7.70523956290278,9.304098259208894,6208651691,15441233764.899725,14.001497635375307,33.17491691012933,16.051718013751074,0,100
2020-11-02,271.73,273.52,266.97,269.98,249.25927155504598,267.5601545866841,277.40298348315656,279.38763464819675,242.35075000000012,270.13570000000004,280.6558000000001,282.688,282.688,297.1802704915406,268.19572950845935,39987409,39.99467504600258,50.11299241430209,NaN,NaN,NaN,NaN,NaN,NaN,-2.1809579426842496,-1.6039672793628483,0.5769906633214014,10.245064669843401,12.386808977377555,6248639100,15437998142.492092,13.007612897119467,30.92839563438864,17.117330310069008,0,100
2020-11-03,271.86,276.82,270.84,274.65,249.51191561917489,267.7005475651656,277.2950233465622,278.9364313483685,242.6076000000001,270.5234000000001,280.4762000000001,282.6625,282.6625,297.20935653328416,268.1156434667159,43604145,45.33343758964317,49.00253401073265,NaN,NaN,NaN,NaN,NaN,NaN,-1.8606967459787525,-1.748880269152039,0.11181647682671325,29.202631278755682,15.717645170500623,6292243245,15449956469.883396,15.612670134200613,28.641936746916173,17.941090327367387,0,92.85714285714286
2020-11-04,283.56,288.77,281.87,286.91,249.88403586177017,268.080932761895,277.6720812545401,279.6958188390001,242.92280000000005,271.00500000000005,280.49720000000013,283.012,283.012,297.61427461732853,268.40972538267147,75728206,56.320604157710264,48.82820563367777,NaN,NaN,NaN,NaN,NaN,NaN,-0.7810372853651948,-0.8644801298797802,-0.08344284451458545,75.82037339822813,38.42268978227574,6367971451,15484857295.25731,25.35482036733343,24.599081639915823,17.457561919941078,7.142857142857143,85.71428571428571
2020-11-05,293.41,295.39,292,294.39,250.3268812760809,268.60190439037234,278.3276859112248,281.0952646638572,243.27180000000007,271.52040000000005,280.5458000000001,283.661,283.661,299.05320958796807,268.26879041203193,52054186,61.415886776231076,49.14166796068514,NaN,NaN,NaN,NaN,NaN,NaN,0.4147324710112964,0.434972744249535,0.02024027323823864,96.48135116115411,67.16811861271265,6420025637,15506201047.039022,29.76436558310426,22.541250912932163,17.47871137170824,100,78.57142857142857
2020-11-06,293.58,295.36,289.83,294.61,250.76750932308508,269.11691618462237,278.9662080323533,282.38238231491846,243.63135000000008,272.03030000000007,280.61700000000013,284.106,284.106,300.207691091311,268.004308908689,40959764,61.55792467756718,49.81570608154682,NaN,NaN,NaN,NaN,61.55792467756718,NaN,1.1563321862872769,1.4656555060973346,0.30932331981005784,97.2554539057003,89.85239282169418,6460985401,15536050567.639383,28.112753322564366,23.467885647015308,18.080912218160098,92.85714285714286,71.42857142857143
2020-11-09,297.31,299.14,288.12,288.59,251.14385251390016,269.5025218047289,279.34361163892765,282.97358399921194,243.9838000000001,272.4734000000001,280.53820000000013,283.80899999999997,283.80899999999997,299.3396444167671,268.27835558323284,86537071,55.53357903658489,50.018885466773845,NaN,NaN,NaN,NaN,NaN,NaN,1.1735332988503648,1.7762399433730138,0.602706644522649,67.20547093565425,86.98075866750288,6374448330,15456895061.67931,28.771284905045803,20.970624407248764,19.1600566066076,100,64.28571428571429
2020-11-10,285.26,286.6599,280.62,283.42,251.46500821027925,269.778115432358,279.5034700060285,283.0160998088108,244.2936500000001,272.8652000000001,280.30900000000014,283.25399999999996,283.25399999999996,297.9867518135633,268.52124818643665,69024878,50.924331978989336,49.910084708805456,NaN,NaN,NaN,NaN,NaN,NaN,0.7873639848975408,1.586911625644575,0.7995476407470342,51.13459745104137,71.86517409746531,6305423452,15451867818.871946,26.569219471818883,26.56794219984154,19.119210550345034,92.85714285714286,57.142857142857146
2020-11-11,285.92,290.25,283.38,289.76,251.84605290470432,270.1737963148856,279.9056868685372,283.65837601749547,244.63340000000008,273.2954000000001,280.10580000000016,283.13899999999995,283.13899999999995,297.6289122150583,268.6490877849416,36102931,55.77222284036046,50.14840230298269,NaN,NaN,NaN,NaN,NaN,NaN,0.9013602844926156,1.9262479963628039,1.0248877118701882,70.84239975132108,63.060822712672234,6341526383,15482820695.668161,28.27326979095204,24.805548636234683,19.118041453082288,85.71428571428571,50
2020-11-12,290.72,292.074,287.25,288.4,252.20977377132417,270.53471123934327,280.2387971874181,284.10995925392444,244.9624000000001,273.6910000000001,279.8186000000002,283.054,283.054,297.398796129607,268.70920387039297,34516826,54.52788137891542,50.2524865188003,NaN,NaN,NaN,NaN,NaN,NaN,0.829424432635816,2.0616682526649583,1.2322438200291423,66.61485856387932,62.863951922080595,6307009557,15464760896.989885,28.728851428105106,23.620673717948986,19.347206333706016,78.57142857142857,42.857142857142854
2020-11-13,290.01,291.57,287.8701,290.93,252.59504965419657,270.9385783435147,280.6580600428134,284.7594869440269,245.32170000000008,274.16320000000013,279.8890000000002,283.17499999999995,283.17499999999995,297.7409637511573,268.6090362488426,24880582,56.47343116047806,50.8700127606084,NaN,NaN,NaN,NaN,NaN,NaN,0.8910811927694549,2.346095310990961,1.4550141182215062,74.47932856698792,70.64552896072945,6331890139,15481033909.877207,27.638405768028314,22.72411642924967,18.737496439202697,71.42857142857143,35.714285714285715
2020-11-16,290.68,293.51,289.99,293.2,252.99907901087124,271.37939857433616,281.1499008254482,285.56334533031,245.6758000000001,274.63490000000013,280.0814000000002,283.6449999999999,283.6449999999999,298.85373762019987,268.4362623798,30168361,58.20144969900748,51.41815758504385,NaN,NaN,NaN,NaN,58.20144969900748,NaN,1.014615517852479,2.723283515537105,1.708667997684626,81.53559216661485,74.20992643249404,6362058500,15505888525.473797,28.666884843772294,21.873485597201654,18.390907994815414,64.28571428571429,28.571428571428573
2020-11-17,293.4,293.74,291.61,292.27,253.3898344435989,271.7930738500919,281.58598314601886,286.20207434647097,245.9998000000001,275.1554000000001,280.5278000000002,284.0379999999999,284.0379999999999,299.70481154543353,268.37118845456627,21843463,57.19954069374889,52.68506346253656,NaN,NaN,NaN,NaN,NaN,NaN,0.9639285902091292,2.9135787354460376,1.9496501452369084,78.64470003108482,78.21987358822919,6340215037,15497581856.445627,28.241381116911175,21.35261855359813,16.886878672902014,57.142857142857146,21.428571428571427
2020-11-18,291.7,293.37,290.02,290.11,253.75520922525462,272.155785259001,281.92025831676324,286.5742577420452,246.3092500000001,275.62810000000013,280.7724000000002,284.33399999999995,284.33399999999995,300.2232333358164,268.4447666641835,28069619,54.83833290336065,53.38432861980741,NaN,NaN,NaN,NaN,NaN,NaN,0.7260075343511576,2.8571595631758555,2.131152028824698,71.93036990985395,77.37022070251788,6312145418,15471020455.779957,27.14648630761282,22.364884130134058,15.280159314047479,50,14.285714285714286
2020-11-19,289.48,292.7,288.85,292.38,254.13953550162023,272.55626475882275,282.33044426512544,287.1271855761361,246.62020000000012,276.0759000000001,281.1732000000002,284.7439999999999,284.7439999999999,301.01477797771463,268.4732220222852,22718422,56.8540895173482,54.63909910399625,NaN,NaN,NaN,NaN,NaN,NaN,0.664261501835349,2.9614789061188844,2.2972174042835354,78.98663350948088,76.52056781680655,6334863840,15489962308.928009,25.903556872462108,22.73230436875743,12.842905038534697,42.857142857142854,7.142857142857143
2020-11-20,292.3,293.065,290.29,290.38,254.50013713842003,272.90921001112326,282.6461131174735,287.4369774260279,246.9261000000001,276.47480000000013,281.57180000000017,285.0259999999999,285.0259999999999,301.48118204093055,268.57081795906925,25907308,54.54412693649186,55.67834566760263,NaN,NaN,54.54412693649186,NaN,NaN,NaN,0.4421599790976254,2.849917378155567,2.4077573990579415,69.04593639575977,73.32097993836487,6308956532,15465735474.960442,25.465957424535407,21.95212171251684,10.458759094336171,35.714285714285715,0
2020-11-23,291.41,292.75,288.07,290.39,254.85725020171932,273.2553642683287,282.9497949560039,287.71821767116813,247.2182000000001,276.85680000000013,281.87640000000016,285.52199999999993,285.52199999999993,301.99598021123177,269.0480197887681,26875588,54.55406937525321,56.33696222371763,NaN,NaN,NaN,NaN,NaN,NaN,0.2584594027594682,2.730831652507277,2.4723722497478087,52.75377969762415,66.92878320095492,6335832120,15465505769.0801,23.97172011322132,23.447404528090424,8.43476622035517,28.571428571428573,0
2020-11-24,291.49,294.98,289.63,294.47,255.25140691613007,273.6754560649955,283.4015677028273,288.3612445596283,247.5305000000001,277.2176000000001,282.18460000000016,286.1124999999999,286.1124999999999,302.9758447156881,269.2491552843117,24516791,58.538721881736734,56.49539920400523,NaN,NaN,NaN,NaN,NaN,NaN,0.3676064939151371,2.93188036714173,2.564273873226593,74.78401727861791,65.5279111240006,6360348911,15485348330.76795,25.164865264731205,21.867769797834686,8.827434565484662,21.428571428571427,28.571428571428573
2020-11-25,295.44,296.94,294.59,296.28,255.65965162343224,274.12307079638174,283.90660426350075,289.1154117444256,247.84055000000012,277.6143000000001,282.61800000000017,287.3444999999999,287.3444999999999,303.37840342368656,271.3105965763133,23326826,60.20566138445747,56.408954533164255,NaN,NaN,NaN,NaN,NaN,NaN,0.5088792123535573,3.2003728886685394,2.691493676314982,84.55723542116621,70.69834413246942,6383675737,15495572428.972204,26.92108583644877,21.15903207478123,8.697065402831722,14.285714285714286,21.428571428571427
2020-11-27,298.29,300.17,297.9,299.01,256.09099837344786,274.6158812756613,284.49889429238306,290.0577534830517,248.16575000000012,278.0045000000002,283.19180000000017,288.4754999999999,288.4754999999999,304.45004158967424,272.50095841032555,17163115,62.64511893974213,56.48661126617675,NaN,NaN,NaN,NaN,NaN,NaN,0.7204343143049146,3.592036569196125,2.8716022548912106,94.06649616368274,84.46924962115561,6400838852,15495194386.791588,29.844813974695217,20.056542587322625,9.454935453308613,100,14.285714285714286
2020-11-30,299.3,299.97,294.78,299.62,256.5241227677419,275.1110123395096,285.09187882993666,290.968443627523,248.49065000000013,278.37890000000016,283.8468000000002,289.9874999999999,289.9874999999999,304.05710393899545,275.91789606100434,27836232,63.18813375865818,57.03336517489628,NaN,NaN,NaN,NaN,NaN,NaN,0.828015521799049,3.906621657140022,3.078606135340973,97.18670076726337,91.93681078403745,6428675084,15519276213.704882,27.766094443706347,22.84669432109465,9.029036032073014,92.85714285714286,7.142857142857143
2020-12-01,301.87,305.14,300.83,303.46,256.9911464217942,275.6723784317966,285.812197307194,292.15811566299703,248.8343000000001,278.77380000000016,284.5658000000002,291.6614999999999,291.6614999999999,303.6191875272884,279.7038124727114,27642640,66.4904522961546,58.145230911836656,NaN,NaN,NaN,NaN,NaN,NaN,1.0690321611566587,4.414896336786796,3.3458641756301377,92.27941176470584,94.51086956521732,6456317724,15525369138.994905,32.634540436685924,21.158694876658284,10.552667933662244,100,0
2020-12-02,302.22,304.195,300.35,303.85,257.4574036713286,276.2303511361174,286.5195621186766,293.2716284569973,249.16865000000013,279.2269000000001,285.1932000000002,293.1214999999999,293.1214999999999,303.43137735136645,282.8116226486334,23620003,66.81604698571593,58.934075493647754,NaN,NaN,NaN,NaN,NaN,NaN,1.1584415729269515,4.793916141788827,3.6354745688618757,92.78926774734508,94.08512675977143,6479937727,15544750441.84666,30.920812878331066,20.70314991538906,11.499762682805933,92.85714285714286,0
2020-12-03,304.07,305.88,303.531,304.28,257.9233001522109,276.7857897274814,287.21604987872854,294.3200447944261,249.5161500000001,279.6660000000001,285.9956000000002,293.9899999999999,293.9899999999999,304.96553096666435,283.01446903333544,22828727,67.19452754398338,59.83883593400976,NaN,NaN,NaN,NaN,NaN,NaN,1.148051906337916,5.070539451784271,3.9224875454463546,91.11599731258907,92.06155894154665,6502766454,15536480009.033974,32.28373403465298,20.011763261505873,12.478959934063752,100,0
2020-12-04,304.33,305.67,303.63,305.52,258.3968991556715,277.3547839903036,287.9338518442686,295.38670719495695,249.89240000000012,280.11220000000014,286.79820000000024,294.54649999999987,294.54649999999987,306.620426080623,282.4725739193767,19332081,68.3167603273752,60.68478801735955,NaN,NaN,NaN,NaN,NaN,NaN,1.1247304195241696,5.328400569851567,4.203670150327397,97.97866367209426,93.96130957734279,6522098535,15552969136.945738,31.305949247890975,19.40566244143406,13.45815718532157,92.85714285714286,0
2020-12-07,305.71,307.63,305.52,307.25,258.88299966158525,277.9467684657431,288.6913478503757,296.51654460496104,250.32170000000008,280.5935000000001,287.5120000000002,295.1784999999999,295.1784999999999,308.4622107391102,281.8947892608895,20850969,69.86560624290772,61.51794205620957,NaN,NaN,NaN,NaN,NaN,NaN,1.1232332363352384,5.6077116957464455,4.484478459411207,98.05725971370146,95.71730689946158,6542949504,15566309804.315407,33.315791727136016,18.772354077832347,14.492392188099299,100,35.714285714285715
2020-12-08,306.76,308.6,304.95,308.29,259.37461160525106,278.5476245357284,289.4599224444786,297.63782607115525,250.78630000000013,281.0822000000001,288.1338000000002,296.16349999999983,296.16349999999983,310.2445756336432,282.08242436635646,18341464,70.79005179786185,62.488692849360504,NaN,NaN,NaN,NaN,70.79005179786185,NaN,1.0888993248815044,5.845602615513087,4.756703290631583,98.4900146127618,98.17531266618583,6561290968,15581535731.964722,32.92947952865739,17.69646297722351,15.64946607948933,100,28.571428571428573
2020-12-09,308.07,308.36,300.21,301.31,259.79187915146747,278.9983646439318,289.92463136822454,297.9875569215214,251.21045000000012,281.4275000000001,288.6410000000002,297.0579999999998,297.0579999999998,310.0153957260117,284.1006042739879,48839306,57.942439499429774,62.710414749079725,NaN,NaN,57.942439499429774,NaN,NaN,NaN,0.5214843430363274,5.408558719426992,4.8870743763906646,64.49098879688256,87.0127543744486,6512451662,15545880042.30828,28.940958257181126,22.597473345079724,15.838800185258677,92.85714285714286,21.428571428571427
2020-12-10,299.21,303.68,298.09,302.52,260.21703458279615,279.4641396014777,290.41856739300005,298.4192181670908,251.69485000000014,281.81270000000006,289.1346000000002,297.6959999999998,297.6959999999998,310.40743013199204,284.98456986800755,27519544,59.320721439702154,62.88660274353358,NaN,NaN,NaN,NaN,NaN,NaN,0.17116740308684353,5.101033630249219,4.929866227162376,70.38480272771538,77.78860204578658,6539971206,15561978237.098978,26.56431222404712,23.856166517166162,15.75670896760684,85.71428571428571,14.285714285714286
2020-12-11,300.81,301.98,298.47,301.85,260.63129294515636,279.90742396580487,290.86685886778434,298.7459592940345,252.17510000000013,282.1819000000001,289.5266000000002,298.3684999999998,298.3684999999998,310.44904017833704,286.2879598216626,26760416,58.18369798549237,63.14657210417648,NaN,NaN,NaN,NaN,NaN,NaN,-0.14507983033935012,4.748516439238188,4.893596269577538,67.12128592303951,67.33235914921248,6513210790,15586756400.061941,24.964730689735724,22.419657146305322,15.611051358116779,78.57142857142857,7.142857142857143
2020-12-14,303.08,306.05,303.01,304.04,261.0632203785379,280.3852967585612,291.38345263767513,299.25015364698356,252.61320000000012,282.64220000000006,290.1212000000002,299.02399999999983,299.02399999999983,310.83872200267075,287.2092779973289,28804832,60.82675506745164,63.594621082190656,NaN,NaN,NaN,NaN,NaN,NaN,-0.24054544440819647,4.592914464067292,4.833459908475488,75.96204533473909,71.15604466183133,6542015622,15577470631.851416,29.497791691981995,21.00695726590242,16.732926189597794,71.42857142857143,0
2020-12-15,306.37,307.29,304.11,307.29,261.52318833497037,280.91806315938175,292.0072388087467,300.0158532996518,253.10225000000014,283.1595000000001,290.6638000000002,299.7284999999998,299.7284999999998,311.74864687932126,287.7083531206784,25790455,64.42078139574937,64.01476819033442,NaN,NaN,NaN,NaN,NaN,NaN,-0.12442997610381656,4.677922438345718,4.802352414449534,90.64953604568167,77.91095576782008,6567806077,15603261086.851416,29.929642325303934,19.95891998293311,17.659766149540445,64.28571428571429,0
2020-12-16,307.7,309.785,306.621,308.98,261.9953954162144,281.4737450770177,292.6728372868351,300.8695815568278,253.55605000000014,283.6481000000001,291.3402000000002,300.56399999999985,300.56399999999985,312.7165263217315,288.4114736782682,25461890,66.15945127230535,64.44003889660927,NaN,NaN,NaN,NaN,NaN,NaN,0.018941496434782934,4.826029284993012,4.8070877885582295,94.6351216261246,87.08223433551511,6593267967,15615766705.39124,32.36157275156352,18.966840713338552,18.667756113631434,100,0
2020-12-17,310.63,311.24,309.39,311,262.4830034220232,282.0584233923243,293.39154955009644,301.8343833133204,254.05310000000011,284.1900000000001,291.96180000000027,301.6084999999999,301.6084999999999,313.57699075699793,289.6400092430018,23730524,68.16214211503423,64.83411198055869,NaN,NaN,NaN,NaN,68.16214211503423,NaN,0.19289739244815518,5.048209529118424,4.8553121366702685,98.54191980558926,94.60885915913184,6616998491,15633340120.46151,33.54074523848844,18.26834276165417,19.37225537181879,100,7.142857142857143
2020-12-18,311.66,311.98,307.61,310.06,262.95640637304786,282.61291005782283,294.0452142736221,302.6177753787185,254.56330000000014,284.6929000000001,292.53480000000025,302.49249999999984,302.49249999999984,314.213057793913,290.7719422060867,41173392,66.19883592595613,65.04916213536569,NaN,NaN,NaN,NaN,NaN,NaN,0.1875640199824682,5.0897671616483535,4.902203141665885,86.17710583153341,93.11804908774907,6575825099,15638333689.742973,31.151775617314815,19.868355775206638,20.257680000837762,100,0
2020-12-21,306.46,309.47,303.6,308.92,263.4137555633658,283.1338425319253,294.62853920406826,303.21798724741194,255.1400500000001,285.1708000000001,292.99900000000025,303.41949999999986,303.41949999999986,314.0427847556847,292.796215244315,37095480,63.79879332271996,64.85690078012036,NaN,NaN,NaN,NaN,NaN,NaN,0.05694416253673573,4.9733833448368046,4.916439182300069,77.96976241900653,87.56292935204306,6538729619,15668477716.93207,27.97921972158858,24.166689508549453,19.25611024924355,92.85714285714286,50
2020-12-22,309.85,310.7105,306.845,309.76,263.8749122244268,283.6610931748575,295.2219298235166,303.8410360809917,255.6683000000001,285.6105000000001,293.30360000000024,304.3879999999998,304.3879999999998,313.508801719177,295.26719828082264,26378343,64.81114827491359,64.71369372934878,NaN,NaN,NaN,NaN,NaN,NaN,-0.01912634063161356,4.892531256510551,4.911657597142165,84.01727861771043,82.72138228941678,6565107962,15681883551.836609,28.23248175088092,22.67837005923966,18.62161053686674,85.71428571428571,42.857142857142854
2020-12-23,309.81,310.18,308.035,308.2,264.31595787393496,284.14701212189004,295.7308737520061,304.25617550184967,256.2332000000001,285.9987000000001,293.57720000000023,305.07449999999983,305.07449999999983,313.1079811259151,297.04101887408456,21201280,61.37829994682755,64.2982489009805,NaN,NaN,61.37829994682755,NaN,NaN,NaN,-0.2101374242221583,4.648985816864467,4.859123241086626,72.7861771058314,78.25773938084944,6543906682,15663944007.221224,27.23031951271467,21.87336091066133,17.724674344489326,78.57142857142857,35.714285714285715
2020-12-24,308.47,310.02,308.39,309.56,264.7661473478262,284.6502396046249,296.27319242839803,304.76130164453065,256.8944000000001,286.3905000000001,293.92720000000025,305.7384999999999,305.7384999999999,312.9028932751039,298.57410672489584,16784997,63.207909253489575,63.93333096713152,NaN,NaN,NaN,NaN,NaN,NaN,-0.2763513961757589,4.513683995866927,4.790035392042686,82.57739380849526,79.79361651067902,6560691679,15671255263.583187,26.37484386656664,21.18618103567897,16.827738152111912,71.42857142857143,28.571428571428573
2020-12-28,312.25,313.17,310.36,312.68,265.2429021005841,285.20528436492935,296.91659664689223,305.5154633926706,257.4961000000001,286.80680000000007,294.37880000000024,306.42199999999985,306.42199999999985,313.49605004226186,299.34794995773785,22497745,67.06281546331067,63.73313162573174,NaN,NaN,NaN,NaN,NaN,NaN,-0.14792496140276246,4.605129190289233,4.7530541516919955,96.75066312997342,84.03807801476667,6583189424,15685906819.9355,30.203632531988717,19.853826994174582,16.310240306827218,100,21.428571428571427
2020-12-29,314.05,314.685,312.03,312.96,265.7176990946081,285.7548826943367,297.5457497195631,306.2244668790829,258.21440000000007,287.19000000000005,294.8678000000002,307.0889999999998,307.0889999999998,313.98525086554196,300.1927491344577,25871925,67.39300119081216,63.49048515379962,NaN,NaN,NaN,NaN,NaN,NaN,-0.08513903076329576,4.646630363237875,4.731769394001171,89.60530280204868,89.64445324683909,6609061349,15678159859.34228,31.477958731240683,18.911844442408984,15.942273361251152,100,14.285714285714286
2020-12-30,314.16,314.49,312.33,312.97,266.1878712429205,286.29379590831024,298.15062227958026,306.86689860488457,258.8685500000001,287.6050000000001,295.4512000000002,307.56449999999984,307.56449999999984,314.70152872352395,300.4274712764757,18138071,67.40556848803462,64.16642293869997,NaN,NaN,NaN,NaN,NaN,NaN,-0.08382335883762426,4.626990195454141,4.710813554291765,89.66556191624,92.00717594942068,6627199420,15670770274.860798,30.221665752709644,18.157068137283137,16.844384101076034,92.85714285714286,7.142857142857143
2020-12-31,312.87,314.24,311.76,313.74,266.6610267529412,286.8372850982447,298.7619704254791,307.5214796901337,259.5542500000001,288.0393000000001,296.03780000000023,308.05899999999986,308.05899999999986,315.4635199709595,300.6544800290402,21611412,68.41502362803598,64.81601595215237,NaN,NaN,NaN,NaN,68.41502362803598,NaN,-0.07241254900137939,4.620297868040041,4.69271041704142,94.17206290471789,91.14764254100216,6648810832,15683667407.82854,28.800430524722138,18.384058346139582,18.037578190638232,85.71428571428571,0
2021-01-04,315.11,315.29,305.18,309.31,267.0853946459468,287.282289353725,299.17561864408776,307.69181495774,260.2125000000001,288.48050000000006,296.5402000000002,308.3104999999999,308.3104999999999,315.5237336022311,301.09726639776864,45305898,57.40068610457837,64.7600865320871,NaN,NaN,NaN,NaN,NaN,NaN,-0.38695928481027586,4.209011311028576,4.5959705958388515,51.30293159609118,78.38018547234967,6603504934,15675377011.062962,23.871888150859792,26.37571012350336,18.009852897833294,100,0
2021-01-05,308.29,312.14,308.29,311.86,267.53091310718116,287.7689766932552,299.6730453639275,308.08878496176476,260.9183000000001,288.88050000000004,297.0938000000002,308.6274999999998,308.6274999999998,315.879478695532,301.37552130446767,29323409,61.26628824846912,64.79148175930263,NaN,NaN,NaN,NaN,NaN,NaN,-0.44299158379642556,4.042231116093319,4.485222699889745,70.65868263473047,72.04455904517984,6632828343,15700435196.93569,22.30642198408895,24.646048792905493,17.164925463248334,92.85714285714286,0
2021-01-06,307,311.88,305.98,307.54,267.9290134742739,288.1604821052699,299.98155338887153,308.036519727311,261.6037000000001,289.2311,297.5498000000002,308.6419999999998,308.6419999999998,315.8840566140136,301.39994338598603,52809622,52.56403883618159,63.944571576476356,NaN,NaN,52.56403883618159,NaN,NaN,NaN,-0.7714724193369973,3.520882175718498,4.292354595055495,33.70402053036782,51.88854492039649,6580018721,15675552019.111961,20.128038502948613,26.06271283729723,16.655082531444435,85.71428571428571,28.571428571428573
2021-01-07,310.28,315.84,310.25,314.98,268.3971824944304,288.6915616675418,300.5697277657785,308.6978035628052,262.2603000000001,289.65930000000003,298.2400000000002,308.9764999999999,308.9764999999999,316.72305349173826,301.2299465082615,30394826,62.45495386376028,63.67996461872314,NaN,NaN,NaN,NaN,NaN,NaN,-0.5012451430045157,3.665798166299851,4.167043309304367,92.97385620915065,65.77885312474965,6610413547,15696594590.958117,23.682964891661324,22.703698913166264,14.941865306668396,100,21.428571428571427
2021-01-08,317.34,319.39,315.0814,319.03,268.90099162383905,289.29232282263996,301.2936600102578,309.68182227110947,262.9439500000001,290.0964000000001,298.96740000000017,309.86249999999984,309.86249999999984,317.9451131294591,301.77988687054057,33955847,66.54439889079845,63.56441153127772,NaN,NaN,NaN,NaN,NaN,NaN,-0.08512442267785225,4.060637780957052,4.145762203634904,97.72007599746667,74.79931757899504,6644369394,15724876156.32603,27.585131274323892,21.14438877990365,13.780372550271638,100,14.285714285714286
2021-01-11,315.98,317.19,313.75,314.42,269.35391708031824,289.78990058852827,301.80841844122807,310.1330772929086,263.5565500000001,290.4609000000001,299.82300000000015,310.45749999999987,310.45749999999987,318.0261349496084,302.88886505039136,32869095,58.70604064566161,63.02921186839954,NaN,NaN,NaN,NaN,NaN,NaN,-0.15184120673053592,3.9559606952217337,4.10780190195227,68.52438252058276,86.4061049090667,6611500299,15704810720.424868,25.341040872265047,21.47561285713756,12.790436881309414,92.85714285714286,7.142857142857143
2021-01-12,314.46,315.58,311.2,313.92,269.79736069145935,290.2677243392505,302.283382423925,310.49373659834583,264.19965000000013,290.8391000000001,300.57360000000017,311.0609999999998,311.0609999999998,317.64942591219653,304.4725740878031,29266762,57.90930234052681,62.60853394110003,NaN,NaN,NaN,NaN,NaN,NaN,-0.2550571052319457,3.7889805204123377,4.044037625644283,61.505981703026194,75.9168134070252,6582233537,15711893544.105234,23.62413649531832,23.965060243198486,12.31937367601591,85.71428571428571,0
2021-01-13,314.19,316.86,313.57,316.04,270.25748645572344,290.7780664315426,302.82285762298676,311.02195216040815,264.81965000000014,291.20020000000005,301.50680000000017,311.6609999999999,311.6609999999999,317.74923094176984,305.57276905822994,22898417,60.365465475100706,62.290985169684824,NaN,NaN,NaN,NaN,NaN,NaN,-0.20795558767102085,3.784093141055507,3.992048728726528,76.4250527797328,68.81847233444724,6605131954,15723377552.631071,24.418145560348524,22.719874723553772,11.797464920715052,78.57142857142857,50
2021-01-14,316.5,317.53,313.8616,314.35,270.6962179337759,291.24483739329423,303.27490242208535,311.33890909751216,265.43940000000015,291.5250000000001,302.3942000000002,312.0139999999999,312.0139999999999,317.8614897178403,306.1665102821595,23500129,57.4856411809372,62.012938114978375,NaN,NaN,NaN,NaN,NaN,NaN,-0.31177849153247994,3.602325614310928,3.914104105843408,64.53201970443371,67.48768472906424,6581631825,15706134899.916973,24.056737481641314,21.385608133796726,11.438077586034721,71.42857142857143,42.857142857142854
2021-01-15,314.13,315.12,310.58,311.86,271.1058078050816,291.6530584350112,303.6115729153369,311.388536802511,266.0871500000001,291.8073000000001,303.13840000000016,312.15799999999984,312.15799999999984,317.83901258583427,306.4769874141654,35118718,53.44039962287046,61.31525885564844,NaN,NaN,53.44039962287046,NaN,NaN,NaN,-0.5550988554755696,3.2202305364989456,3.7753293919745152,47.00914848698112,62.65540699038254,6546513107,15690818807.044727,22.310475656884353,25.080137306868565,11.076280481671072,64.28571428571429,35.714285714285715
2021-01-19,314.25,316.93,313.12,316.41,271.5565957871206,292.14329490164465,304.1134720166963,311.86677139274803,266.7391500000001,292.1128000000001,303.7284000000002,312.4284999999999,312.4284999999999,318.3723145159799,306.48468548401985,24537049,59.10365687007723,60.74674752756033,NaN,NaN,NaN,NaN,NaN,NaN,-0.42255673348420775,3.2471334751192558,3.6696902086034635,79.02885292047878,63.52334037063121,6571050156,15708658078.889872,23.385533833399087,23.066457895000767,9.648497867651711,57.142857142857146,28.571428571428573
2021-01-20,320.14,324.74,316.509,323.77,272.07613214744777,292.7695662897309,304.88431625133563,313.0004122124863,267.4411500000001,292.43090000000007,304.3160000000002,313.1139999999999,313.1139999999999,320.7332687313334,305.49473126866644,30728096,66.25404843814161,60.665393759512426,NaN,NaN,NaN,NaN,NaN,NaN,0.11891136357185639,3.818329413068284,3.6994180494964275,95.04089979550088,73.69296706765361,6601778252,15732143737.00383,32.13923351053862,20.197178444446376,9.497073537474668,100,21.428571428571427
2021-01-21,325.15,327.13,323.73,326.36,272.6162701360304,293.4347233929046,305.7264999277538,314.27275390653523,268.09055000000006,292.7840000000001,304.9510000000002,313.98599999999993,313.98599999999993,323.2911112836025,304.68088871639736,25316935,68.35110676344233,60.73293220775583,NaN,NaN,NaN,NaN,NaN,NaN,0.5836204077434237,4.428943559175707,3.845323151432283,96.49202733485203,90.18726001694391,6627095187,15745993589.680302,34.11730005678564,19.150094593618974,9.72281908811165,100,14.285714285714286
2021-01-22,325.29,326.46,324.71,325.42,273.1416803834331,294.06809520690643,306.49879404823406,315.33439639162714,268.7356500000001,293.1129000000001,305.6876000000002,314.7689999999999,314.7689999999999,325.0989659244534,304.4390340755464,21609444,66.73032389876592,60.61259651280797,NaN,NaN,NaN,NaN,NaN,NaN,0.7492510064063129,4.781886909440175,4.032635903033862,92.20956719817777,94.58083144284358,6605485743,15741918665.954588,33.16427337351363,18.615159205867737,10.152991210411722,92.85714285714286,7.142857142857143
2021-01-25,328.91,330.32,321.41,328.11,273.68862883732925,294.7421923315222,307.34629232085234,316.5511205448055,269.3733500000001,293.44520000000006,306.5814000000002,315.76449999999994,315.76449999999994,327.153539423945,304.3754605760549,39080644,68.99604035046333,61.44083610179975,NaN,NaN,NaN,NaN,NaN,NaN,0.948692824919898,5.218501934183735,4.269809109263837,90.92029580936737,93.20729678079907,6644566387,15761612503.391176,34.513438636844086,16.14269118701964,12.387464614579693,100,0
2021-01-26,328.85,329.76,327.22,328.59,274.2349111374553,295.4124459487198,308.17937889650517,317.69768049291923,270.01200000000006,293.73190000000005,307.35800000000023,316.71599999999995,316.71599999999995,329.0159323575469,304.416067642453,25498112,69.39653910421994,62.02156830578196,NaN,NaN,NaN,NaN,69.39653910421994,NaN,1.015672491429287,5.539399723550446,4.523727232121159,92.89235825801141,92.00740708851886,6670064499,15763620228.745506,33.16125528136617,15.510245415232472,14.62193801874766,92.85714285714286,7.142857142857143
2021-01-27,326.26,326.27,317.36,319.43,274.68461351419705,295.8880410784481,308.6205797240932,317.8626633031174,270.5940000000001,293.89860000000004,307.9786000000002,317.0534999999999,317.0534999999999,329.2620220645385,304.84497793546126,55263985,54.838351367207835,62.18401920085527,NaN,NaN,NaN,NaN,NaN,NaN,0.3785990602241567,4.996976057401355,4.618376997177198,45.7399103139014,76.51752146042674,6614800514,15734034458.998032,27.947799476545406,26.87538292082315,13.843934412491235,85.71428571428571,0
2021-01-28,320.67,326.42,320.03,321.32,275.1486472105732,296.39164422540955,309.1185962055013,318.19193346472525,271.14130000000006,294.2377,308.5864000000002,317.47149999999993,317.47149999999993,329.6632337159339,305.27976628406594,42836324,56.84977514797358,61.78364929258479,NaN,NaN,NaN,NaN,NaN,NaN,0.037957510468523914,4.665823885262853,4.627866374794329,54.40729483282677,64.3465211349132,6657636838,15708493552.19991,25.487914764162007,24.313152883109613,13.861635501033463,78.57142857142857,0
2021-01-29,319.58,320.7193,312.76,314.56,275.5407999746471,296.75141364668855,309.3319845895993,317.8460350395133,271.66695000000004,294.54750000000007,309.01360000000017,317.5509999999999,317.5509999999999,329.6446246014313,305.45737539856844,55259018,48.52505890076606,60.49655357901104,NaN,NaN,48.52505890076606,NaN,NaN,NaN,-0.6511385907799134,3.8139431363194376,4.465081727099351,20.16210739615003,40.10310418095941,6602377820,15678228247.817942,22.641198736435246,31.08336872015871,14.039954491138033,71.42857142857143,35.714285714285715
2021-02-01,318.11,323.54,316.02,322.42,276.00725967639187,297.259702485368,309.84524009588955,318.28165075003585,272.2128000000001,295.07220000000007,309.61660000000023,317.9849999999999,317.9849999999999,330.1233285505173,305.8466714494825,35646008,56.50097759490917,60.339049075385866,NaN,NaN,NaN,NaN,NaN,NaN,-0.5880173763383976,3.7300600066763536,4.318077383014751,59.97973657548139,44.8497129348194,6638023828,15703256295.988155,23.623792490735372,27.60066420317542,14.00474703550375,64.28571428571429,28.571428571428573
2021-02-02,325.48,328.87,325.31,327.68,276.52141629652726,297.8620846143706,310.54464244507034,319.1767316309848,272.77475000000004,295.57020000000006,310.36800000000017,318.9034999999999,318.9034999999999,331.05717973085876,306.749820269141,33930844,60.87052777818014,60.550565178075395,NaN,NaN,NaN,NaN,NaN,NaN,-0.22131555503894873,4.041432939216065,4.262748494255014,86.62613981762925,55.58932792975355,6671954672,15714503036.415121,28.33030541299325,25.399363166502404,14.34321776765499,57.142857142857146,21.428571428571427
2021-02-03,329.82,330.195,326.32,326.38,277.0175216070096,298.4267958101256,311.16563685898916,319.86275718993863,273.34295000000003,296.1106000000001,311.0480000000002,319.6294999999999,319.6294999999999,331.7481244681608,307.51087553183896,24824518,59.28546041723904,60.473421959656704,NaN,NaN,NaN,NaN,NaN,NaN,-0.10169785783957064,4.1356261719555505,4.237324029795121,80.0405268490375,75.54880108071605,6647130154,15690447277.682219,28.618007860954325,24.15304624053998,14.690235114161982,50,14.285714285714286
2021-02-04,327.82,330.33,326.46,330.24,277.54709850644235,299.0567602495291,311.91365109981314,320.8510660289921,273.96970000000005,296.7085000000001,311.84520000000015,320.7644999999999,320.7644999999999,332.38317027677095,309.1458297232288,22350947,62.41502259950078,60.825520632411234,NaN,NaN,NaN,NaN,NaN,NaN,0.18631267513127092,4.47021487370921,4.283902198577939,99.54430379746849,88.73699015471175,6669481101,15711758645.751986,27.32994882702986,22.918514656860587,14.897462235827856,100,7.142857142857143
2021-02-05,331.22,332.4025,329.53,331.36,278.0825502625972,299.6964283633998,312.6762530174675,321.8519168833738,274.57165000000003,297.2705000000001,312.6646000000002,321.5834999999999,321.5834999999999,333.75195474989454,309.41504525010527,22731960,63.29659069690657,61.529534280556675,NaN,NaN,NaN,NaN,NaN,NaN,0.38948554406498026,4.770759128659165,4.381273584594185,94.6926307751052,91.42582047387039,6692213061,15717990645.229794,29.054999045140363,22.036412642864864,15.46124695839019,100,0
2021-02-08,333.1,333.74,331.41,333.58,278.6347636928201,300.3673901779859,313.49600780109625,322.96887718019536,275.18695,297.81570000000005,313.44680000000017,322.31099999999986,322.31099999999986,335.480411376381,309.1415886236187,20462812,65.04663943612715,61.95403303527452,NaN,NaN,NaN,NaN,NaN,NaN,0.5981448651017995,5.128954665971435,4.530809800869635,99.23736892278347,97.82476783178572,6712675873,15735643113.950823,29.956194592152258,21.304750798219818,16.61770177971817,100,57.142857142857146
2021-02-09,332.62,334.81,332.61,333.51,279.1807859446329,301.0236794813921,314.28087024026894,323.9727936392244,275.7853,298.4047000000001,314.19140000000016,323.26549999999986,323.26549999999986,336.7717599930692,309.7592400069305,17597478,64.94149271046633,61.86027905472629,NaN,NaN,NaN,NaN,NaN,NaN,0.6517989783423657,5.345558523797592,4.693759545455227,94.10430839002262,96.01143602930377,6695078395,15732443572.496277,30.55386047905278,20.623112278200196,16.373905256671453,100,50
2021-02-10,334.99,335.46,329.5,332.75,279.7138129501589,301.6519234520576,315.00514983868976,324.80871805453637,276.37125000000003,299.02900000000005,314.86620000000016,324.2069999999999,324.2069999999999,337.6009107060029,310.8130892939969,28068700,63.73684057102642,61.53068861241086,NaN,NaN,NaN,NaN,NaN,NaN,0.5599664232596373,5.393717574529774,4.833751151270136,88.06167400881066,93.80111710720558,6667009695,15734986709.744598,27.94533409040789,23.31737494468679,15.011739250131162,100,42.857142857142854
2021-02-11,334.33,335,332.12,334.58,280.2597451596101,302.3039645718188,315.7727910214862,325.73931633505674,276.98665000000005,299.70610000000005,315.5654000000001,325.13399999999984,325.13399999999984,338.70379646127526,311.5642035387244,22046071,65.40111036757946,61.43574478875468,NaN,NaN,NaN,NaN,NaN,NaN,0.5457711298401469,5.51596506357032,4.970193933730173,96.12334801762115,92.76311013881813,6689055766,15750602676.702932,26.75658358517064,22.325490533620933,13.649573243590874,92.85714285714286,35.714285714285715
2021-02-12,333.71,336.62,332.63,336.45,280.8188521729473,302.98012368920854,316.5836619618201,326.7593814460037,277.57390000000004,300.3955000000001,316.2252000000001,326.23899999999986,326.23899999999986,339.7151536055491,312.7628463944506,20346819,67.06451299097145,61.29777854879098,NaN,NaN,NaN,NaN,67.06451299097145,NaN,0.5822902924347995,5.698056799273672,5.115766506838873,99.28751047778704,94.49084416807294,6709402585,15769215681.552557,27.582836539949994,20.99312441751716,12.028158413463533,100,28.571428571428573
2021-02-16,337.27,338.19,334.34,335.54,281.36334120605227,303.6248737151648,317.3270477672389,327.5956308320986,278.15705,301.02610000000004,316.85900000000015,327.4229999999999,327.4229999999999,339.74979536620725,315.0962046337925,27080777,65.41632838051558,61.013477782812096,NaN,NaN,NaN,NaN,NaN,NaN,0.46994163593373717,5.703193551756044,5.233251915822307,89.5792371215101,94.99669853897275,6682321808,15759016427.877234,28.353419649264634,19.767262333285075,10.71225632035259,100,21.428571428571427
2021-02-17,332.47,335.657,330.17,333.93,281.8863925373353,304.2249752257556,317.97814393322955,328.1989040861844,278.76300000000003,301.72380000000004,317.45200000000017,328.29899999999986,328.29899999999986,339.835522699682,316.76247730031776,31467456,62.49019494843918,61.56003803861433,NaN,NaN,NaN,NaN,NaN,NaN,0.22443155997350495,5.513791365789189,5.289359805815684,83.24813212740862,90.70495990890191,6650854352,15770675501.696808,26.021292072576465,24.39234175981324,10.803330120265567,92.85714285714286,14.285714285714286
2021-02-18,330.23,333.8661,328.36,332.47,282.38971201457576,304.7842826470278,318.5464520142794,328.60567512559544,279.34925000000004,302.3946000000001,317.99100000000016,328.73399999999987,328.73399999999987,340.21056464279985,317.2574353571999,32236240,59.87464755148454,61.77610035315083,NaN,NaN,NaN,NaN,NaN,NaN,-0.08261034542072565,5.186096874039777,5.268707219460502,77.50688163586328,83.44475029492732,6618618112,15786564412.493198,23.874517782903563,25.060858787284022,10.808001001763882,85.71428571428571,7.142857142857143
2021-02-19,333.86,333.99,329.97,331.02,282.8735954771173,305.3038018025322,319.0356107588175,328.8356108279197,279.91605,302.98920000000004,318.4664000000002,328.9669999999999,328.9669999999999,340.430523193167,317.50347680683285,39157677,57.30913356155986,62.403534257493256,NaN,NaN,NaN,NaN,NaN,NaN,-0.4112971030653565,4.754585840628806,5.165882943694163,67.65899864681998,76.13800413669729,6579460435,15767862238.403645,22.621588682468623,23.550718706089928,9.829323300532971,78.57142857142857,0
2021-02-22,326.5,327.8,322.23,322.44,283.2672910445092,305.6431324599078,319.169116219256,328.2265050347845,280.43325,303.44160000000005,318.74940000000015,328.81799999999987,328.81799999999987,340.53668866385595,317.0993113361438,47256944,45.01734092994059,61.58327449570978,NaN,NaN,NaN,NaN,NaN,NaN,-1.1904026455304164,3.6778796367811424,4.868282282311559,1.315789473684084,48.82722325212243,6532203491,15724168654.633448,19.810558493530632,31.566176031953532,10.909151084572816,71.42857142857143,0
2021-02-23,317,323.2,311,321.48,283.6475170042653,305.95673379733535,319.25973911261855,327.5839807457574,280.93155,303.8969000000001,319.1528000000002,328.48649999999986,328.48649999999986,340.63380797338704,316.3391920266127,97241936,43.88322220782657,60.36989552639881,NaN,NaN,NaN,NaN,NaN,NaN,-1.721976189598676,2.715812045313214,4.43778823491189,38.54358219933806,35.839456773280695,6434961555,15793991552.941645,16.70738216392915,41.04038784357722,13.529274131646739,64.28571428571429,100
2021-02-24,318.74,324.45,315.96,324.13,284.0503277803423,306.31660045481385,319.4507297356531,327.2550301985424,281.4279,304.3598,319.5850000000002,328.2634999999999,328.2634999999999,340.5578829044129,315.9691170955869,58206272,47.7931228503441,59.5490142716206,NaN,NaN,NaN,NaN,NaN,NaN,-1.8362290105619863,2.1425019717094074,3.9787309822713937,48.28981243104081,29.383061368020964,6493167827,15847810072.988758,16.498924896914158,36.72869535182572,15.639641788197407,57.142857142857146,92.85714285714286
2021-02-25,321.39,324.03,311.24,312.83,284.3366926780503,306.4455786636294,319.1910932754314,325.8812177986812,281.8577,304.66560000000004,319.80460000000016,327.9334999999999,327.9334999999999,341.4519574194032,314.41504258059666,110182582,36.20811839928035,57.67709254303343,NaN,NaN,NaN,NaN,NaN,NaN,-2.568995238370661,0.7674869343080672,3.3364821726787284,6.730415593968313,31.18793674144904,6382985245,15765022378.46022,14.08025426561742,36.712399430317284,18.195260971141032,50,85.71428571428571
2021-02-26,315.85,319.11,310.88,314.14,284.6332429996618,306.59794344256744,318.99301118619877,324.7630065797592,282.3178,305.06390000000005,320.00660000000016,327.5744999999999,327.5744999999999,342.11883288261436,313.0301671173854,104739841,38.08192924345639,55.87604529635842,NaN,NaN,NaN,NaN,NaN,NaN,-2.8404248699502888,-0.21404891475913246,2.6263759551911563,11.937019406810657,22.31908247727324,6487725086,15743259908.459005,12.790949815059754,33.75125033898308,20.430813320134863,42.857142857142854,100
2021-03-01,319.27,323.94,317.935,323.59,285.0208724225507,306.93441981004133,319.17328525732825,324.65129166740115,282.83905,305.49820000000005,320.3326000000002,328.0259999999999,328.0259999999999,341.443228327799,314.6087716722008,49164518,49.58611096110391,54.77172183385676,NaN,NaN,NaN,NaN,49.58611096110391,NaN,-2.2825191844718393,-0.22677302539864286,2.0557461590731965,46.53972903698271,21.735721345920542,6536889604,15786693341.929447,16.62597817183809,30.20452236295228,21.296372257711255,35.714285714285715,92.85714285714286
2021-03-02,324.25,324.33,318.14,318.4,285.3530030452119,307.1614610019217,319.14296034527615,324.05593055622006,283.3219,305.9306,320.52100000000013,327.82499999999993,327.82499999999993,341.68526478824265,313.9647352117572,48370034,44.67659561497939,53.324229184179124,NaN,NaN,NaN,NaN,NaN,NaN,-2.163136802447583,-0.6481748439862827,1.5149619584613006,27.53570120834852,28.67081655071394,6488519570,15742386703.354326,15.937145340226047,28.189522631643687,21.893633530711917,28.571428571428573,85.71428571428571
2021-03-03,317.27,318.24,309.1,309.16,285.58988858705055,307.2010360315866,318.75147170428494,322.6372705032467,283.75135,306.22300000000007,320.48420000000016,326.8989999999999,326.8989999999999,342.97224721393536,310.8257527860644,86301073,37.54868006366173,51.45364629079593,NaN,NaN,NaN,NaN,NaN,NaN,-2.5784018652871974,-1.7080403731476963,0.8703614921395011,0.2062564455139303,24.760562230281703,6402218497,15657218686.017345,14.384491902774183,34.91318804962838,24.223232926659193,21.428571428571427,100
2021-03-04,308.78,312.04,300.11,304.1,285.7740688001147,307.1396293774958,318.17690418646987,320.8718161696042,284.13470000000007,306.44990000000007,320.3650000000001,325.7849999999999,325.7849999999999,344.68712421925704,306.8828757807428,139131582,34.31953811222739,49.23353398684221,NaN,NaN,NaN,NaN,NaN,NaN,-3.034370173772305,-2.92260122507588,0.11176894869642484,10.477941176470617,12.739966276777666,6263086915,15611152487.450706,12.678163836982993,39.71065487707126,27.264076387388723,14.285714285714286,100
2021-03-05,306.795,309.609,297.45,308.68,286.0019885135464,307.17013176606025,317.8044765713142,319.7106908201181,284.5438000000001,306.67960000000005,320.36020000000013,324.70699999999994,324.70699999999994,344.885918801566,304.5280811984339,121523726,39.39958482595246,47.25746768934086,NaN,NaN,NaN,NaN,NaN,NaN,-2.8698296532741683,-3.4755181178962857,-0.6056884646221173,27.565046637211623,12.749748086398723,6384610641,15714106340.68913,11.217631206694616,37.65618321602936,30.159058371643418,7.142857142857143,100
2021-03-08,308.12,310.06,299.51,299.94,286.14067519500367,307.0269608399997,317.1039088626352,317.82776788486876,284.8865500000001,306.7337,320.16380000000015,323.1359999999999,323.1359999999999,345.74451556383656,300.52748443616326,88409781,33.99591419088421,45.01315239008147,NaN,NaN,33.99591419088421,NaN,NaN,NaN,-3.168502065762415,-4.566316046825136,-1.397813981062721,6.517130368780615,14.853372727487619,6296200860,15632903423.353586,10.542908892081824,33.9966148557862,32.64585985526404,0,92.85714285714286
2021-03-09,307.47,313.73,306.92,311.77,286.3956933522673,307.12088240752445,316.89473596606126,317.25083761011933,285.3010500000001,306.90620000000007,320.23520000000013,322.0454999999999,322.0454999999999,344.63775484541844,299.45324515458134,80391114,44.99290642850657,43.76334606722914,NaN,NaN,NaN,NaN,NaN,NaN,-2.4218994674660657,-4.425188315395303,-2.0032888479292374,39.18992884510122,24.42403528369782,6376591974,15667019476.137726,12.47682237990277,29.905504546322515,35.35238506007658,0,85.71428571428571
2021-03-10,316.16,316.47,310.17,310.88,286.6393182940358,307.1953203796527,316.65886396739216,316.6440911710603,285.70715000000007,307.09440000000006,320.26160000000016,320.91399999999993,320.91399999999993,343.36250854734396,298.4654914526559,76798065,44.393648371984845,42.6575604115506,NaN,NaN,NaN,NaN,NaN,NaN,-1.86551756963145,-4.33518580996855,-2.4696682403371,36.754241926655716,27.487100380179186,6299793909,15607531451.185345,14.210471358590803,28.233886156306053,37.539186863326286,7.142857142857143,78.57142857142857
2021-03-11,315.77,319.86,314.85,318.04,286.95176288812496,307.41006651074866,316.71302616474935,316.7770348690546,286.15215000000006,307.3738000000001,320.36880000000014,320.17849999999993,320.17849999999993,341.98229533476257,298.3747046652373,53484804,50.14638138958333,42.145935256409416,NaN,NaN,NaN,NaN,NaN,NaN,-0.9395446944920991,-3.644099108452224,-2.7045544139601247,67.841845140033,47.928671970596646,6353278713,15622157036.311092,16.070686426926727,26.00275149826638,39.08162881747798,0,71.42857142857143
2021-03-12,313.86,318.2302,311.391,315.46,287.2354269389894,307.56947113429817,316.6638878837788,316.6516029767637,286.5780000000001,307.64330000000007,320.41880000000015,319.2224999999999,319.2224999999999,340.0724869304588,298.372513069541,69315601,48.210911038766255,42.374047407039825,NaN,NaN,NaN,NaN,NaN,NaN,-0.4499030163326099,-3.266933184375887,-2.817030168043277,66.70370370370367,57.09993025679747,6283963112,15635320432.991814,15.092482387727312,27.498502152251113,39.527847993336316,0,64.28571428571429
2021-03-15,315.79,319,314.095,318.83,287.549800800293,307.792451903916,316.74883345696395,316.85906935992904,287.02220000000005,307.9936000000001,320.5360000000002,318.3414999999999,318.3414999999999,337.63633793661853,299.04666206338123,43123176,50.87788548750231,42.873666212730946,NaN,NaN,NaN,NaN,NaN,NaN,0.12132741453164275,-2.6653708998787238,-2.7866983144103665,79.18518518518516,71.24357800964061,6327086288,15675454438.789978,15.119499987551832,26.263776177973835,38.44161356466488,7.142857142857143,57.142857142857146
2021-03-16,321.09,324.2,319.1,320.58,287.87845949879755,308.04567067809586,316.89907528218106,317.21344370660245,287.45830000000007,308.3553000000001,320.67280000000017,317.59349999999995,317.59349999999995,335.25411298483607,299.93288701516383,54925896,52.25294041387127,43.192224610125756,NaN,NaN,NaN,NaN,NaN,NaN,0.6100901067506421,-2.024085680972064,-2.634175787722706,86.04910714285714,77.31266534391533,6382012184,15652407102.037037,19.227954986281205,24.943286016159533,36.651104970295385,0,50
2021-03-17,317.45,323.85,315.68,321.9,288.2169822898543,308.32001383298507,317.09518997699746,317.6597824012117,287.8975000000001,308.7324000000001,320.92460000000017,316.9919999999999,316.9919999999999,333.1407765480942,300.8432234519056,78258729,53.314502860884666,44.41410921452606,NaN,NaN,NaN,NaN,53.314502860884666,NaN,0.9927097558807834,-1.393288592871727,-2.3859983487525103,90.95982142857142,85.39803791887124,6460270913,15693308543.0199,17.764549577645226,26.230822387637527,34.842936593140585,21.428571428571427,42.857142857142854
2021-03-18,316.87,317.8801,311.57,312.04,288.45402724219406,308.3936769254012,316.8969472328015,317.12456502966774,288.27955000000003,309.0110000000001,320.9282000000002,315.9704999999999,315.9704999999999,330.58555726982456,301.35544273017524,82942269,45.22589545161138,44.92439251510855,NaN,NaN,NaN,NaN,NaN,NaN,0.572999379859199,-1.6697491239285114,-2.2427485037877104,54.27827380952394,77.09573412698417,6377328644,15622721978.82014,16.096440812338923,27.503763501633415,33.49496638618223,14.285714285714286,35.714285714285715
2021-03-19,311.87,314.73,309.6601,313.14,288.6996588119235,308.4876635209378,316.74961596877006,316.74508264588985,288.6618000000001,309.29500000000013,321.0402000000002,315.0764999999999,315.0764999999999,327.98803790221325,302.16496209778654,78446204,46.206421825494445,44.68298614827931,NaN,NaN,NaN,NaN,NaN,NaN,0.3705416131867434,-1.7795714873042812,-2.1501131004910246,58.370535714285715,67.86954365079369,6455774848,15651964267.80801,15.335331413212879,27.984531215353037,33.50957006535447,7.142857142857143,28.571428571428573
2021-03-22,315.21,320.74,315.21,318.61,288.9972741471282,308.6881058274539,316.8225722052889,316.9226938224718,289.07970000000006,309.6764000000001,321.11280000000016,314.8849999999999,314.8849999999999,327.46331546751634,302.3066845324834,56194755,50.91225374086024,45.12839030012794,NaN,NaN,NaN,NaN,NaN,NaN,0.5929053954402761,-1.4089813561906794,-2.0018867516309555,79.10280373831786,63.917204420709176,6511969603,15664869754.037666,19.856033442852247,25.999866160382666,32.483266608405884,0,21.428571428571427
2021-03-23,319.73,321.09,316.375,317.22,289.2780972899429,308.8570542269103,316.8381576090031,316.9510086965221,289.46735000000007,310.02200000000016,321.07660000000016,314.6719999999999,314.6719999999999,326.9367537276634,302.4072462723364,53455411,49.7219272772266,45.997907958239715,NaN,NaN,NaN,NaN,NaN,NaN,0.6307418923773356,-1.2134593861592862,-1.8442012785366217,73.90654205607491,70.45996050289283,6458514192,15630574394.912535,19.293576255715948,24.82364877903375,30.404169035989998,64.28571428571429,14.285714285714286
2021-03-24,318.63,318.67,311.72,311.87,289.5028923417842,308.9167165194467,316.6433278988461,316.4671031063771,289.81895000000003,310.42430000000013,321.02560000000017,314.0589999999999,314.0589999999999,325.5742332151921,302.5437667848077,64803729,45.329096305982134,46.78430497207934,NaN,NaN,NaN,NaN,NaN,NaN,0.2967812729976278,-1.473224687289587,-1.770005960287215,53.90654205607483,68.97196261682254,6393710463,15568567949.17872,18.00087578646244,27.64808569432421,28.22800738149662,57.142857142857146,7.142857142857143
2021-03-25,309.968,312.885,307.3899,311.33,289.72007749261223,308.96450431114084,316.43496209889133,315.9778551914841,290.1591,310.77370000000013,320.9738000000002,313.9839999999999,313.9839999999999,325.54970343732623,302.4182965626736,78729008,44.89792734171617,47.17704372320532,NaN,NaN,44.89792734171617,NaN,NaN,NaN,0.05357872993844848,-1.7030325478641544,-1.7566112778026028,47.87363304981772,58.56223905398915,6314981455,15602739585.178211,17.029340712068976,30.40879542172104,26.37861235415286,50,0
2021-03-26,311.11,316.33,309.67,316,289.9815692588549,309.10382105745487,316.4179047616799,315.9799642208666,290.508,311.23990000000015,320.9730000000002,314.0769999999999,314.0769999999999,325.6760897918875,302.4779102081123,63519634,49.38210031284997,48.27605701763145,NaN,NaN,NaN,NaN,NaN,NaN,0.21237858174780322,-1.4911380506178489,-1.703516632365652,52.54629629629629,51.44215713406294,6378501089,15659964480.673706,19.31273386083464,28.407629250331603,23.978651132523005,42.857142857142854,0
2021-03-29,315.45,316.99,312.47,315.91,290.2395635945877,309.2385968780993,316.39798692788855,315.9733009617364,290.91745,311.69920000000013,321.0042000000002,313.6929999999999,313.6929999999999,324.4875173120489,302.89848268795095,54607963,49.29883552214299,48.58362338146262,NaN,NaN,NaN,NaN,NaN,NaN,0.31056506242432835,-1.3153103043352417,-1.62587536675957,50.68440996781712,50.368113104643705,6323893126,15688476602.948042,19.096541448767788,27.103965296459897,22.27932063814198,35.714285714285715,0
2021-03-30,313.89,314.91,311.54,314.32,290.47916992697986,309.33921872209737,316.31649724444196,315.8158437272853,291.30965,312.0959000000001,321.0534000000002,313.4889999999999,313.4889999999999,324.07212789302895,302.9058721069709,44635676,47.76649765267142,48.82454118722594,NaN,NaN,NaN,NaN,NaN,NaN,0.26917882246382097,-1.2894018386797939,-1.5585806611436148,41.22581067334514,48.15217231248618,6279257450,15717483169.844183,18.22569334499423,26.838445293033224,21.28451217168333,28.571428571428573,78.57142857142857
2021-03-31,316.16,320.74,315.81,319.13,290.7642528132786,309.53309557908557,316.4268306858364,316.13147765802006,291.71155000000005,312.4181000000001,321.1078000000002,313.9874999999999,313.9874999999999,324.64698943431495,303.32801056568485,55032535,52.56945393655486,48.99761779772392,NaN,NaN,NaN,NaN,NaN,NaN,0.5503001757145904,-0.8707054415003768,-1.4210056172149672,69.83956074026925,53.9165937938105,6334289985,15736571533.91112,23.11012075134309,25.03240070795186,19.88354050891892,21.428571428571427,71.42857142857143
2021-04-01,323.07,324.71,322.81,324.57,291.1006284071763,309.83085606266803,316.74617065894085,316.93514645249434,292.12015,312.7199000000001,321.12380000000024,315.01099999999985,315.01099999999985,325.6072180045688,304.4147819954309,55685602,57.3464331131045,49.65015508874807,NaN,NaN,NaN,NaN,NaN,NaN,1.057777077301757,-0.09878427058777106,-1.156561347889528,99.19169057915377,70.08568733092271,6389975587,15784050836.669014,25.956554884277384,23.549099751827058,18.150305769101934,100,64.28571428571429
2021-04-05,327.13,331.84,324.6375,331.05,291.49813459217955,310.251037130734,317.30710514290394,318.27941821892347,292.55730000000005,313.0843000000001,321.2176000000002,316.1294999999999,316.1294999999999,328.4058699439311,303.85313005606866,42172475,62.22667380775484,50.46078282590896,NaN,NaN,NaN,NaN,NaN,NaN,1.7444859560484072,1.0240460971709808,-0.7204398588774263,96.76892937043218,88.60006022995174,6432148062,15816972008.57981,31.492209106225555,21.741504224737888,17.53511757329084,100,57.142857142857146
2021-04-06,330.73,332.83,330.02,330.82,291.8893969345459,310.65834332616504,317.83702258828026,319.47375934093077,292.99,313.5066000000001,321.3256000000002,317.6734999999999,317.6734999999999,329.1589556287633,306.18804437123646,33537210,61.95571406731073,51.15383808686892,NaN,NaN,NaN,NaN,NaN,NaN,2.07534299103811,1.8737388799202108,-0.2016041111178989,92.09908766081898,96.01990253680164,6398610852,15802530718.864508,31.60797815328093,21.068350766316065,18.04006385589214,100,50
2021-04-07,330.33,332.48,329.37,331.62,292.2847263182818,311.073425636538,318.3775315063869,320.630544165604,293.4269,313.98860000000013,321.3958000000002,318.6659999999999,318.6659999999999,331.3114013775881,306.0205986224117,32046381,62.56628751639108,51.81467984797653,NaN,NaN,NaN,NaN,NaN,NaN,2.2268169791241776,2.5819171127873233,0.35510013366314563,95.24372938785625,94.70391547303579,6430657233,15816853699.440071,30.483057798404506,21.062370646608716,17.970986815004473,92.85714285714286,42.857142857142854
2021-04-08,334.56,335.27,333.7399,335.08,292.71054993700534,311.54880334670554,319.0325302708423,322.0066828164989,293.8686,314.4418000000001,321.5256000000002,319.87599999999986,319.87599999999986,333.86918748535857,305.88281251464116,29940799,65.16988688728813,53.239250664810584,NaN,NaN,NaN,NaN,NaN,NaN,2.422596251304592,3.383345447793886,0.9607491964892937,99.3185103353288,95.55377579466801,6460598032,15839358707.563658,32.46125165646242,20.15571888433648,17.77266838730144,100,35.714285714285715
2021-04-09,333.68,337.32,332.92,337.11,293.15233550977143,312.05496565667175,319.7414506523779,323.4450939768323,294.30995,314.9289000000001,321.8792000000002,320.82949999999994,320.82949999999994,336.6693427706886,304.98965722931126,36664892,66.6360857438544,54.69851237326487,NaN,NaN,NaN,NaN,NaN,NaN,2.5391012981049315,4.134625819120458,1.5955245210155267,99.29836519089486,97.95353497135996,6497262924,15872523768.963657,33.20906583156823,19.088974530406972,17.615506676291467,100,28.571428571428573
2021-04-12,336.04,337.1,334.73,336.67,293.5853470967389,312.5423920793119,320.4053153326768,324.7046088361816,294.77475,315.3863000000001,322.18620000000027,321.88999999999993,321.88999999999993,338.94344422690517,304.8365557730947,25833013,65.98768691943343,55.77532902887724,NaN,NaN,NaN,NaN,NaN,NaN,2.4363946540698693,4.641017838602863,2.204623184532994,97.8282732099125,98.81504957871205,6471429911,15888982777.246357,32.21585668822205,18.518065847312368,18.587017024381264,92.85714285714286,21.428571428571427
2021-04-13,338.24,341.08,338.02,340.6,294.0531545883136,313.09798827576117,321.1972637510032,326.2184556136881,295.24760000000003,315.8603000000001,322.7070000000002,322.9784999999999,322.9784999999999,341.79925266827274,304.157747331727,30374033,68.89864902521906,57.145094868019555,NaN,NaN,NaN,NaN,68.89864902521906,NaN,2.475004575684975,5.298378904139213,2.823374328454238,98.57524910878875,98.56729583653203,6501803944,15909827701.8542,35.484254236909635,17.475145442313,20.120627688481544,100,14.285714285714286
2021-04-14,340.85,340.98,335.67,336.51,294.4756107615642,313.5615924683203,321.7977632117482,327.19860269809874,295.72905000000003,316.30270000000013,322.98880000000025,323.7749999999999,323.7749999999999,343.45119932812855,304.0988006718713,42564337,62.86823547407403,58.39789052288326,NaN,NaN,NaN,NaN,NaN,NaN,2.0827062871142044,5.426757187346993,3.344050900232789,86.43518422325847,94.27956884731991,6459239607,15880730047.746855,33.06923650574961,19.297827955413105,20.48951144396287,92.85714285714286,7.142857142857143
2021-04-15,339.47,342.01,336.2153,341.61,294.9446096594591,314.1170064788486,322.5747136740326,328.57111672685124,296.2229,316.8177000000001,323.26740000000024,324.7604999999999,324.7604999999999,345.88352769491644,303.6374723050834,36342821,66.7735167438411,59.96043262303504,NaN,NaN,NaN,NaN,NaN,NaN,2.022625426575176,5.872332683451759,3.849707256876583,98.76314162028456,94.59119165077726,6495582428,15912055480.99598,31.93652339128511,17.868615890177576,20.49250354543097,100,0
2021-04-16,342.15,342.23,340.08,342.01,295.412922001156,314.66934298421796,323.33688176524697,329.85101037191305,296.69495,317.31400000000014,323.58000000000027,326.2589999999999,326.2589999999999,347.80771495009174,304.71028504990807,40860099,67.06608325494742,61.223574261756276,NaN,NaN,NaN,NaN,NaN,NaN,1.8693685593683664,6.186417956087041,4.317049396718675,99.28315412186372,94.8271599884689,6536442527,15944553513.223885,31.31271073693485,17.355038367419677,21.179702141030436,100,0
2021-04-19,340.39,341.58,336.9016,338.88,295.8454302399505,315.1487619350255,323.94641581366864,330.7109141460166,297.13689999999997,317.79900000000015,323.75280000000026,327.5459999999999,327.5459999999999,348.88043076344985,306.2115692365499,34533129,62.433463119506044,62.161761947282216,NaN,NaN,NaN,NaN,NaN,NaN,1.4362077321678601,6.112309061928499,4.676101329760639,89.08439231019868,95.71022935078231,6501909398,15939227096.951998,29.16761291260593,20.42847971290297,21.20032443578555,92.85714285714286,7.142857142857143
2021-04-20,338.2,339.52,334.3816,336.41,296.24905779975194,315.5697765501735,324.43518382097574,331.25368422734834,297.55799999999994,318.25920000000013,323.8538000000002,328.43599999999986,328.43599999999986,349.69001646749206,307.1819835325077,38081818,58.97164468687703,62.96212959258262,NaN,NaN,NaN,NaN,NaN,NaN,0.8891617819934154,5.787553557252409,4.898391775258993,77.97123391370178,88.77959344858806,6463827580,15931211120.315536,27.1526530358215,22.40519649199716,20.51942570182346,85.71428571428571,0
2021-04-21,335.09,339.48,333.97,339.29,296.67732588134646,316.03948394521956,325.01772563191787,332.01904763426757,297.9625,318.7074000000001,323.9680000000002,329.5394999999999,329.5394999999999,350.6407914059844,308.43820859401546,36598082,61.642310330999905,63.610190763614405,NaN,NaN,NaN,NaN,NaN,NaN,0.6388098175834616,5.69690404723832,5.058094229654858,84.86096807415038,83.97219809935028,6500425662,15965285196.660364,25.14655400827236,21.301754633320115,20.825475219512516,78.57142857142857,0
2021-04-22,338.89,339.9,334.01,335.2,297.0606360715818,316.41890010472014,325.4170305090976,332.321995478623,298.35544999999996,319.0966000000001,324.00180000000023,330.7059999999999,330.7059999999999,350.29649810495573,311.1155018950441,45936143,56.061285353248365,63.51839449505325,NaN,NaN,56.061285353248365,NaN,NaN,NaN,0.1412786655930951,5.234692561646227,5.093413896053132,60.03978968310349,74.29066389031856,6454489519,15937910686.99483,23.734368518062396,19.631998707617214,21.153818480913003,71.42857142857143,0
2021-04-23,335.85,340.767,335.85,339.42,297.4821222798248,316.87436742937916,325.96616656756436,332.9979959092304,298.7526,319.5007000000001,324.13520000000017,332.1104999999999,332.1104999999999,349.8868331145734,314.3341668854264,36414916,60.07758149467209,63.36488790126163,NaN,NaN,NaN,NaN,NaN,NaN,0.044904576270690555,5.149544616391495,5.104640040120804,78.149300155521,74.3500193042583,6490904435,15954374050.482323,23.131386209843196,18.18137444648761,20.70131944134779,64.28571428571429,0
2021-04-26,339.67,341.92,338.9,341.63,297.9214046451997,317.36457797533205,326.58043454530696,333.82009153692275,299.14984999999996,319.9208000000001,324.2762000000002,333.39199999999994,333.39199999999994,349.994517399486,316.78948260051385,30811968,62.0347539917367,63.3705336101492,NaN,NaN,NaN,NaN,NaN,NaN,0.07664420025160545,5.200445290435312,5.123801090183706,95.33437013996873,77.84115332619774,6521716403,15979268488.204176,23.75407164482491,17.429001232423587,20.369186776491535,57.142857142857146,7.142857142857143
2021-04-27,341.93,342.15,339.17,340.15,298.34158967360565,317.8157744510681,327.1125743670596,334.4229399619777,299.53074999999995,320.2877000000001,324.3502000000002,334.6039999999999,334.6039999999999,349.36129839775185,319.846701602248,33187183,59.916336105413954,63.18125136650798,NaN,NaN,NaN,NaN,NaN,NaN,-0.04864269290338985,5.062997724054469,5.111640416957859,77.65843179376971,83.71403402975314,6488529220,15967909116.841759,23.078602591783724,16.69485387341875,20.21017244166642,50,0
2021-04-28,339.81,340.85,338.3301,339,298.7461509703857,318.23526406589843,327.5787479212926,334.85885044178934,299.93305,320.63920000000013,324.4194000000002,335.8379999999999,335.8379999999999,347.3819882189959,324.2940117810039,33615696,58.251749662957316,62.68709870762721,NaN,NaN,NaN,NaN,NaN,NaN,-0.24461232332777527,4.80587501279814,5.050487336125915,65.30612244897941,79.43297479423927,6454913524,15952166475.129944,22.226043243062936,17.309407359407555,19.427959211123255,42.857142857142854,7.142857142857143
2021-04-29,342.37,342.8,336.9001,340.22,299.1588260851082,318.67060537152423,328.0744832969282,335.3694361139999,300.3323,320.9986000000001,324.5452000000002,336.8924999999999,336.8924999999999,345.65747090698454,328.1275290930153,37708884,59.536077107209834,62.17995523358116,NaN,NaN,NaN,NaN,NaN,NaN,-0.32280608805631594,4.64697972605552,4.969785814111836,70.78142695356752,71.2486603987722,6492622408,15956895504.990044,23.148456967267762,15.834497665420974,18.83957833543306,100,0
2021-04-30,337.7,340.26,337.05,337.99,299.5452059250574,319.053167641395,328.4633270892055,335.61901362695227,300.71774999999997,321.32330000000013,324.6556000000002,337.5634999999999,337.5634999999999,344.26393662759267,330.86306337240717,38263421,56.136591260152855,61.476305543632556,NaN,NaN,NaN,NaN,NaN,NaN,-0.5425163753075974,4.291640344977338,4.834156720284936,45.526613816534415,60.53805440636045,6454358987,15941041813.423065,22.047699651574607,15.08153433960688,18.25119745974287,92.85714285714286,50
2021-05-03,339.23,340,335.73,336.19,299.9098307417235,319.3925108564169,328.76633387002096,335.67339328152826,301.1030999999999,321.61270000000013,324.7590000000002,337.8204999999999,337.8204999999999,343.86399393979053,331.7770060602093,29729730,53.482027211534486,60.375118271226505,NaN,NaN,NaN,NaN,NaN,NaN,-0.810730800933082,3.820743219118583,4.631474020051665,25.141562853906844,47.14986787466958,6424629257,15917717552.181847,20.64158691530461,16.091223173739547,16.70707148065687,85.71428571428571,42.857142857142854
2021-05-04,333.56,333.89,326.21,330.14,300.21062844578597,319.6053324236166,328.82020313002016,335.1464034451922,301.45669999999996,321.83120000000014,324.9130000000002,337.78649999999993,337.78649999999993,343.99261077892663,331.58038922107323,65146972,45.66566755974105,59.14636342020272,NaN,NaN,NaN,NaN,NaN,NaN,-1.3646636891513104,2.925644408612527,4.2903080977638375,23.68896925858951,31.452381976343585,6359482285,15919244434.338097,17.78641292781051,27.060052133555306,16.305699839480877,78.57142857142857,100
2021-05-05,332.25,333.14,328.23,329.03,300.4973883617483,319.79195950433706,328.8284304582547,334.5638888313644,301.7679499999999,322.10840000000013,325.0640000000002,337.657,337.657,344.4525017474868,330.8614982525132,46219307,44.38399997573644,57.54711222248096,NaN,NaN,NaN,NaN,NaN,NaN,-1.7502716932552147,2.102468481194819,3.852740174450034,16.99819168173591,21.942907931410748,6313262978,15888086408.641558,16.571912267319448,25.212324245840563,15.765181625729614,71.42857142857143,92.85714285714286
2021-05-06,328.76,331.67,326.45,331.51,300.8059715621289,320.0239999101918,328.93359004812703,334.2730422759964,302.1054999999999,322.3983000000001,325.2116000000002,337.47849999999994,337.47849999999994,344.7090138821717,330.2479861178282,46814283,47.90218354709208,56.17826224334844,NaN,NaN,NaN,NaN,NaN,NaN,-1.7770680758911,1.631405079586159,3.408473155477259,31.946955997588915,24.211372312638105,6360077261,15932030850.538109,15.370297254851051,25.856734139580816,15.53349001138246,64.28571428571429,85.71428571428571
2021-05-07,334.37,336.65,331.6914,334.2,301.13825045205795,320.3047127832573,329.14011592859265,334.26608586875864,302.4518499999999,322.72180000000014,325.6390000000002,337.33299999999997,337.33299999999997,344.7030884662308,329.96291153376916,53324460,51.486963381431075,55.396369404914516,NaN,NaN,NaN,NaN,NaN,NaN,-1.5601115678598307,1.4583336956524704,3.018445263512301,48.16154309825192,32.36889692585891,6413401721,15932661031.104399,21.190607282809708,24.010561399403247,14.720494794475538,57.142857142857146,78.57142857142857
2021-05-10,332.78,332.96,325.55,325.76,301.3832429848733,320.4127382726977,329.0075623627655,333.4559824526864,302.7905999999999,322.93900000000014,325.87140000000016,336.78749999999997,336.78749999999997,345.7220886866796,327.8529113133203,60700462,41.77450575890235,54.16800233863061,NaN,NaN,NaN,NaN,NaN,NaN,-1.908483477340618,0.6328409168365283,2.5413243941771464,1.2173913043477074,27.108630133396176,6352701259,15875401081.120592,18.762702115237527,29.3942246635263,15.613152190716107,50,100
2021-05-11,319.7,326.1299,319.02,325.31,301.6213201691034,320.50971375244626,328.86255991716683,332.6801746000496,303.1393499999999,323.11920000000015,325.90580000000017,336.02299999999997,336.02299999999997,346.0693229094126,325.9766770905873,71963612,41.326875760595264,52.71689986931598,NaN,NaN,NaN,NaN,NaN,NaN,-2.078677101739692,-0.05702198299746897,2.021655118742223,26.45079899074858,25.276577797782736,6280737647,15930767282.333155,17.03502290689032,35.144610479358604,17.50091291866334,42.857142857142854,100
2021-05-12,320.23,322.62,316,316.89,301.77324733159986,320.4380362523978,328.39304776355243,331.17634844766394,303.42319999999995,323.1983000000002,325.87560000000013,335.042,335.042,348.0898375219851,321.99416247801486,91164855,33.988164015745255,51.14024834520861,NaN,NaN,33.988164015745255,NaN,NaN,NaN,-2.6321592529526745,-1.2685439474486202,1.3636153055040543,3.3208955223880072,10.329695272494762,6189572792,15864115031.849771,15.077256315843396,34.83357803962729,19.652586981453982,35.714285714285715,100
2021-05-13,319.92,322.4,316.9,319.34,301.94804089048944,320.4162929602711,328.0380262826288,330.049077166934,303.7358499999999,323.28170000000017,326.0792000000002,333.92849999999993,333.92849999999993,348.2801330429741,319.57686695702574,69877765,37.46776831996224,49.5252616898722,NaN,NaN,NaN,NaN,NaN,NaN,-2.6971675492208527,-2.0078441310220114,0.6893234181988411,12.46268656716408,14.078127026766888,6259450557,15856237901.977045,14.048230176550053,32.456178493117974,21.624117993744314,28.571428571428573,92.85714285714286
2021-05-14,322.6,327.33,322.08,326.39,302.1912444637184,320.53458418878057,327.97339780095706,329.700593627226,304.0689499999999,323.44500000000016,326.5250000000002,333.1474999999999,333.1474999999999,347.3543010121999,318.9406989877999,44370015,46.24807674276972,48.397641886374565,NaN,NaN,NaN,NaN,NaN,NaN,-2.152893410222477,-2.001793344579255,0.15110006564322187,38.768656716417844,18.184079601989975,6303820572,15884719225.89133,18.63808309608924,29.330115495505044,22.119218884521274,21.428571428571427,85.71428571428571
2021-05-17,324.63,326.3721,321.45,324.41,302.41232660835806,320.6113250959334,327.83365671072346,329.1967275674902,304.3853499999999,323.59990000000016,326.8396000000002,332.424,332.424,346.8613077822761,317.9866922177238,39394997,44.364005377282055,47.286761120079426,NaN,NaN,NaN,NaN,NaN,NaN,-1.8266312190040495,-2.13218895811184,-0.3055577391077905,31.380597014925453,27.53731343283579,6264425575,15892706115.12688,17.51484580368294,28.33108607271478,22.657955361029558,14.285714285714286,78.57142857142857
2021-05-18,325.39,326.65,321.94,322.22,302.60941788588684,320.6431800445288,327.61351331030295,328.53227732296733,304.6674999999999,323.72450000000015,327.2852000000002,331.71449999999993,331.71449999999993,346.68343379637713,316.74556620362273,36528454,42.31086256442172,46.148126327326885,NaN,NaN,NaN,NaN,NaN,NaN,-1.663356343611241,-2.3847531686218417,-0.7213968250106008,23.20895522388069,31.11940298507466,6227897121,15860520746.952784,16.838016642989047,26.680125220136325,23.3851043956675,7.142857142857143,71.42857142857143
2021-05-19,316.66,322.9,316.3,322.59,302.8082296482163,320.68173093473615,327.4165127883303,327.9663461493514,304.9335499999999,323.8684000000001,327.50160000000017,330.8795,330.8795,345.92787994602804,315.831120053972,66319108,42.79256976930678,44.95216151747667,NaN,NaN,NaN,NaN,NaN,NaN,-1.4436335540132177,-2.5259387675271228,-1.082305213513905,27.164056059356874,27.251202766054337,6294216229,15920609878.140663,15.476986719621259,31.43090711824852,24.474334498944383,0,64.28571428571429
2021-05-20,324.12,329.71,323.89,328.83,303.06715273629374,320.84308279741464,327.47194365937617,328.0485988970322,305.2257999999999,324.0611000000002,327.8606000000002,330.56100000000004,330.56100000000004,345.49936389970145,315.6226361002986,46466135,50.32589468804007,44.53711176232576,NaN,NaN,NaN,NaN,NaN,NaN,-0.8221485175783072,-2.109990860486789,-1.287842342908482,53.458333333333265,34.6104482055236,6340682364,15953024398.43276,22.35913498316087,28.732707750523605,24.025248400304122,0,57.142857142857146
2021-05-21,330.43,330.86,326.64,327.01,303.30539002249975,320.9651999697431,327.45382822175355,327.94968471636247,305.50559999999984,324.2044000000002,328.0400000000002,329.94050000000004,329.94050000000004,344.37795749776785,315.50304250223223,50330449,48.32697496711442,44.16889374486717,NaN,NaN,NaN,NaN,NaN,NaN,-0.49392248841470066,-1.9052454534268577,-1.411322965012157,53.31719128329299,44.64652689199437,6290351915,15911519667.977783,22.613265851020763,27.24010890565128,23.803331675292647,0,50
2021-05-24,329.37,333.67,326.9032,332.51,303.59598315660423,321.19380987133235,327.6521094679593,328.3840004576613,305.79494999999986,324.3999000000002,328.3810000000002,329.4845,329.4845,342.9604051273006,316.00859487269946,32475771,54.241882771553044,44.78148054571089,NaN,NaN,NaN,NaN,NaN,NaN,0.10155937395241743,-1.2843737475716352,-1.3859331215240527,79.95157384987898,62.24236615550174,6322827686,15932861108.316319,24.170211189279083,24.997665121688176,22.446494205805266,21.428571428571427,42.857142857142854
2021-05-25,334.07,334.81,331.755,332.97,303.8882619311654,321.4270017550683,327.860654194706,328.8207623188364,306.10244999999986,324.5999000000002,328.6638000000002,329.1255,329.1255,341.80476098004556,316.4462390199544,31280314,54.708840276635,45.518969138632215,NaN,NaN,NaN,NaN,NaN,NaN,0.5114633717556145,-0.7466039068295345,-1.258067278585149,82.17917675544817,71.81598062954005,6354108000,15926461698.741852,24.67611072180681,24.03565158695897,21.063362297547656,14.285714285714286,35.714285714285715
2021-05-26,333.66,334.61,332.95,334.13,304.1891747477707,321.67854627476993,328.1065108929528,329.3264040027567,306.42154999999985,324.8038000000002,328.93480000000017,328.88199999999995,328.88199999999995,340.9664670548691,316.7975329451308,25444932,55.930176848741354,46.09239723160717,NaN,NaN,NaN,NaN,55.930176848741354,NaN,0.8270695505814762,-0.2242303403583037,-1.05129989093978,87.7966101694916,83.30912025827291,6379552932,15937191489.344261,24.132649820942106,23.50629600853812,19.340431253658334,7.142857142857143,28.571428571428573
2021-05-27,333.67,334.54,332.67,332.88,304.4746555960516,321.900357239626,328.29370654420956,329.66484171677985,306.7599999999999,325.0395000000002,329.15440000000024,328.515,328.515,339.6047403035465,317.42525969645345,27931747,54.233018348653815,46.288544014980225,NaN,NaN,NaN,NaN,NaN,NaN,0.9113414573107939,0.08787693069871239,-0.8234645266120815,89.73950026581602,86.5717623969186,6351621185,15915533182.846935,23.50464427528578,23.284240299851017,18.928458775903007,0,21.428571428571427
2021-05-28,334.12,335.5699,333.6,333.93,304.767743600071,322.13856798735617,328.51473766012293,330.07104726756273,307.0703499999999,325.26020000000017,329.5922000000002,328.312,328.312,338.8346814073253,317.7893185926747,29927449,55.45575185546612,47.265775879020495,NaN,NaN,NaN,NaN,NaN,NaN,0.9909033466301338,0.4151646566755858,-0.575738689954548,91.62029443175484,89.71880162235415,6381548634,15895632697.824802,24.077489419730046,22.3819713441383,17.612217898304273,100,14.285714285714286
2021-06-01,335.3,335.785,331.43,332.82,305.04687052942353,322.350081492557,328.683571477373,330.3328522896996,307.3720499999999,325.51300000000015,329.98580000000015,328.1435,328.1435,338.256120382473,318.03087961752703,31145424,53.818814600515076,48.158057224729056,NaN,NaN,NaN,NaN,NaN,NaN,0.9232376995649133,0.5783084345015936,-0.34492926506331967,85.01389941875144,88.79123137210745,6350403210,15884368853.324228,22.553688511420443,24.11894457100458,15.372750304991456,100,7.142857142857143
2021-06-02,333.25,334.34,331.695,333.47,305.32968773808597,322.57027789864503,328.8712745566917,330.63162826210913,307.6785999999999,325.6979000000002,330.2830000000002,328.31,328.31,338.6555942313657,317.9644057686343,22047940,54.6627623356543,49.6348142475797,NaN,NaN,NaN,NaN,NaN,NaN,0.8770546728465706,0.7513890759948936,-0.125665596851677,88.11906594816527,88.25108659955718,6372451150,15891912666.443321,21.657206329935534,23.160245330604095,12.784925920388533,92.85714285714286,0
2021-06-03,330.55,331.86,328.28,330,305.5751634819856,322.71740110857286,328.9155382995665,330.5714731895273,307.9519999999999,325.8076000000002,330.5386000000002,328.35849999999994,328.35849999999994,338.7262119462384,317.9907880537615,37057825,49.465726959140454,50.49181129323529,NaN,NaN,49.465726959140454,NaN,NaN,NaN,0.5818297670104257,0.6016216119113551,0.019791844900929417,70.31049525275843,81.14782020655838,6335393325,15890463477.75617,19.97907542660266,26.464200709362423,10.954947843494287,85.71428571428571,28.571428571428573
2021-06-04,331.85,336.0582,331.78,335.6,305.87391807420465,322.97250207671993,329.17767405252465,331.0503805048104,308.2401499999999,326.0194000000002,331.0132000000002,328.563,328.563,339.32513937839985,317.8008606216001,38736545,56.6317646090029,51.23350328368051,NaN,NaN,NaN,NaN,NaN,NaN,0.723486516581289,0.9241499906275408,0.2006634740462517,97.68096284074471,85.37017468055615,6374129870,15920902568.257082,24.356604717566412,24.11523916609612,9.398384617880245,100,21.428571428571427
2021-06-07,335.05,336.66,334.34,336.6,306.17965023267027,323.24235352074527,329.468745658308,331.5789156948284,308.5426499999999,326.24620000000016,331.5186000000002,328.683,328.683,339.7432696169701,317.6227303830299,32611852,57.78303343220929,52.192005287603884,NaN,NaN,NaN,NaN,NaN,NaN,0.8363361173891234,1.246083620782656,0.4097475033935326,99.70530451866404,89.23225420405572,6406741722,15951827600.326048,24.4125067297146,23.263661511896203,7.885320321405708,100,14.285714285714286
2021-06-08,338.395,339.29,335.03,336.76,306.48393231990735,323.5100296886513,329.7546772011195,332.07235229532097,308.8267999999999,326.45340000000016,331.9338000000002,329.233,329.233,340.7420557388553,317.7239442611447,27282819,57.97526056486064,53.31089085906381,NaN,NaN,NaN,NaN,NaN,NaN,0.8697011760982604,1.496873973516358,0.6271727974180977,88.99521531100466,95.46049422347114,6434024541,15946704066.24154,26.848742788127254,21.745204578901483,7.020056791418743,100,7.142857142857143
2021-06-09,338.17,338.97,336.651,336.84,306.7859827445849,323.7739894967968,330.032532997154,332.52641398148086,309.1016499999999,326.6783000000002,332.3524000000002,329.80949999999996,329.80949999999996,341.6257709430758,317.9932290569241,21485319,58.07804417957139,54.40271045979699,NaN,NaN,NaN,NaN,NaN,NaN,0.8444101741725261,1.6826855151337554,0.8382753409612294,84.09090909090884,90.93047630685919,6455509860,15928720882.03326,25.85924224682624,20.943793061374514,5.340860508695052,92.85714285714286,0
2021-06-10,337.19,340.46,336.73,340.35,307.1199530655343,324.1022273285434,330.4371395462852,333.27151741181603,309.3852499999999,326.9632000000002,332.8730000000003,330.98249999999996,330.98249999999996,342.0711552385831,319.8938447614168,33702067,62.420825007317205,55.26663405403108,NaN,NaN,NaN,NaN,NaN,NaN,1.0006504912109357,2.089088454974899,1.0884379637639632,99.20405209840841,90.76339216677395,6489211927,15960435159.558731,26.704582982557273,19.686998326371434,5.530297145208709,100,0
2021-06-11,340.36,341.25,339.69,341.24,307.4594560201061,324.44158916362176,330.86078113270537,334.0304205154526,309.66214999999994,327.21150000000017,333.31520000000023,332.0775,332.0775,342.6650339432777,321.48996605672227,21222830,63.45460149756854,56.34717880620637,NaN,NaN,NaN,NaN,NaN,NaN,1.0929977824534962,2.4546851918308334,1.3616874093773372,99.93029804555727,94.40841974495817,6510434757,15981385901.994629,27.33450516946956,19.16890642706833,6.121599768724086,100,0
2021-06-14,341.68,344.52,340.46,344.51,307.82811814925924,324.83898343760944,331.3960446176973,335.0284757044571,309.9248999999999,327.4189000000002,333.7140000000002,332.9835,332.9835,344.5271740685196,321.43982593148036,27827716,67.04202284178542,57.26147452550868,NaN,NaN,NaN,NaN,67.04202284178542,NaN,1.28985204218625,2.9740024621101497,1.6841504199238997,99.93842364532026,99.69092459642864,6538262473,16009076535.649801,30.989430218319143,17.852154245245853,7.922657703971436,100,0
2021-06-15,344.15,344.47,341.52,342.26,308.17072393881887,325.18395406260726,331.82208208366995,335.7171923040326,310.18094999999994,327.57790000000017,333.9382000000002,333.87600000000003,333.87600000000003,345.39033437069196,322.3616656293081,35963780,62.496100087614174,57.81770736915005,NaN,NaN,NaN,NaN,NaN,NaN,1.186676481562946,3.1674960218775823,1.9808195403146363,86.0837438423646,95.3174885110807,6502298693,15991155601.209124,29.388354688168217,16.929818883763577,9.750010077989016,92.85714285714286,42.857142857142854
2021-06-16,342.74,343.84,337.45,341.01,308.4974829046018,325.49734111087247,332.1823925901927,336.2212692274581,310.4233499999999,327.7338000000002,334.1420000000003,334.81550000000004,334.81550000000004,345.40113077950383,324.22986922049625,55399538,60.059583154217,58.11266496239831,NaN,NaN,NaN,NaN,NaN,NaN,0.961969663537654,3.1832816197367038,2.2213119561990498,78.38669950738922,88.13628899835801,6446899155,15997484499.91648,26.265201291398803,21.899455157899375,10.303539898794408,85.71428571428571,35.714285714285715
2021-06-17,339.97,346.38,339.92,345.34,308.86407511450625,325.890265049271,332.69837719449885,337.089719777224,310.67564999999996,327.9061000000002,334.41640000000024,335.95300000000003,335.95300000000003,345.9099274377163,325.99607256228376,59722700,65.13089058402255,58.8910844077818,NaN,NaN,NaN,NaN,NaN,NaN,1.02677895118862,3.5047856451848247,2.4780066939962047,94.25414364640874,86.24152899872085,6506621855,16037977599.91648,27.618893555006892,19.62843935372068,11.477890488462508,100,28.571428571428573
2021-06-18,343.63,344.8082,341.86,342.63,309.2000544666007,326.22174494928544,333.0878525986361,337.61736551272645,310.88919999999996,328.0465000000002,334.5674000000002,336.64300000000003,336.64300000000003,346.4412163682984,326.84478363170166,55414862,59.99638634532507,59.215415442771715,NaN,NaN,59.99638634532507,NaN,NaN,NaN,0.8180373248653967,3.5005533500779507,2.682516025212554,79.28176795580113,83.97420370319969,6451206993,16011508836.376556,26.051592138617032,18.514575732090123,12.42521275502233,92.85714285714286,21.428571428571427
2021-06-21,342.43,344.69,340.15,344.36,309.5499046709131,326.5809183166263,333.52989759476804,338.2595211781811,311.09719999999993,328.29580000000016,334.7124000000003,337.51050000000004,337.51050000000004,346.80277092803306,328.218229071967,32992649,62.05298979428298,59.80357081375514,NaN,NaN,NaN,NaN,NaN,NaN,0.7302678210212177,3.595350801489076,2.865082980467858,88.83977900552497,87.45856353591161,6484199642,16039705197.19594,24.12793488586001,19.928663350308216,12.86648753716086,85.71428571428571,14.285714285714286
2021-06-22,344.15,348.03,343.84,347.57,309.9282140771727,326.9965436964951,334.0804898459536,339.14623344692575,311.3979999999999,328.55830000000014,334.93040000000025,338.2635000000001,338.2635000000001,348.22923986214215,328.297760137858,28941626,65.5881047463368,60.58395241451818,NaN,NaN,NaN,NaN,NaN,NaN,0.8157080367192315,3.8847180263668974,3.069009989647666,97.67088607594947,88.59747767909185,6513141268,16062292098.632694,27.92844253247482,18.56609924153975,14.06525495716821,100,7.142857142857143
2021-06-23,347.51,348.92,346.88,347.74,310.30445075302174,327.4073052074556,334.6161569108182,339.96468740436137,311.71879999999993,328.8901000000002,335.0732000000002,339.00200000000007,339.00200000000007,349.4657958695625,328.53820413043763,27188454,65.76997503851021,61.74854156304458,NaN,NaN,NaN,NaN,NaN,NaN,0.8093689700840532,4.080721202252732,3.271352232168679,93.11551925320884,93.20872811156109,6540329722,16058027243.103283,28.471762024059018,17.923553972895583,14.69182370415469,100,0
2021-06-24,349.73,351.46,349.17,349.89,310.6983368151807,327.85250708453566,335.21513114960965,340.90995527061267,312.1184999999999,329.1648000000002,335.34080000000023,339.7900000000001,339.7900000000001,351.01362151891817,328.566378481082,32581605,68.06848760728894,62.56545034863644,NaN,NaN,NaN,NaN,NaN,NaN,0.8703509904481068,4.3592909702288125,3.4889399797807057,90.82943925233648,93.8719481938316,6572911327,16045933634.260489,31.005093776539926,16.782915720547344,16.782039849089994,100,0
2021-06-25,350.47,350.72,348.84,349.46,311.08402500607446,328.2803782313765,335.7737534574681,341.72424524484,312.4763999999999,329.38260000000025,335.4978000000002,340.619,340.619,352.1243411944196,329.1136588055804,28682801,67.09805743029683,63.2308092056427,NaN,NaN,NaN,NaN,NaN,NaN,0.803698507030814,4.493563113569223,3.6898646065384093,87.8271454656117,90.59070132371902,6544228526,16036169276.473253,29.96716152839365,16.808701614509864,18.619267794038553,92.85714285714286,0
2021-06-28,350.78,353.85,350.72,353.71,311.5081640607404,328.78393509808194,336.4771356748223,342.8657456977124,312.8832499999999,329.6559000000002,335.73180000000025,341.60800000000006,341.60800000000006,354.00907672744233,329.2069232725578,39130305,71.43304018020098,64.192079178167,NaN,NaN,NaN,NaN,NaN,NaN,0.9573760978511228,4.886584728852313,3.92920863100119,99.18599918599894,92.61419463464904,6583358831,16071799106.904562,33.17640722577322,15.503556929896211,20.462249290496498,100,0
2021-06-29,353.53,355.0199,352.67,354.99,311.94081914471315,329.30286707633775,337.20313035424107,344.02043658364454,313.30594999999994,329.90340000000026,336.05400000000026,342.71650000000005,342.71650000000005,355.72578172498265,329.70721827501745,29426039,72.60378468359659,65.22963207131167,NaN,NaN,NaN,NaN,NaN,NaN,1.0493757621268731,5.240928333659781,4.191552571532908,99.83652179618261,95.61655548259773,6612784870,16100476315.25977,33.887969162972496,14.83934193194782,22.50438399249908,100,0
2021-06-30,354.83,355.23,353.83,354.43,312.36359706367125,329.8004340649251,337.87869386976104,345.0118235756784,313.7022999999999,330.1341000000003,336.4144000000002,343.76450000000006,343.76450000000006,357.0004306057405,330.5285693942596,32723964,71.22843153677847,65.85874682341604,NaN,NaN,NaN,NaN,NaN,NaN,0.978077881467688,5.414149923367518,4.43607204189983,95.50056242969623,98.17436113729259,6580060906,16095801463.25977,33.38286031991615,14.442352800563798,24.252723529885877,100,0
2021-07-01,354.07,355.09,352.68,354.57,312.78356127199294,330.29092051908503,338.5332548944763,345.92212609228045,314.0798499999999,330.3440000000002,336.7200000000002,344.99300000000005,344.99300000000005,357.42732684144687,332.55867315855323,29289978,71.37442515569144,66.42444851328197,NaN,NaN,NaN,NaN,NaN,NaN,0.8506089432964394,5.499333221020379,4.6487242777239395,96.2879640044993,97.20834941012606,6609350884,16112451782.703753,31.8054689220093,16.014670763489907,25.3571585691277,92.85714285714286,21.428571428571427
2021-07-02,356.52,358.97,356.28,358.64,313.2398442444109,330.8522884295982,339.321754702536,347.1333521787299,314.49999999999994,330.5953000000002,337.1888000000002,346.145,346.145,359.1414033486252,333.14859665137476,32727244,75.29855799099079,67.01420102393949,NaN,NaN,NaN,NaN,NaN,NaN,0.9434799158234028,5.828074172503193,4.88459425667979,98.4665427509292,96.75168972837491,6642078128,16137149293.975126,36.59784639831253,14.653313590401817,26.49429461414446,100,14.285714285714286
2021-07-06,359.26,360.48,356.49,360.19,313.7070099733222,331.4332332131705,340.1401172632209,348.3768424474223,314.9493499999999,330.86970000000025,337.6042000000002,347.3245,347.3245,360.9102505865536,333.7387494134464,38842397,76.61341425215102,68.0225806071207,NaN,NaN,NaN,NaN,NaN,NaN,1.0066163314456045,6.142864670986796,5.136248339541192,98.74077290490655,97.83175988677836,6680920525,16170345427.752068,36.693413620705826,13.530105662601729,27.867345537281217,100,7.142857142857143
2021-07-07,362.45,362.76,358.94,360.95,314.17708947607525,332.0177236445929,340.95619109603575,349.57428602385824,315.41974999999996,331.13340000000017,337.9906000000002,348.534,348.534,362.4455123548839,334.6224876451161,35265242,77.25278216313407,69.25066625061478,NaN,NaN,NaN,NaN,77.25278216313407,NaN,0.9950957509662928,6.380118028249058,5.385022277282765,92.07530647985988,96.42754071189854,6716185767,16172191775.50076,38.37744684214002,12.539121788591611,30.84464467045562,100,0
2021-07-08,355.74,359.65,354.42,358.77,314.62080002855214,332.5474716912346,341.65477183736766,350.4500683073003,315.8760499999999,331.35660000000024,338.36300000000017,349.6305,349.6305,363.13331966850575,336.1276803314942,50890021,71.2366791598206,69.68679400602893,NaN,NaN,NaN,NaN,NaN,NaN,0.7474935834149106,6.319389256551403,5.571895673136493,82.35294117647057,91.05634018707902,6665295746,16205956282.741676,33.81767005347939,19.273481821344372,31.593414743100958,92.85714285714286,0
2021-07-09,358.17,361.5,357.57,361.01,315.08238410787004,333.11108611319037,342.413800392765,351.4557760875574,316.3187,331.6113000000002,338.80320000000023,350.6635,350.6635,364.32844972548384,336.99855027451616,35184534,73.51868566890032,70.65267252914144,NaN,NaN,NaN,NaN,NaN,NaN,0.6452701505084084,6.3784833612720035,5.733213210763595,92.26006191950465,88.89610319194503,6700480280,16232367065.26076,34.765497768853564,17.895405999968684,32.673654484906486,85.71428571428571,7.142857142857143
2021-07-12,362.45,362.89,360.83,362.42,315.5534051615231,333.69146064560243,343.19835724010755,352.4999878887424,316.80999999999995,331.89620000000025,339.24720000000013,351.72249999999997,351.72249999999997,365.5835069980545,337.86149300194546,25717677,74.87020592962584,71.56818796738023,NaN,NaN,NaN,NaN,NaN,NaN,0.5850866511260042,6.464571524671101,5.879484873545096,97.5328083989503,90.7152704983085,6726197957,16246349491.590857,36.034526413239696,17.201134435734687,34.519787368900936,100,0
2021-07-13,362.03,365.465,361.54,362.42,316.01973943852283,334.26034261301623,343.9521471522602,353.4447509469574,317.29515,332.1957000000002,339.73580000000015,352.618,352.618,366.8096561401439,338.4263438598561,39723015,74.87020592962584,72.23119519475802,NaN,NaN,NaN,NaN,NaN,NaN,0.4630914493020999,6.458349185172722,5.995257735870622,83.61581920903976,91.13622984249822,6726197957,16224438580.132257,38.21494262788143,15.932791162686588,36.02080363945178,100,0
2021-07-14,364.83,365.49,362.22,363.07,316.4879012351544,334.830830878105,344.7018668717794,354.3614413329615,317.75269999999995,332.51620000000025,340.2734000000002,353.6585,353.6585,367.7106802934668,339.6063197065332,35336350,75.53769477983303,72.92888946199535,NaN,NaN,NaN,NaN,NaN,NaN,0.34917506234140916,6.431726563797383,6.082551501455974,85.4654654654654,88.87136435781849,6761534307,16207472809.64296,35.89109209738311,14.944139272439863,37.34009504244341,100,0
2021-07-15,362.98,363.19,358.46,360.52,316.926031571123,335.33952729636036,345.3221858179841,354.94797072982226,318.16929999999996,332.8970000000003,340.8810000000002,354.634,354.634,367.71362140124836,341.55437859875167,53391557,67.91620291723908,72.91801198413465,NaN,NaN,NaN,NaN,NaN,NaN,0.041281640452263346,6.134153552021303,6.0928719115690395,70.15015015015005,79.7438116082184,6708142750,16200587217.725412,32.72761983734006,20.633497114315777,36.83321626153706,92.85714285714286,7.142857142857143
2021-07-16,361.4,362.41,357.24,357.6,317.33074767489296,335.7803287360364,345.80366872708277,355.20054494602965,318.57755,333.2582000000002,341.4524000000002,355.247,355.247,367.6589766354943,342.83502336450573,47261961,60.40089173377912,72.43964300581196,NaN,NaN,NaN,NaN,NaN,NaN,-0.3957591718467528,5.598172946760599,5.9939321186073515,46.58090724441438,67.39884095334328,6660880789,16159907193.266998,29.65127628113191,20.912125429876376,36.05840728856557,85.71428571428571,0
2021-07-19,354.05,355.18,352.04,354.67,317.702282523899,336.1543816323525,346.15136799268737,355.1500168559316,318.9617,333.56360000000024,341.9156000000002,355.84900000000005,355.84900000000005,366.8415609391026,344.8564390608975,64404625,53.949804717015915,71.19084047272732,NaN,NaN,53.949804717015915,NaN,NaN,NaN,-0.8905728263292563,4.880716085695781,5.771288912025037,19.55390334572489,45.42832024676312,6596476164,16203390570.655533,26.7401975215942,28.041070518148615,33.6348723747425,78.57142857142857,0
2021-07-20,355.63,360.28,353.8,358.79,318.11111553361144,336.6026116990386,346.6470006204251,355.4966819172715,319.3444,334.0232000000003,342.4074000000002,356.57050000000004,356.57050000000004,366.2702226248957,346.87077737510435,42183702,60.36084132561417,70.31634451858572,NaN,NaN,NaN,NaN,NaN,NaN,-0.9437141041074781,4.591646281890689,5.5353603859981675,50.185873605948,38.77356139869576,6638659866,16226174977.599977,32.44088872516076,24.964806120569616,31.77279672132366,71.42857142857143,92.85714285714286
2021-07-21,358.35,361.56,358.12,361.56,318.54344274223223,337.09681740796856,347.2318241255065,356.0741407822932,319.78065000000004,334.49740000000025,343.1234000000002,357.2700000000001,357.2700000000001,366.2647006620449,348.2752993379553,30259860,63.9906163260169,69.79935771781703,NaN,NaN,NaN,NaN,NaN,NaN,-0.8012408700072742,4.533809298489075,5.335050168496349,70.78066914498133,46.84014869888475,6668919726,16256434837.599977,32.72230731128413,23.491452290550804,30.116895691096083,64.28571428571429,85.71428571428571
2021-07-22,361.77,363.96,361.77,363.95,318.99524928211054,337.62856359790976,347.88743886568267,356.824222612551,320.19960000000003,334.9010000000003,343.8962000000002,358.08050000000003,358.08050000000003,366.3893686955542,349.77163130444586,30252240,66.81425824998419,69.47363151026649,NaN,NaN,NaN,NaN,NaN,NaN,-0.5660534541354858,4.627483350826992,5.193536804962478,88.55018587360578,69.83890954151171,6699171966,16286410801.435595,35.57887579689409,22.49402001229355,29.367649120766174,57.142857142857146,78.57142857142857
2021-07-23,365.31,368.485,363.9157,368.2,319.4848487917413,338.23393857616895,348.68400989055783,357.9076299827843,320.6648,335.3990000000003,344.9224000000002,358.99600000000004,358.99600000000004,367.5252869573007,350.4667130426994,31960799,71.14698106910608,69.17709030156043,NaN,NaN,NaN,NaN,NaN,NaN,-0.16509249324661912,4.987171188404204,5.152263681650823,98.26695044086333,85.86593515315015,6731132765,16314384631.878048,40.66032467286106,20.692612416562987,28.633936168710388,100,71.42857142857143
2021-07-26,367.49,368.89,366.601,368.49,319.9724622365996,338.8330685053537,349.4607153850458,358.91547474632864,321.10765000000004,335.99230000000034,345.90540000000016,359.9475000000001,359.9475000000001,368.2521658572058,351.6428341427944,28438126,71.42116853378494,68.80621560739142,NaN,NaN,NaN,NaN,71.42116853378494,NaN,0.0664114084343499,5.235277942193761,5.168866533759411,97.62611275964404,94.81441635803772,6759570891,16332883701.172064,39.70914877661958,19.835630372451348,27.72360139881584,100,64.28571428571429
2021-07-27,368.22,368.22,360.16,364.43,320.4148257964344,339.3399384359408,350.04774615425964,359.44066762763066,321.52275000000003,336.5956000000003,346.6662000000002,360.48350000000005,360.48350000000005,368.4869724338862,352.4800275661139,57933148,62.47070619371325,67.75035303814708,NaN,NaN,NaN,NaN,NaN,NaN,-0.09819111137595549,5.046127644539467,5.144318755915423,73.53115727002974,89.80807349017904,6701637743,16336333814.20432,34.16404611861157,27.86332633658469,24.82442765948769,92.85714285714286,57.142857142857146
2021-07-28,365.6,367.45,363.24,365.83,320.8667180770669,339.8644941104766,350.66665806977886,360.04917547261823,321.92335,337.1671000000003,347.4946000000002,361.0255000000001,361.0255000000001,368.93510296095434,353.1158970390458,42066195,64.13956926736931,67.2434166172577,NaN,NaN,NaN,NaN,NaN,NaN,-0.1537684843898557,4.952108150428103,5.1058766348179585,81.83976261127592,84.3323442136499,6743703938,16346026025.403845,31.750831774434175,25.895170148102338,23.593228858725727,85.71428571428571,50
2021-07-29,365.25,367.6794,365.25,366.48,321.3205815787876,340.3915338310612,351.286789125866,360.6616349514165,322.28310000000005,337.83250000000027,348.37980000000016,361.62800000000004,361.62800000000004,369.2673706547097,353.9886293452904,25672533,64.91955280806881,66.62919284148403,NaN,NaN,NaN,NaN,NaN,NaN,-0.18561032821240708,4.87386372455245,5.059474052764857,85.69732937685475,80.35608308605349,6769376471,16346349388.995596,30.812762722959143,24.806266102121498,22.076373877516886,78.57142857142857,42.857142857142854
2021-07-30,362.44,365.17,362.41,364.57,321.75092405064044,340.87031533935703,351.8076993562242,361.03386019413875,322.63335,338.36050000000034,349.2194000000002,362.12800000000004,362.12800000000004,369.13713575270907,355.118864247291,36484649,60.73892295823526,65.6198154863847,NaN,NaN,60.73892295823526,NaN,NaN,NaN,-0.3638561759921588,4.604653832774659,4.968510008766818,74.36201780415429,80.63303659742833,6732891822,16366971147.12603,28.639945964536338,27.977589226157164,19.632979625370275,71.42857142857143,35.714285714285715
2021-08-02,366.28,366.88,363.87,364.6,322.1772830153107,341.34021008511235,352.30935820499974,361.3734925566017,322.99605,338.89770000000027,349.93480000000017,362.4260000000001,362.4260000000001,369.3224988218528,355.5295011781474,27334097,60.78164265563266,64.61348953824232,NaN,NaN,NaN,NaN,NaN,NaN,-0.4998857056256307,4.3436528767347795,4.84353858236041,74.54005934718117,78.19980217606341,6760225919,16352895449.335333,30.13795954839435,26.489843780472118,17.15380866791441,64.28571428571429,28.571428571428573
2021-08-03,365.28,366.93,362,366.81,322.62138965197425,341.84456236065466,352.8780108244115,361.8912551702587,323.37960000000004,339.3854000000003,350.73080000000016,362.7570000000001,362.7570000000001,369.82576255081216,355.6882374491881,35558511,63.89803746224724,63.78208544412905,NaN,NaN,NaN,NaN,NaN,NaN,-0.4620621244273142,4.265960926826267,4.728023051253581,87.65578635014843,78.8526211671613,6795784430,16386722917.203487,27.553551787545693,27.470955391457547,14.221274855030776,57.142857142857146,21.428571428571427
2021-08-04,366.77,368.32,365.63,367.34,323.06635094896956,342.3494225119288,353.4451476548267,362.4101832492817,323.77375000000006,339.90420000000034,351.4274000000002,363.0765000000001,363.0765000000001,370.3639420066168,355.78905799338344,29602236,64.62404237071999,63.5469311193777,NaN,NaN,NaN,NaN,NaN,NaN,-0.4234140982476404,4.198755428444031,4.622169526691671,90.8011869436201,84.3323442136499,6825386666,16394756237.753674,28.710601156101507,26.15312122822268,12.935334896466788,50,14.285714285714286
2021-08-05,368.18,369.91,367.45,369.67,323.53006884997484,342.8904240463461,354.0814163742453,363.10159436839774,324.2031,340.41260000000034,352.1614000000002,363.6215000000001,363.6215000000001,371.1649985914956,356.0780014085046,21443925,67.69932528087395,64.06824780131305,NaN,NaN,NaN,NaN,67.69932528087395,NaN,-0.2704384780713607,4.28412142910247,4.5545599071738305,98.65696698377164,92.37131342584674,6846830591,16412015982.26587,30.270173997321955,24.922986694814302,12.39280516895431,100,7.142857142857143
2021-08-06,368.37,369.37,366.905,368.05,323.9730532395273,343.3886334711709,354.62920396741214,363.572871095217,324.6213,340.8873000000003,352.8398000000002,363.9735000000001,363.9735000000001,371.6525032556126,356.29449674438763,33332107,63.562013115382896,64.75483411548213,NaN,NaN,NaN,NaN,NaN,NaN,-0.3052871597456077,4.172950957491821,4.478238117237429,88.45437616387329,92.6375100304217,6813498484,16409649605.501163,28.705783448151788,24.653609306361975,12.765622909788016,92.85714285714286,0
2021-08-09,368.52,369.27,367.39,368.73,324.4183959933629,343.8904427093656,355.18217636084694,364.0640262290059,325.04400000000004,341.3556000000003,353.5568000000001,364.2890000000001,364.2890000000001,372.201718622564,356.3762813774362,25960245,64.5415752071825,65.05345796416557,NaN,NaN,NaN,NaN,NaN,NaN,-0.3085572116093349,4.09254160272576,4.401098814335095,89.99151823579301,92.36762046114599,6839458729,16420696518.267122,27.65909918422931,23.754677390552402,12.377828184672868,85.71428571428571,0
2021-08-10,369.26,369.56,365.62,366.84,324.8405015058667,344.344889388388,355.63934591532353,364.3284046833863,325.45730000000003,341.9036000000003,354.2150000000002,364.5100000000001,364.5100000000001,372.4484280559688,356.5715719440314,35130796,59.7349150243155,64.74947929975833,NaN,NaN,NaN,NaN,NaN,NaN,-0.45517110027679575,3.8321349389890997,4.2873060392658955,68.51282051282,82.31957163749546,6804327933,16407321849.739202,25.5559889432736,25.36431478178699,11.231787568425187,78.57142857142857,0
2021-08-11,368.14,368.65,364.84,366.21,325.2521383068034,344.7778618757467,356.05388136962455,364.5076042373495,325.86465000000004,342.4343000000003,354.8828000000002,364.6670000000001,364.6670000000001,372.6095011173995,356.7244988826007,34249812,58.17953145374181,64.13271310002673,NaN,NaN,NaN,NaN,NaN,NaN,-0.6024967030899422,3.5341851604034673,4.1366818634934095,62.05128205128158,73.51854026663155,6770078121,16397703136.132904,23.680844890252335,25.005378637552354,9.816699977634906,71.42857142857143,21.428571428571427
2021-08-12,365.69,367.9,364.295,367.53,325.6728135475317,345.22839926434574,356.5039252374824,364.79545145284,326.29995,342.92350000000033,355.56400000000025,365.01750000000004,365.01750000000004,372.8144067584607,357.2205932415394,26003877,60.500245942400994,63.3722320195478,NaN,NaN,NaN,NaN,NaN,NaN,-0.616727686694527,3.3657722551252505,3.9824999418197775,75.58974358974305,68.71794871794822,6796081998,16418369185.3992,22.033479251893056,24.317552417097495,7.843994396897619,64.28571428571429,14.285714285714286
2021-08-13,367.89,369.16,367.38,368.82,326.1021387858647,345.69555967495273,356.98690856150273,365.17874179066473,326.73075,343.43950000000035,356.3404000000002,365.5785,365.5785,372.74933056558166,358.4076694344184,19336190,62.67984551794731,62.747851804130825,NaN,NaN,NaN,NaN,NaN,NaN,-0.5473004125396721,3.2983744261451875,3.8456748386848596,88.82051282051249,75.48717948717905,6815418188,16430318516.298077,23.772557233022095,23.450116826545592,5.508784072629134,57.142857142857146,7.142857142857143
2021-08-16,367.67,369.02,363.7,368.98,326.52878417108,346.1566377011913,357.45722587281637,365.54076638203,327.21745,344.01060000000035,357.00800000000027,366.29400000000004,366.29400000000004,371.57491052756603,361.01308947243405,35044107,62.95290136486732,62.782294316356115,NaN,NaN,NaN,NaN,NaN,NaN,-0.4999438073516349,3.220745079495316,3.720688886846951,88.24273072060677,84.21766237695411,6850462295,16464835644.245445,21.324242214375662,28.15906987676407,5.769814258803133,50,0
2021-08-17,366.15,367.15,363.23,365.73,326.918846020124,346.54422903384096,357.7816483876079,365.55878863136047,327.66414999999995,344.5546000000003,357.5906000000003,366.641,366.641,370.66691554805493,362.6150844519451,44793902,54.267396014901486,62.07713908403698,NaN,NaN,NaN,NaN,NaN,NaN,-0.6853819419421887,2.8639614594192153,3.549343401361404,47.15549936788883,74.73958096966938,6805668393,16477176821.327078,19.041609931381874,26.019778655545455,6.150382062849202,42.857142857142854,28.571428571428573
2021-08-18,365.18,366.62,361.865,362.21,327.2700017811178,346.85444232029954,357.9553092351527,365.2398563807547,328.1283,345.01670000000036,358.09960000000024,366.6735,366.6735,370.54224798871104,362.80475201128894,38541940,46.74496570660866,60.77895429107554,NaN,NaN,46.74496570660866,NaN,NaN,NaN,-1.0226789811516985,2.2709946749217806,3.293673656073479,4.288377874455808,46.562202654317154,6767126453,16444227718.04632,17.384358587604513,26.25362332925879,6.830759860308808,35.714285714285715,100
2021-08-19,360.22,365.68,359.96,363.96,327.6350763902609,347.19316623474907,358.1907873043624,365.1179652968733,328.5982,345.4972000000003,358.6420000000003,366.67400000000004,366.67400000000004,370.54134223983385,362.8066577601662,48499368,50.42429105246842,60.04219486923506,NaN,NaN,NaN,NaN,NaN,NaN,-1.098826591044348,1.920140417268044,3.018967008312392,40.20100502512545,30.548294089156695,6815625821,16463559633.962404,15.622884975362341,26.968023995997136,8.649873227717018,28.571428571428573,100
2021-08-20,365.06,368.14,364.74,367.73,328.03403085403943,347.5998362102986,358.56487407674035,365.3667305066949,329.0636,346.03130000000033,359.1896000000002,366.6505,366.6505,370.4860467667823,362.81495323321775,39486034,57.27285320104563,59.791567051050265,NaN,NaN,NaN,NaN,NaN,NaN,-0.8758828854254981,1.9241134015305192,2.7999962869560173,78.09045226130657,40.859945053629275,6855111855,16493522565.644758,18.815421216354274,24.976379200461626,9.194621673752994,21.428571428571427,92.85714285714286
2021-08-23,368.8,373.935,368.79,373.23,328.48374198982015,348.10736420613426,359.1399770541231,366.11561331558113,329.49520000000007,346.5723000000003,359.82940000000025,366.8875,366.8875,371.62753744713405,362.14746255286593,34034744,64.89252240827435,59.8626016900522,NaN,NaN,NaN,NaN,NaN,NaN,-0.36476074237786005,2.344045358983692,2.708806101361552,94.9552772808588,71.08224485576359,6889146599,16518230003.708899,26.690441788518733,22.33897773860585,9.817843233381469,100,85.71428571428571
2021-08-24,373.84,374.99,373.36,374.37,328.94032167151346,348.6274164000722,359.73723285592223,366.9017453807639,329.8951,347.0703000000004,360.4266000000002,367.3845,367.3845,372.9942788726768,361.77472112732323,21732913,66.23654316270402,59.97778031805107,NaN,NaN,NaN,NaN,NaN,NaN,0.02277854424857617,2.737279281672272,2.714500737423696,95.87491683300064,89.64021545838868,6910879512,16523429903.138346,27.729506523188864,21.64094070598658,10.36576437635926,100,78.57142857142857
2021-08-25,374.63,375.39,373.855,374.8,329.3966368787621,349.145685382249,360.32792960667035,367.6539601064054,330.29605000000004,347.5078000000004,361.0774000000002,367.833,367.833,374.25013674469653,361.4158632553035,20441880,66.75355425256726,59.91022524460059,NaN,NaN,NaN,NaN,NaN,NaN,0.2671805826642375,3.0484764657539927,2.781295883089755,96.17627997407664,95.66882469597869,6931321392,16528157504.050398,27.681865979420145,21.02390685912749,10.6501657823611,100,71.42857142857143
2021-08-26,373.92,374.62,371.97,372.42,329.82473004414754,349.60656289943216,360.8021284456245,368.10786866770013,330.71520000000004,347.9238000000003,361.7056000000002,368.13,368.13,374.81347215151686,361.44652784848313,29133325,61.17030773217196,59.739389145799805,NaN,NaN,NaN,NaN,NaN,NaN,0.22911841430108026,3.0676939009661055,2.8385754866650252,80.75178224238516,90.93432634982082,6902188067,16508918515.84285,26.19874661261369,23.46616692933779,10.500731251990297,92.85714285714286,64.28571428571429
2021-08-27,373.07,376.56,372.57,376.04,330.28458347654407,350.1299972974632,361.39969203599213,368.86330974696676,331.17830000000004,348.36800000000034,362.3196000000002,368.7035,368.7035,376.0063823761693,361.4006176238307,27104749,65.84907248665337,59.832781808619146,NaN,NaN,NaN,NaN,NaN,NaN,0.3983922108242579,3.336565750195348,2.93817353937109,96.86746987951818,91.26517736532666,6929292816,16528958367.860394,27.806952272853813,21.639627258699864,10.849201758261142,100,57.142857142857146
2021-08-30,376.85,380.76,376.83,380.26,330.78185130264814,350.7266310143451,362.1393119561493,369.9487088186842,331.6308,348.8198000000004,363.07220000000024,369.48650000000004,369.48650000000004,378.1017499093199,360.8712500906802,27295665,70.33632741936799,60.59002555112289,NaN,NaN,NaN,NaN,NaN,NaN,0.7261291431033237,3.8458349682502444,3.1197058251469207,97.59615384615385,91.73846865601907,6956588481,16549308571.028332,33.143441819613464,19.75196774211595,12.630664099795608,100,50
2021-08-31,380.51,380.579,378.36,379.95,331.27108661306954,351.3053115883185,362.83777031081013,370.9012127407143,332.08854999999994,349.24820000000034,363.7840000000002,370.1435,370.1435,379.7850855024006,360.50191449759944,29628175,69.61272369570113,61.40668213983428,NaN,NaN,NaN,NaN,NaN,NaN,0.845258175091387,4.176278544011154,3.3310203689197673,96.10576923076923,96.85646431881374,6926960306,16562139880.706114,31.741588636674408,18.916527687359512,14.244688476075028,92.85714285714286,42.857142857142854
2021-09-01,381.04,382.71,380.37,380.58,331.76172256716836,351.8850083885498,363.5335440241117,371.8230020035034,332.5368,349.68730000000033,364.4442000000002,370.80550000000005,370.80550000000005,381.36103783566176,360.24996216433834,28138311,70.28184745575885,62.10536796221698,NaN,NaN,NaN,NaN,NaN,NaN,0.8854529655049297,4.4378365758009295,3.552383610296,90.63736263736266,94.77976190476191,6955098617,16539052035.783037,34.179507079115204,17.902267383580636,16.125078734936597,100,35.714285714285715
2021-09-02,381.97,382.31,379.15,380.4,332.24568552669905,352.44966168778643,364.19497367022495,372.6398589555507,332.9728,350.08530000000036,365.0974000000002,371.34200000000004,371.34200000000004,382.6743017961877,360.0096982038124,25503535,69.80886839562154,62.61458388205086,NaN,NaN,NaN,NaN,NaN,NaN,0.8203557910682586,4.577828349131323,3.7574725580630646,89.84615384615384,92.19642857142857,6929595082,16533725348.093164,32.06000302837184,19.186224624954654,17.87069361190331,92.85714285714286,28.571428571428573
2021-09-03,379.22,381.98,379.2003,381.57,332.73647472543837,353.0263020504045,364.87634725178475,373.49034857883163,333.4193,350.5359000000003,365.7310000000002,372.0180000000001,372.0180000000001,384.07404014590793,359.96195985409224,24624937,71.16713368775275,63.20131476225697,NaN,NaN,NaN,NaN,NaN,NaN,0.776960243724937,4.728672862719236,3.951712618994299,94.98901098901105,91.82417582417584,6954220019,16551086030.554905,30.281164389317077,18.121683312520894,18.678481291035677,85.71428571428571,21.428571428571427
2021-09-07,381.68,382.778,380.4882,382.11,333.22775358389174,353.6022168612876,365.5521767713226,374.3112677618,333.8793,350.94090000000034,366.38400000000024,372.68700000000007,372.68700000000007,385.40570134879187,359.9682986512083,23970203,71.79777322359911,64.45348456287823,NaN,NaN,NaN,NaN,71.79777322359911,NaN,0.7074657443492871,4.836044799430908,4.128579055081621,97.07248663335962,93.96921715617482,6978190222,16561070649.133558,30.495510224181803,17.271547047530493,19.549792610291952,100,14.285714285714286
2021-09-08,381.93,381.93,378.45,380.78,333.70091026464905,354.1403907848265,366.1493463097021,374.92733749877146,334.32129999999995,351.3286000000004,366.92540000000025,373.38400000000007,373.38400000000007,386.2713572154981,360.49664278450206,32949159,67.86086465256707,65.96176305901811,NaN,NaN,NaN,NaN,NaN,NaN,0.5043044550759488,4.7589596239265575,4.254655168850609,91.24375493031796,94.43508418422954,6945241063,16572243065.116316,28.21691222836057,20.14203019047987,19.290732657412804,92.85714285714286,7.142857142857143
2021-09-09,381.01,382.15,379.22,379.47,334.1563240928615,354.6419672049289,366.6717248857922,375.359972022698,334.76674999999994,351.7345000000003,367.4150000000002,374.0470000000001,374.0470000000001,386.7529168893762,361.34108311062397,29398978,64.13080819585412,66.94079999783138,NaN,NaN,NaN,NaN,NaN,NaN,0.22814040335560648,4.539830673045117,4.31169026968951,81.66093801973616,89.99239319447126,6915842085,16547860977.560001,26.963663733322473,18.923056554650135,18.63968023274925,85.71428571428571,0
2021-09-10,381.23,381.97,376.245,376.59,334.5785497237783,355.0765817157224,367.06067685105523,375.4771175443458,335.1977499999999,352.13630000000035,367.85820000000024,374.5000000000001,374.5000000000001,386.886226221079,362.1137737789212,40249405,56.74603121317931,66.90316985584091,NaN,NaN,NaN,NaN,NaN,NaN,-0.18001709995847115,4.086668894741422,4.266685994699893,55.7620817843863,76.22225824481347,6875592680,16512462592.551268,23.917834935617222,22.655498235491077,17.828371677026734,78.57142857142857,0
2021-09-13,378.99,379.43,374.22,376.33,334.99398703995956,355.49744148372787,367.4241797196413,375.55834444488426,335.60704999999996,352.50670000000036,368.29340000000025,374.8755000000001,374.8755000000001,387.00282035529114,362.74817964470907,48741781,56.11777519164377,66.27640219751017,NaN,NaN,NaN,NaN,NaN,NaN,-0.48189667623453936,3.6643151494067183,4.146211825641258,40.34048852701665,59.254502777046376,6826850899,16503200718.618446,21.533891125718775,24.27139073023841,17.621312672401096,71.42857142857143,0
2021-09-14,377.86,378.61,374.28,375.26,335.3946438853331,355.8887792761293,367.73146678945926,375.5299306882286,336.0019499999999,352.9073000000003,368.62580000000025,375.18950000000007,375.18950000000007,387.01133145709554,363.3676685429046,41826624,53.49299353384745,65.36614865259183,NaN,NaN,NaN,NaN,NaN,NaN,-0.7519322482575133,3.206296515319366,3.958228763576879,30.440414507771706,42.18099493972489,6785024275,16480307162.29512,19.770209172307638,22.283500405856408,17.167310848214928,64.28571428571429,14.285714285714286
2021-09-15,375.73,378.41,373.37,378.05,335.81907528945914,356.3276153300673,368.13611515065696,375.7699372893497,336.39714999999995,353.2936000000003,368.98300000000023,375.8055000000001,375.8055000000001,386.8498623174801,364.76113768252014,34097865,58.89211369622456,64.80461718428164,NaN,NaN,NaN,NaN,NaN,NaN,-0.7398029164072875,3.03347511806777,3.7732780344750574,56.254626202812624,42.34517641253367,6819122140,16509533903.723692,17.92946892772945,21.88985013286343,16.901319792009854,57.142857142857146,7.142857142857143
2021-09-16,376.68,378.9,374.695,378.31,336.24187056021077,356.76291007600656,368.53509102710177,376.0118480236973,336.7906,353.6604000000003,369.33020000000016,376.6105000000001,376.6105000000001,385.75778478838697,367.46321521161326,35193083,59.36554058628623,64.6757052452898,NaN,NaN,NaN,NaN,NaN,NaN,-0.7112264578356888,2.8842449621804462,3.595471420016135,56.23040752351091,47.64181607803175,6854315223,16534851163.194561,17.44491821641372,20.199983592234748,17.031071879760507,50,0
2021-09-17,377.82,377.87,372.76,373.83,336.6158817984176,357.1008722527193,368.74273451623503,375.8040529738214,337.14244999999994,353.99720000000036,369.6314000000002,377.1040000000001,377.1040000000001,384.33157608052187,369.8764239194783,60912267,48.912612071035575,63.465958072745686,NaN,NaN,NaN,NaN,NaN,NaN,-0.9747139815796086,2.3770789430416244,3.351792924621233,10.680774605709624,41.05526944401105,6793402956,16499448143.039963,15.719980965905329,21.650033381384333,17.273627218937715,42.857142857142854,0
2021-09-20,367.46,369.25,360.93,365.7,336.9052760093786,357.27115201009116,368.62341159402973,374.8417622144098,337.4516999999999,354.26420000000036,369.7252000000002,377.0025000000001,377.0025000000001,384.78918832044246,369.21581167955776,76203202,36.39025963477333,61.041238945274635,NaN,NaN,36.39025963477333,NaN,NaN,NaN,-1.638162002438273,1.3040904215733917,2.9422524240116648,21.832662028560872,29.581281385927138,6717199754,16510622170.25631,12.601126296978649,35.54906989663801,18.86949819721899,35.714285714285715,100
2021-09-21,367.58,368.81,364.99,366.15,337.1962682878923,357.44697078216853,368.5264150609305,374.01397533684695,337.7610499999999,354.52350000000035,369.7998000000002,376.6485000000001,376.6485000000001,385.63962067540353,367.6573793245967,41927483,37.346391532427624,58.73650093361224,NaN,NaN,NaN,NaN,NaN,NaN,-1.9662292146914822,0.48446590564731196,2.450695120338794,23.89234712559487,18.801927919955123,6759127237,16494158498.92123,11.851288986077188,33.43370192490882,20.46536917550026,28.571428571428573,92.85714285714286
2021-09-22,367.09,371.07,365.9584,369.57,337.51839497159483,357.68703076668004,368.56733996050184,373.59073959048055,338.0812999999999,354.8393000000004,369.94280000000015,376.4085000000001,376.4085000000001,385.87383522912717,366.94316477087307,46972920,44.20994820939042,56.8742224160145,NaN,NaN,NaN,NaN,NaN,NaN,-1.8728685124990772,0.10960947971494761,1.9824779922140248,39.54595386305374,28.423654339069827,6806100157,16513562994.16186,14.407163582044083,30.79317648983083,20.82242150138141,21.428571428571427,85.71428571428571
2021-09-23,370.76,374.04,370.099,372.98,337.8712467629222,357.98986184060715,368.74038545224687,373.5325739151967,338.40994999999987,355.2072000000003,370.1410000000002,376.3175000000001,376.3175000000001,385.87746417355964,366.7575358264406,44652002,50.0817990732094,55.4651460358422,NaN,NaN,NaN,NaN,NaN,NaN,-1.5166286106836386,0.08669222885947647,1.603320839543115,55.15378982057856,39.53069693640906,6850752159,16534195142.25676,18.00951851519396,28.6614138619673,20.65827772013925,14.285714285714286,78.57142857142857
2021-09-24,370.65,373.76,370.27,373.33,338.22407017821655,358.29362695267434,368.9203703364725,373.5132811613684,338.73514999999986,355.6391000000003,370.3972000000002,376.3630000000001,376.3630000000001,385.85676447989374,366.8692355201065,36056800,50.65585241797161,54.00005451657212,NaN,NaN,NaN,NaN,50.65585241797161,NaN,-1.2061211515684014,0.09566940008261327,1.3017905516510146,56.75576711827156,50.48517026730129,6886808959,16561366885.523235,17.018874163919996,27.084843798868224,20.49413393889709,7.142857142857143,71.42857142857143
2021-09-27,370.2,371.2516,367.73,370.35,338.54373117146815,358.53236701301745,368.97643424484613,373.2120162888571,339.0803499999999,356.05230000000034,370.65220000000016,376.0785000000001,376.0785000000001,385.92828025134725,366.2287197486529,43338079,45.82394398652979,52.144780999638606,NaN,NaN,NaN,NaN,NaN,NaN,-1.1503190420842924,-0.13610825095435075,1.0142107911299416,44.39208294062219,52.10054662649077,6843470880,16582514135.339684,15.541607537465737,28.670909794032895,20.63782105382945,0,64.28571428571429
2021-09-28,365.67,370.302,359.35,359.87,338.75593285135403,358.5588547949379,368.6193191764208,371.94134807087073,339.36709999999994,356.3359000000003,370.75620000000015,375.0590000000001,375.0590000000001,386.9714622139966,363.1465377860036,97701632,33.66291157825205,49.70207006575896,NaN,NaN,NaN,NaN,NaN,NaN,-1.7330972189240705,-1.1521607325251466,0.5809364863989239,2.28070175438589,34.47618393775988,6745769248,16494090233.186287,13.130584032175967,36.04144187087738,22.77321183372573,7.142857142857143,100
2021-09-29,361.17,363.37,358.635,359.28,338.9601524249724,358.5731348980084,368.25307136558075,370.73550539745446,339.6542499999999,356.58670000000035,370.7660000000002,374.0255000000001,374.0255000000001,387.540131293524,360.5108687064762,58076621,33.12985545818846,47.48771629878284,NaN,NaN,NaN,NaN,NaN,NaN,-2.0504681785623333,-1.9821487368039925,0.0683194417583406,2.7640882794085315,16.478957658138874,6687692627,16451835965.109201,12.2496542004117,34.636503465291845,24.932105700284094,0,100
2021-09-30,360.97,362.68,357.1,357.96,339.14920563467416,358.5609936128993,367.849421508107,369.51879059769686,339.92384999999996,356.9087000000003,370.6940000000002,372.8945000000001,372.8945000000001,387.745640663253,358.0433593367472,61384577,31.91230752198892,45.71387889226925,NaN,NaN,NaN,NaN,NaN,NaN,-2.226763388956914,-2.7151347944378017,-0.488371405480888,3.8513210927002124,2.9653703754982157,6626308050,16409372798.940742,11.288501342343293,34.07725027255735,28.326602034795346,0,100
2021-10-01,358.6,361.25,354.38,360.18,339.35846727015,358.5930531453172,367.5486598803381,368.62938196934476,340.18829999999997,357.25740000000036,370.61860000000013,371.8835000000001,371.8835000000001,387.2956085838355,356.4713914161647,56375488,36.16155985126092,44.288434939384764,NaN,NaN,NaN,NaN,NaN,NaN,-2.0744035924681743,-3.081375896066106,-1.0069723035979317,23.654159869494354,10.089856413867704,6682683538,16448187363.458939,10.224775666013507,34.5969507200546,31.783703606454672,0,100
2021-10-04,358.52,358.86,350.32,352.62,339.49042281970077,358.4747748652119,366.96322223797193,367.10467892464527,340.40649999999994,357.6147000000003,370.30700000000013,370.4360000000001,370.4360000000001,387.3061777109691,353.5658222890311,76766005,29.426568649100574,42.56940459047427,NaN,NaN,29.426568649100574,NaN,NaN,NaN,-2.3434449238059205,-3.936278458355332,-1.5928335345494116,8.04758572428276,11.851022228825778,6605917533,16412770728.833647,8.924900627831418,35.43340463544946,35.625387358352135,14.285714285714286,100
2021-10-05,353.71,359.69,353.48,357.38,339.66842856278834,358.4530961550097,366.5874096011887,366.17851902706,340.6384,357.9951000000003,370.0848000000001,369.19950000000006,369.19950000000006,386.09099309563373,352.3080069043664,47232904,37.339761680908154,41.02995087509453,NaN,NaN,NaN,NaN,NaN,NaN,-2.070933923765234,-4.181500939255955,-2.1105670154907203,24.70258922323305,18.801444939003392,6653150437,16424864177.683887,9.176529350065204,32.26588988965905,38.89456146720653,7.142857142857143,92.85714285714286
2021-10-06,354.08,359.95,353.15,359.67,339.86744917410385,358.4771932608511,366.3161386364362,365.55866007210193,340.88644999999997,358.3279000000003,369.98960000000005,368.14400000000006,368.14400000000006,384.6426937664727,351.64530623352744,56806536,40.78002705061011,39.702414193974796,NaN,NaN,NaN,NaN,NaN,NaN,-1.6261834432643547,-4.143296319571164,-2.517112876306809,33.93829401088936,22.22948965280173,6709956973,16476992528.366241,8.39885130829376,29.942740530985496,42.385331683432575,0,85.71428571428571
2021-10-07,362.8,365.69,362.25,362.97,340.0973253017247,358.56615973093324,366.18491751343873,365.31212101761605,341.1566999999999,358.71350000000035,369.93240000000003,367.3190000000001,367.3190000000001,383.1045248883212,351.53347511167897,39411172,45.42967017920003,39.45363263027226,NaN,NaN,NaN,NaN,NaN,NaN,-1.028628906881365,-3.802899009908515,-2.77427010302715,53.33052276559874,37.323801999907054,6749368145,16454079056.273218,14.898937943937266,27.70432259976716,43.39881811857857,0,78.57142857142857
2021-10-08,364.08,364.3166,360.61,361.16,340.3069041544439,358.6175229045781,365.98786192467645,364.91668092070023,341.41369999999995,359.1029000000003,369.8260000000001,366.54750000000007,366.54750000000007,381.94874394326035,351.1462560567398,41822309,43.416167469148,39.95548318987045,NaN,NaN,NaN,NaN,NaN,NaN,-0.6903883535464153,-3.637255544960169,-2.946867191413754,45.699831365936,44.32288271414137,6707545836,16424668267.237606,14.195286312084027,28.485529704422714,42.386144418339555,21.428571428571427,71.42857142857143
2021-10-11,359.58,363.2,358.3,358.39,340.4868354563897,358.61301750052706,365.6899065550813,364.2950922615859,341.6646499999999,359.4609000000003,369.70240000000007,365.6505000000001,365.6505000000001,380.7551144935818,350.54588550641836,34847182,40.46066371807574,40.17793120313103,NaN,NaN,NaN,NaN,NaN,NaN,-0.5921033323172007,-3.686996356810255,-3.094893024493054,34.021922428330456,44.350758853288404,6672698654,16391101185.80087,13.300970788004848,29.660957744350075,41.701938022915996,14.285714285714286,64.28571428571429
2021-10-12,359.88,360.33,356.48,357.14,340.6525385861769,358.5838488371503,365.35461610194085,363.61365490333964,341.9025499999999,359.7440000000003,369.55320000000006,364.74450000000013,364.74450000000013,379.606641803915,349.88235819608525,43905101,39.164997713617566,39.81757759629011,NaN,NaN,NaN,NaN,NaN,NaN,-0.5510176808543688,-3.783665125561015,-3.2326474447066462,28.75210792580095,36.15795390668914,6628793553,16362249262.286585,12.627802385168351,30.55229770392912,42.077583808548674,7.142857142857143,57.142857142857146
2021-10-13,359.51,360.69,357.43,360,340.84505064004577,358.6118914344344,365.1446311567667,363.26949729349775,342.1391499999999,360.07390000000026,369.41700000000003,363.8420000000001,363.8420000000001,377.50655356020854,350.17744643979165,40120795,43.6140894708694,39.35559833898011,NaN,NaN,NaN,NaN,NaN,NaN,-0.28439078492104697,-3.588135925857955,-3.303745140936908,41.296928327645084,34.69031956059217,6668914348,16385386407.869408,12.508797271963504,29.090318591796095,43.29450306752836,0,50
2021-10-14,363.69,366.85,363.01,366.63,341.10161730034383,358.7706658614753,365.2028809153249,363.5895451703075,342.4074999999999,360.41510000000034,369.40280000000007,363.2580000000001,363.2580000000001,375.3014955058672,351.214504494133,43433867,52.31952639477707,39.47443219446621,NaN,NaN,NaN,NaN,NaN,NaN,0.3508647478393163,-2.865164206137763,-3.216028953977079,77.92046475185843,49.32316700176816,6712348215,16423843477.60899,19.510720027054166,26.459307572180812,42.74393665050159,0,42.857142857142854
2021-10-15,367.88,369.06,366.82,368.94,341.37861613317625,358.9720388147134,365.34943460492,364.09911229694484,342.6873499999999,360.7748000000003,369.3882,363.01350000000014,363.01350000000014,374.3673650247226,351.6596349752777,40419878,54.93040548953569,40.12489373039521,NaN,NaN,NaN,NaN,NaN,NaN,0.9073764244767681,-2.081808423381119,-2.9891848478578873,93.18386547893093,70.80041951947815,6752768093,16459932654.394703,21.896541854630623,25.575616069772895,41.17637008542035,0,35.714285714285715
2021-10-18,367.61,372.87,366.99,372.65,341.68977418160233,359.24288953125375,365.63573128708003,364.9134825543787,342.98189999999994,361.1600000000003,369.4802,363.3610000000001,363.3610000000001,375.42566725606696,351.29633274393325,34513514,58.82962460037245,41.9225160891181,NaN,NaN,NaN,NaN,NaN,NaN,1.4726363508671643,-1.148389409273932,-2.6210257601410962,99.0243902439023,90.04290682489723,6787281607,16491863524.48994,25.331224954952507,23.52793744513995,38.111906556378365,100,28.571428571428573
2021-10-19,373.75,375.52,372.6974,375.47,342.0258958315366,359.56421845142694,366.0213888836651,365.91886516824735,343.31269999999995,361.58590000000027,369.615,363.8270000000001,363.8270000000001,376.95930535738916,350.69469464261107,29090963,61.55246609454361,43.95270256314346,NaN,NaN,NaN,NaN,NaN,NaN,1.9535934944066882,-0.17903389213273613,-2.1326273865394243,99.80158730158749,97.33661434147359,6816372570,16519923843.296644,28.037163292870915,22.577757728279188,35.471828837795385,100,21.428571428571427
2021-10-20,375.94,376.565,373.46,374.98,342.3537973655512,359.86948145238875,366.37270696665865,366.78183039031904,343.62829999999997,361.9964000000003,369.77780000000007,364.09750000000014,364.09750000000014,377.8977259039328,350.2972740960675,31390338,60.8000242474227,46.01611090067444,NaN,NaN,NaN,NaN,NaN,NaN,2.140809616681746,0.5433846343127584,-1.5974249823689877,93.96075442941522,97.59557732496835,6784982232,16519266718.668625,28.289637653018655,21.563149268687823,32.847494984344216,100,14.285714285714286
2021-10-21,374.16,377.47,373.85,377.27,342.7012222673865,360.2140461761038,366.80005179149555,367.7807036864791,343.97695,362.44090000000034,369.9990000000001,364.31200000000007,364.31200000000007,378.7752425133453,349.84875748665485,25469277,63.07201805707791,47.93828648680422,NaN,NaN,NaN,NaN,NaN,NaN,2.3066341463032214,1.285867700510039,-1.0207664457931824,99.26335174953944,97.67523116018072,6810451509,16541921710.917244,28.11394245088237,20.411489946579373,30.09729610807978,100,7.142857142857143
2021-10-22,375.98,376.97,372.385,374.1,343.0136479164673,360.4890155587552,367.08632427026043,368.382541430624,344.27254999999997,362.8472000000003,370.13040000000007,364.3505000000001,364.3505000000001,378.9133149407904,349.7876850592098,36275822,58.0558104682692,49.98323233103056,NaN,NaN,NaN,NaN,NaN,NaN,2.096656313970741,1.6000539466702435,-0.4966023673004972,86.14309210526316,93.12239942807263,6774175687,16532783526.749306,26.089011826272863,21.101373326723884,26.583669467529205,92.85714285714286,0
2021-10-25,375.56,378.87,373.56,377.93,343.36107430535816,360.83438158729473,367.5115664557404,369.291823199136,344.56704999999994,363.3265000000003,370.3126000000001,364.7295000000001,364.7295000000001,380.2595604956901,349.1994395043101,32597804,61.989224800065884,51.74390826811326,NaN,NaN,NaN,NaN,NaN,NaN,2.104085169483949,2.1335040945544392,0.029418925070490154,96.3452566096423,93.91723348814831,6806773491,16553840112.007309,26.8426883218195,19.460562814588478,23.742860879060355,100,7.142857142857143
2021-10-26,380.23,382.71,377.905,379.12,343.716884511275,361.19647304101164,367.9667991437506,370.2278400373135,344.89055,363.76170000000025,370.51540000000006,365.6920000000001,365.6920000000001,382.25012501461515,349.1338749853851,47191279,63.14565508229926,53.34145312751962,NaN,NaN,NaN,NaN,NaN,NaN,2.0741166239972793,2.622064705067089,0.54794808106981,86.31338162409462,89.6005767796667,6853964770,16530514557.870993,30.581140188224275,18.089792038068186,21.562543699728053,100,0
2021-10-27,379.58,383.15,379.31,380,344.0779105360384,361.5688201095065,368.43868937340744,371.15852193852174,345.22094999999996,364.1957000000003,370.8008000000001,366.7280000000001,366.7280000000001,384.12338283567345,349.3326171643268,45760496,64.0174710251699,54.669153187946044,NaN,NaN,NaN,NaN,NaN,NaN,1.9977683056268307,3.0451584631033484,1.0473901574765176,88.18897637795283,90.28253820389659,6899725266,16501199240.120993,29.404973396637242,17.00773006988729,21.32351484433561,100,21.428571428571427
2021-10-28,381.95,384.48,381.155,384.22,344.4773343117992,362.0173583251598,369.0575642999405,372.4024722300911,345.56185,364.67030000000034,371.24100000000004,368.0410000000001,368.0410000000001,386.52131157744896,349.56068842255127,38007005,67.93475563872974,56.420480914344736,NaN,NaN,NaN,NaN,NaN,NaN,2.104950028222353,3.678577692754459,1.573627664532106,99.0714285714286,91.19126219115869,6937732271,16533262292.45934,29.42385325061634,15.871187682683557,21.069172339873088,100,14.285714285714286
2021-10-29,381.06,386.28,380.7,386.11,344.8915896917813,362.49444033852296,369.7262872685703,373.7079510653205,345.92064999999997,365.1630000000003,371.684,369.33750000000015,369.33750000000015,389.0285374282217,349.6464625717786,37310116,69.53444820984144,58.49717980661371,NaN,NaN,NaN,NaN,NaN,NaN,2.1680534183227493,4.283694437435543,2.1156410191127932,99.42953020134242,95.56331171690795,6975042387,16568299032.215612,29.657000941418023,14.565593140905674,20.786730570781433,100,7.142857142857143
2021-11-01,386.56,387.56,384.42,387.43,345.31485745604215,362.98821379716605,370.42055051294005,375.0148128686233,346.2985,365.63380000000035,372.07800000000003,371.07800000000015,371.07800000000015,390.70431763728584,351.45168236271445,30765303,70.6362666978708,60.74512759120323,NaN,NaN,NaN,NaN,NaN,NaN,2.1589038789033053,4.814270867741925,2.6553669888386198,99.56853634251578,99.35649837176227,7005807690,16596516889.744274,30.18442605532424,13.873954427051027,20.465953793040573,100,0
2021-11-02,386.8,389.54,386.75,389.05,345.7500330037432,363.5042887714796,371.15111715949143,376.35149735732585,346.6617,366.11190000000033,372.3944,372.66150000000016,372.66150000000016,392.7172715134474,352.60572848655295,25135292,71.97581908198646,62.770965420568736,NaN,NaN,NaN,NaN,NaN,NaN,2.1191719575119032,5.304331935728499,3.1851599782165954,98.15303430079152,99.05036694821659,7030942982,16612823297.815958,31.956961768563673,13.270960796565777,20.56987622194921,100,0
2021-11-03,389.55,393.61,388.48,393.18,346.22197297385526,364.0919266175889,372.0149949179428,377.9542118947234,347.00875,366.5986000000004,372.77060000000006,374.3370000000001,374.3370000000001,395.34772878316613,353.3262712168341,33748901,75.09509020236936,64.39779140682532,NaN,NaN,NaN,NaN,NaN,NaN,2.217706719179689,5.957293377191206,3.7395866580115174,98.39492347891002,98.7054980407391,7064691883,16640914488.316933,35.7114721561108,12.21934247626382,22.991098204119478,100,0
2021-11-04,394.48,399.2,393.92,398.22,346.739366277598,364.767730050904,373.04264217606266,379.8842869523688,347.36805,367.15820000000036,373.23900000000003,376.09950000000015,376.09950000000015,398.8429144094422,353.3560855905581,40265313,78.27327810250813,66.06513945060907,NaN,NaN,NaN,NaN,NaN,NaN,2.4507584759556504,6.80303475295608,4.3522762770004295,96.95746662527178,97.83514146832447,7104957196,16666232829.066933,40.913274825036524,11.107051597080934,26.530191128230836,100,0
2021-11-05,400.04,400.99,397.16,398.6,347.255392483791,365.43767599049005,374.04489150249157,381.66673581404797,347.73395,367.73410000000035,373.7626,377.97150000000016,377.97150000000016,401.6329059387766,354.3100940612237,43383802,78.49609578721656,67.4698873925265,NaN,NaN,NaN,NaN,78.49609578721656,NaN,2.4529298333537195,7.418438568692579,4.96550873533886,91.64481733962599,95.66573581460261,7148340998,16655471833.792782,41.25512112254122,10.455000594763247,30.521066364023746,100,0
2021-11-08,398.57,399.62,397.4,398.06,347.76091096653937,366.08366260453977,374.98666046317817,383.2279990698529,348.08369999999996,368.26130000000035,374.20300000000003,379.95500000000015,379.95500000000015,403.3675517618146,356.5424482381857,29256270,77.28316725965132,68.59350890431992,NaN,NaN,NaN,NaN,NaN,NaN,2.245973029196419,7.772975021834384,5.527001992637965,89.75703548330709,92.78643981606831,7119084728,16643611183.792782,39.79674607388611,10.085414672186811,34.00512934040247,92.85714285714286,21.428571428571427
2021-11-09,399.16,399.57,393.92,395.32,348.23413573304146,366.6625999787073,375.78404632736726,384.3796182060574,348.41735,368.7882000000003,374.50419999999997,381.86400000000015,381.86400000000015,403.6970542068593,360.030945793141,50490720,71.26575800964115,69.34106131590694,NaN,NaN,NaN,NaN,NaN,NaN,1.7732698752697145,7.743589336725108,5.970319461455394,80.17829050865228,87.19338111052848,7068594008,16618142413.527294,36.28149249021782,14.635081712743037,36.078042443567206,85.71428571428571,14.285714285714286
2021-11-10,392.47,395.36,387.53,389.51,348.6448408501256,367.1150237415052,376.32231902041167,384.86822599595666,348.76775000000004,369.2397000000003,374.6954,383.33950000000016,383.33950000000016,402.9369288874766,363.7420711125237,54937385,60.50745490826811,69.1578782338491,NaN,NaN,60.50745490826811,NaN,NaN,NaN,0.9588200694420799,7.168844548257994,6.210024478815914,59.86715609159234,76.60082736118392,7013656623,16590989453.124996,32.055663967830704,22.43578395693076,36.20524989580269,78.57142857142857,7.142857142857143
2021-11-11,392.57,392.75,390.24,390.59,349.06220561778605,367.5798747565249,376.881835921572,385.4131568534846,349.11409999999995,369.66990000000027,374.8956,384.5375000000001,384.5375000000001,402.7855375657193,366.28946243428084,32242983,61.66591292283503,69.41574269488952,NaN,NaN,NaN,NaN,NaN,NaN,0.41038324638788914,6.723003536800775,6.312620290412886,62.085308056871924,67.37691821903887,7045899606,16567738537.097107,30.47396572457764,21.32875213546248,36.71130293208619,71.42857142857143,0
2021-11-12,391.77,395.25,390.13,394.7,349.51631302457423,368.116906939564,377.5805874540594,386.29761810553373,349.5148,370.13950000000034,375.18160000000006,385.8255000000001,385.8255000000001,403.09842618521185,368.55257381478833,34730564,65.77978395485476,69.68649692023158,NaN,NaN,NaN,NaN,NaN,NaN,0.2498603468585845,6.624945723986116,6.375085377127531,72.75286982889318,64.9017779924525,7080630170,16595007456.487732,31.895788239058536,19.676499938185778,37.26491149186068,64.28571428571429,0
2021-11-15,395.91,396.24,392.095,394.61,349.9650064273148,368.64152264373104,378.2484075539002,387.0892735240543,349.87575,370.58670000000035,375.44239999999996,386.9235000000001,386.9235000000001,403.48388317792853,370.3631168220717,33716861,65.61373136452535,69.86278808324774,NaN,NaN,NaN,NaN,NaN,NaN,0.07228558479180425,6.465442358117286,6.393156773325482,70.57195571955722,68.47004453510746,7046913309,16602206352.020905,31.388931273124005,18.431657085760737,37.28940909376721,57.142857142857146,0
2021-11-16,393.86,397.93,393.66,397.42,350.43719541808775,369.211393482469,379.00023470864926,388.0731522360491,350.22445,371.06630000000035,375.7486,388.0210000000001,388.0210000000001,404.306792458459,371.7352075415412,27872940,68.30406004381234,70.16897301315076,NaN,NaN,NaN,NaN,NaN,NaN,0.0782382796934975,6.490954622942354,6.4127163432488565,82.40512567767378,75.24331707537475,7074786249,16623421118.999826,31.926029567865722,17.222842907183082,37.51831834264582,50,0
2021-11-17,397.75,399.7196,396.64,397.63,350.9067755631814,369.7741381659845,379.7308137396826,388.98332821356826,350.5807,371.5055000000003,376.0856,389.15350000000007,389.15350000000007,404.7915897490698,373.51541025093036,28703263,68.50239328254276,70.20951855913741,NaN,NaN,NaN,NaN,NaN,NaN,0.032806132210910555,6.453724008512495,6.420917876301584,83.44011828486934,78.8057332273668,7103489512,16613172350.33026,33.195224736106134,16.388059487756728,37.802316765034554,42.857142857142854,7.142857142857143
2021-11-18,399.73,402.27,397.45,401.75,351.412678293896,370.4073235488363,380.5943112400872,390.19920171703797,350.93825,371.9731000000003,376.53119999999996,390.3775000000001,390.3775000000001,405.93539172734535,374.8196082726549,45721515,72.18034641523218,70.39851128809389,NaN,NaN,NaN,NaN,NaN,NaN,0.20700088297153574,6.679668980016004,6.472668097044468,97.08683473389365,87.64402623214562,7149211027,16649028642.176733,34.68443367767948,15.150322781653102,38.164584854920996,100,0
2021-11-19,403.43,405.3,402.58,403.99,351.9358357238075,371.07232704291874,381.51178923067204,391.51261107732006,351.3014,372.4687000000003,377.07919999999996,391.8720000000001,391.8720000000001,406.6091131501321,377.13488684986817,45191721,73.96065074130416,70.63596729119627,NaN,NaN,NaN,NaN,73.96065074130416,NaN,0.3892729371314383,6.959259268458766,6.5699863313273275,92.93800539083557,91.15498613653288,7194402748,16650690102.507616,37.54815398600737,14.294031593952713,38.724260837628485,100,0
2021-11-22,405.57,408.71,399.19,399.3,352.40712094048604,371.63129086385106,382.20936612358685,392.25426716519434,351.63,372.9160000000003,377.5385999999999,392.94050000000004,392.94050000000004,406.5336931127294,379.3473068872707,61715370,64.63423726917772,70.11156859028135,NaN,NaN,NaN,NaN,NaN,NaN,0.12390904428732519,6.724872636686484,6.600963592399159,55.57129367327684,81.86537793266871,7132687378,16590400928.032825,37.30556022872491,12.288252921149383,39.376348290041264,100,0
2021-11-23,398.11,400.23,392.92,397.48,352.85560729928716,372.14314649030945,382.8082145108972,392.7519560066044,351.9498499999999,373.3044000000002,377.98299999999995,393.8585000000001,393.8585000000001,405.99621687756036,381.72078312243985,70098736,61.39862965579308,69.13324997981162,NaN,NaN,NaN,NaN,NaN,NaN,-0.22523929285305666,6.319414476332838,6.544653769185895,46.978281397545054,65.16252682055251,7062588642,16607757797.001362,33.426837992256054,19.9285774869077,37.68250415034248,92.85714285714286,35.714285714285715
2021-11-24,394.93,399.05,392.54,398.76,353.3123674256624,372.6702128964419,383.4337747261561,393.3241506726421,352.2799,373.69010000000026,378.39719999999994,394.7965000000001,394.7965000000001,405.29402975703937,384.2989702429608,46954382,62.80875338618331,68.02864107150269,NaN,NaN,NaN,NaN,NaN,NaN,-0.4102510399863455,6.031839969202963,6.442091009189308,53.021718602455216,51.857097891092394,7109543024,16650528839.284004,30.395891342886188,18.650852879239018,35.30031551275156,85.71428571428571,28.571428571428573
2021-11-26,396.11,397.54,389.77,391.2,353.68935879456126,373.0371393737401,383.73833258003236,393.1218506085809,352.56299999999993,373.99260000000027,378.6549999999999,395.1455000000001,395.1455000000001,404.6284014019961,385.6625985980041,51533314,50.96646749076163,66.06223905032735,NaN,NaN,NaN,NaN,NaN,NaN,-1.045899633897986,5.134716466816826,6.180616100714812,17.3276676109538,39.10922253698471,7058009710,16617964029.536257,26.784094231849725,20.095904901337313,32.0648566300652,78.57142857142857,21.428571428571427
2021-11-29,395.89,400.73,395.14,399.69,354.14707661750094,373.56491879208187,384.36388816512914,393.74738864585896,352.87919999999997,374.4018000000002,379.1721999999999,395.82450000000006,395.82450000000006,404.5356250134526,387.1133749865475,54447106,60.07128558487269,64.8328189307003,NaN,NaN,NaN,NaN,NaN,NaN,-0.9040196023285239,5.050591597804157,5.954611200132681,57.41265344664788,42.5873465533523,7112456816,16652151747.257187,27.583103619931588,17.695477179799106,29.370162000418777,71.42857142857143,14.285714285714286
2021-11-30,398.78,401.19,391.75,393.82,354.5418320740432,373.9660095090704,384.73471608022214,393.75430401292,353.1706,374.72990000000027,379.73459999999994,396.14400000000006,396.14400000000006,404.02977554841857,388.25822445158155,81332693,52.77471065673521,63.512029834064165,NaN,NaN,NaN,NaN,NaN,NaN,-1.1965984861242465,4.4588630924773724,5.655461578601619,29.697828139754574,34.81271639911875,7031124123,16606488264.958458,24.465639804462224,19.75421164611088,27.094524015307773,64.28571428571429,7.142857142857143
2021-12-01,398.28,400.48,386.64,387.12,354.86599294892835,374.2264845682967,384.82825662609577,393.12246553549903,353.43655,374.9769000000002,380.15399999999994,396.04750000000007,396.04750000000007,404.31610054664594,387.7788994533542,78379245,45.9188153056092,62.46998414815995,NaN,NaN,NaN,NaN,NaN,NaN,-1.7963917036225343,3.4099719490734515,5.206363652695986,2.174898051653912,29.76179321268545,6952744878,16533545730.594296,20.760932323553845,22.353837323864052,26.09742708560704,57.142857142857146,100
2021-12-02,385.8,391.74,384.34,389.91,355.2146895365012,374.53704923031063,385.0275406799744,392.8165164368801,353.72375,375.25180000000023,380.5608,395.88400000000007,395.88400000000007,404.4951611296059,387.27283887039425,84416623,48.896009844494856,61.557848213992806,NaN,NaN,NaN,NaN,NaN,NaN,-1.947574792487468,2.7718951620866505,4.7194699545741186,22.855970455478246,18.242898882295577,7037161501,16576210348.164566,19.0959172069051,23.053757373502616,25.50714422222171,50,100
2021-12-03,391.31,392.34,378.9,383.13,355.49245381972014,374.70720667129456,384.9531273199754,391.8939910619391,353.9843,375.4524000000003,380.7637999999999,395.1295,395.1295,405.29397435926984,384.9650256407302,105349104,42.73868152920494,59.912055183589246,NaN,NaN,42.73868152920494,NaN,NaN,NaN,-2.4159486022400154,1.6995342017740995,4.115482804014115,14.189869171419048,13.073579226183732,6931812397,16537174742.664566,16.50662097371756,25.41613881436052,25.332766062764843,42.857142857142854,100
2021-12-06,383.63,387.6,379.3,386.2,355.798001542907,374.9347867372095,385.0020242878195,391.3517061988973,354.3031,375.7092000000003,381.0211999999999,394.5095,394.5095,405.24808738383524,383.77091261616476,67588801,46.05145681690639,58.51474985875932,NaN,NaN,NaN,NaN,NaN,NaN,-2.4244680576166564,1.0848977319932942,3.5093657896099506,24.48842670244888,20.51142210978205,6999401198,16581962502.363361,15.141204470108619,23.313733031226587,24.993076848537033,35.714285714285715,92.85714285714286
2021-12-07,393.03,398.46,392.99,397.83,356.21623038327607,375.3881572968687,385.5050821588854,391.9686865609071,354.68485,376.1115000000002,381.57079999999985,394.498,394.498,405.22183625389175,383.77416374610823,56005264,56.35316826536913,57.66111473172766,NaN,NaN,NaN,NaN,NaN,NaN,-1.5925080531991673,1.5187307231109912,3.1112387763101585,63.50218047635023,34.06015878340605,7055406462,16625067102.260984,23.680992772300186,20.602736631693794,23.352762502456596,28.571428571428573,85.71428571428571
2021-12-08,398.17,399.82,396.22,399.61,356.6480091854325,375.86779774643566,386.05821619187026,392.69643069796354,355.06225,376.56090000000023,382.3655999999999,394.7125,394.7125,405.66275091037863,383.7622490896213,39204041,57.68499886051613,56.88844370158291,NaN,NaN,NaN,NaN,57.68499886051613,NaN,-0.9023388649754671,1.9833151950908245,2.8856540600662917,69.47333109694745,52.48797942524885,7094610503,16659697338.477652,24.180970632352043,19.872008868709322,21.630225359440825,21.428571428571427,78.57142857142857
2021-12-09,398.35,400.2,393.5299,393.73,357.01698421841326,376.2215047217538,386.35907045885574,392.79486586958603,355.46675000000005,376.91030000000023,383.05459999999994,394.9235,394.9235,405.6244238386285,384.2225761613715,49973714,52.0363439224754,55.449586380671704,NaN,NaN,NaN,NaN,NaN,NaN,-0.8240079147403132,1.8556441666409,2.6796520813812132,49.74840657497497,60.90797271609088,7044636789,16612722002.36446,22.582800456383527,21.224167883620247,19.051914080258427,14.285714285714286,71.42857142857143
2021-12-10,396.62,398.28,393.36,398.01,357.42487492270766,376.6529600737982,386.8159696565477,393.2915453105778,355.8861,377.27480000000025,383.8555999999999,395.2945,395.2945,405.88263765494844,384.7063623450516,52545767,55.45556175539526,54.12779431024965,NaN,NaN,NaN,NaN,NaN,NaN,-0.4830060115421868,2.0758945669534796,2.5589005784956664,64.10600469641064,61.109247456111014,7097182556,16659500551.035192,21.45632416589831,20.337718242215672,16.039119375139588,7.142857142857143,64.28571428571429
2021-12-13,398,398.325,391.88,392.26,357.7714930826807,376.96201036936657,387.0294610425654,393.1933029000466,356.22945,377.55790000000025,384.49719999999996,395.1725,395.1725,405.8411491647336,384.5038508352664,50166410,50.27068917613352,53.101826589317916,NaN,NaN,NaN,NaN,NaN,NaN,-0.6342332267422304,1.7661090450678785,2.400342271810109,59.93719156572455,57.93053427903671,7047016146,16615249807.691515,20.045710112772184,20.51034882400557,12.517780698266913,0,57.142857142857146
2021-12-14,387.3,390.09,383.63,388.2,358.07426429578834,377.1845448174979,387.07536453109225,392.7177502428993,356.57845000000003,377.75790000000023,385.2088,394.852,394.852,405.94564971504667,383.7583502849533,75199181,46.933944999487714,52.06863482815324,NaN,NaN,NaN,NaN,NaN,NaN,-0.9767551391118827,1.1793983479202552,2.156153487032138,41.7227456258412,55.25531396265879,6971816965,16646446991.140432,18.30986641362183,27.012401641997823,12.082258696162938,28.571428571428573,50
2021-12-15,387.94,397.4198,383.88,397.05,358.4620825615019,377.5779201676465,387.46652670634353,393.13034545786127,357.0179,378.0435000000002,386.0022,394.8335,394.8335,405.91118075908344,383.7558192409166,73858028,54.08777096690208,51.445707512490294,NaN,NaN,NaN,NaN,NaN,NaN,-0.5951090346108989,1.412267193768514,2.007376228379413,81.42664872139981,61.028861970988515,7045674993,16716270587.501205,22.882469457039722,23.564647725501704,10.476694290451364,21.428571428571427,42.857142857142854
2021-12-16,398.04,398.475,385.21,386.84,358.7444498991984,377.7613276890792,387.44195703158493,392.53126493806496,357.43160000000006,378.2676000000002,386.5456,394.294,394.294,405.8164084288052,382.7715915711948,82591368,46.32825448009806,51.114406583157184,NaN,NaN,NaN,NaN,NaN,NaN,-0.9945832645361741,0.7641471477091955,1.7587304122453695,35.621354867653615,52.92358307163153,6963083625,16653976834.252808,21.110818094283328,20.767945172280562,9.516130840423457,14.285714285714286,35.714285714285715
2021-12-17,383.33,389.19,381.77,384.91,359.0048036315447,377.9028855566222,387.3426645989738,391.8054301820588,357.81275,378.4584000000001,386.98440000000005,393.452,393.452,405.13204897250586,381.77195102749414,81642848,45.01364721071507,50.03886098500307,NaN,NaN,NaN,NaN,NaN,NaN,-1.3320303751780096,0.09369244327285742,1.425722818450867,26.962763571108308,48.00358905338724,6881440777,16641433323.913185,19.702235954685136,22.47560906955712,8.425995913882671,7.142857142857143,28.571428571428573
2021-12-20,379.565,381.5,377.47,380.69,359.2205767297383,377.9580759416396,387.0817757911709,390.7468177837675,358.2165,378.6005000000001,387.375,392.287,392.287,404.1764274042193,380.3975725957807,65336827,42.194329574567476,49.28311947913395,NaN,NaN,42.194329574567476,NaN,NaN,NaN,-1.7560170374485455,-0.7692984783598149,0.9867185590887306,13.99391568883082,25.526011375864243,6816103950,16680505719.215914,18.378103243676144,24.849374485857023,8.73426149277041,0,100
2021-12-21,384.05,389.53,380.201,389.21,359.51897895133294,378.1808863190329,387.16523556406617,390.6004541853134,358.6037,378.8469000000001,387.9914,391.78249999999997,391.78249999999997,403.288913646322,380.27608635367795,48899477,49.122764433511556,49.511972988269825,NaN,NaN,NaN,NaN,NaN,NaN,-1.394979577618234,-0.757005912934062,0.637973664684172,51.649802023757026,30.868827094565376,6865003427,16726050531.698816,24.010709326806463,22.781844911739054,8.657949156003713,0,92.85714285714286
2021-12-22,388.91,394.16,388.23,393.95,359.8615761756978,378.4931459958837,387.4313047576322,390.9194585486169,359.01905000000005,379.14040000000006,388.72759999999994,391.60599999999994,391.60599999999994,402.8630091942882,380.34899080571165,37042200,52.53150235907407,49.77165102502549,NaN,NaN,NaN,NaN,NaN,NaN,-0.7988817153280626,-0.36062847947590626,0.43825323585215636,72.50329960404747,46.049005772211764,6902045627,16760469169.472847,26.924207524724032,21.554200820337734,8.778459445136594,35.714285714285715,85.71428571428571
2021-12-23,394.31,398.425,394.14,396.92,360.230316711263,378.858034193985,387.8034104534113,391.49093868684383,359.41345000000007,379.44150000000013,389.466,391.51399999999995,391.51399999999995,402.56380434217755,380.46419565782236,29595536,54.58471957926598,50.61779660002984,NaN,NaN,NaN,NaN,NaN,NaN,-0.19783743352988764,0.19095644393979683,0.38879387746968447,85.56973163220422,69.90761108666958,6931641163,16769275309.12279,29.793274293133848,20.64987677028658,8.555168087071669,28.571428571428573,78.57142857142857
2021-12-27,398.25,403.48,398.2194,403.48,360.6606618186136,379.34559787331204,388.4181786709246,392.63275405000155,359.85355000000004,379.8029000000001,390.20300000000003,392.128,392.128,404.3430523535629,379.9129476464371,32820705,58.82146506877032,51.52994004659155,NaN,NaN,NaN,NaN,58.82146506877032,NaN,0.6043557583921679,1.1442385754598945,0.5398828170677266,100,86.02434374541723,6964461868,16802096014.12279,32.72937649027926,19.367096821578237,8.86923125436532,100,71.42857142857143
2021-12-28,404.4,404.58,400.71,401.61,361.06811791992095,379.7864771233455,388.935504997555,393.4877298547633,360.26745000000005,380.1223000000001,390.8564,392.22399999999993,392.22399999999993,404.70260312697053,379.74539687302934,33113728,57.18379724178989,51.58927068776446,NaN,NaN,NaN,NaN,NaN,NaN,0.9512125425910719,1.7288984953065665,0.7776859527154946,89.04463297676143,91.53812153632187,6931348140,16784384020.076279,32.56590193601367,18.63176965070367,10.316740348437358,100,64.28571428571429
2021-12-29,401.75,403.05,399.11,401.55,361.4709227167377,380.21743797238815,389.4301910760822,394.2555651066906,360.6723,380.4573000000001,391.43440000000004,392.61049999999994,392.61049999999994,405.7255073961253,379.4954926038746,32248484,57.128838130848955,51.54954492135966,NaN,NaN,NaN,NaN,NaN,NaN,1.107832447694778,2.162476512333967,1.054644064639189,88.8233124308374,92.6226484691996,6899099656,16792077820.827547,31.26442500065484,19.51008209031881,11.271652508901628,92.85714285714286,57.142857142857146
2021-12-30,401.33,403.5699,399.75,400.35,361.85777920711837,380.61610256699436,389.8584188770202,394.835987477482,361.06455,380.7735000000001,391.932,393.272,393.272,406.546183364719,379.99781663528097,23850065,55.97022501737521,51.83053642813822,NaN,NaN,NaN,NaN,NaN,NaN,1.0617281772627982,2.3818042862176867,1.3200761089548885,84.39690151235718,87.42161563998532,6875249591,16775720118.978415,30.55728381179621,18.72859981813419,12.764419544261406,85.71428571428571,50
2021-12-31,399.66,401.0589,397.34,397.85,362.2159107572963,380.9573678626974,390.17181421517625,395.1230362891504,361.4936,381.08360000000016,392.3894,393.669,393.669,406.99208207586656,380.3459179241334,34752884,53.53432839765329,51.6933054740138,NaN,NaN,NaN,NaN,NaN,NaN,0.8055943268202934,2.3270690174802553,1.5214746906599619,75.17521209885662,82.79847534735039,6840496707,16750499070.112461,29.32572275308043,20.585597413222565,13.824050721749215,78.57142857142857,42.857142857142854
2022-01-03,399.05,401.94,396.88,401.68,362.6085882621988,381.36771701393116,390.62311561850265,395.747509023517,361.9363000000001,381.43830000000014,392.87760000000003,394.5965,394.5965,407.4294502064115,381.7635497935885,40575854,56.647207979285675,52.14877110281037,NaN,NaN,NaN,NaN,NaN,NaN,0.8333746637976522,2.5631930204070272,1.729818356609375,89.30284028033944,82.95831796385107,6881072561,16786905073.503765,28.66144066338264,19.437690770907608,15.111970093877781,71.42857142857143,35.714285714285715
2022-01-04,402.24,402.28,393.288,396.47,362.9455177322267,381.66677212256616,390.8524052020908,395.816317687944,362.32560000000007,381.72770000000014,393.325,395.11,395.11,407.36690172923045,382.8530982707696,58027206,51.58460527836352,52.48096112273008,NaN,NaN,NaN,NaN,NaN,NaN,0.4588395116038524,2.3033677461141906,1.8445282345103382,70.08483954260431,78.18763064060012,6823045355,16769946054.668356,25.897714572046578,21.415297595272538,14.417149142074422,64.28571428571429,28.571428571428573
2022-01-05,394.74,395.89,384.03,384.29,363.1579006403637,381.71871722905,390.59505597847937,394.71857314623503,362.66095,381.88240000000013,393.4522,394.433,394.433,407.48417328059486,381.3818267194051,75739847,42.10975599263111,51.62538862456786,NaN,NaN,NaN,NaN,NaN,NaN,-0.5940803483579227,1.1019277990629348,1.6960081474208575,25.156768720029525,61.51481618099109,6747305508,16697527010.4036,22.644527676339646,28.073729857673037,15.076857025321273,57.142857142857146,21.428571428571427
2022-01-06,382.42,387.35,380.13,384.02,363.36548371856907,381.7642871849104,390.33721064598996,393.6996614180222,363.0217,382.0328000000001,393.5502,393.6535,393.6535,407.2265796431809,380.0804203568191,70814324,41.925917717883756,51.31093599869541,NaN,NaN,NaN,NaN,NaN,NaN,-1.2555803963737182,0.12653265195370977,1.382113048327428,24.16082626337132,39.80081150866838,6676491184,16703019534.148752,20.996037320162987,29.9623364845899,16.27518649954934,50,14.285714285714286
2022-01-07,384.03,385.76,378.04,379.86,363.5296082586828,381.7265785277835,389.92633964026487,392.38159842582957,363.36435,382.1741000000001,393.54740000000004,392.96,392.96,407.8043821023399,378.11561789766006,72652304,39.094018614144424,50.88810538465465,NaN,NaN,39.094018614144424,NaN,NaN,NaN,-1.8824581542792673,-0.9709596445216562,0.9114985097576112,8.815935079306493,19.377843354235782,6603838880,16664622979.703156,19.37211597325399,29.738827449094718,17.313281806689197,42.857142857142854,7.142857142857143
2022-01-10,374.82,380.64,369.31,380.11,363.6945872809845,381.6945670717878,389.5413851445682,391.2128747662268,363.68489999999997,382.35310000000004,393.46520000000004,392.065,392.065,407.71988997087425,376.41011002912575,91770497,39.35910787951513,50.685589549293766,NaN,NaN,NaN,NaN,NaN,NaN,-2.169046963201473,-1.7998101942442304,0.3692367689572428,30.620924298270534,21.19922854698279,6695609377,16747807710.876148,17.26195785273851,34.89254590966212,18.658586345047663,35.714285714285715,100
2022-01-11,379.355,385.9899,377.2182,385.82,363.9147406413727,381.7762588129405,389.3954484722322,390.69926764563377,364.03445,382.5717000000001,393.4594,391.74300000000005,391.74300000000005,407.63177729720235,375.85422270279776,68295698,45.22330797520269,50.40705694512884,NaN,NaN,NaN,NaN,NaN,NaN,-1.8739376512375139,-1.9731852950896496,-0.09924764385213569,46.810320385596825,28.749059921057952,6763905075,16813457755.447462,20.902687155853712,31.98747681122398,19.96801021258306,28.571428571428573,92.85714285714286
2022-01-12,388.46,390.2,385.01,387.35,364.14792730165755,381.88662992555555,389.3152348066545,390.380289774621,364.39959999999996,382.7679,393.45779999999996,391.70050000000003,391.70050000000003,407.63144909288377,375.7695509071163,54576366,46.71035942879798,49.991261021537696,NaN,NaN,NaN,NaN,46.71035942879798,NaN,-1.4921880960375933,-1.9644827638991273,-0.47229466786153407,51.14828466118523,42.85984311501753,6818481441,16808094759.944572,23.93630053056729,30.37600492245747,20.023702731948088,21.428571428571427,85.71428571428571
2022-01-13,388.77,389.47,376.7,377.66,364.28237578621815,381.80293428346533,388.85816677502095,389.1688336056095,364.69225,382.8122,393.23,390.73100000000005,390.73100000000005,407.5755574593105,373.8864425406896,77993962,39.41270255418766,48.90754551974639,NaN,NaN,NaN,NaN,NaN,NaN,-1.7887792468973307,-2.7082687264831975,-0.9194894795858668,23.674510915792535,40.54437198752487,6740487479,16741827376.412857,21.117333186761194,34.462418487295245,20.444027982052734,14.285714285714286,78.57142857142857
2022-01-14,375.07,380.35,374.86,380.01,364.4388695594896,381.7674306342878,388.51117984266716,388.2965637384086,364.96945,382.8686,392.9666,390.38950000000006,390.38950000000006,407.8030757097736,372.9759242902265,80121210,41.787965937942644,47.69086701040156,NaN,NaN,NaN,NaN,NaN,NaN,-1.7225517503490746,-3.0726791675222103,-1.3501274171731357,30.33739722143463,35.053397599470806,6820608689,16812024647.833622,20.025437478602175,34.41345609618835,20.49978238122217,7.142857142857143,71.42857142857143
2022-01-18,374.04,376.22,369.7704,370.55,364.49967682755437,381.54530329499494,387.80681984883705,386.60641481094115,365.16695,382.8261,392.4132,389.67150000000004,389.67150000000004,409.00764984943913,370.33535015056094,75812296,35.71753372244925,46.1575624733058,NaN,NaN,NaN,NaN,NaN,NaN,-2.182148875186674,-4.077813511156478,-1.8956646359698042,3.6193917670513005,19.210433301426153,6744796393,16754540082.533697,18.14132659125145,35.852180712017095,20.898745388377936,0,64.28571428571429
2022-01-19,372.15,374.69,366.21,366.48,364.5193815357379,381.2469804574703,386.9704739724121,384.6896134003753,365.34525,382.76670000000007,391.7708,388.961,388.961,410.48547713651,367.43652286349004,81791482,33.46511727752396,44.4672966980683,NaN,NaN,NaN,NaN,NaN,NaN,-2.5982790783939014,-5.143513483962181,-2.5452344055682796,0.7227000072271028,11.559829665237679,6663004911,16677957020.378038,16.736906061993846,36.327021937076644,21.882164323217133,7.142857142857143,100
2022-01-20,369.79,373.87,361.17,361.72,364.49152699309377,380.86030757712433,385.9802593068273,382.5020311717681,365.49575000000004,382.62350000000004,391.04400000000004,387.58650000000006,387.58650000000006,412.1659249525899,363.00707504741024,88610680,31.002687808328474,42.6839011831364,NaN,NaN,NaN,NaN,NaN,NaN,-3.0034630087794203,-6.299563166542555,-3.2961001577631346,1.3378739965945317,1.8933219236243108,6574394231,16597021281.16544,14.87911153657257,36.69976146134669,23.189682663282372,0,100
2022-01-21,359.47,362.18,351.4,351.69,364.364148615053,380.282677724112,384.63554325557914,379.5675520125521,365.5788,382.3378000000001,390.1714,385.47350000000006,385.47350000000006,414.38546933797517,356.56153066202495,143388920,26.566722932042595,40.757643649878496,NaN,NaN,NaN,NaN,NaN,NaN,-3.71001920484332,-7.933624163817285,-4.223604958973965,0.5699685534591598,0.8768475190935975,6431005311,16461347163.911266,13.50845711386832,41.66785470137604,25.584253643312667,14.285714285714286,100
2022-01-24,345.905,353.98,334.15,353.3,364.2540575840575,379.7483672741296,383.40669842202703,377.06588039230905,365.65975,382.07130000000006,389.44719999999995,383.2925,383.2925,414.87884633825445,351.7061536617456,199448109,28.339197631216663,38.735642910730704,NaN,NaN,NaN,NaN,NaN,NaN,-3.8171373640918773,-8.995026664088812,-5.177889299996934,28.1080287685308,10.005290439528164,6630453420,16647116532.203249,11.42373680241243,48.66219654588422,28.64131047323676,7.142857142857143,100
2022-01-25,346.67,351.0295,341.68,345.11,364.06356944889274,379.0624590112755,381.9048671113593,374.0224632120891,365.70195,381.7166,388.5376,380.374,380.374,414.6333102090522,346.11468979094786,124398394,25.029542410732134,36.83885270589989,NaN,NaN,NaN,NaN,NaN,NaN,-4.159637141229768,-10.377435726534145,-6.217798585304377,17.75186264982189,15.47661999060395,6506055026,16613992856.94115,10.409924139744335,44.34361393979312,32.39140866718047,0,92.85714285714286
2022-01-26,352.91,356.88,340.78,344.57,363.8696035837296,378.3794400209532,380.4407546756197,371.2174667156997,365.72180000000003,381.35830000000004,387.535,377.52200000000005,377.52200000000005,413.6793846399331,341.364615360067,146559524,24.823689940163916,35.604133702152225,NaN,NaN,NaN,NaN,NaN,NaN,-4.1340293694312455,-11.385335297093434,-7.251305927662188,18.5905441570027,21.48347852511846,6359495502,16536434649.209475,13.441896231277106,39.15827123847656,35.11895583816855,0,85.71428571428571
2022-01-27,349.4,351.27,340.05,341.1,363.643040363991,377.641233287865,378.89797998245814,368.34913655229974,365.74475,380.9536,386.46479999999997,374.4995,374.4995,412.19111576531446,336.80788423468556,95255656,23.486940474610336,34.287063899061266,NaN,NaN,23.486940474610336,NaN,NaN,NaN,-4.056604784924922,-12.322061908818341,-8.26545712389342,12.39964317573603,16.247349994186873,6264239846,16459007591.926052,12.357406653773863,36.523911607188026,37.393513207660476,28.571428571428573,78.57142857142857
2022-01-28,343.03,352.02,337.95,351.8,363.52519916633935,377.1295256980063,377.83531410079314,366.77302830922355,365.7957,380.6505,385.5524,372.072,372.072,409.0380745008182,335.1059254991818,108167897,35.09366675256925,34.00132448037733,NaN,NaN,NaN,NaN,NaN,NaN,-3.0372190315617615,-12.061980913345622,-9.02476188178386,31.489741302408618,20.826642878382447,6372407743,16563792839.695065,11.143280458727052,34.40183599137776,39.5333922988797,21.428571428571427,71.42857142857143
2022-01-31,353.2,363.65,351.52,363.05,363.52047081642553,376.85072320893687,377.25549786154636,366.4184541845356,365.9009,380.4732000000001,384.86080000000004,370.332,370.332,405.51379222268116,335.1502077773188,94326389,44.607930629605285,34.37624039109805,NaN,NaN,NaN,NaN,NaN,NaN,-1.4388460003869792,-10.823319382267584,-9.384473381880605,51.56110615521861,31.816830211121083,6466734132,16648787681.55574,18.22660402118743,31.52604469850333,39.028148354951036,14.285714285714286,64.28571428571429
2022-02-01,364.43,366.19,359.14,365.52,363.5403666291974,376.6263524523243,376.79528225913276,366.33288711934176,366.03409999999997,380.3337,384.1362,368.524,368.524,400.6608121629978,336.3871878370022,74433023,46.46345875355368,34.464822589551694,NaN,NaN,NaN,NaN,NaN,NaN,-0.11840398304341804,-9.532478360684877,-9.414074377641459,55.9678858162355,46.33957775795424,6541167155,16709073151.247938,19.111725606606107,29.958538160745686,39.110042958645316,7.142857142857143,57.142857142857146
2022-02-02,369.76,370.1,364.285,368.49,363.589616712489,376.46523656217926,376.46958491563737,366.5383264413092,366.19449999999995,380.25270000000006,383.42619999999994,367.12499999999994,367.12499999999994,396.59957107406353,337.65042892593635,78777135,48.689191367318024,34.606167728017404,NaN,NaN,NaN,NaN,NaN,NaN,0.9907952053099187,-8.17558037100406,-9.166375576313978,62.075198843094725,56.534730271516274,6619944290,16744228209.773304,21.147431782741048,28.691363871217725,39.34431871979973,0,50
2022-02-03,358.53,361.93,352.46,353.55,363.48972002878264,376.011469501542,375.57077766404376,365.30134297070833,366.26579999999996,380.0249,382.5112,365.5879999999999,365.5879999999999,394.5229191116912,336.65308088830864,95384771,39.73923339242847,34.62949135932032,NaN,NaN,NaN,NaN,NaN,NaN,0.7642128449231418,-8.21110952016005,-8.975322365083192,41.991341991342026,53.34480888355741,6524559519,16670801073.491362,18.788205860512768,33.72014544960184,39.66050228730888,0,42.857142857142854
2022-02-04,354.08,361.4,351.97,358.01,363.43519545138184,375.65500475893725,374.8821197164342,364.6069293544504,366.37985000000003,379.85240000000005,381.72180000000003,364.28749999999997,364.28749999999997,392.108388465322,336.46661153467795,86318301,43.10169042022814,34.72332882234071,NaN,NaN,NaN,NaN,NaN,NaN,0.948587192320808,-7.789588374682182,-8.73817556700299,56.7149988115046,53.593846548647115,6610877820,16695058072.181711,17.547977064816617,31.837249306758906,39.83940499027658,0,35.714285714285715
2022-02-07,358.62,361.05,353.84,355.13,363.3525566906716,375.2485690211365,374.10752678637795,363.70436465402656,366.4584,379.62320000000005,380.8492,363.051,363.051,390.18322283558535,335.9187771644146,58198087,41.49169164873103,35.13576867421798,NaN,NaN,NaN,NaN,NaN,NaN,0.9102923601361859,-7.600310116832759,-8.510602476968945,51.75135668475581,50.15256582920082,6552679733,16657685375.536774,16.64335805010457,30.196001373014642,39.5631538124321,0,28.571428571428573
2022-02-08,353.96,360.24,352.8,359.12,363.3104416987246,374.9291914167576,373.51978063789255,363.2677584965002,366.54585,379.4313,380.20759999999996,362.00149999999996,362.00149999999996,388.0138119118629,335.98918808813704,64720897,44.580284249211765,35.92970917219568,NaN,NaN,NaN,NaN,NaN,NaN,1.1707928883959688,-7.047111366473985,-8.217904254869953,62.86505538771402,57.11047029465814,6617400630,16702920411.074408,15.741561010636895,29.317278489682373,39.07821905997052,0,21.428571428571427
2022-02-09,363.76,366.81,362.12,366.73,363.3444671544587,374.7668311906832,373.2535147305242,363.5974957825478,366.67875,379.36030000000005,379.54839999999996,361.0469999999999,361.0469999999999,384.7957608939951,337.2982391060047,55766422,50.001497898582535,37.28676703578526,NaN,NaN,NaN,NaN,50.001497898582535,NaN,1.8332681610063473,-5.926319053612019,-7.759587214618366,90.6258692628651,68.41409377844498,6673167052,16756784353.859056,19.705874221590697,27.649663512369653,37.25460345793427,0,14.285714285714286
2022-02-10,359.52,366.4885,356.54,358.43,363.29556698376757,374.4433295829469,372.6722004273664,363.10535332706706,366.7759,379.2876000000001,378.8406,359.60099999999994,359.60099999999994,380.06169783756394,339.14030216243594,112468483,44.84851803858216,38.59260954339522,NaN,NaN,NaN,NaN,NaN,NaN,1.6934479470421158,-5.6427772808157215,-7.336225227857837,67.53824756606397,73.67639073888103,6560698569,16687049033.219212,18.226405807497727,29.685008265386152,35.31752663020139,57.142857142857146,7.142857142857143
2022-02-11,358.43,360.07,345.8,347.06,363.13401905358086,373.9010854327895,371.66780041060696,361.577224438775,366.8100999999999,379.09670000000006,378.0394,358.07099999999997,358.07099999999997,377.4489874083967,338.69301259160324,101569102,38.92983540131839,39.34908366983107,NaN,NaN,NaN,NaN,NaN,NaN,0.8583141334564619,-6.263332561037259,-7.121646694493721,28.335925349922253,62.166680726283765,6459129467,16603416450.983753,16.372608140502418,34.32069917510493,33.4196631032068,50,0
2022-02-14,346.49,350.98,343.89,347.49,362.97835717245067,373.3780936420412,370.7196513748969,360.2355840160345,366.85759999999993,378.8759000000001,377.19100000000003,356.44499999999994,356.44499999999994,373.5054355161316,339.38456448386825,80254439,39.25632600501025,40.36528249799379,NaN,NaN,NaN,NaN,NaN,NaN,0.3822424821115318,-6.643843591854306,-7.026086073965838,29.673405909797854,41.849192941928024,6539383906,16604661583.32367,15.527578440901088,33.939730046088826,31.651485296282598,42.857142857142854,21.428571428571427
2022-02-15,352.91,356.37,351.82,356.13,362.9102143150134,373.03654723328793,370.1475081837245,359.8445760145074,366.9573,378.7074000000001,376.65100000000007,355.72399999999993,355.72399999999993,371.5103465057698,339.93765349423006,55390805,45.55474571075273,41.84607219589299,NaN,NaN,NaN,NaN,NaN,NaN,0.679252312510263,-6.17702068332801,-6.856272995838273,56.547433903576945,38.185588387765684,6594774711,16654208962.741251,18.467487582920132,31.730778227931932,30.046593820099677,35.714285714285715,14.285714285714286
2022-02-16,353.82,357.0896,350.71,356.04,362.84185397357044,372.69998194153965,369.59427256867644,359.4822354416972,367.0868,378.5345000000001,376.04780000000005,355.20199999999994,355.20199999999994,370.2020154666658,340.2019845333341,58947086,45.501819262274346,43.418563537868984,NaN,NaN,NaN,NaN,NaN,NaN,0.8865685339467904,-5.748062328404785,-6.6346308623515755,56.267496111975156,47.496111975116655,6535827625,16693759578.283669,17.582138147807242,31.04370881505118,28.492653723585057,28.571428571428573,7.142857142857143
2022-02-17,352.74,353.46,345.02,345.45,362.6688007002016,372.1603783387369,368.64743835029697,358.14583206629743,367.1689,378.2855000000001,375.00020000000006,354.3884999999999,354.3884999999999,369.6488004885313,339.1281995114685,61801353,39.66255714457007,43.74491285158333,NaN,NaN,NaN,NaN,NaN,NaN,0.35469254092954916,-6.191265186189639,-6.545957727119188,5.951926745516979,39.58895225368969,6474026272,16638255519.546701,16.1425085938574,32.729597004757665,27.269276498773397,21.428571428571427,0
2022-02-18,346.41,346.81,339.14,341.51,362.45826536985135,371.55344015381144,367.5832250816579,356.5614671076024,367.2189,378.10190000000017,373.8382000000001,353.8794999999999,353.8794999999999,370.11388385034246,337.6451161496573,80001513,37.722924396778865,43.253126692095734,NaN,NaN,NaN,NaN,NaN,NaN,-0.18903394479728952,-6.782250158115801,-6.593216213318511,7.655038759689928,23.291487205727353,6394024759,16607694315.754004,15.209081291806378,35.26997067346489,28.198554899403742,14.285714285714286,100
2022-02-22,338.49,344.04,334.35,338.08,362.2156955651762,370.89059975472605,366.4262358627693,354.80132738306884,367.2382999999999,377.8899000000002,372.72520000000003,353.1184999999999,353.1184999999999,370.7564253598669,335.48057464013294,85967095,36.06921909574568,42.510681002252305,NaN,NaN,NaN,NaN,NaN,NaN,-0.6787071937802365,-7.441600205543807,-6.762893011763571,10.433566433566325,8.013510646257744,6308057664,16587910350.650805,14.099814601681082,36.302900660403665,29.76617731815691,7.142857142857143,100
2022-02-23,341.32,342.183,329.1,329.42,361.88937023616944,370.06939975958295,364.97501092697445,352.3840581084909,367.25659999999993,377.6045000000002,371.3534,352.33399999999995,352.33399999999995,372.5362576956186,332.1317423043813,86215371,32.2277985016659,41.33486722613429,NaN,NaN,32.2277985016659,NaN,NaN,NaN,-1.4410509110823764,-8.56420665061654,-7.123155739534164,0.8485812781755326,6.312395490477264,6221842293,16505912501.430212,12.747926377572739,36.66969004100165,32.14265547963014,0,100
2022-02-24,318.84,341.04,318.26,340.49,361.6764411790931,369.4836690712744,364.01481442003427,351.251290669587,367.3325,377.40760000000023,370.31800000000004,352.12999999999994,352.12999999999994,372.7204074753308,331.5395925246691,130614053,40.89351828756934,41.417316147215786,NaN,NaN,NaN,NaN,NaN,NaN,-1.0719289244044532,-8.46306689503973,-7.3911379706352776,45.78784757981465,19.023331763852173,6352456346,16630219466.708527,10.805277280177894,38.333159434370415,34.11292778613927,28.571428571428573,100
2022-02-25,341.31,345.98,337.39,345.77,361.518168132535,369.0140914659026,363.29933150160156,350.7292629867692,367.4769,377.3391000000002,369.4694,352.36349999999993,352.36349999999993,372.55024146563073,332.1767585343691,78842088,44.536297825296906,41.519788104720696,NaN,NaN,NaN,NaN,NaN,NaN,-0.3800372697485672,-7.866184557820986,-7.486147288072419,56.66323377960862,34.4332208791996,6431298434,16705206644.701542,13.527043565161032,36.09919401102904,35.295070782461366,21.428571428571427,92.85714285714286
2022-02-28,342.51,348.54,341.32,346.8,361.3717186983804,368.5742084665778,362.6522988936956,350.35504746421975,367.6142,377.2333000000002,368.46440000000007,352.1135,352.1135,372.4452862225634,331.78171377743655,77515544,45.24523489399277,41.78789833652511,NaN,NaN,NaN,NaN,NaN,NaN,0.20753116646084457,-7.226733329996364,-7.434264496457208,58.784757981462434,53.74527978029524,6508813978,16745360125.94254,14.625907510559122,34.290344657895695,36.09977840437736,14.285714285714286,85.71428571428571
2022-03-01,345.75,348.078,338.9,341.49,361.17389065163036,368.03788750684356,361.822404819433,349.51075722953215,367.6897,377.05150000000026,367.55740000000003,351.0355,351.0355,371.21924442466025,330.8517555753398,67407000,42.24718673954898,41.62124851440633,NaN,NaN,NaN,NaN,NaN,NaN,0.2938335279761235,-7.066972586487054,-7.360806114463178,47.847579814624126,54.431857191898395,6441406978,16715997172.575792,13.687028552597964,33.78174813268262,36.97146648393602,7.142857142857143,78.57142857142857
2022-03-02,343.08,348.59,340.24,347.22,361.0350459685296,367.62565211066845,361.24976149318076,349.2925898743386,367.80375,376.89400000000023,366.8036000000001,350.1205,350.1205,369.2251093652853,331.0158906347147,70609015,46.37639289053171,41.362312442402704,NaN,NaN,NaN,NaN,46.37639289053171,NaN,0.7653052151124973,-6.404174595572556,-7.169479810685053,60.04748229781154,55.55994003129937,6512015993,16763436283.25244,13.239963060982221,31.782797756535647,38.71508674245316,0,71.42857142857143
2022-03-03,349.93,350.04,340.35,342.26,360.84822959073324,367.12336196986314,360.5050649640364,348.6228194101159,367.90394999999995,376.70500000000027,366.0350000000001,348.80899999999997,348.80899999999997,366.2151987808999,331.4028012191,71089385,43.478516376010056,41.264455180790414,NaN,NaN,NaN,NaN,NaN,NaN,0.7695231370672833,-6.207575889350949,-6.977099026418232,57.40253527864147,55.09919913035905,6440926608,16720371815.765339,13.35866941630853,29.5942819609245,39.706684538937644,0,64.28571428571429
2022-03-04,339.84,341.31,334.92,337.3,360.6139188485369,366.5328003466975,359.59506241642714,347.5444556567715,367.9775,376.49410000000023,364.99680000000006,347.9965,347.9965,365.9500826786749,330.04291732132515,77009763,40.73720232603914,41.393552818270464,NaN,NaN,NaN,NaN,NaN,NaN,0.4789004418894036,-6.378473474056477,-6.857373915945881,49.03475698951317,55.49492485532206,6363916845,16700727697.816982,12.648203308302913,31.954791805586957,40.26955314321166,0,57.142857142857146
2022-03-07,337.29,338.48,324.65,324.86,360.2581584619843,365.70759637943615,358.232903105979,345.38403130850753,367.95765,376.17130000000026,363.6150000000001,346.339,346.339,366.2976421381816,326.3803578618184,89933794,34.80928001191239,41.075906675906346,NaN,NaN,NaN,NaN,NaN,NaN,-0.459735354517651,-7.432043109092945,-6.972307754575294,16.99734223375986,41.14487816730483,6273983051,16613525081.942797,11.416198308288099,36.07544192917386,41.319730824569945,14.285714285714286,50
2022-03-08,324.05,333.21,319.94,323.35,359.8909131041536,364.8688320946948,356.8649461214308,343.28555213626873,367.93935,375.8048000000002,362.14360000000016,344.75,344.75,366.6244188494232,322.8755811505768,116153921,34.159503360372256,40.26196079373631,NaN,NaN,34.159503360372256,NaN,NaN,NaN,-1.0567534738105255,-8.29324959683845,-7.2364961230279246,13.108556359066352,26.38021852744646,6157829130,16557067448.902103,10.37222588935923,36.02223397200744,43.38151515272347,7.142857142857143,42.857142857142854
2022-03-09,331.75,336.38,329.09,334.99,359.6431428245103,364.27717205321574,356.00710509706096,342.49549955186217,367.95174999999995,375.4884000000002,360.77380000000016,343.5435,343.5435,364.7665952266625,322.3204047733375,64723366,42.99344585389836,40.08279126456659,NaN,NaN,NaN,NaN,NaN,NaN,-0.566744740855059,-7.944927049096748,-7.378182308241689,47.52840909090916,25.878102561245118,6222552496,16597108927.730637,11.602796574336312,32.846028681321705,44.8178422613721,0,35.714285714285715
2022-03-10,330.82,332.51,326.71,331.27,359.3608229954107,363.62356468582533,355.037022544235,341.4264043564467,367.94325,375.1117000000002,359.3670000000002,341.77049999999997,341.77049999999997,360.7560381540814,322.78496184591853,69362714,41.095723207663234,40.18516026907324,NaN,NaN,NaN,NaN,NaN,NaN,-0.40004329393680216,-7.878236425662692,-7.47819313172589,40.93769666456885,33.858220704848115,6153189782,16636813101.951326,10.9425200197893,32.6125936758092,45.94737355649995,0,28.571428571428573
2022-03-11,334.32,334.64,323.9,324.4,359.0129541098842,362.84686043462085,353.8355706797552,339.8048420367851,367.89459999999997,374.6292000000002,357.82400000000024,340.069,340.069,358.876161295634,321.261838704366,66228432,37.779209246970126,40.18918061551547,NaN,NaN,NaN,NaN,NaN,NaN,-0.644837217150517,-8.284239653164036,-7.639402436013519,19.320327249842606,35.92881100177353,6086961350,16576751190.621717,10.136733745082612,32.137722229197195,46.8261022952813,57.142857142857146,21.428571428571427
2022-03-14,323.13,326.59,317.45,318.17,358.60655655655205,361.9621701289848,352.4369208491766,337.7443808904246,367.82105,374.0562000000002,356.18040000000013,338.6245,338.6245,359.39711223341874,317.8518877665813,79802606,35.019218387708804,40.11418056494141,NaN,NaN,NaN,NaN,NaN,NaN,-1.0924029451169357,-9.00490611740969,-7.9125031722927535,2.2092666462105757,20.82243018687401,6007158744,16509521424.079048,9.495872528965602,34.567407150579726,47.743785221420694,50,100
2022-03-15,320.88,328.95,319.23,328.15,358.3035062425565,361.29262220563857,351.48449258058145,336.8306303294318,367.79215000000005,373.5879000000002,354.7864000000002,337.6575,337.6575,358.48979884098003,316.82520115902,76470991,42.292259290494925,40.83307062128633,NaN,NaN,NaN,NaN,NaN,NaN,-0.6066258391656945,-8.670785471249872,-8.064159632084177,32.83215710340588,18.120583666486354,6083629735,16573404597.630487,10.4173358800666,31.99792823255917,47.92035282302622,42.857142857142854,92.85714285714286
2022-03-16,332.17,340.44,328.401,340.32,358.1245658819341,360.87732275602195,351.04666934212725,337.1629512504383,367.82965,373.21840000000026,353.5592000000002,336.867,336.867,355.96297454962576,317.7710254503743,105242954,49.6874911312516,41.46121153869221,NaN,NaN,NaN,NaN,NaN,NaN,0.5798305413829947,-7.339371455355433,-7.919201996738428,70.17490027615828,35.07210800859158,6188872689,16676549511.181946,17.36482727248048,29.321914249058377,45.7482266431756,35.714285714285715,85.71428571428571
2022-03-17,338.37,344.5,337.0406,344.44,357.98840104728794,360.55183121629875,350.78758426988696,337.85600351230136,367.88450000000006,372.92180000000025,352.5186000000002,336.28700000000003,336.28700000000003,353.64384084157876,318.9301591584213,67809951,51.93320394889594,41.98956197609214,NaN,NaN,NaN,NaN,NaN,NaN,1.628209368017819,-5.883940286716154,-7.512149654733973,82.81681497391833,61.941290784494164,6256682640,16743268597.753172,19.28584442430053,27.80213217088514,43.79119805766461,28.571428571428573,78.57142857142857
2022-03-18,342.74,351.79,341.55,351.49,357.92374034034975,360.3723890139958,350.8151299847934,339.15447936827263,367.99195,372.6574000000003,351.8626000000002,336.58900000000006,336.58900000000006,354.7639617881262,318.4140382118739,85446347,55.58638309645338,42.728215419125036,NaN,NaN,NaN,NaN,NaN,NaN,2.718360844893299,-4.1141985986173495,-6.8325594435106485,99.1263832265579,84.03936615887817,6342128987,16823708322.85864,22.980034457415073,25.823416288569717,41.33591077065398,100,71.42857142857143
2022-03-21,350.2,352.48,345.575,350.08,357.8456931727841,360.16857933055036,350.7863013579387,340.19500514272283,368.06435,372.36700000000025,351.18380000000025,337.01750000000004,337.01750000000004,356.02152470530757,318.0134752946925,73799072,54.69110659592272,43.61706683743745,NaN,NaN,NaN,NaN,NaN,NaN,3.231453937730329,-2.793242021347737,-6.024695959078066,93.14872966029108,91.69730928692245,6268329915,16846206084.851398,22.34179058820776,24.554355890357648,38.64916159584526,100,64.28571428571429
2022-03-22,350.59,357.85,350.2,356.96,357.8368803053932,360.105043106183,351.0284071870392,341.7916713196064,368.16614999999996,372.13660000000027,350.7258000000002,337.9615,337.9615,358.86373172295237,317.05926827704764,63345928,58.22654424272319,44.46350621973683,NaN,NaN,NaN,NaN,NaN,NaN,3.877644123026476,-1.1776408052949705,-5.055284928321447,97.79702970297019,96.6907141966064,6331675843,16894812698.885386,24.970584650496004,23.17423832388115,35.97385180554745,100,57.142857142857146
2022-03-23,354.01,357.66,351.77,351.83,357.7771103521057,359.94118086645665,351.0598421993122,342.74770262250104,368.24150000000003,371.81270000000023,350.16020000000026,339.082,339.082,360.43046186496775,317.73353813503223,70615457,54.79332905915863,45.271707125676016,NaN,NaN,NaN,NaN,NaN,NaN,3.7980945522916993,-0.3076667379568221,-4.105761290248521,85.09900990099001,92.01492308808376,6261060386,16825635926.917645,23.875086977786744,22.157549107110356,33.54046143805825,92.85714285714286,50
2022-03-24,353.8,359.7,351.5939,359.65,357.7957460699952,359.935414908705,351.39671113267246,344.3574452298819,368.35555,371.54810000000026,349.6368000000002,340.04,340.04,363.1981044129239,316.88189558707614,53555251,58.782944562451995,46.56068871399122,NaN,NaN,NaN,NaN,NaN,NaN,4.085617603018157,1.0012607135241751,-3.084356889493982,99.88165680473371,94.25923213623129,6314615637,16878530499.527296,23.953914992981428,20.80476963201832,30.95120591741136,100,42.857142857142854
2022-03-25,359.59,360.67,354.9438,359.35,357.81121128322906,359.9238225342752,351.70860481374416,345.7853075889407,368.45055,371.26730000000026,349.0768000000002,340.719,340.719,365.26410696656154,316.17389303343845,57584158,58.56939512075875,48.257839793194535,NaN,NaN,NaN,NaN,NaN,NaN,4.060630848917498,1.9914316716528901,-2.0691991772646077,96.94585839888943,93.97550836820437,6257031479,16909566130.21075,23.642594195557177,19.881367695027446,27.859663208413757,100,35.714285714285715
2022-03-28,359.34,365.01,358.07,364.91,357.88184599682876,360.02255872171526,352.2263065857542,347.6067068661845,368.5689,371.02590000000026,348.8218000000002,341.6245,341.6245,368.24831901606103,315.000680983939,56833866,61.370349904012045,50.201471689168805,NaN,NaN,NaN,NaN,NaN,NaN,4.205795361296464,3.188045024355972,-1.0177503369404917,99.78973927670319,98.87241816010878,6313865345,16964762132.637264,25.77232494940932,18.792701525684823,25.029296784658204,100,28.571428571428573
2022-03-29,368.9,371.83,366.06,371.19,358.0142654396464,360.2436961727704,352.96998083729324,349.8527347836907,368.70230000000004,370.80600000000027,348.6454000000002,343.10949999999997,343.10949999999997,372.6869741822239,313.53202581777606,68072955,64.30565829675889,51.72377257794456,NaN,NaN,NaN,NaN,64.30565829675889,NaN,4.4863604870905505,4.590200271922697,0.10383978483214618,98.8230967267378,98.51956480077679,6381938300,17017733981.502083,29.81429605589449,17.749051412292964,23.42744848695751,100,21.428571428571427
2022-03-30,369.275,370.98,365.57,367.09,358.10457125616733,360.3792665455868,353.523707078968,351.4943790900059,368.82645,370.4947000000003,348.57620000000026,344.10299999999995,344.10299999999995,375.44805453815997,312.75794546183994,68757710,61.04438224431762,53.14867679484844,NaN,NaN,NaN,NaN,NaN,NaN,4.164431733246591,5.3093794513903845,1.1449477181437937,91.28356013240159,96.63213204528085,6313180590,16987612766.585262,28.43325317019434,17.33075946563541,21.60652636680451,92.85714285714286,14.285714285714286
2022-03-31,367.24,367.6,361.68,362.54,358.14870487550894,360.4220533466643,353.87728719351827,352.54634298619584,368.93409999999994,370.1341000000003,348.4974000000002,345.11699999999996,345.11699999999996,377.4543611168279,312.779638883172,67011405,57.555870245078154,54.56129543757044,NaN,NaN,NaN,NaN,NaN,NaN,3.443537994114231,5.449370210786583,2.005832216672352,82.91651342405304,91.00772342773081,6246169185,16940070891.416344,27.01374630652142,19.74602641682601,18.999344579410927,85.71428571428571,7.142857142857143
2022-04-01,362.81,363.61,358.59,361.85,358.1855336827178,360.4503295180175,354.189942597694,353.4324055589391,369.01665,369.77200000000033,348.50000000000017,346.3445,346.3445,379.2603845999933,313.42861540000666,54527761,57.02367365446051,56.13304224233842,NaN,NaN,NaN,NaN,NaN,NaN,2.7488588351564722,5.441905760617942,2.69304692546147,81.0266159695818,85.07556317534547,6191641424,16956364047.093636,25.83586729373863,21.568967991963113,15.578062376370848,78.57142857142857,0
2022-04-04,362.71,369.31,362.44,369.3,358.29612538736734,360.6255705176607,354.7824938683727,354.94360502951633,369.15,369.5118000000003,348.8522000000002,348.5665,348.5665,381.3808348401267,315.75216515987336,45950171,61.19576193036477,57.483292430900555,NaN,NaN,NaN,NaN,NaN,NaN,2.620237274760271,5.968343518911809,3.3481062441515377,94.1743995947409,86.03917632945858,6237591595,17002180447.581263,29.134605970341067,20.162045262911054,13.24390879416111,71.42857142857143,0
2022-04-05,367.81,368.54,359.93,361.1,358.3240246372443,360.63496516087537,355.03023920686786,355.5299283600386,369.23369999999994,369.2277000000003,349.0082000000002,350.454,350.454,381.5469782426851,319.3610217573149,62738661,54.880589269158115,57.85422801217959,NaN,NaN,NaN,NaN,NaN,NaN,1.8484337160023303,5.65864838915445,3.81021467315212,69.15727204263379,81.45276253565217,6174852934,16956492711.87046,26.77242064811453,20.69923583148985,12.328335522342172,64.28571428571429,0
2022-04-06,355.65,356.78,350.56,353.26,358.2736363323961,360.48892624679866,354.9608180615005,355.3137447067016,369.26214999999996,368.85440000000034,349.17120000000017,351.3675,351.3675,381.6525298827654,321.0824701172346,90077072,49.60933263089139,57.688237203750695,NaN,NaN,NaN,NaN,NaN,NaN,0.7327167637081038,4.72611062778725,3.993393864079146,38.67239101717302,67.33468755151591,6084775862,16944617599.484608,24.378059515183605,26.798643057068517,11.374331754614499,57.142857142857146,0
2022-04-07,352.24,356.35,348.69,354.1,358.2321076126708,360.36241285577296,354.92706049046126,355.19814997273,369.29395,368.44840000000033,349.36180000000024,352.509,352.509,381.3652359984816,323.65276400151845,63777373,50.16167296384382,57.3007579085643,NaN,NaN,NaN,NaN,NaN,NaN,0.012196597548534527,4.008639611014814,3.99644301346628,32.47000571319762,46.76655625766816,6148553235,16970927847.35406,22.783312756386223,26.642550163126476,11.515899144798457,50,0
2022-04-08,352.32,353.09,348.5,349.15,358.141738382694,360.1403848784309,354.7005090986785,354.62213568961283,369.29024999999996,367.99380000000036,349.5228000000002,353.7465,353.7465,379.6461164257309,327.84688357426916,61956094,46.89930003638558,56.74420029716879,NaN,NaN,NaN,NaN,NaN,NaN,-0.7923830935998608,3.0059641464664537,3.7983472400663145,2.7861123017572984,24.64283634404266,6086597141,16926519230.957544,21.667368001138225,25.5037617321147,11.75982175139653,42.857142857142854,0
2022-04-11,344.81,345.75,340.535,340.89,357.97007929430896,359.75918913826393,354.15892050657345,353.314313242983,369.2473999999999,367.42850000000027,349.3046000000002,354.88250000000005,354.88250000000005,375.99052205323574,333.77447794676436,66107401,41.991543983981344,55.584557421544375,NaN,NaN,NaN,NaN,NaN,NaN,-1.816902735476317,1.5272188207209183,3.3441215561972353,1.1343665122222777,12.130161509059073,6020489740,16869412070.5539,20.04107506255278,30.528938719667792,12.97469052520424,35.714285714285715,100
2022-04-12,345.76,347.69,338.035,339.45,357.78579989834566,359.3570269771102,353.582100094551,351.993902457937,369.1760999999999,366.8467000000003,348.8326000000002,355.4475,355.4475,374.1284741448368,336.7665258551632,72790215,41.18245558674689,54.61235217351497,NaN,NaN,41.18245558674689,NaN,NaN,NaN,-2.4861919088662816,0.23638167011438327,2.722573578980665,4.187009912708878,2.702496242229485,5947699525,16817957568.49538,18.376381518370092,30.143885256968865,14.440521164407793,28.571428571428573,100
2022-04-13,339.8,347.43,339.06,346.35,357.6720108446308,359.0994620864744,353.2984883261372,351.4563879381335,369.13289999999995,366.29270000000025,348.4492000000002,355.749,355.749,373.62076085336696,337.8772391466331,61367755,46.50164928280044,53.735116796397,NaN,NaN,NaN,NaN,NaN,NaN,-2.359838411645177,-0.22722443557580618,2.1326139760693708,24.604231395176825,9.975202606702661,6009067280,16863488483.49538,17.053885179211644,27.97451486919682,15.670301798026847,21.428571428571427,92.85714285714286
2022-04-14,346.44,346.97,338.21,338.43,357.48054805015687,358.6901658075343,352.7154103525632,350.21577956307317,369.0528999999999,365.6371000000002,347.8480000000001,355.4485,355.4485,374.2487524185145,336.6482475814855,73519367,41.825960336771836,52.53915716896937,NaN,NaN,NaN,NaN,NaN,NaN,-2.6818143904500675,-1.2196540119932138,1.4621603784568538,1.1688119544310764,9.98668442077226,5935547913,16793661870.088987,15.77435803062554,26.603645542712094,16.878322657219396,14.285714285714286,85.71428571428571
2022-04-18,337.35,341.04,335.791,338.69,357.2935774227921,358.29412292025637,352.1653942603058,349.1180862713519,368.9734999999999,365.0310000000002,347.55080000000015,354.8085,354.8085,374.9293004562446,334.68769954375534,58560555,42.03202249926993,51.15784806863064,NaN,NaN,NaN,NaN,NaN,NaN,-2.739775198894116,-1.9625586201607916,0.7772165787333246,8.044063375787347,11.272368908465083,5994108468,16799786797.636139,15.045904869977718,27.503284773795585,17.850889444341455,7.142857142857143,100
2022-04-19,338.03,346.85,336.98,346.26,357.18379058276435,358.0558234564889,351.9338101716663,348.84588757884217,368.9115999999999,364.51880000000017,347.3158000000001,354.6175,354.6175,374.98522729098505,334.24977270901496,56515684,47.826643340215135,49.98077557173466,NaN,NaN,NaN,NaN,47.826643340215135,NaN,-2.156466387640519,-1.9183664058173235,0.23809998182319503,29.750774389724025,12.987883239980818,6050624152,16849545793.984669,18.793190879725255,25.151294388742336,17.07244693545427,0,92.85714285714286
2022-04-20,347.09,347.56,339.96,341.21,357.0248473928861,357.72224279398415,351.5132685963069,348.118660190381,368.8166999999999,363.94330000000025,347.0374000000001,353.83000000000004,353.83000000000004,374.9775398096265,332.6824601903736,65500022,44.622093711509386,48.80775496224836,NaN,NaN,NaN,NaN,NaN,NaN,-2.002264108248651,-2.264730153487619,-0.2624660452389679,16.16695008800973,17.98726261784037,5985124130,16805591831.85309,18.16735682294959,23.485820469759673,16.25159917063483,0,85.71428571428571
2022-04-21,345.19,347.87,333.2,334.15,356.79723697106635,357.2554657089548,350.8323561023341,346.78831160082086,368.6826999999999,363.37280000000027,346.5380000000001,352.946,352.946,375.766015249772,330.12598475022804,75801008,40.53319848742265,47.59184983670154,NaN,NaN,NaN,NaN,NaN,NaN,-2.248810967500093,-3.073479754614084,-0.824668787113991,2.630850180005506,16.18285821924642,5909323122,16739608268.652,15.969185818466528,26.219670516380656,16.876884045336134,14.285714285714286,100
2022-04-22,334.31,335.56,324.96,325.4,356.4848266529463,356.62466440778735,349.8350088042033,344.7513295435998,368.51584999999994,362.62990000000025,345.7114000000001,351.23350000000005,351.23350000000005,376.76368157005095,325.70331842994915,82562145,36.116028972139695,46.098446645107195,NaN,NaN,NaN,NaN,NaN,NaN,-2.8363415860600423,-4.370095769689044,-1.5337541836290018,0.9921082299887204,6.596636166001319,5826760977,16663900339.463322,14.595032387467613,30.652653781635063,18.76883345401878,7.142857142857143,100
2022-04-25,323.73,329.9,322.43,329.58,356.2171169350066,356.08912649872224,349.04069473345027,343.3064410156379,368.3586999999999,361.9875000000003,345.1344000000001,349.74500000000006,349.74500000000006,376.6434560895168,322.8465439104833,101755856,39.50749648564305,44.54928482762707,NaN,NaN,NaN,NaN,NaN,NaN,-2.775167903758266,-5.0027140633268345,-2.2275461595685684,15.50639774452391,6.376452051506046,5928516833,16756938156.930525,13.700321676776847,30.84981183225482,20.21838026818292,0,100
2022-04-26,327.47,327.66,316.855,317.14,355.82828990082743,355.31785666706435,347.7896870968444,340.8143990141486,368.1322999999999,361.28770000000026,344.53600000000006,347.35650000000004,347.35650000000004,376.806949419316,317.90605058068405,105819629,33.76284626566587,43.04087461309191,NaN,NaN,NaN,NaN,NaN,NaN,-3.3649301623161763,-6.433708862463789,-3.0687787001476123,0.7138384470882116,5.7374481405336155,5822697204,16656700868.377539,12.315334770064473,32.16011849887604,22.49169071567149,0,100
2022-04-27,317.24,322.88,315,316.76,355.43955069783414,354.55433475286503,346.57283662245834,338.52350386994397,367.9039999999999,360.5562000000002,343.92140000000006,344.63500000000005,344.63500000000005,374.8231556243458,314.4468443756543,111204164,33.602115652213314,41.89750197175777,NaN,NaN,33.602115652213314,NaN,NaN,NaN,-3.5544597636143456,-7.511853404665544,-3.9573936410511985,4.256348246674704,6.82552814609561,5711493040,16595171660.885153,11.537512794590182,31.615720484156473,25.47725123973408,0,100
2022-04-28,321.85,329.89,317.52,328.01,355.1666198451194,354.0287043617192,345.84488224510704,337.52221778709213,367.7286999999999,360.0050000000003,343.3590000000001,342.6810000000001,342.6810000000001,371.844075900865,313.5179240991352,99449957,42.35191415202431,41.339662056627795,NaN,NaN,NaN,NaN,NaN,NaN,-2.7328950712603035,-7.373512480126578,-4.640617408866275,34.15594644263586,13.042044378799593,5810942997,16664392689.969227,15.797858408956836,28.397356945042063,26.955865901947014,0,92.85714285714286
2022-04-29,323.7,327.225,312.6,313.25,354.7495390506406,353.2212052654475,344.5666515688283,335.21057799784523,367.49234999999993,359.27550000000025,342.50320000000005,340.21650000000005,340.21650000000005,370.5570789496475,309.8759210503526,91977859,35.704080009974675,40.54000348331274,NaN,NaN,NaN,NaN,NaN,NaN,-2.974332457763275,-8.358532981070368,-5.3842005233070935,1.8429259994328824,13.418406896247816,5718965138,16580590640.658115,13.996963235852494,28.799759164514256,28.845558272037465,0,100
2022-05-02,312.83,318.72,309.645,318.48,354.3886481148133,352.5332606067258,343.5436456249527,333.61718961709806,367.29674999999986,358.48200000000026,341.96380000000005,338.04800000000006,338.04800000000006,368.09187764586676,308.00412235413336,115511770,39.337593537529074,40.350435594280434,NaN,NaN,NaN,NaN,NaN,NaN,-2.5868882017325463,-8.617810775472776,-6.03092257374023,23.11314584695888,19.704006096342543,5834476908,16689992697.20357,13.053255056070597,29.053417175359137,30.078402538049325,50,100
2022-05-03,318.5,321.17,315.98,318.82,354.03473121814847,351.8656712877807,342.5740908945624,332.20793346308875,367.11749999999984,357.67410000000024,341.51000000000005,335.52400000000006,335.52400000000006,363.01505265354155,308.03294734645857,78185527,39.57665525767459,40.23573557077527,NaN,NaN,NaN,NaN,NaN,NaN,-2.131755918329132,-8.695617471651644,-6.563861553322512,24.00261608894704,16.319562645112935,5912662435,16697374375.089888,14.41491085964874,27.895075079153557,30.62181106063604,42.857142857142854,92.85714285714286
2022-05-04,319.31,330.29,313.891,329.6,353.79159956423655,351.4247669058444,342.0653030163443,331.9595588475565,366.9715499999999,357.0328000000003,341.3404,333.9490000000001,333.9490000000001,358.8894866832954,309.00851331670486,116083395,46.7429117898882,40.252968606995815,NaN,NaN,NaN,NaN,46.7429117898882,NaN,-0.9869417638657509,-7.797538758154701,-6.81059699428895,52.204054937867966,33.10660562459129,6028745830,16803689181.450336,19.336461045045027,24.562723398299298,29.739838706164903,35.714285714285715,85.71428571428571
2022-05-05,325.17,325.25,309.62,313,353.3857130014083,350.6638804324614,340.92548721178173,330.1538865763606,366.7287499999999,356.18270000000024,341.01200000000006,331.9360000000001,331.9360000000001,356.81587893860615,307.05612106139404,154607447,39.06047316942957,40.05543380932851,NaN,NaN,NaN,NaN,NaN,NaN,-1.2149396190828785,-8.329271518142548,-7.114331899059669,8.83660130718953,28.347757444668176,5874138383,16715949702.570618,16.71630904170843,24.130963237359392,29.211132342530533,28.571428571428573,100
2022-05-06,310.95,315.09,305.105,309.25,352.9465516780112,349.8438035922146,339.68331124269224,328.1630402357548,366.45524999999986,355.35260000000034,340.3872,329.6935000000001,329.6935000000001,354.2612734237301,305.1257265762701,139572805,37.55870861074754,39.73591138871977,NaN,NaN,NaN,NaN,NaN,NaN,-1.4686113486545267,-8.950096084877828,-7.481484736223301,9.692505553606882,23.57772059955479,5734565578,16692256572.427904,15.580103016614382,25.564235456865614,28.85316939548466,21.428571428571427,100
2022-05-09,303.48,309.3487,295.72,297.15,352.39136210907577,348.80036193692325,338.0153382527827,325.2094173561591,366.09999999999985,354.4421000000004,339.4148,327.09350000000006,327.09350000000006,353.7888233919312,300.3981766080689,113387342,33.13227104962948,38.68631336796365,NaN,NaN,NaN,NaN,NaN,NaN,-2.2546073045935433,-10.29974386696523,-8.045136562371686,2.7420901246403653,7.09039899514559,5621178236,16602663708.119833,14.164892564994192,29.497168164486716,30.327976209843943,14.285714285714286,100
2022-05-10,304.51,305.76,296.57,300.76,351.87761721246807,347.8490676411426,336.55434459581085,322.8809014174773,365.7613499999999,353.47920000000033,338.4940000000001,325.0870000000001,325.0870000000001,353.32098809944586,296.85301190055435,124124550,35.57190948142889,38.039871637243614,NaN,NaN,NaN,NaN,NaN,NaN,-2.325336361295781,-10.951807013991413,-8.626470652695632,9.664429530201277,7.366341736149508,5745302786,16591723459.4256,13.288360388370446,27.671865438269762,31.924214713239472,7.142857142857143,92.85714285714286
2022-05-11,298.44,304.09,290.95,291.84,351.28022798647334,346.73997719280317,334.8008408861712,319.9246250920032,365.3983999999998,352.52920000000034,337.50100000000015,322.7065000000001,322.7065000000001,353.5983178649232,291.814682135077,140326148,32.42402917758969,37.46064525796983,NaN,NaN,NaN,NaN,NaN,NaN,-2.738377664253118,-12.049442733012029,-9.31106506875891,1.9950683703205248,4.800529341720721,5604976638,16470406485.203377,12.132344387947052,28.9853366392979,33.11639690974299,0,100
2022-05-12,287.45,295.75,284.94,291.15,350.68191726023974,345.63918556522293,333.08904320436056,317.18418460705055,365.02499999999986,351.5916000000004,336.37960000000004,319.9465000000001,319.9465000000001,351.7457693469466,288.14723065305367,120910850,32.186751383108955,37.17998257303906,NaN,NaN,32.186751383108955,NaN,NaN,NaN,-2.8128606540204224,-12.82714088628444,-10.014280232264017,13.693495038588702,8.450997646370167,5484065788,16488414484.139547,11.264170582632007,30.889606876992215,33.907003839588825,0,100
2022-05-13,295.72,302.999,294.0825,301.94,350.1969230586453,344.7738551579908,331.8675120983072,315.7323575016172,364.7022999999998,350.80410000000035,335.57320000000016,318.12200000000007,318.12200000000007,349.6560638675023,286.5879361324978,83684931,39.62703754825047,37.18852122036816,NaN,NaN,NaN,NaN,NaN,NaN,-1.932199471603278,-12.429529571768114,-10.497330100164836,37.4862183020948,17.724927237001342,5567750719,16552221135.112854,15.152001357372752,28.483596673032345,33.33966788277994,50,92.85714285714286
2022-05-16,300.15,302.26,297.13,298.44,349.6819287993553,343.85635307565434,330.5566292709226,314.085466310987,364.3716499999999,349.89640000000037,334.7960000000001,316.1095000000001,316.1095000000001,347.2714039694259,284.9475960305743,59190432,38.16430887515055,37.50291140675993,NaN,NaN,NaN,NaN,NaN,NaN,-1.4065886831992955,-12.255565954163956,-10.84897727096466,29.768467475192928,26.982726938625476,5508560287,16523260514.387709,14.621015480843507,27.485419126092236,32.33484476151661,42.857142857142854,85.71428571428571
2022-05-17,304.45,306.56,300.55,306.17,349.2489742839388,343.1100886583146,329.6002908681413,313.33161237660727,364.0794999999998,349.0186000000004,334.4222000000001,314.1050000000001,314.1050000000001,342.26419707661705,285.9458029233831,62715293,43.15499873198303,38.185260198172045,NaN,NaN,NaN,NaN,43.15499873198303,NaN,-0.4111917245473755,-11.36296692664888,-10.951775202101505,46.813671444321955,38.02278574053656,5571275580,16577836385.001686,16.781892823850235,25.936099642037057,30.542108475228776,35.714285714285715,78.57142857142857
2022-05-18,301.54,302.25,289.85,291.14,348.6707755348449,342.08097799181337,328.0920441674299,311.2181254835971,363.7011499999998,347.9608000000003,333.7780000000001,311.6015000000001,311.6015000000001,338.55353834591546,284.64946165408475,79477109,36.916180982119535,37.79699354317885,NaN,NaN,NaN,NaN,NaN,NaN,-0.6250750884168461,-11.733119062622563,-11.108043974205717,13.671444321940431,30.08452774715177,5491798471,16514895642.229105,14.957020382488842,30.24522991035291,30.92161202636778,28.571428571428573,71.42857142857143
2022-05-19,289.29,294.39,287.58,289.58,348.0828076190753,341.0413546652428,326.5817679255699,309.1573516280164,363.31234999999987,346.8218000000004,332.8698000000001,309.3730000000001,309.3730000000001,335.8654488109285,282.8805511890717,79920709,36.3291291077998,37.841639907309215,NaN,NaN,NaN,NaN,NaN,NaN,-0.7246512072400915,-12.013857983255832,-11.28920677601574,10.23153252480702,23.572216097023134,5411877762,16481918080.953041,14.260187790604018,30.389101554384602,31.03125070688692,21.428571428571427,64.28571428571429
2022-05-20,293.13,293.8,280.21,288.68,347.4917349064477,340.0044961570202,325.0954240853515,307.2071276634434,362.9073999999998,345.69250000000034,332.0180000000001,307.5370000000001,307.5370000000001,334.41884078517916,280.655159214821,91764174,35.973704518615975,37.60136212024399,NaN,NaN,35.973704518615975,NaN,NaN,NaN,-0.7035905298743881,-12.168694938358726,-11.465104408484338,16.91293929712464,13.605305381290696,5320113588,16504538388.745535,12.96233987943936,32.55900466894121,31.391985323008633,14.285714285714286,100
2022-05-23,289.75,293.87,287.29,293.48,346.95430470837357,339.083219005396,323.8556035329848,305.89978217168687,362.5345499999998,344.61180000000036,331.39960000000013,305.7320000000001,305.7320000000001,331.26516165302866,280.1988383469715,63648400,39.38007060771675,37.58732035953272,NaN,NaN,NaN,NaN,NaN,NaN,-0.24265677238920347,-11.768425373970842,-11.525768601581639,26.49760383386587,17.880691885265836,5383761988,16560641841.633074,12.423268172908914,31.083892400782798,32.17987441840086,7.142857142857143,92.85714285714286
2022-05-24,288.125,288.86,282.25,287.24,346.3601325222206,338.05662060924953,322.4196975120834,304.12266006009764,362.12709999999987,343.48070000000035,330.7810000000001,304.2370000000001,304.2370000000001,330.41646836740006,278.0575316326001,73491124,36.650227681308166,36.866414351777,NaN,NaN,NaN,NaN,NaN,NaN,-0.23417594394542718,-11.818488531513424,-11.584312587567997,15.608348134991177,19.67296375532722,5310270864,16598110084.882696,11.468294624038542,32.14437934839887,34.715823334970196,0,85.71428571428571
2022-05-25,285.71,293.39,285.5,291.26,345.8118724971239,337.12995485461096,321.19774859004093,302.89764481627884,361.74919999999986,342.4148000000004,330.0432000000001,302.9620000000001,302.9620000000001,329.0613766975317,276.8626233024685,67144548,39.557142481153726,36.90189073118587,NaN,NaN,NaN,NaN,NaN,NaN,0.14557454011848314,-11.402344412419893,-11.547918952538376,31.68004587155967,24.595332613472234,5377415412,16629001683.011974,13.993719890156095,30.37756709920997,36.056701553777295,0,78.57142857142857
2022-05-26,290.44,300.92,290.15,299.33,345.3493663031227,336.3814408970939,320.340189821804,302.55786911949036,361.4147999999998,341.3913000000004,329.2234000000001,301.5280000000001,301.5280000000001,324.9824209905022,278.07357900949796,59462231,45.01204482022253,37.434271889005515,NaN,NaN,NaN,NaN,NaN,NaN,0.9962522483919951,-10.302603642048382,-11.298855890440377,65.61720323830502,37.635199081618616,5436877643,16670906820.736208,18.17444723795075,28.106569950279482,35.8562981788075,0,71.42857142857143
2022-05-27,302.54,309.25,302.42,309.1,344.9886760911513,335.8412143446762,319.8993980640862,303.1809292033484,361.12264999999985,340.51760000000036,328.5166000000001,301.32050000000004,301.32050000000004,324.4272872929123,278.2137127070878,66985596,50.80104523013422,38.696327187613,NaN,NaN,NaN,NaN,NaN,NaN,2.2037234543725255,-8.54420157247472,-10.747925026847245,99.48347107438025,65.5935733947483,5503863239,16734950150.440454,22.716846298650864,26.166198466376965,33.85205182572006,0,64.28571428571429
2022-05-31,309.07,311.33,304.33,308.28,344.6234156325329,335.2954477239895,319.44373539490635,303.6665549935057,360.81994999999984,339.75750000000045,327.6524000000001,300.81050000000005,300.81050000000005,322.8032365054893,278.8177634945108,60968330,50.322195154895816,39.74991902143206,NaN,NaN,NaN,NaN,NaN,NaN,2.890676485259089,-7.134579420273383,-10.025255905532472,90.19922879177373,85.09996770148634,5442894909,16742788935.726168,23.06564964848108,24.861884540199604,31.611482439692825,100,57.142857142857146
2022-06-01,310.47,312.65,303.73,306,344.2391030391744,334.715339848267,318.91653008530216,303.88878785126707,360.5050499999998,338.9773000000004,326.77080000000007,300.1695000000001,300.1695000000001,320.7256353128403,279.61336468715984,65341653,48.94084415618768,40.92969151990335,NaN,NaN,NaN,NaN,NaN,NaN,3.115605369486932,-6.130749193673807,-9.24635456316074,79.5006165228114,89.72777212965512,5377553256,16710704133.01989,22.536317848748777,23.270076105752764,28.798243426438557,100,50
2022-06-02,304.85,314.56,303.4001,314.38,343.94199753629704,334.3126598512716,318.73862694470205,304.88795091305116,360.24829999999986,338.3225000000004,325.9192000000001,299.40850000000006,299.40850000000006,316.3612287184044,282.45577128159573,59291333,53.94483665856297,42.48384046815006,NaN,NaN,NaN,NaN,53.94483665856297,NaN,3.712350527132756,-4.605916404244795,-8.31826693137755,99.47598253275108,89.72527594911207,5436844589,16768082825.23637,22.10577348034346,21.42208989691727,25.58495146292059,100,42.857142857142854
2022-06-03,309.03,310.47,304.92,306.2,343.5664552722543,333.755973517583,318.2469160841255,305.012907968951,359.9682499999999,337.5834000000003,325.0066000000001,299.06850000000003,299.06850000000003,315.16855375766846,282.9684462423316,60914684,48.9063276283952,43.146646902446115,NaN,NaN,NaN,NaN,NaN,NaN,3.445578843837131,-4.011293376581136,-7.456872220418267,75.66229985443957,84.87963297000069,5375929905,16735265725.20754,20.611512997002965,19.97404364637577,23.51484944005455,92.85714285714286,35.714285714285715
2022-06-06,310.75,312.35,305.62,307.22,343.2047990008886,333.23050869545267,317.8144880023951,305.2231072100033,359.6845499999999,336.7974000000003,323.95800000000014,298.96700000000004,298.96700000000004,314.8329170551155,283.1010829448846,51785013,49.53923123852825,43.9591413569731,NaN,NaN,NaN,NaN,NaN,NaN,3.2308254821667832,-3.4183403677097886,-6.649165849876572,78.63173216885015,84.59000485201359,5427714918,16708103601.003975,20.972088682142438,18.990560353224776,21.686731029775284,85.71428571428571,28.571428571428573
2022-06-07,303.81,310.67,302.6886,309.87,342.8731094585912,332.76792436484965,317.50293945328156,305.66566842809823,359.39524999999986,336.0226000000004,322.96840000000014,299.60300000000007,299.60300000000007,316.1324925511877,283.07350744881245,44900292,51.229508585963536,44.53589206082885,NaN,NaN,NaN,NaN,NaN,NaN,3.1565930100307504,-2.7034245873381337,-5.860017597368884,86.34643377001458,80.21348859776809,5472615210,16744002907.31224,19.731279666777986,20.03998570056728,20.211503167377124,78.57142857142857,21.428571428571427
2022-06-08,309.05,311.72,306.77,307.64,342.5225312550231,332.27034170415953,317.1161575139372,305.8537000063746,359.0672999999999,335.32240000000036,321.82300000000015,299.947,299.947,316.84083686436975,283.05316313563026,38342062,49.720191212198245,45.45046422012019,NaN,NaN,NaN,NaN,NaN,NaN,2.855702984552366,-2.290388866678427,-5.146091851230793,79.85443959243084,81.61086851043184,5434273148,16719138661.045574,19.787572282732118,19.278186963682938,17.88879809889497,71.42857142857143,14.285714285714286
2022-06-09,305.91,309.05,299.23,299.4,342.09345134203784,331.61944384863165,316.4214062388808,305.2390619105294,358.6924499999999,334.5163000000004,320.3872000000002,300.325,300.325,316.80970017925426,283.8402998207457,55900475,44.502785511062854,46.03429682035327,NaN,NaN,NaN,NaN,NaN,NaN,2.0384686637629894,-2.5980060215270555,-4.636474685290045,55.86608442503635,74.02231926249392,5378372673,16665173640.373476,18.30124500489884,23.597544573879915,16.21145068238332,64.28571428571429,7.142857142857143
2022-06-10,293.65,294.87,288.384,288.84,341.5635662540574,330.77232614865875,315.33978246480706,303.677246490479,358.26264999999984,333.6992000000004,318.82220000000024,300.20950000000005,300.20950000000005,316.9796192303388,283.4393807696613,85963456,38.8730065962844,46.24138982590101,NaN,NaN,NaN,NaN,NaN,NaN,0.7877374529539605,-3.651802869097594,-4.439540322051554,20.396162178891906,52.038895398786366,5292409217,16591297552.83971,16.77867677138318,29.825443781186596,15.136127874013328,57.142857142857146,0
2022-06-13,279.75,282.34,274.53,275.41,340.9053218137185,329.6760424625467,313.7739086426578,300.98512777710005,357.7775999999999,332.7885000000004,317.0796000000002,298.88300000000004,298.88300000000004,318.7978839815798,278.9681160184203,94442009,33.132444692531166,45.79513083195918,NaN,NaN,33.132444692531166,NaN,NaN,NaN,-0.8540879216379622,-5.507150224099007,-4.653062302461045,2.1983512365726994,26.153532613500317,5197967208,16518138250.093233,15.029473480407852,36.80904476119176,15.073509043542819,50,100
2022-06-14,277.66,278.66,273.3375,275.91,340.2586021936815,328.6113683543775,312.2890494802006,298.59702036975716,357.27694999999983,331.93040000000036,315.3608000000002,297.7565000000001,297.7565000000001,320.0508735278589,275.4621264721412,64697521,33.526027915665935,45.57197370584188,NaN,NaN,NaN,NaN,NaN,NaN,-1.764049646094401,-6.858124360079046,-5.094074713984645,6.24052398568754,9.611679133717383,5262664729,16515980653.103567,14.427024775218515,36.231661431331716,14.761638685991995,42.857142857142854,100
2022-06-15,279.415,286.83,276.61,282.8,339.68687480866976,327.7042125453799,311.13261616725157,297.0925422393041,356.7896499999998,331.2415000000004,313.63080000000025,296.588,296.588,319.4388097011858,273.73719029881426,86051428,38.865987100173676,45.52260546434331,NaN,NaN,NaN,NaN,NaN,NaN,-1.7557762181956562,-7.288794986729215,-5.533018768533559,22.954697070774525,10.46452409767826,5348716157,16534167647.671082,19.340365596699915,33.28383866453394,14.01677268937237,35.714285714285715,92.85714285714286
2022-06-16,275.59,276.06,269.28,271.39,339.0073039150511,326.5890796236892,309.5740821999084,294.6446810736561,356.2468499999998,330.42240000000044,311.8366000000002,295.6005,295.6005,320.88509173093104,270.315908269069,81910297,33.995632927545955,44.73571890058069,NaN,NaN,NaN,NaN,NaN,NaN,-2.336265971438303,-8.453351232831437,-6.117085261393134,4.659893992932889,11.285038349798322,5266805860,16503239865.91297,17.447636491970332,35.332345244625174,14.904267969833189,28.571428571428573,100
2022-06-17,272.18,277.19,270.5119,274.69,338.36733074176703,325.56137507668547,308.20607897638257,292.74423525711745,355.7173999999998,329.7182000000004,310.2652000000002,294.85600000000005,294.85600000000005,321.6383444828819,268.0736555171182,82703402,36.47504211824332,43.712432964017054,NaN,NaN,NaN,NaN,NaN,NaN,-2.311268190818505,-9.006170499916266,-6.694902309097761,11.947879858657291,13.187490307454908,5349509262,16524021911.53915,17.42157662706004,33.58403858854425,16.663644857704753,21.428571428571427,92.85714285714286
2022-06-21,278.75,283.45,278.64,281.08,337.79730755030664,324.6805557682363,307.14231117338716,291.63335570882055,355.2207999999999,329.08330000000046,308.8048000000002,294.476,294.476,321.8080949800763,267.1439050199237,51633741,41.08968879359414,43.052968223924076,NaN,NaN,NaN,NaN,NaN,NaN,-1.7056085502585994,-8.82691299692101,-7.1213044466624105,26.0600706713781,14.222614840989431,5401143003,16524773338.12335,20.952186972123958,31.389867446662382,17.82032165347581,14.285714285714286,85.71428571428571
2022-06-22,278.52,285.18,277.91,280.67,337.2288766294081,323.8090596144098,306.1041813234504,290.5892265936948,354.7162999999999,328.4790000000004,307.4352000000002,293.8355,293.8355,321.82344703081674,265.8475529691833,67472924,40.88446859294309,42.477512826549464,NaN,NaN,NaN,NaN,NaN,NaN,-1.1978236714060104,-8.618584035919923,-7.420760364513913,25.15459363957605,21.054181389870486,5333670079,16508531575.124725,21.109104622054637,29.658076188109682,18.908728417870385,7.142857142857143,78.57142857142857
2022-06-23,283.21,285.72,280.31,284.85,336.7076937773742,323.0375930873918,305.27068401664843,290.04263358477147,354.22999999999985,327.8095000000004,306.31440000000015,293.716,293.716,321.8356688458421,265.5963311541579,57457796,43.95759972359522,41.764138759766055,NaN,NaN,NaN,NaN,NaN,NaN,-0.4823505601014837,-8.023698564640767,-7.541348004539284,36.15045275133511,29.121705687429756,5391127875,16547509414.555408,20.637947865658557,28.402314217547836,19.92743956164259,0,71.42857142857143
2022-06-24,287.74,295.04,287.5001,294.61,336.2888112522262,322.47467045199795,304.85261797677987,290.47762086241227,353.7991499999999,327.1251000000004,305.4176000000002,293.8835,293.8835,321.9825571194082,265.7844428805918,58422262,50.436478694580764,41.873435264493594,NaN,NaN,NaN,NaN,50.436478694580764,NaN,0.6829931675548977,-6.687606545095662,-7.370599712650559,58.81123752031579,40.03876130374232,5449550137,16599268041.053612,26.23969554096218,26.155872458915546,19.826675342063165,7.142857142857143,64.28571428571429
2022-06-27,296,296.5799,291.29,292.45,335.8526041750896,321.8801225222554,304.3662408012199,290.6654664945635,353.36404999999985,326.39440000000036,304.3396000000002,293.53950000000003,293.53950000000003,321.53167353118204,265.547326468818,54151452,49.08405675966205,41.84092280171744,NaN,NaN,NaN,NaN,NaN,NaN,1.3069546059647452,-5.736906455194628,-7.043861061159373,54.594721960414674,49.85213741068853,5395398685,16568865878.953232,26.361248375712815,25.048286553831485,19.654923611454514,0,57.142857142857146
2022-06-28,293,295.65,283.35,283.54,335.33208075046184,321.12091217528007,303.54952547568183,289.9868506379384,352.8987999999998,325.5449000000004,303.24180000000024,292.2615,292.2615,319.62207037051326,264.90092962948677,61867060,43.859604173347904,41.314501057959184,NaN,NaN,NaN,NaN,NaN,NaN,1.1251309794579907,-5.637447336836885,-6.762578316294876,33.60037700282759,49.00211216118603,5333531625,16508910159.018272,23.834002363021924,28.835578328818627,20.27777604771037,7.142857142857143,50
2022-06-29,283.4,285.34,280.84,283.8,334.8193237280692,320.38188421141314,302.77503428055707,289.39762676765855,352.43614999999977,324.8474000000004,302.14400000000023,291.0375,291.0375,317.6008024114069,264.47419758859314,57302726,44.04676109827626,40.9092560498219,NaN,NaN,NaN,NaN,NaN,NaN,1.0304319559782913,-5.474538371322012,-6.5049703273003034,36.509932109630434,41.56834369095757,5390834351,16526992352.556051,22.966504269655715,29.816207024623697,21.111579867432145,0,42.857142857142854
2022-06-30,280.75,283.9441,275.78,280.28,334.27664388997897,319.58778749435544,301.8928760734764,288.5292813612149,351.9612499999998,324.07010000000037,300.82440000000025,289.7515,289.7515,315.77770469833814,263.7252953016619,79313580,42.00508745348608,40.73084904570926,NaN,NaN,42.00508745348608,NaN,NaN,NaN,0.7517258929920709,-5.565312961060215,-6.317038854052286,40.29318788713506,36.801165666531034,5311520771,16535113054.350737,21.441709335209456,31.95154067790935,21.614660006862568,0,35.714285714285715
2022-07-01,278.95,282.53,277.03,282.13,333.75777181147174,318.8460491281306,301.1178613254969,287.9198259934801,351.4816499999998,323.3401000000004,299.64280000000025,288.139,288.139,311.74551511764923,264.5324848823508,56675107,43.48770467115821,41.06047033677168,NaN,NaN,NaN,NaN,NaN,NaN,0.7132855341457462,-5.425431936370103,-6.138717470515849,47.06976948633513,41.290963161033545,5368195878,16583544509.423464,20.456373568551133,30.483234427806234,21.02101297388404,71.42857142857143,28.571428571428573
2022-07-05,278.31,287.08,276.7501,286.96,333.2921223407108,318.2146422147022,300.5626510774382,287.8284139941011,351.02489999999983,322.6185000000003,298.6990000000002,287.177,287.177,309.2813851757925,265.07261482420756,61829272,47.27733283732372,42.07081948997114,NaN,NaN,NaN,NaN,NaN,NaN,1.016005087226068,-4.868711111483265,-5.884716198709333,64.76214198586801,50.708366453112745,5430025150,16643937269.426252,22.46260352605246,27.890821052234354,18.79001099254214,64.28571428571429,21.428571428571427
2022-07-06,287.35,290.95,285.59,288.8,332.8494146557286,317.6321740520348,300.1013706430289,287.9209459946629,350.59974999999986,321.8392000000003,297.9670000000002,286.25600000000003,286.25600000000003,306.39038193736786,266.1216180626322,63194715,48.68895949014006,43.15388603100501,NaN,NaN,NaN,NaN,NaN,NaN,1.3235575086180278,-4.230269312936798,-5.553826821554826,71.50209341426164,61.111334962154935,5493219865,16656434731.72103,24.719072710456924,26.625517795905935,15.980781933984625,57.142857142857146,14.285714285714286
2022-07-07,289.63,295.7,289.63,294.98,332.4726045596517,317.18361615001436,299.90053257859637,288.593236852314,350.24614999999983,321.20470000000034,297.2750000000002,285.51150000000007,285.51150000000007,303.0293095377174,267.99369046228276,56620114,53.21943013331206,44.17913196194346,NaN,NaN,NaN,NaN,NaN,NaN,1.8919686777822369,-3.1888659743270296,-5.080834652109266,94.13953897267027,76.80125812426665,5549839979,16699622726.419548,27.329809575295343,25.05004529775046,14.39907171850457,50,7.142857142857143
2022-07-08,292.08,296.75,291.12,295.35,332.1032254098044,316.7512673153606,299.7220803206122,289.23673810447457,349.89214999999984,320.6876000000004,296.83920000000023,284.89700000000005,284.89700000000005,299.9564928201362,269.8375071798639,59895478,53.48423781114523,45.57117516791484,NaN,NaN,NaN,NaN,53.48423781114523,NaN,2.218991197530607,-2.307095655196008,-4.526086852726615,94.6642477923326,86.76862672642152,5609735457,16729730044.845837,26.900817698802637,23.811956397308983,12.413749748361766,100,0
2022-07-11,292.88,293.11,288.14,289.04,331.6747356047317,316.2025293487198,299.30317520999995,289.21800114214363,349.48949999999985,320.1031000000003,296.28480000000025,284.3790000000001,284.3790000000001,298.05673797086706,270.7012620291331,55273920,48.44750619021758,46.42635117305586,NaN,NaN,NaN,NaN,NaN,NaN,1.9462134033391472,-2.093320098552681,-4.039533501891828,63.23319027181703,84.01232567893997,5554461537,16694474848.387085,25.184165061833546,24.92995004642637,10.186582553714855,92.85714285714286,0
2022-07-12,290.32,292.28,284.61,286.24,331.2226486832916,315.6092119358739,298.79089382921563,288.934381985749,349.0557999999998,319.40420000000034,295.44940000000025,284.24900000000014,284.24900000000014,297.80353710016124,270.69446289983904,55797088,46.36114034537666,46.80288342675461,NaN,NaN,NaN,NaN,NaN,NaN,1.53135604112405,-2.1253384504867654,-3.6566944916108155,49.88078206962338,69.25940671125768,5498664449,16662393341.466616,23.46844643104109,26.36698565000778,9.177649157379667,85.71428571428571,50
2022-07-13,280.6,288.05,280.02,285.65,330.7691894924131,315.01596021437143,298.27556465944247,288.62158370139196,348.61739999999986,318.70030000000037,294.89740000000023,284.7610000000001,284.7610000000001,297.7010106645905,271.82098933540965,73939418,45.91246898429105,47.16202631185089,NaN,NaN,45.91246898429105,NaN,NaN,NaN,1.1867402335147585,-2.1732691997173674,-3.360009433232126,47.067238912732435,53.393737084724286,5424725031,16692134850.824024,21.794397161807684,28.56355658146446,8.934972200555414,78.57142857142857,42.857142857142854
2022-07-14,282.99,287.56,279.8,286.67,330.3303915870159,314.4546540715126,297.8204444767192,288.4357185869737,348.19899999999984,318.11250000000035,294.26120000000026,285.2990000000001,285.2990000000001,297.6013134409615,272.99668655903866,63741837,46.86977056117433,47.37003851453512,NaN,NaN,NaN,NaN,NaN,NaN,1.0042574193142775,-2.1046876590892794,-3.108945078403557,51.93133047210314,49.62645048481966,5488466868,16741255493.254436,20.288276039809976,26.78556544993394,8.789950693584553,71.42857142857143,35.714285714285715
2022-07-15,289.73,291.98,288.08,291.87,329.9477011234635,314.0074331988094,297.58709371292633,288.7627930072619,347.85899999999987,317.61610000000036,293.7222000000002,285.7525000000001,285.7525000000001,298.3187593877277,273.1862406122725,63818149,51.57527942340792,47.45138142373706,NaN,NaN,NaN,NaN,NaN,NaN,1.1974314039621214,-1.6121558234509052,-2.8095872274130267,76.72865999046262,58.5757431250994,5552285017,16801473644.105719,23.338717096312084,25.487604743650984,9.092886635233546,64.28571428571429,28.571428571428573
2022-07-18,294.72,296.16,288.2,289.4,329.5442414107922,313.52015729388245,297.2660312143802,288.8234793875227,347.50959999999986,317.12930000000034,292.91820000000024,286.65300000000013,286.65300000000013,297.4266643719561,275.87933562804415,59519581,49.339948189804396,47.46965938303294,NaN,NaN,NaN,NaN,NaN,NaN,1.1237226230999062,-1.4049339485381438,-2.52865657163805,64.94992846924171,64.53663964393583,5492765436,16759899665.417276,25.455356647716147,23.638411709832766,9.174818199908712,57.142857142857146,21.428571428571427
2022-07-19,293.11,298.6,291.47,298.3,329.2333534365555,313.21876804053824,297.3065790098947,289.7260051601396,347.2112999999998,316.81810000000036,292.62420000000026,287.8335000000001,287.8335000000001,298.27406372997865,277.3929362700215,55172640,56.63340416945523,48.38207366846918,NaN,NaN,NaN,NaN,NaN,NaN,1.6096464777281065,-0.5165984744779166,-2.126244952206023,98.68536371603851,80.12131739191429,5547938076,16810429446.511246,25.543680417005298,21.680546069637014,9.080837491102232,100,14.285714285714286
2022-07-20,298.73,304.24,297.9329,303.03,328.9726235516146,313.0170102575573,297.5310268918596,290.99305228774534,346.92554999999976,316.44350000000037,292.4998000000002,288.9310000000001,288.9310000000001,300.81595334444773,277.04604665555246,67769430,59.934752738646125,49.516930214209886,NaN,NaN,NaN,NaN,NaN,NaN,2.151075926944839,0.5625999564750259,-1.5884759704698133,95.74841883345033,86.46123700624354,5615707506,16852196114.449442,29.224759820021823,20.431193804452665,9.418824289941734,100,7.142857142857143
2022-07-21,303.5,307.435,300.78,307.38,328.7577715759767,312.9053862920611,297.9172611313945,292.55371397462676,346.6993499999998,316.05960000000033,292.70440000000025,290.26650000000006,290.26650000000006,303.9975659090891,276.53543409091105,55049363,62.7437299824863,50.99826182342419,NaN,NaN,NaN,NaN,62.7437299824863,NaN,2.669759131723741,1.7487229441848626,-0.9210361875388781,99.82075874452904,98.08484709800598,5670756869,16906335570.622995,30.379185177292577,19.175552470538417,9.627737173234587,100,0
2022-07-22,306.43,308.55,300.115,301.99,328.49142559014604,312.689240028852,298.07697638114377,293.4524078818052,346.4223999999998,315.6115000000003,292.7290000000002,291.12350000000004,291.12350000000004,305.51880378282465,276.7281962171754,57127715,57.37595262016863,51.99027953406779,NaN,NaN,NaN,NaN,NaN,NaN,2.5193262337971905,2.22812160470761,-0.29120462908958034,79.37100431133433,91.64672729643792,5613629154,16874605476.39952,29.051061822711187,17.69147171624028,9.957640716034268,100,7.142857142857143
2022-07-25,302.02,302.5,298.22,300.27,328.21061538526897,312.4433144837262,298.1629773073734,294.10170236925234,346.1253999999998,315.19930000000033,292.89760000000024,291.40650000000005,291.40650000000005,306.2794610703363,276.5335389296638,40582381,55.73727230141521,52.594560924360046,NaN,NaN,NaN,NaN,NaN,NaN,2.185859038832407,2.4411191694509284,0.2552601306185215,71.1999999999999,83.4639210186211,5573046773,16872898740.749987,27.872300626410578,18.770139960016518,10.58153540539084,92.85714285714286,0
2022-07-26,298.53,298.79,293.54,294.37,327.873892844122,312.0854270682069,298.0142330992411,294.12725452456164,345.78239999999977,314.6708000000003,292.9620000000003,291.5025000000001,291.5025000000001,306.4258640644327,276.57913593556754,50074122,50.41793388574471,52.71805909547466,NaN,NaN,50.41793388574471,NaN,NaN,NaN,1.4834105441750145,2.1095233108372895,0.6261127666622751,50.67826086956519,67.08308839363315,5522972651,16838657579.229986,26.080322298874275,22.034218221113203,10.916983752746374,85.71428571428571,42.857142857142854
2022-07-27,299.04,308.54,298.46,306.81,327.6643018705486,311.98096316586617,298.359165134565,295.33513504603195,345.5106499999998,314.31630000000035,293.05940000000027,292.66600000000005,292.66600000000005,308.5239789380532,276.80802106194693,69304364,59.24883448358114,53.14873083477959,NaN,NaN,NaN,NaN,NaN,NaN,1.7535501917796514,2.8180505063868395,1.064500314607188,93.9478260869565,71.94202898550719,5592277015,16884172945.269669,31.516586521733537,19.230750060166663,12.335372814237838,78.57142857142857,35.714285714285715
2022-07-28,306.59,310.3965,302.745,309.81,327.486647125568,311.93797379624505,298.8082174822291,296.71369361307654,345.2677499999998,314.0414000000003,293.2868000000002,293.96650000000005,293.96650000000005,310.93035719698526,277.00264280301485,55139941,61.05047484001531,53.68917633684174,NaN,NaN,NaN,NaN,NaN,NaN,2.0126926360461304,3.580366109664851,1.5676734736187208,98.083114081676,80.90306701273256,5647416956,16930859752.793488,31.01689734790563,17.905931748250488,13.81454319301514,100,28.571428571428573
2022-07-29,311.385,316.39,309.931,315.46,327.36697899496534,312.0077168893887,299.46122856135736,298.4990561261169,345.05934999999977,313.94740000000036,293.4726000000002,295.72550000000007,295.72550000000007,313.90037768871304,277.5506223112871,57501043,64.25562005791494,54.81832732739155,NaN,NaN,NaN,NaN,NaN,NaN,2.4158870466438467,4.587532281923529,2.1716452352796827,97.45832194588684,96.49642070483976,5704917999,16971802204.683409,34.61952662265585,16.832039203614727,16.2476897295952,100,21.428571428571427
2022-08-01,313.65,318.81,312.53,315.27,327.24661104476667,312.07231655494536,300.0811803824806,300.09628887601053,344.8356999999998,313.86660000000035,293.9552000000002,297.38250000000005,297.38250000000005,316.32381872388333,278.44118127611677,46358833,64.0646988518279,56.082867220709495,NaN,NaN,NaN,NaN,NaN,NaN,2.510032869778764,5.3091863225031375,2.7991534527243735,90.92540374263005,95.4889465900643,5658559166,16965896620.861753,34.84687493064351,15.854710503093344,18.50786810919965,100,14.285714285714286
2022-08-02,312.92,318.545,311.8401,314.33,327.1180875517839,312.11702315781775,300.63995762238335,301.45188041162857,344.5741999999998,313.66000000000037,294.4502000000002,298.75100000000003,298.75100000000003,318.42332157117613,279.07867842882393,48676501,63.066310713561805,57.30814162994312,NaN,NaN,NaN,NaN,NaN,NaN,2.3519536254398377,5.739095484524171,3.387141859084333,88.51576518841318,92.29983029231003,5609882665,16953372670.933327,32.6660637339032,15.50642401548602,20.09209373183912,92.85714285714286,7.142857142857143
2022-08-03,316.05,323.7291,315.99,322.89,327.0760170288806,312.33034943192035,301.5125083038585,303.49360608671157,344.3439499999997,313.57620000000037,295.1344000000002,300.4555,300.4555,322.183655444029,278.72734455597094,53735729,67.96261381254249,58.81477329075513,NaN,NaN,NaN,NaN,NaN,NaN,2.644978598625782,6.69336510736656,4.048386508740778,97.64622388784,92.36246427296108,5663618394,16995455972.595806,34.60739653161783,14.167865656832795,22.099464602858223,100,0
2022-08-04,322.97,324.72,320.77,324.4,327.04938999376736,312.5693524134665,302.4100569978248,305.48469122131047,344.10269999999974,313.57620000000037,295.7528000000002,301.9265,301.9265,325.8457176084413,278.00728239155865,38973659,68.74963878126442,60.041513244887746,NaN,NaN,NaN,NaN,68.74963878126442,NaN,2.7494431315552204,7.485190423184804,4.7357472916295835,99.12376779846646,95.09525229157322,5702592053,17028114912.162893,34.24940365730936,13.635166972286777,24.8600908427967,100,0
2022-08-05,319.19,323.83,318.39,321.75,326.99665974507315,312.75114741518,303.16848613516504,307.0337682478523,343.83409999999975,313.6120000000003,296.4430000000002,303.24649999999997,303.24649999999997,328.44776050418733,278.0452394958126,53893972,65.69931536731906,61.21003947185308,NaN,NaN,NaN,NaN,NaN,NaN,2.4584974115855482,7.808869056111519,5.35037164452597,91.06766917293226,95.94588695307958,5648698081,17040795846.75113,32.26180835769708,15.142022491765436,27.17536258180588,92.85714285714286,0
2022-08-08,322.69,326.47,319.21,320.71,326.93410591676394,312.90874845646357,303.85638863966835,308.3362665099616,343.5627499999998,313.53760000000034,297.0320000000002,304.83,304.83,330.24069617306674,279.41930382693323,44066297,64.48999884748427,61.77122480599801,NaN,NaN,NaN,NaN,NaN,NaN,2.032111086716629,7.890510502921757,5.858399416205128,82.50835104767675,90.89992933969182,5604631784,17014938763.387493,32.54974078430406,14.079111205997663,29.42047764125957,100,0
2022-08-09,318.77,319.03,315.42,317.08,326.836055111622,312.9913474969296,304.37496163419115,309.1690030328224,343.26179999999977,313.30520000000035,297.38700000000017,306.37199999999996,306.37199999999996,330.807369937857,281.9366300621429,39764220,60.31674315709041,61.79850983588689,NaN,NaN,60.31674315709041,NaN,NaN,NaN,1.3732657488288762,7.574981602241223,6.201715853412347,71.48496811418147,81.68699611159683,5564867564,17011744407.764225,30.850410440293814,17.084443989602377,30.206840972754467,92.85714285714286,28.571428571428573
2022-08-10,324.59,326.23,322.0601,325.93,326.8270396378745,313.2475584375845,305.22025725637974,310.7652884582679,343.02094999999974,313.1201000000004,297.7236000000002,308.38599999999997,308.38599999999997,332.2917594733973,284.48024052660264,51459564,66.07990724882615,62.036808212054034,NaN,NaN,NaN,NaN,NaN,NaN,1.3965718603824753,7.947430678890441,6.550858818507966,98.36015791071965,84.11782569085929,5616327128,17055799540.386974,35.090252341041314,15.570267631162327,31.344152362721474,85.71428571428571,21.428571428571427
2022-08-11,328.305,330.36,323.36,324.08,326.7997059101345,313.4620622308996,305.9598550110315,312.03335622414716,342.75169999999974,312.84600000000034,298.0396000000002,310.2565,310.2565,332.8934973936442,287.6195026063558,45897650,63.98789304627537,62.50908967106165,NaN,NaN,NaN,NaN,NaN,NaN,1.1601834674808593,8.00108815285904,6.840904685378181,82.94405214557297,84.26305939015803,5570429478,17019343692.672688,36.7173166892076,14.510706998594141,32.70458725084534,100,14.285714285714286
2022-08-12,326.175,330.585,325.1001,330.39,326.8354302294366,313.79726891939663,306.9178999125597,313.7816080123236,342.5080499999997,312.6491000000003,298.52740000000017,312.1825,312.1825,334.78901753366347,289.57598246633654,40928379,67.73943252163683,63.36638682964891,NaN,NaN,NaN,NaN,NaN,NaN,1.291523304423296,8.455308815907301,7.163785511484005,99.47361317316778,93.59260774315347,5611357857,17057361887.74773,34.59674690228432,13.585499205830267,34.42552310302118,100,7.142857142857143
2022-08-15,329.42,333.5652,329.4,333.06,326.89736624705415,314.1787091388145,307.94308030814557,315.61764534448326,342.2733499999997,312.41010000000034,298.9010000000002,314.3655,314.3655,336.1682112763498,292.5627887236502,38266614,69.20146697102406,64.70806776431172,NaN,NaN,NaN,NaN,69.20146697102406,NaN,1.4112230813155993,8.927814363128505,7.5165912818129055,98.56089696113396,93.65952075995823,5649624471,17086345733.384722,36.15303433067599,13.013345252064187,37.186575426707066,100,0
2022-08-16,332.055,334.4209,329.16,332.28,326.95092479185956,314.5371505420063,308.8974693156693,317.2045362640563,342.0136499999997,312.21460000000036,299.42260000000016,316.06449999999995,316.06449999999995,337.8905765828408,294.2384234171591,41186864,68.22867370166874,65.349484851318,NaN,NaN,NaN,NaN,NaN,NaN,1.2939648309403777,9.134047320488378,7.840082489548,93.24123387180776,97.09191466870315,5608437607,17094010972.895527,35.075478921366795,12.308258152325873,38.889345532141974,100,0
2022-08-17,329.07,331.43,326.36,328.49,326.9662389730351,314.81344459067947,309.6658038523097,318.2793423341462,341.7255499999997,311.90300000000036,299.8480000000002,317.3375,317.3375,338.94292698027243,295.7320730197275,47842155,63.55373795970519,65.52828935986726,NaN,NaN,NaN,NaN,NaN,NaN,0.8392923752753827,8.889197958642228,8.049905583366845,75.78226125872298,89.19479736388821,5560595452,17086367551.682508,32.91432773601469,14.464083411105848,39.75670435433903,92.85714285714286,0
2022-08-18,328.44,330.49,326.79,329.28,326.98926147081585,315.0999110344284,310.43498801496423,319.32702401660845,341.43479999999977,311.6023000000004,300.2362000000002,318.43249999999995,318.43249999999995,340.1279528645994,296.7370471354005,41937172,64.10582212623783,65.51758950760461,NaN,NaN,NaN,NaN,NaN,NaN,0.4873418971610288,8.659082954818132,8.171741057657103,77.23331325728033,82.08560279593702,5602532624,17100875546.320345,31.60368604280379,13.888126614275006,40.068917139580726,85.71428571428571,0
2022-08-19,326.17,326.84,322.08,322.86,326.94817429200174,315.25357616245947,310.9222433869264,319.6634979197886,341.10384999999974,311.18180000000046,300.5406000000002,319.47599999999994,319.47599999999994,339.8766494014293,299.0753505985706,51770570,56.60208901607098,64.98454594790769,NaN,NaN,NaN,NaN,NaN,NaN,-0.24301071673478525,7.867977661738621,8.110988378473406,48.802079642882454,67.27255138629523,5550762054,17066071801.78253,29.16955347615225,17.85688194501897,39.111578885786734,78.57142857142857,7.142857142857143
2022-08-22,318.5,318.74,313.53,314.36,326.8229188264097,315.235881584985,311.0570573717528,319.1584028798087,340.7097499999997,310.61350000000044,300.8398000000002,320.18049999999994,320.18049999999994,338.77248265382383,301.58851734617605,51098890,48.506500442462915,63.94455949997206,NaN,NaN,NaN,NaN,NaN,NaN,-1.3044390377611865,6.4804395812719235,7.78487861903311,3.973021746310782,43.33613821549118,5499663164,17031253940.074278,26.338598391111645,25.017647340645905,36.75092806797091,71.42857142857143,0
2022-08-23,314.12,317,313.33,314.1,326.69632261918173,315.2133888803318,311.1763884552135,318.67665022458885,340.2891499999997,310.08360000000044,301.3450000000002,321.167,321.167,335.8614616777889,306.47253832221105,39497074,48.279035923167086,62.538589650730955,NaN,NaN,NaN,NaN,NaN,NaN,-1.9889067412139312,5.298745192515696,7.287651933729627,3.6508636426138166,18.808655010602333,5460166090,17008330570.150574,25.298516909612506,24.244926923457598,33.909575980408405,64.28571428571429,100
2022-08-24,313.61,316.87,312.99,315.01,326.5800408020754,315.209361377751,311.3267261628522,318.3274454412947,339.87119999999976,309.60830000000044,302.13700000000017,321.57699999999994,321.57699999999994,335.05334386620177,308.1006561337981,38057059,49.17734095379764,61.140568377340465,NaN,NaN,NaN,NaN,NaN,NaN,-2.3220221170236357,4.385124287450083,6.707146404473718,9.425642413524308,5.683175934149612,5498223149,17009899933.408306,24.21003679859363,23.578805149104983,30.928934898410354,57.142857142857146,100
2022-08-25,316.83,320.6,315.7577,320.58,326.5203389035473,315.3157106573995,311.6895996466619,318.54197444688566,339.48379999999975,309.19560000000035,303.0304000000002,322.1155,322.1155,334.4831294818312,309.7478705181688,38098255,54.39815387512521,60.333342556469475,NaN,NaN,NaN,NaN,NaN,NaN,-2.114771530753546,4.063681991031785,6.178453521785332,35.41615144487619,16.16421916700475,5536321404,17047683476.349987,26.87064037010025,22.103279010279564,29.04462898662127,50,92.85714285714286
2022-08-26,320.28,321.51,307.35,307.44,326.3304847851041,315.1597559909163,311.52294868012615,317.48464354718226,339.0443999999997,308.5770000000004,303.5232000000002,321.71449999999993,321.71449999999993,335.3720978488202,308.05690215117966,69047740,43.13961840741584,58.808315382178876,NaN,NaN,NaN,NaN,NaN,NaN,-2.7689029442134503,2.7173248415185185,5.486227785731969,0.33246031716705027,15.058084725189161,5467273664,16979513461.858461,22.952413318992935,27.538378346607768,26.86396872458608,42.857142857142854,100
2022-08-29,304.62,307.22,303.28,304.41,326.11237050863537,314.94688953565066,311.24400951619964,316.23943939983155,338.6188999999997,308.01010000000036,304.1836000000002,321.1714999999999,321.1714999999999,336.5641414562322,305.7788585437676,48321851,41.030797752144046,57.43074785325414,NaN,NaN,NaN,NaN,NaN,NaN,-3.2771337866692756,1.3898105523953745,4.66694433906465,3.6286684071431803,13.125760056395473,5418951813,16958909220.82293,21.940211412790614,30.638528674241005,25.994350041646364,35.714285714285715,100
2022-08-30,306.1,306.73,298.44,301.02,325.8626951801912,314.6711095448457,310.84306796654477,314.7899689808,338.17104999999975,307.48770000000036,304.7102000000002,320.506,320.506,338.02790674555564,302.9840932544443,51184500,38.7485610764237,55.478508840939675,NaN,NaN,NaN,NaN,NaN,NaN,-3.68277978538892,0.06346960732849993,3.74624939271742,7.1704709998915614,3.7105332414005967,5367767313,16939583830.593737,20.043272644833394,33.03735202006783,24.9907022950132,28.571428571428573,100
2022-08-31,303.99,304.91,299.16,299.27,325.59809124805,314.36613707861113,310.3892221639352,313.3118766969143,337.6938999999997,306.9394000000004,305.0740000000002,319.32499999999993,319.32499999999993,339.0859468396655,299.56405316033437,50044041,37.586300946887555,53.59268083384054,NaN,NaN,NaN,NaN,NaN,NaN,-3.8898081891605356,-1.1160108437332497,2.773797345427286,2.3067794301976425,4.368639612410795,5317723272,16891454518.118954,18.827366433327867,31.033172251388695,23.642940390716344,21.428571428571427,92.85714285714286
2022-09-01,296.72,299.78,292.95,299.4,325.33741372319383,314.0697779285396,309.95827227515343,311.9869360591129,337.21784999999977,306.4419000000004,305.4486000000002,318.07499999999993,318.07499999999993,339.48749681844896,296.6625031815509,57990745,37.735709956772354,51.44955779349309,NaN,NaN,NaN,NaN,NaN,NaN,-3.8326512935895627,-2.0170167715596676,1.815634522029895,15.553074565538688,8.343441665209298,5375714017,16942992413.016464,17.471551369754373,35.34597505378625,22.945367467170712,14.285714285714286,100
2022-09-02,302.34,303.75,293.52,295.17,325.03724045231627,313.6955249002517,309.37834002906897,310.38532310110213,336.70659999999975,305.9847000000003,305.6550000000002,316.746,316.746,340.2759115170452,293.2160884829548,64666839,34.81526969294464,48.993400845058844,NaN,NaN,NaN,NaN,NaN,NaN,-3.8824140561047096,-3.037383048100992,0.8450310080037177,5.353151245813391,7.7376684138499074,5311047178,16899185844.661627,19.691971667363468,31.667526886333324,21.24915814232939,7.142857142857143,92.85714285714286
2022-09-06,295.66,296.6,290.87,293.05,324.7189594527907,313.2867026249992,308.73801296910545,308.7343399486162,336.18369999999976,305.52070000000026,305.62380000000024,315.36299999999994,315.36299999999994,340.959159946369,289.76684005363086,57005444,33.41930821232212,46.507017595819796,NaN,NaN,33.41930821232212,NaN,NaN,NaN,-3.8530792650694723,-3.971318073333123,-0.11823880826365041,5.374753451676545,8.760326421009543,5254041734,16885556270.790771,18.528820603263092,32.52874494975466,19.775678531460297,0,100
2022-09-07,293.54,299.99,293.27,298.97,324.46275090102165,313.003203563118,308.3549536369837,307.80440281065273,335.6697999999997,305.04690000000033,305.75420000000025,314.4574999999999,314.4574999999999,341.01009224633566,287.9049077536642,49260381,40.58370701507205,44.86630109977458,NaN,NaN,NaN,NaN,NaN,NaN,-3.253829473925672,-4.185525650670741,-0.9316961767450684,20.444220090863254,10.390708262784399,5303302115,16919862607.558628,20.697573393103657,30.201883721634275,18.327850799354085,0,92.85714285714286
2022-09-08,296.85,301.87,295.45,300.52,324.2245145736483,312.7560114133533,308.0477005531804,307.1106501620191,335.15244999999976,304.66780000000034,306.0938000000002,313.1869999999999,313.1869999999999,339.85365715833564,286.52034284166416,55649821,42.33335550248637,43.311124912363766,NaN,NaN,NaN,NaN,NaN,NaN,-2.600248721397323,-4.182007078491722,-1.5817583570943992,26.827912149013024,17.548961897184274,5358951936,16952108298.231525,21.268728385653684,28.1927844865863,16.546177492933918,0,85.71428571428571
2022-09-09,302.83,307.6,300.5209,307.09,324.0540218913235,312.6438131675443,308.01014366874193,307.10868347992204,334.69139999999976,304.3518000000003,306.5596000000003,312.3375,312.3375,338.6420090241197,286.03299097588024,56125215,49.16640313849604,42.78000449253699,NaN,NaN,NaN,NaN,NaN,NaN,-1.6205849927003115,-3.6074895979697885,-1.986904605269477,52.93733681462134,33.403156351499206,5415077151,17000146649.18101,25.6372619102265,26.128521146710654,14.89567894349266,0,78.57142857142857
2022-09-12,308.5,311.08,308.18,310.74,323.9215440615591,312.60611389689984,308.11719685820304,307.45452314850087,334.25769999999983,303.99660000000034,307.1688000000002,311.3549999999999,311.3549999999999,336.3229358377937,286.3870641622061,45905737,52.53157151574568,43.067509569200034,NaN,NaN,NaN,NaN,52.53157151574568,NaN,-0.6705483006322277,-2.8250899810597616,-2.154541680427534,64.84986945169717,48.205039471777184,5460982888,17035288282.332735,28.257339323784937,25.016831029340707,15.14643375923511,28.571428571428573,71.42857142857143
2022-09-13,301.8,303.02,292.785,293.7,323.6208321803495,312.23173540389195,307.5518165892539,306.14456856292935,333.73239999999976,303.52150000000034,307.40020000000027,309.3869999999999,309.3869999999999,333.38750257807567,285.3864974219241,79562172,39.41367276307968,42.43426934347951,NaN,NaN,NaN,NaN,NaN,NaN,-1.1077429035838642,-3.539220309907364,-2.4314774063235,9.236292428198386,42.34116623150563,5381420716,16969951686.762632,23.426952515506212,35.39738012282642,16.448065963588324,21.428571428571427,64.28571428571429
2022-09-14,294.865,296.93,293.06,296.03,323.34629653676393,311.91090896025054,307.0999806445773,305.18127631884084,333.2565499999998,303.14030000000037,307.58160000000026,307.5744999999999,307.5744999999999,329.7949297663258,285.35407023367395,54907198,41.56252397374654,41.89035384490443,NaN,NaN,NaN,NaN,NaN,NaN,-1.152835825302323,-3.872522187951404,-2.719686362649081,16.840731070495988,30.308964316797184,5436327914,16999320653.134724,22.532870414100227,34.04645050517618,17.807249708189484,14.285714285714286,57.142857142857146
2022-09-15,294.07,296.53,289.46,291.1,323.0254378647563,311.49881175311685,306.4725304232213,303.8402023837131,332.7135999999998,302.79730000000035,307.62760000000026,305.7049999999999,305.7049999999999,326.83690904769696,284.5730909523029,65299411,38.45469724636716,40.75153551427885,NaN,NaN,NaN,NaN,NaN,NaN,-1.41049185730241,-4.482801184277093,-3.0723093269746835,5.117004680187341,10.398009392960573,5371028503,16964315735.498232,20.959147225783976,35.22487634342146,18.92557739494472,7.142857142857143,100
2022-09-16,287.72,289.72,285.62,289.32,322.69006037356473,311.059627361966,305.7998821713303,302.4573259662166,332.1910999999998,302.3947000000003,307.51440000000025,303.70699999999994,303.70699999999994,323.02349771568424,284.39050228431563,79920391,37.36823354999457,40.339293738748765,NaN,NaN,NaN,NaN,NaN,NaN,-1.5836311365597728,-5.0518482476744,-3.468217111114627,14.532600157109158,12.163445302597497,5291108112,17028641903.864084,19.804569789798375,37.14455601355858,20.45167949081135,0,100
2022-09-19,286.1,291.21,286.04,291.05,322.375233902186,310.6633971171746,305.2214554195134,301.37091396943407,331.71074999999973,302.13380000000035,307.42840000000024,302.1164999999999,302.1164999999999,320.05196127090403,284.1810387290958,52613831,39.1671651963864,40.20617712762322,NaN,NaN,NaN,NaN,NaN,NaN,-1.467111289745957,-5.3021062232970735,-3.8349949335511164,21.32757266300083,13.659059166765777,5343721943,17077999172.790585,20.282412741370216,35.17581626558443,21.188233916937094,64.28571428571429,92.85714285714286
2022-09-20,288.49,291.07,286.38,288.73,322.04045545539805,310.229072421785,304.5747316775717,300.16701740091656,331.2048499999998,301.85350000000034,307.42220000000026,300.8349999999999,300.8349999999999,318.75065851427627,282.9193414857236,51271117,37.60719083625213,40.12465068189668,NaN,NaN,NaN,NaN,NaN,NaN,-1.4302645723165366,-5.622825648946787,-4.19256107663025,12.215239591516166,16.025137470542052,5292450826,17078108492.869476,19.28389698186992,33.44408901289762,21.357896897926217,57.142857142857146,85.71428571428571
2022-09-21,289.59,293.95,283.42,283.56,321.6575653513642,309.70097197778927,303.7506245529611,298.5853966960674,330.7069999999998,301.4090000000003,307.3686000000003,299.3079999999999,299.3079999999999,317.64203894400276,280.973961055997,82930963,34.32617742841357,39.89178471629139,NaN,NaN,NaN,NaN,NaN,NaN,-1.6239074742814221,-6.222445419482028,-4.598537945200606,0.5061460592913468,11.349652771269447,5209519863,16997382721.668146,17.23260934651779,32.87670267593124,21.839328382649708,50,100
2022-09-22,282,283.03,278.815,280.07,321.2437587309526,309.114220057437,302.8219726097077,296.8220255821562,330.1763499999998,301.0772000000003,307.2570000000003,297.56099999999986,297.56099999999986,316.2328642882877,278.889135711712,62757073,32.27890573354392,39.502012986060784,NaN,NaN,NaN,NaN,NaN,NaN,-1.8409508346257768,-6.899726488482827,-5.05877565385705,3.889663722299693,5.537016457702403,5146762790,16971997001.747623,16.38671487682132,36.02674426905262,22.098578793801483,42.857142857142854,100
2022-09-23,277.55,277.85,272.02,275.51,320.7886964550227,308.44878995728976,301.7509148603074,294.7923088600461,329.56474999999983,300.64750000000026,307.0338000000003,295.30749999999995,295.30749999999995,313.1848576067613,277.4301423932386,74815189,29.779740094163003,39.14233230043353,NaN,NaN,NaN,NaN,NaN,NaN,-2.1253723782904483,-7.71549112672011,-5.590118748429662,8.934971838197667,4.443593873262902,5071947601,16986754714.843678,15.038058644040357,40.008768495800325,23.673260943223113,35.714285714285715,100
2022-09-26,275.03,279.49,273.56,274.37,320.3268188783558,307.773962433383,300.6771534932365,292.84732706385125,328.9385499999998,300.20300000000026,306.68380000000036,293.65399999999994,293.65399999999994,312.80863223348484,274.49936776651504,71176694,29.171658236088405,38.83892873070255,NaN,NaN,NaN,NaN,NaN,NaN,-2.2140148507996162,-8.357637311929182,-6.143622461129565,6.016385048643171,6.280340203046843,5000770907,16935022581.430525,15.81140256024307,37.55665923971247,24.625113946039992,28.571428571428573,92.85714285714286
2022-09-27,277.81,280.21,272.11,274.48,319.87063162583485,307.1146760485636,299.6498141405606,291.0980578196749,328.3422999999998,299.65180000000026,306.38540000000035,292.1574999999999,292.1574999999999,312.36472729619487,271.95027270380496,69780115,29.32162679062128,38.034494428956066,NaN,NaN,NaN,NaN,NaN,NaN,-2.0904817420294775,-8.756724638666412,-6.666242896636935,6.298003072196713,7.083119986345849,5070551022,16906076755.949043,14.5037843066246,35.93113664704196,26.32600226707956,21.428571428571427,85.71428571428571
2022-09-28,274.46,281.25,272.945,279.94,319.4733119081649,306.5765636515623,298.87688025269546,290.03538564637256,327.7519499999998,299.32120000000026,306.0182000000003,291.10349999999994,291.10349999999994,311.5493565729121,270.6576434270878,79652140,36.50780694209769,37.61838381749974,NaN,NaN,NaN,NaN,NaN,NaN,-1.4942477669525225,-8.534052605327588,-7.0398048383750655,20.276497695852573,10.863628605564152,5150203162,16960600827.701,14.338005473077853,32.924575353414205,28.135095717728877,14.285714285714286,78.57142857142857
2022-09-29,275.86,276.25,268.84,271.87,318.99964711305876,305.88930496539274,297.8177869094525,288.3053489181466,327.1499999999998,298.94740000000024,305.3950000000003,289.73349999999994,289.73349999999994,311.44001079745595,268.0269892025439,81215957,31.4224930020722,36.35096166489803,NaN,NaN,NaN,NaN,NaN,NaN,-1.493036915352329,-8.906100982565476,-7.413064067213147,7.173295454545523,11.249265407531603,5068987205,16945804398.288046,12.796774752066465,33.360716890347355,31.249573235434006,7.142857142857143,100
2022-09-30,271.03,275.19,267.1,267.26,318.48482475372487,305.12436823340477,296.61944232476804,286.3010299735612,326.5452999999998,298.64850000000024,304.59260000000035,288.12649999999996,288.12649999999996,311.432426520953,264.8205734790469,78482378,28.942343863810052,34.66601683261691,NaN,NaN,28.942343863810052,NaN,NaN,NaN,-1.6406264549260943,-9.463847135870765,-7.8232206809446705,0.44543429844089183,9.298409149612995,4990504827,16870426391.234894,11.801112394912355,32.438510333940116,34.14717514305703,0,100
2022-10-03,269.07,275.16,267.53,273.53,318.03751306463306,304.49873717927795,295.7139739983065,285.0847414046506,325.92769999999985,298.37620000000027,304.0234000000003,287.04449999999997,287.04449999999997,310.94371963161234,263.1452803683876,61267449,36.305900926294676,34.444033129989414,NaN,NaN,NaN,NaN,NaN,NaN,-1.1756688075089432,-9.292806690330849,-8.117137882821906,21.55548105933608,9.724736937440833,5051772276,16905516660.190332,10.90854381282105,29.985047117506262,36.02572359095952,0,92.85714285714286
2022-10-04,278.99,282.85,278.99,282.13,317.6802243774228,304.0557918885992,295.1812691356278,284.8033374613505,325.40414999999985,298.27910000000026,303.66060000000033,286.4985,286.4985,310.32280462783797,262.674195372162,66696931,44.76132890037087,34.672519196176864,NaN,NaN,NaN,NaN,44.76132890037087,NaN,-0.19977755475970405,-8.366859826271536,-8.167082271511832,51.0703363914373,24.357083916404758,5118469207,16947331834.547844,17.185816492370584,27.35629612393912,36.20314880046716,0,85.71428571428571
2022-10-05,278.28,283.81,275.42,281.98,317.3249982642146,303.6186474947655,294.66357230677966,284.5344481793171,324.88949999999977,298.18740000000025,303.4128000000003,285.64899999999994,285.64899999999994,308.83707012237323,262.46092987762665,55766318,44.64999298565917,35.11504032041201,NaN,NaN,NaN,NaN,NaN,NaN,0.4872499263834378,-7.558019863532536,-8.045269789915974,55.41899441340787,42.68160395472709,5062702889,16978771010.24987,15.839586431060324,28.546527814149904,36.43437114513459,0,78.57142857142857
2022-10-06,280.96,284.18,279.43,279.76,316.9512171869588,303.1461990295226,294.0791184908275,284.07973882890593,324.38484999999974,297.9656000000003,302.8718000000003,284.611,284.611,306.8839332599002,262.3380667400998,53489411,42.94738210351576,35.51355093137781,NaN,NaN,NaN,NaN,NaN,NaN,0.8239949706391796,-7.015276076616999,-7.839271047256179,47.15083798882676,51.21338959789065,5009213478,16932713812.146711,15.472637570741485,27.245289412046574,36.22800247020377,21.428571428571427,71.42857142857143
2022-10-07,275.02,275.15,267.74,269.1,316.47508567266067,302.47201687052217,293.0995452166774,282.6530970356768,323.7842999999998,297.6722000000003,302.05760000000026,282.7115,282.7115,303.41677205810123,262.00622794189877,71354674,35.873515554164655,35.27829024264768,NaN,NaN,NaN,NaN,NaN,NaN,0.3830379040515046,-7.360473667191798,-7.743511571243302,7.448789571694609,36.67287399130975,4937858804,16887551407.145363,13.762971362685345,34.98104296289631,37.419032527757565,14.285714285714286,64.28571428571429
2022-10-10,269.3,269.7,263.64,266.41,315.9769256162163,301.7579175265514,292.05289638465086,281.1061354132314,323.1465999999998,297.27460000000025,301.07660000000027,280.495,280.495,297.96168886766895,263.02831113233105,60392990,34.336575583127626,35.044674867424504,NaN,NaN,NaN,NaN,NaN,NaN,-0.014498321178860962,-7.761634472716878,-7.747136151538017,9.138898053447834,21.2461752046564,4877465814,16882369170.379686,12.984022285477778,36.83040553033674,38.92012264100398,7.142857142857143,100
2022-10-11,264.7,267.63,261.03,262.75,315.4473044658062,300.98548351612465,290.9037631930959,279.3579320405427,322.47574999999983,296.99070000000023,300.0262000000003,278.9475,278.9475,296.9366299122555,260.95837008774447,66522509,32.30837206924248,34.900545913197995,NaN,NaN,NaN,NaN,NaN,NaN,-0.4258497877203453,-8.279448386188449,-7.853598598468103,7.429805615550863,8.005831080231099,4810943305,16850518999.403929,12.17576589864282,36.999417540543575,40.29584452261344,0,100
2022-10-12,263.4,265.36,261.95,262.66,314.9220576552012,300.2265630504588,289.79616463650393,277.76765279858625,321.77164999999985,296.7215000000003,298.9928000000003,277.279,277.279,294.8051917141176,259.7528082858824,50580179,32.257913268117434,34.89904645138182,NaN,NaN,32.257913268117434,NaN,NaN,NaN,-0.5954969986319778,-8.597969846758076,-8.002472848126098,7.041036717062851,7.869913462020512,4760363126,16821001534.239706,11.76815716624636,35.760786163375805,41.22503675565724,71.42857142857143,92.85714285714286
2022-10-13,255.16,270.17,254.26,268.82,314.4633307133584,299.60465091084575,288.9735699448763,276.9154953891971,321.10769999999985,296.5229000000003,297.9114000000003,276.165,276.165,292.84763588285466,259.4823641171454,112894068,39.25121597881487,35.57558044314267,NaN,NaN,NaN,NaN,NaN,NaN,-0.20453782060272196,-8.258145123879501,-8.05360730327678,48.663101604278054,21.044647978963923,4873257194,16914736960.907211,10.073679651988357,37.57123730206706,42.10724026281648,64.28571428571429,100
2022-10-14,271.2,271.81,260.14,260.74,313.9287702087479,298.8350538631062,287.8663711235086,275.37497201879734,320.4036499999998,296.19550000000027,296.63820000000027,274.736,274.736,291.5620956849776,257.9099043150224,77244302,34.25578449515892,35.938732318790564,NaN,NaN,NaN,NaN,NaN,NaN,-0.39099349457417176,-8.542349171494493,-8.151355676920321,21.657754010695236,25.78729744401205,4796012892,16845435517.724691,10.480077857658051,33.73430229869753,42.953556839354704,57.142857142857146,92.85714285714286
2022-10-17,266.84,270.24,266.74,269.35,313.4852003559245,298.25119141037146,287.1402389225867,274.80116515986424,319.7486499999998,296.01660000000027,295.5902000000003,273.65099999999995,273.65099999999995,288.8490615869288,258.4529384130711,64576452,42.63399001290718,36.8896154060967,NaN,NaN,NaN,NaN,NaN,NaN,0.13642066551864573,-7.980829845022015,-8.11725051054066,50.43449197860971,40.25178253119433,4860589344,16877170231.278978,9.618901943041557,30.962264816666647,43.67563579027001,50,85.71428571428571
2022-10-18,276.53,277.21,268.74,271.48,313.0672381633282,297.72106880818586,286.5261119060147,274.48486371606765,319.11679999999984,295.81880000000024,294.6056000000003,272.7885,272.7885,286.3337150591997,259.2432849408003,69780995,44.517679080764,37.46174913028715,NaN,NaN,NaN,NaN,NaN,NaN,0.6697772940332047,-7.280028892999155,-7.94980618703236,57.553475935828935,43.21524064171129,4930370339,16852536798.569416,14.933315786770782,28.69801803809622,43.120032998678035,42.857142857142854,78.57142857142857
2022-10-19,269.93,273.68,268.07,270.49,312.64358405225033,297.1818397228752,285.8972447724455,274.1044005050136,318.4608499999998,295.53040000000027,293.6738000000003,272.13499999999993,272.13499999999993,284.7689297132834,259.50107028671647,53115405,43.79782023715563,38.345701075650254,NaN,NaN,NaN,NaN,NaN,NaN,0.978261441786783,-6.726979384798881,-7.705240826585664,54.244652406417146,54.077540106951936,4877254934,16845246448.863533,14.192979967991585,27.867367261841174,42.26000888360641,35.714285714285715,71.42857142857143
2022-10-20,269.58,274.84,267.92,269.11,312.2104140616807,296.62596170856085,285.23892144803585,273.62874331405993,317.82404999999983,295.13050000000027,292.5374000000003,271.58699999999993,271.58699999999993,283.7382239712784,259.4357760287215,60605496,42.759862419220774,39.33266668675102,NaN,NaN,NaN,NaN,NaN,NaN,1.1025100817354412,-6.327103224416362,-7.429613306151803,49.63235294117652,53.81016042780754,4816649438,16805485039.6381,14.351775788057115,26.145508510019265,41.008091251485276,28.571428571428573,64.28571428571429
2022-10-21,267.98,275.969,266.8236,275.42,311.8443402899227,296.20604167472794,284.85386570497565,273.79933918891135,317.2796999999999,294.8019000000003,291.56420000000026,271.5825,271.5825,283.727974671666,259.43702532833396,77897694,48.741598187753794,40.22093077685524,NaN,NaN,NaN,NaN,NaN,NaN,1.5930151468763674,-5.438344372556344,-7.031359519432711,70.7219251336899,58.19964349376119,4894547132,16874030308.592503,14.189566320901855,24.032139602882012,39.51538689284859,21.428571428571427,57.142857142857146
2022-10-24,275.69,279.4,271.97,278.45,311.51205829698813,295.85443688908975,284.60273371654523,274.2422592661579,316.7518499999999,294.5264000000003,290.5254000000003,271.78649999999993,271.78649999999993,284.245415321975,259.3275846780249,63963569,51.36963840787508,40.692952884534115,NaN,NaN,NaN,NaN,NaN,NaN,2.0744168166503067,-4.438338498619828,-6.512755315270135,80.84893048128338,67.06773618538325,4958510701,16921637110.284292,16.30237895399068,22.44481740698353,39.01675825301919,14.285714285714286,50
2022-10-25,279.41,284.6,277.9,284.21,311.2403960253763,295.6238539803949,284.58733239432775,275.19156790747616,316.27359999999993,294.22470000000027,289.5484000000003,272.27299999999997,272.27299999999997,285.8264321852451,258.71956781475484,59014494,55.989103598012385,41.50288935684506,NaN,NaN,NaN,NaN,55.989103598012385,NaN,2.694370990247962,-3.1447915774601825,-5.8391625677081445,98.71456822676322,83.42847461391216,5017525195,16973781260.20668,19.997867818197047,21.091935882998023,37.162075114387655,100,42.857142857142854
2022-10-26,278.46,283.98,277.43,277.93,310.90894929875566,295.2734806342485,284.32626053572665,275.452370963907,315.76269999999994,293.94200000000023,288.4614000000003,272.1724999999999,272.1724999999999,285.52536018050847,258.81963981949133,63898246,50.37103638928668,42.033150377257265,NaN,NaN,NaN,NaN,NaN,NaN,2.594162477961868,-2.596459470255809,-5.190621948217677,78.0158206987475,85.85977313559802,4953626949,16919638471.611261,18.765225559315354,20.219145521883206,35.459964509017645,92.85714285714286,35.714285714285715
2022-10-27,276.79,278.2795,272.34,272.87,310.53045229080783,294.82984735436236,283.87699541667854,275.20643087210635,315.19794999999993,293.59850000000023,287.3490000000003,272.22249999999997,272.22249999999997,285.5779436466953,258.86705635330463,57760302,46.3365977451007,42.78051339089556,NaN,NaN,NaN,NaN,NaN,NaN,2.1197679706594688,-2.5409119848933415,-4.66067995555281,61.338167435728394,79.35618545374638,4895866647,16872186431.269651,17.733974707946007,23.81753320358676,33.396493881518914,85.71428571428571,28.571428571428573
2022-10-28,272.23,281.698,272.06,281.22,310.238805999357,294.5603454265532,283.7727995179853,275.7791517414296,314.6672999999999,293.31200000000024,286.38780000000025,272.92049999999995,272.92049999999995,286.6203094512339,259.220690548766,62651312,53.02321091616925,44.11527305754139,NaN,NaN,NaN,NaN,NaN,NaN,2.286672966645507,-1.8023387472459262,-4.089011713891433,88.85959129861571,76.07119314436386,4958517959,16928623315.55934,19.287931137295896,21.73062008600913,30.40254020443745,78.57142857142857,21.428571428571427
2022-10-31,278.92,279.76,275.99,277.95,309.9175243476221,294.23142769533433,283.5444544388486,275.98589919462677,314.16875,293.01510000000025,285.4896000000003,273.14149999999995,273.14149999999995,287.0150104065304,259.2679895934695,47741952,50.375947347786266,45.405814148865936,NaN,NaN,NaN,NaN,NaN,NaN,2.100009587771202,-1.4639997291774307,-3.5640093169486327,78.08174027686215,76.09316633706875,4910776007,16930522862.721144,18.34841222148313,20.672117311511524,27.22218625525857,71.42857142857143,14.285714285714286
2022-11-01,281.495,282.07,274.74,275.11,309.5711808217751,293.85278556275347,283.2136915196781,275.9024802237099,313.64425,292.7722000000003,284.70460000000026,272.79049999999995,272.79049999999995,286.07951271728217,259.50148728271773,45895897,48.12850380510397,46.53942775865069,NaN,NaN,NaN,NaN,NaN,NaN,1.7241768528620622,-1.408788250871055,-3.132965103733117,68.72116018457483,78.55416392001757,4864880110,16889260385.063572,19.25008214153627,19.256383582165824,23.617638105800875,64.28571428571429,7.142857142857143
2022-11-02,275.08,278.21,265.61,265.68,309.13445265439424,293.2949086209168,282.5260957738084,274.92891067859466,313.1198999999999,292.5406000000003,283.7362000000003,271.97549999999995,271.97549999999995,284.9046693081979,259.046330691802,79803142,41.50689069825338,46.70054738146773,NaN,NaN,NaN,NaN,NaN,NaN,0.8249900510366421,-2.1017275399373148,-2.926717590973957,22.649223221586315,56.48404122767443,4785076968,16810343944.64135,17.084165925635673,25.242605474058266,20.87202198627602,57.142857142857146,0
2022-11-03,263.01,264.5,260.1,260.49,308.6504282498729,292.64530647000754,281.66193515522764,273.5537763282523,312.58995,292.39140000000026,282.6458000000003,271.012,271.012,284.34293185039775,257.68106814960225,70038903,38.37737552651333,46.99494674085019,NaN,NaN,38.37737552651333,NaN,NaN,NaN,-0.08638150750908347,-3.034694475360311,-2.9483129678512277,1.5918367346938218,30.98740671361833,4715038065,16752721028.99135,16.21410363266749,28.985961420211975,19.13359523814404,50,100
2022-11-04,265.53,266.61,259.08,264.68,308.2129115508692,292.0915380250569,280.99597691384616,272.7086547731806,312.10475,292.27910000000026,281.5278000000003,270.791,270.791,284.3853398515698,257.19666014843017,78313213,42.16837401666542,46.96168845540434,NaN,NaN,NaN,NaN,NaN,NaN,-0.35880806490158257,-3.396823048978206,-3.0380149840766233,21.943573667711654,15.39487787466394,4793351278,16790889620.187897,17.027753929641968,26.988489829722145,16.993268484405892,42.857142857142854,100
2022-11-07,265.75,268.14,263.57,267.59,307.8087034757362,291.6063590542637,280.47025232898943,272.2211638424015,311.68425,292.12700000000024,280.73080000000033,270.85,270.85,284.37785274904707,257.322147250953,47333828,44.71230628516082,46.97559039857555,NaN,NaN,NaN,NaN,NaN,NaN,-0.29734403721815994,-3.409695030599323,-3.1123509933811633,33.34639498432593,18.960601795577148,4840685106,16826830185.430784,17.736793181369464,25.825316434571636,16.066129153826743,35.714285714285715,92.85714285714286
2022-11-08,269.14,272.85,265.52,269.54,307.42792035657465,291.16940144922876,280.04161498275454,271.9658149050299,311.26545000000004,292.1085000000002,280.0334000000003,271.1895,271.1895,284.21881229958024,258.1601877004198,63213785,46.413378776087036,47.16241600849922,NaN,NaN,NaN,NaN,NaN,NaN,-0.09041315529796634,-3.225367437503621,-3.134954282205655,40.9874608150471,32.092476489028236,4903898891,16832953212.354385,20.960019016652268,24.035948697204528,14.232176327128284,28.571428571428573,85.71428571428571
2022-11-09,267.76,268.56,263.03,263.32,306.9890355769072,290.61792815320445,279.3858653755877,271.14240396169373,310.85650000000004,291.9948000000002,279.2794000000003,271.22249999999997,271.22249999999997,284.16830839499977,258.27669160500017,64862129,41.97683755782366,47.10648566125656,NaN,NaN,NaN,NaN,NaN,NaN,-0.32433836959146456,-3.5403772441949855,-3.216038874603521,16.614420062695935,30.316091954022998,4839036762,16774893982.960173,19.657331616464077,24.919295450427153,12.995178529496343,21.428571428571427,78.57142857142857
2022-11-10,276.01,283.05,273.85,282.75,306.74785114330615,290.46212759571523,279.51779222360386,272.24788929867526,310.5474,292.01150000000024,278.9490000000003,271.919,271.919,285.742015445266,258.09598455473395,99256693,56.09510434338411,47.631736100944444,NaN,NaN,NaN,NaN,NaN,NaN,0.8153414117607736,-2.196862109902554,-3.0122035216633276,92.7507836990595,50.11755485893419,4938293455,16867677413.373217,28.727623308099542,20.716842300884295,12.313057552115241,14.285714285714286,71.42857142857143
2022-11-11,282.56,288.64,281.19,287.96,306.56090735083546,290.41258051461193,279.84885919522725,273.7442807940395,310.28169999999994,292.08440000000024,278.7202000000003,273.28000000000003,273.28000000000003,287.7760408387932,258.78395916120684,66961751,58.977488365460054,48.17515395505766,NaN,NaN,NaN,NaN,NaN,NaN,1.8468807883716782,-0.7036025361987299,-2.550483324570408,97.6995940460081,69.02159926925452,5005255206,16922415274.25778,31.699369089021612,19.387310991811727,12.902180995019389,100,64.28571428571429
2022-11-14,285.86,289.215,284.44,285.44,306.35074906873757,290.31411357372855,280.06811961894385,274.8581588136548,309.94989999999996,292.09030000000024,278.5256000000003,274.0845,274.0845,289.3825540919435,258.78644590805646,55080048,57.02733194768662,48.24931312289153,NaN,NaN,NaN,NaN,NaN,NaN,2.259044899445701,0.273322799736718,-1.9857220997089828,87.47303799568616,92.64113858025127,4950175158,16890405403.430555,30.865533175029032,18.564935353260562,14.489468194209163,100,57.142857142857146
2022-11-15,292.21,293.26,285.97,289.39,306.18198539641185,290.2958142950408,280.43368355545584,276.24214368854484,309.5815999999999,292.0381000000002,278.4524000000003,274.97999999999996,274.97999999999996,291.60280842697955,258.3571915730204,73985372,59.29912197813316,48.88703352209485,NaN,NaN,NaN,NaN,59.29912197813316,NaN,2.6691417342193655,1.3507050680652242,-1.3184366661541413,88.67758923346985,91.28340709172137,5024160530,16885838405.15895,32.31754251349732,17.272729532843304,16.390092476219536,100,50
2022-11-16,287.39,289.4838,284.6,285.44,305.9755974820197,290.19965955652515,280.630009690536,277.1181300039215,309.18119999999993,291.96800000000025,278.1818000000003,275.72749999999996,275.72749999999996,292.81354796317896,258.64145203682097,48859804,56.104926073452816,49.58477125983429,NaN,NaN,NaN,NaN,NaN,NaN,2.5462018284423378,1.8643156193987807,-0.6818862090435569,77.12112346401406,84.42391689772336,4975300726,16853786101.613514,30.872292656833565,17.754778354082784,17.271145253526303,92.85714285714286,42.857142857142854
2022-11-17,280.88,286.3189,280.72,284.81,305.7649945219996,290.09293362471277,280.7939308791424,277.8506890511671,308.76279999999997,291.98070000000024,277.86760000000027,276.5125,276.5125,293.7522283911327,259.2727716088673,55462076,55.59059502105138,49.768155838754446,NaN,NaN,NaN,NaN,NaN,NaN,2.3016808681992096,2.195214876205455,-0.1064659919937545,75.27794031597429,80.3588843378194,4919838650,16879354188.981318,29.25695522545297,20.45175454490493,18.11103910237156,85.71428571428571,35.714285714285715
2022-11-18,287.89,287.99,282.3211,284.82,305.55658661630804,289.9885190974907,280.9518159427054,278.51443295105594,308.41915,291.99090000000024,277.42220000000026,276.98249999999996,276.98249999999996,294.5861597047332,259.37884029526674,53588631,55.59755315504671,50.14112768213018,NaN,NaN,NaN,NaN,NaN,NaN,2.029370759783316,2.4302474577353905,0.4008766979520746,75.30719719133998,75.90208699044278,4973427281,16873010219.205153,29.268906350515906,19.34790690831378,19.143284530415524,78.57142857142857,28.571428571428573
2022-11-21,283.4,284.58,281.04,281.89,305.3210981922652,289.8281523826889,280.988607474364,278.83591552714586,308.03855,292.00700000000023,276.84520000000026,277.1545,277.1545,294.87896047133825,259.4300395286617,40083527,52.97835356170139,50.48754552188715,NaN,NaN,NaN,NaN,NaN,NaN,1.561668619427289,2.352962472236186,0.7912938528088969,66.73493270918665,72.44002340550031,4933343754,16852175843.589333,28.176841191503634,19.890550650101503,20.373465766357803,71.42857142857143,21.428571428571427
2022-11-22,282.64,286.11,280.46,285.95,305.128350946571,289.751357286002,281.18317188713405,279.5134473817034,307.69265,292.04520000000025,276.69020000000023,277.2415,277.2415,295.12004499113453,259.3629550088654,41873444,56.06685831148495,51.52754320854655,NaN,NaN,NaN,NaN,NaN,NaN,1.438542369271279,2.589471814397996,1.1509294451267167,78.6132241076653,73.55178466939732,4975217198,16891677694.300837,28.11467747957399,18.763613082150194,20.421511831790514,64.28571428571429,14.285714285714286
2022-11-23,285.97,289.46,285.79,288.82,304.9660787978489,289.73291456746733,281.48265534254057,280.39978572630304,307.34115,292.06380000000024,276.5460000000002,277.786,277.786,296.36485830722626,259.20714169277375,46389967,58.159008949497604,52.940517024474,NaN,NaN,NaN,NaN,NaN,NaN,1.458622344048141,2.974207375186893,1.515585031138752,87.00994733762435,77.45270138482545,5021607165,16921888054.281763,30.522689048465917,18.04830715481284,20.237690239370774,57.142857142857146,7.142857142857143
2022-11-25,287.19,287.91,286.42,286.92,304.786515824736,289.6772132889036,281.6958845447939,281.0207585142742,306.9421,292.04500000000024,276.4624000000003,278.48850000000004,278.48850000000004,297.3313376578444,259.6456623421557,15498797,56.24927015920215,53.94629532036947,NaN,NaN,NaN,NaN,NaN,NaN,1.2596738290076273,3.090177317398286,1.8305034883906588,79.02745616936828,81.55020920488599,5006108368,16916791134.46297,29.724653895391384,17.57642266455194,20.455768652557197,50,0
2022-11-28,284.9,286.96,281.76,282.71,304.5668490006093,289.53924866932135,281.73565377833137,281.18163865577185,306.56350000000003,291.92230000000023,276.3302000000003,278.563,278.563,297.4601512138729,259.66584878612707,38877045,52.16207819143298,54.4784218851032,NaN,NaN,NaN,NaN,NaN,NaN,0.7835818548608606,2.8099808069667347,2.026398952105874,65.1008931524975,77.04609888649672,4967231323,16892119163.597586,28.015525133606705,21.718568853119372,20.033872330883195,42.857142857142854,14.285714285714286
2022-11-29,282.94,283.35,279.17,280.57,304.3280743836878,289.3616397847803,281.68994186545564,281.1233873552221,306.23105,291.7745000000002,276.12060000000025,278.6940000000001,278.6940000000001,297.6086540015878,259.77934599841234,35618878,50.16663452255637,54.746511581279584,NaN,NaN,NaN,NaN,NaN,NaN,0.2890558802498542,2.387718802418192,2.0986629221683377,58.021832616606055,67.38339397949062,4931612445,16880359821.099977,26.687158574693658,23.62671297174233,19.980064873019256,35.714285714285715,7.142857142857143
2022-11-30,280.84,293.47,279.97,293.36,304.2189393151934,289.44081523458664,282.14759120406524,282.2887790356772,305.9604,291.8177000000003,276.21320000000026,279.60650000000004,279.60650000000004,299.47815848639397,259.7348415136061,74718088,60.01243444117878,56.03476850151924,NaN,NaN,NaN,NaN,NaN,NaN,0.761038604004983,3.0499611771745663,2.2889225731695833,99.43934760448515,74.18735779119625,5006330533,16953860280.999237,33.52149653842356,20.281912331607057,20.894566451061092,100,0
2022-12-01,293.69,295.75,290.88,293.72,304.11447225733076,289.525551566575,282.601411156847,283.37746674656506,305.64835,291.89250000000027,276.41640000000024,281.0085,281.0085,300.70796930756865,261.3090306924314,51547332,60.25049047942792,56.33158179695094,NaN,NaN,NaN,NaN,60.25049047942792,NaN,1.0190800190428169,3.5627725969731046,2.5436925779302877,87.75633293124261,81.73917105077795,5057877865,16962433861.886301,34.21461597878258,19.224598100140003,21.740925240711594,100,0
2022-12-02,288.54,293.45,288.36,292.55,303.99940288163594,289.5854416345636,282.9915518957942,284.2510413421303,305.3309,291.9615000000002,276.6660000000002,282.61150000000004,282.61150000000004,300.5064750209346,264.71652497906547,53583172,59.02071245349916,56.33466923181088,NaN,NaN,NaN,NaN,NaN,NaN,1.029536493995976,3.830613195425258,2.801076701429282,80.69963811821476,89.29843955131419,5004294693,16997068171.489445,32.22353522911471,20.841824658945793,21.55150709699567,92.85714285714286,78.57142857142857
2022-12-05,290.38,291.68,286.15,287.64,303.83662275346046,289.5469180378396,283.17384397831205,284.5737993095465,305.0418499999999,291.97120000000024,276.90860000000026,283.7595,283.7595,299.7503704891219,267.7686295108781,41482121,54.0361099381789,56.12101051684605,NaN,NaN,NaN,NaN,NaN,NaN,0.6432387947241742,3.6051251948345,2.9618864001103256,51.085645355850296,73.18053880176923,4962812572,16977939887.845684,29.980116278082864,21.794889430408517,20.903262595727266,85.71428571428571,71.42857142857143
2022-12-06,287.48,287.62,280.255,281.68,303.6161588454658,289.39113748263486,283.1152618615155,284.29819937530397,304.7426999999999,291.86930000000024,277.0548000000002,284.46400000000006,284.46400000000006,298.68711414563563,270.2408858543645,53937605,48.6635716826062,55.36132835287983,NaN,NaN,NaN,NaN,NaN,NaN,-0.039960989159199656,2.911935163661326,2.9518961528205256,15.138721351025291,48.974668275030126,4908874967,16944874268.487232,27.592910178257174,26.415530920058167,18.89195950825143,78.57142857142857,64.28571428571429
2022-12-07,280.47,282.57,278.7801,280.53,303.3864458221278,289.2156694136718,283.0138790434168,283.9393232443226,304.45494999999994,291.7806000000003,277.17580000000027,285.0135,285.0135,297.6483443203671,272.37865567963297,45614254,47.67853010516624,54.75944292657365,NaN,NaN,47.67853010516624,NaN,NaN,NaN,-0.5663847439821224,2.2439152228428725,2.810299966824995,10.311787341115556,25.512051349330402,4863260713,16941382700.085585,26.429821656583652,26.942472188870997,17.0337290689464,71.42857142857143,100
2022-12-08,281.91,284.84,279.79,283.85,303.19205332638523,289.10941853419314,283.0466681005377,283.93081626867286,304.2270999999999,291.6361000000003,277.25400000000025,286.04,286.04,293.88688728095156,278.1931127190485,42594913,50.776304080511316,54.41556500224936,NaN,NaN,NaN,NaN,NaN,NaN,-0.6803924552801357,1.9598093977248254,2.640201853004961,29.875838985497968,18.442115892546273,4905855626,16967277033.33509,27.486188861722187,25.40574922843272,16.04942765895147,64.28571428571429,92.85714285714286
2022-12-09,282.81,285.64,281.59,282.04,302.9815851340829,288.96943004836754,283.00719092012446,283.7507385287993,303.93484999999987,291.4262000000002,277.4574000000003,286.0045,286.0045,293.91675498830386,278.09224501169615,47860487,49.070552004335866,53.94935063434144,NaN,NaN,NaN,NaN,NaN,NaN,-0.8557631710580216,1.570497889182434,2.4262610602404555,19.209895167325776,19.7991738313131,4857995139,16930052210.11287,27.123130414581738,24.21298449622698,14.996734003635767,57.142857142857146,85.71428571428571
2022-12-12,282.22,285.64,281.16,285.58,302.8084350332462,288.9023126216672,283.10808539384504,283.92495390700884,303.63389999999987,291.20820000000026,277.8238000000003,285.88550000000004,285.88550000000004,293.7479664705059,278.02303352949417,35732518,52.435997679349576,53.91061092845917,NaN,NaN,NaN,NaN,NaN,NaN,-0.7170268477430048,1.5299775005616993,2.247004348304704,40.07035987247999,29.718698008434576,4893727657,16964827607.095013,25.686530287045663,23.438900515970523,14.092190126635842,50,78.57142857142857
2022-12-13,296.65,296.875,285.91,288.65,302.66755508266664,288.8973163321292,283.3254153784001,284.3749582968175,303.34314999999987,291.07480000000027,278.12620000000027,286.04600000000005,286.04600000000005,293.99610289240957,278.09589710759053,80667675,55.20079751571524,53.84874944304705,NaN,NaN,NaN,NaN,55.20079751571524,NaN,-0.4170471576769197,1.7256954012085544,2.142742558885474,54.54520334458867,37.94181946146481,4974395332,16924475377.512249,34.96309282383052,20.491953338513362,14.531313321159331,100,71.42857142857143
2022-12-14,288.05,291.41,283.19,286.51,302.5067833903018,288.85004274139396,283.4503010498354,284.57829560188253,303.06824999999986,290.93720000000025,278.2138000000003,285.9020000000001,285.9020000000001,293.7076251511144,278.0963748488858,64984432,52.892766362569354,53.47258925826646,NaN,NaN,NaN,NaN,NaN,NaN,-0.363268173838299,1.6886573415876,2.051925515425899,42.71866658561245,45.778076600893705,4909410900,16911984452.626604,31.826919956114764,21.621994340062056,14.060604678046726,92.85714285714286,64.28571428571429
2022-12-15,282.33,283.01,275.67,276.89,302.2518900232341,288.61321021186143,283.1930343419987,283.8460769731318,302.71659999999986,290.76240000000024,278.11200000000025,285.4745000000001,285.4745000000001,294.21505484507213,276.73394515492805,60554119,43.98878464774661,52.596840293162494,NaN,NaN,NaN,NaN,NaN,NaN,-0.9431503698674355,0.8729875530916047,1.8161379229590402,5.753360056590291,34.33907666226381,4848856781,16871560040.760118,28.23064345601456,27.017575134721266,12.382953962906871,85.71428571428571,100
2022-12-16,276.2,277.77,272.61,274.25,301.97326425185867,288.32879020766615,282.84232711290076,282.9321648804526,302.3765499999999,290.43680000000023,278.00180000000023,284.94650000000007,284.94650000000007,294.9660674058219,274.92693259417825,68300351,41.90401922115748,51.86412179528567,NaN,NaN,NaN,NaN,NaN,NaN,-1.442203810534997,0.01338315979029403,1.455586970325291,6.75870595507928,18.410244199094006,4780556430,16846675416.752367,26.68492782571989,28.785265745930328,11.74903821766341,78.57142857142857,100
2022-12-19,273.87,273.96,268.49,269.75,301.6526347568153,287.9608933718708,282.328902520238,281.6767206061238,302.03879999999987,290.03620000000024,278.01480000000026,284.1930000000001,284.1930000000001,296.2056684795575,272.1803315204427,44167920,38.550232044780486,51.03437876115883,NaN,NaN,NaN,NaN,NaN,NaN,-1.9798479277374714,-1.0192229393465482,0.9606249883909233,4.438964241676912,5.650343417782158,4736388510,16822855423.33372,25.036963013063364,31.424888992920813,12.122680724918443,71.42857142857143,100
2022-12-20,268.56,271.32,266.95,269.54,301.3331060527674,287.59612320609114,281.8273769312091,280.5208424531596,301.7621999999999,289.5770000000003,278.07740000000024,283.57550000000003,283.57550000000003,297.16447711381784,269.98652288618223,51064199,38.39579377258778,49.4903329991166,NaN,NaN,NaN,NaN,NaN,NaN,-2.2352054886406716,-1.833381872409916,0.40182361623075546,8.654970760234022,6.6175469856634015,4685324311,16832320412.164383,23.834342216973695,31.608156511158974,11.366542595511566,64.28571428571429,100
2022-12-21,270.6,274.78,269.74,273.45,301.0556622114463,287.3160019544854,281.4988523456715,279.847428886192,301.5126999999999,289.15880000000027,278.29140000000024,282.95050000000003,282.95050000000003,297.17988153961466,268.7211184603854,46394694,42.97641714535193,48.25647061811118,NaN,NaN,NaN,NaN,NaN,NaN,-2.03222177918103,-2.1384536077455323,-0.10623182856450208,21.720969089390135,11.604968030433687,4731719005,16854229017.664383,26.29878789928992,29.76209929840828,9.804197741651649,57.142857142857146,92.85714285714286
2022-12-22,270.38,270.5149,262.455,266.76,300.71441184118316,286.9089524108322,280.9208581360373,278.60100708750707,301.1715499999999,288.68310000000025,278.37340000000023,281.8475,281.8475,297.4406111392167,266.25438886078337,60278377,37.797789719215636,46.74054756566236,NaN,NaN,NaN,NaN,NaN,NaN,-2.224434774424743,-2.886775296595431,-0.6623405221706878,12.5072632190587,14.294401022894283,4671440628,16858343105.331438,23.232639484830823,34.01704737045936,9.617699277060177,50,100
2022-12-23,265.47,268.04,263.53,267.36,300.382527146246,286.5218444423009,280.3890597777613,277.530434983935,300.8519999999999,288.12780000000026,278.3442000000002,280.8695000000001,280.8695000000001,297.48728141027874,264.2517185897214,39373584,38.51339704222856,45.63178235880876,NaN,NaN,NaN,NaN,NaN,NaN,-2.183972579077846,-3.392306246017995,-1.2083336669401492,14.2504357931436,16.159556033864142,4710814212,16885843502.138533,22.094719003244943,32.35091318234024,9.83400444136045,42.857142857142854,92.85714285714286
2022-12-27,266.74,266.85,263.03,263.58,300.0163328462833,286.0675504929484,279.7298809629471,276.20182212832214,300.54789999999997,287.51960000000025,278.40100000000024,279.91300000000007,279.91300000000007,298.1228589780325,261.7031410219676,38009005,35.724929627105894,44.70759364055874,NaN,NaN,NaN,NaN,NaN,NaN,-2.274338829318435,-4.051257203588193,-1.776918374269758,3.268448576409063,10.008715862870451,4672805207,16858779498.578323,21.029734732393575,31.348163437686388,11.08543129176493,35.714285714285715,85.71428571428571
2022-12-28,263.17,265.47,259.73,260.1,299.6191554050268,285.55334157229595,278.9600817094982,274.6683152589581,300.25755000000004,286.9031000000002,278.21600000000024,278.88950000000006,278.88950000000006,299.03480761740457,258.74419238259554,47139043,33.33221939819471,43.68285716148934,NaN,NaN,33.33221939819471,NaN,NaN,NaN,-2.4176396891355667,-4.798967985689217,-2.38132829655365,0.9960963790550672,6.171660249535907,4625666164,16817717614.431982,19.675805657408695,33.03130107727685,12.826757072518856,28.571428571428573,100
2022-12-29,262.96,267.405,262.25,266.44,299.28901455522555,285.17485956096334,278.46909811304727,273.8846661866764,299.94899999999996,286.36040000000025,278.11520000000024,277.54350000000005,277.54350000000005,297.23373846985754,257.85326153014256,45893567,41.07525306500378,42.98992494609594,NaN,NaN,NaN,NaN,NaN,NaN,-1.9544071202771627,-4.824337196900103,-2.8699300766229405,18.06434244178216,7.442962465748764,4671559731,16846428914.834505,20.228217965626293,30.353014976636732,13.975580412531544,21.428571428571427,92.85714285714286
2022-12-30,263.62,266.41,262.29,266.28,298.96056664920343,284.80070392609275,277.99109426547676,273.1604122641358,299.5788,285.8524000000003,278.03100000000023,276.17150000000004,276.17150000000004,294.9654727306352,257.37752726936486,37858277,40.946005580452116,42.409600201532825,NaN,NaN,NaN,NaN,NaN,NaN,-1.5456548911970076,-4.8019986906192,-3.2563437994221927,17.633598061650176,12.2313456274958,4633701454,16881898077.266542,19.272180941806198,28.918454297513062,15.000444418666294,14.285714285714286,85.71428571428571
2023-01-03,268.65,270.155,262.13,264.48,298.61747643378845,284.39831374933846,277.4612474315365,272.3337063342181,299.17900000000003,285.23790000000025,277.93840000000023,274.7680000000001,274.7680000000001,292.62916860678035,256.9068313932198,42335325,39.44237177944342,41.481484065825235,NaN,NaN,NaN,NaN,NaN,NaN,-1.2936154594197582,-4.87336312369689,-3.579747664277132,12.787723785166246,16.16188809619953,4591366129,16864357272.82729,21.72684497134915,26.327236113421744,15.357449729614514,7.142857142857143,78.57142857142857
2023-01-04,266.64,267.45,262.53,265.74,298.29033736479556,284.02884218994564,277.00159066951545,271.70573430238784,298.75025,284.65450000000027,277.7448000000002,273.67300000000006,273.67300000000006,290.9179564800795,256.4280435199206,47754861,41.07363086660116,40.47240073374566,NaN,NaN,NaN,NaN,NaN,NaN,-0.9547824338641506,-4.77322570660732,-3.8184432727431696,18.970959595959563,16.46409381425866,4639120990,16878916681.668753,20.51326488951028,24.85669543440232,14.17731402919405,0,71.42857142857143
2023-01-05,264.04,264.21,261.26,261.58,297.92506037609115,283.58431066143186,276.39682240796583,270.7413786545414,298.30774999999994,283.96640000000025,277.4074000000003,272.66800000000006,272.66800000000006,290.26840181359086,255.06759818640927,45396744,37.48356478822222,39.37174347843514,NaN,NaN,NaN,NaN,NaN,NaN,-0.9230266478866476,-4.972226582601479,-4.0491999347148315,7.946735395188866,13.235139592104892,4593724246,16843368722.807735,19.448030924761696,25.038006624454706,13.711087401880475,0,64.28571428571429
2023-01-06,263.35,269.94,260.34,268.8,297.63525878030913,283.29155203447283,276.0989078037319,270.55648544934695,297.86695,283.3238000000003,277.0992000000002,272.0815000000001,272.0815000000001,289.37393450181924,254.789065498181,54659739,46.262561005621784,39.534156075426225,NaN,NaN,NaN,NaN,NaN,NaN,-0.3570568386921682,-4.495520983080041,-4.138464144387873,50.27716186252778,25.731618951225403,4648383985,16885046773.795235,23.75414816008168,22.3586325089059,13.770418855033286,0,57.142857142857146
2023-01-09,270.83,275.29,269.92,270.54,297.36565421533095,283.0390460535922,275.8809114192718,270.554915406552,297.46049999999997,282.70640000000026,276.9514000000002,271.4160000000001,271.4160000000001,287.8486643000975,254.9833356999027,45568676,48.15219530185192,39.980454366904404,NaN,NaN,NaN,NaN,NaN,NaN,0.16517190523019742,-3.931999262850127,-4.097171168080324,69.47300771208226,42.56563498993297,4693952661,16850000473.631361,27.99547924918785,20.74258324299408,14.562915517186093,0,50
2023-01-10,269.49,272.94,268.97,272.83,297.1215183524918,282.8368867257983,275.76126783420233,270.77159012973755,297.02639999999997,282.1498000000003,276.95060000000024,270.9555000000001,270.9555000000001,286.6720587518348,255.23894124816536,35247763,50.613578726500926,40.84212198702729,NaN,NaN,NaN,NaN,NaN,NaN,0.6673317580636775,-3.263006470500727,-3.9303382285644046,84.19023136246763,67.98013364569256,4729200424,16883294960.092318,26.723071723570136,20.88742877219132,14.630297494263205,92.85714285714286,42.857142857142854
2023-01-11,273.92,277.66,273.12,277.55,296.9267768763476,282.7321958995449,275.8314141936454,271.41715297452447,296.6174,281.6325000000003,276.87720000000024,270.5540000000001,270.5540000000001,285.124095950262,255.98390404973816,44077036,55.3215930782926,42.0511076517205,NaN,NaN,NaN,NaN,NaN,NaN,1.284144708509276,-2.3251573429278096,-3.6093020514370857,99.38650306748458,84.34991404734483,4773277460,16925236104.479982,30.71344531222123,19.713495866822996,15.186885815817456,100,35.714285714285715
2023-01-12,278.12,280.1,273.74,279.05,296.7488984994685,282.65928112925684,275.957633244875,272.1440907864745,296.18809999999996,281.1944000000003,276.8992000000003,270.0740000000001,270.0740000000001,282.73533705418816,257.4126629458121,60599953,56.7332162484018,43.03373615908121,NaN,NaN,NaN,NaN,NaN,NaN,1.7320659422017135,-1.444219623684944,-3.1762855658866576,94.84536082474222,92.80736508489815,4833877413,16965826639.036587,31.278235897860196,18.258325296851865,16.62300501288484,100,28.571428571428573
2023-01-13,276.5,281.219,276.16,280.97,296.5918945342997,282.6258300177864,276.15419664703677,272.98465356871503,295.7369999999999,280.86050000000034,277.01640000000026,269.79700000000014,269.79700000000014,281.1864110470944,258.4075889529059,44802936,58.53895929403585,44.51524827156835,NaN,NaN,NaN,NaN,NaN,NaN,2.073504038744897,-0.5844055174555365,-2.6579095562004333,98.84126762529682,97.69104383917454,4878680349,17006219244.511187,30.733515580911803,17.172462202362304,17.299444064238376,100,21.428571428571427
2023-01-17,280.77,282.85,279.581,281.54,296.44212443943104,282.6043284332758,276.3654046216628,273.79944846693263,295.3092499999999,280.53490000000033,277.3336000000002,270.0295000000001,270.0295000000001,282.1546778955935,257.9043221044067,36269738,59.084897256295704,45.98464114400172,NaN,NaN,NaN,NaN,NaN,NaN,2.239422037338781,0.14136799047304294,-2.0980540468657383,94.33391003460206,96.00684616154702,4914950087,17013419935.84248,31.494927744281824,16.49001341555659,18.187483470192543,100,14.285714285714286
2023-01-18,283.11,284.69,277.67,277.88,296.2574266838148,282.51077737519114,276.42480051885246,274.1880724224629,294.8859499999999,280.1636000000003,277.6814000000002,270.2110000000001,270.2110000000001,282.6870456876273,257.73495431237296,47754549,54.154014613378095,47.30100435730689,NaN,NaN,NaN,NaN,NaN,NaN,2.011576929514238,0.416417115027059,-1.5951598144871788,72.71634615384612,88.63050793791501,4867195538,16968522496.61171,28.843988996807763,17.393347069869797,18.54926622826685,100,7.142857142857143
2023-01-19,276.22,277.375,273.89,275.15,296.04740253770717,282.3650194073656,276.37480834164256,274.2796845727045,294.45244999999994,279.70930000000027,277.89080000000024,270.4810000000001,270.4810000000001,283.1378699132029,257.8241300867973,44150436,50.75176937880912,48.54525792735077,NaN,NaN,50.75176937880912,NaN,NaN,NaN,1.6036383887219272,0.4093881714152303,-1.194250217306697,60.82135523613958,75.95720380819593,4823045102,16956297196.542843,27.43074500861022,21.182879419124735,17.65733826924222,92.85714285714286,0
2023-01-20,276.79,283.02,275.71,282.68,295.9143935572325,282.3712566468237,276.6220707596174,275.07971461339935,294.0193499999999,279.4617000000003,278.19260000000025,271.1380000000001,271.1380000000001,284.8513432830894,257.42465671691076,60613606,58.49695650109927,49.78966531564331,NaN,NaN,NaN,NaN,NaN,NaN,1.7553198000284123,0.9998995327288185,-0.7554202672995938,91.74537987679676,75.09436042226083,4883658708,17011272327.5661,31.60642491670006,19.186079355093728,17.974209908216586,85.71428571428571,35.714285714285715
2023-01-23,283.54,290.21,282.73,288.96,295.8451956113894,282.50172681223313,277.10591112198534,276.40164655498035,293.65864999999985,279.3072000000003,278.58100000000024,271.9135000000001,271.9135000000001,287.6648761620936,256.1621238379066,52799905,63.633719389206945,51.41021630198294,NaN,NaN,NaN,NaN,NaN,NaN,2.1660359567870238,1.9521246786841857,-0.21391127810283783,95.81519919651825,82.79397810315155,4936458613,17046425205.493906,37.261647380453205,17.487512828775078,19.12426636480049,100,28.571428571428573
2023-01-24,287.31,289.55,286.78,288.37,295.7708155555547,282.61793024169384,277.5476400975938,277.5414897402203,293.33419999999984,279.1807000000003,279.0820000000002,272.9940000000001,272.9940000000001,290.0904176364492,255.89758236355098,44875146,62.84672922370405,53.081956119430124,NaN,NaN,NaN,NaN,NaN,NaN,2.2742154695275953,2.6288580588066566,0.3546425892790611,93.83997321727493,93.80018409686333,4891583467,17053067375.118456,35.999072590049046,16.894965413491907,21.02029013063566,92.85714285714286,21.428571428571427
2023-01-25,283.77,288.36,281.18,287.73,295.690807440574,282.7191593458187,277.9469483290607,278.5118240506755,293.00234999999986,279.06530000000026,279.18160000000023,274.0125000000001,274.0125000000001,292.04634803639453,255.97865196360567,50872022,61.95167835373457,54.57324522565394,NaN,NaN,NaN,NaN,NaN,NaN,2.1787256458179556,3.0780496465515057,0.89932400073355,91.69735520589234,93.78417587322853,4840711445,17095011994.92904,32.884358150672725,22.1720321583531,21.72626480869054,85.71428571428571,14.285714285714286
2023-01-26,291.22,293.52,288.519,293.34,295.66741632176235,282.9294730221391,278.5505974141956,279.9240312839445,292.7232999999998,279.00470000000024,279.2892000000002,275.50050000000005,275.50050000000005,294.7178395401116,256.2831604598885,51596335,66.46073920120395,56.64304339800979,NaN,NaN,NaN,NaN,NaN,NaN,2.354480204503119,3.842424256362449,1.4879440518593299,99.45750452079564,94.99827764798765,4892307780,17142894136.647697,36.80939838058002,20.624483339126787,22.84157883313944,100,7.142857142857143
2023-01-27,292,298.26,291.88,296.26,295.6733126767697,283.1934438533839,279.2450837901095,281.47983782833074,292.5001499999998,279.0156000000003,279.50560000000024,277.3085000000001,277.3085000000001,297.18277913157766,257.4342208684225,56441939,68.54992448380781,58.23499793216593,NaN,NaN,NaN,NaN,NaN,NaN,2.5139962904915363,4.6304394149737504,2.116443124482214,93.17173096620006,94.7755302309627,4948749719,17163949280.036411,39.67666271363217,19.04690789213395,25.134719558923184,100,0
2023-01-30,292.93,294.38,289.89,290.27,295.6195483715282,283.33357367806934,279.67743344539934,282.3169961303945,292.25424999999984,278.9878000000002,279.5232000000002,278.5000000000001,278.5000000000001,298.4820799718075,258.51792002819275,49405833,60.25780698383388,59.09968448087893,NaN,NaN,60.25780698383388,NaN,NaN,NaN,2.08062702887918,4.717226910581189,2.636599881702009,72.72106520996921,88.45010023232165,4899343886,17122906127.009686,36.66143601743895,19.973535847608066,26.176457911018694,92.85714285714286,7.142857142857143
2023-01-31,290.31,294.72,290.2,294.62,295.6096026165876,283.5570672686026,280.2634164475405,283.48871078464265,291.9955999999998,278.9443000000003,279.7068000000002,279.9170000000001,279.9170000000001,300.2481869796074,259.5858130203928,46705106,63.69260118044015,60.03390037044601,NaN,NaN,NaN,NaN,NaN,NaN,1.953499124299289,5.0784737870761205,3.1249746627768316,85.52108194112972,83.80462603909969,4946048992,17167544635.399065,35.062126586504874,18.87728950813899,27.444210360681716,85.71428571428571,0
2023-02-01,294.41,303.43,292.3,300.92,295.66244239154696,283.9008877187293,281.07347854763697,285.14883356705764,291.8080499999998,278.94830000000024,280.0290000000002,281.7390000000001,281.7390000000001,302.73050866421363,260.74749133578655,67562173,68.00542059148339,60.93988804995964,NaN,NaN,NaN,NaN,NaN,NaN,2.144973649041223,5.80619172407836,3.6612180750371373,91.54597507578313,83.26270740896071,5013611165,17204634022.37391,40.55013333457978,16.478884966812217,28.90100578947781,100,0
2023-02-02,307.57,313.68,306.73,311.72,295.8222190841684,284.4517612292495,282.2753029183179,287.6794208463855,291.6731999999998,278.9946000000002,280.56700000000023,284.0380000000001,284.0380000000001,307.44911496703475,260.6268850329655,83070628,73.75982906663224,62.156074679833246,NaN,NaN,NaN,NaN,73.75982906663224,NaN,2.8083952514935415,7.171712139404065,4.363316887910523,95.0741392309626,90.71373208262516,5096681793,17240850425.66024,45.943932977276816,14.244445726183248,30.785554803068088,100,0
2023-02-03,304.94,312.39,304.54,306.18,295.9252815808434,284.8820233831257,283.2127420195603,289.44138076577735,291.4727999999998,278.94900000000024,281.0528000000002,286.26800000000014,286.26800000000014,309.18895076561154,263.34704923438875,76170804,67.09365813375013,62.767124596955696,NaN,NaN,NaN,NaN,NaN,NaN,2.683664954828866,7.717898081446606,5.03423312661774,81.15104297562202,89.25705242745592,5020510989,17196506403.458965,42.156788189523134,15.369911511516648,32.08959817981538,92.85714285714286,21.428571428571427
2023-02-06,303.51,305.91,302.22,303.59,296.00154743576036,285.25247836563807,284.011850175656,290.7888683118938,291.28469999999976,279.04790000000025,281.4056000000002,288.0075000000001,288.0075000000001,310.6404555073965,265.3745444926037,40802348,64.1736248751878,63.13060514116228,NaN,NaN,NaN,NaN,NaN,NaN,2.2536203780760236,7.85125859921277,5.597638221136746,74.64186981653675,83.6223506743738,4979708641,17186001733.91967,40.349879549423875,17.22221742741436,32.72542696761477,85.71428571428571,14.285714285714286
2023-02-07,303.46,311.03,302.32,309.88,296.13964149112593,285.740152061368,285.0262874236695,292.60707132980866,291.16334999999975,279.1864000000002,281.8268000000002,289.97450000000015,289.97450000000015,313.0273275705964,266.9216724294039,67583981,67.83485785867549,64.1078082301121,NaN,NaN,NaN,NaN,NaN,NaN,2.2163187708114735,8.368036684651088,6.151717913839614,90.44986177431512,82.08092485549132,5047292622,17235739198.696938,42.048830012311505,15.63487460113328,34.227290683903185,78.57142857142857,7.142857142857143
2023-02-08,308.54,309.5,303.67,304.37,296.2215356056421,286.10905994134094,285.78486438744716,293.72735025077924,291.0581999999998,279.3191000000002,282.1758000000002,291.55150000000015,291.55150000000015,314.00466126962016,269.09833873038014,56720860,61.87012337499764,64.90197637269698,NaN,NaN,NaN,NaN,NaN,NaN,1.6690363881749288,8.238013399058275,6.568977010883346,75.48064261258891,80.19079140114694,4990571762,17192639128.405342,39.26976864493949,14.601545588768525,36.5800714091112,71.42857142857143,0
2023-02-09,308.84,308.99,300.2,301.68,296.2758486841929,286.41739538804705,286.4082030389198,294.48474546499074,290.91869999999983,279.44270000000023,282.5552000000002,292.75800000000015,292.75800000000015,314.6584745153976,270.8575254846027,49137818,59.13625633539043,64.94764064657492,NaN,NaN,NaN,NaN,NaN,NaN,1.0069591227695343,7.827675914345264,6.820716791575729,63.07692307692308,76.33580915460904,4941433944,17160048288.93549,35.6756074149891,16.87823933418053,37.38826555139168,64.28571428571429,0
2023-02-10,299.48,301.57,297.25,299.7,296.3099198415641,286.6804172615511,286.92944997857,294.98143637308686,290.83149999999983,279.52920000000023,282.9378000000002,293.7905000000001,293.7905000000001,314.94287525668506,272.6381247433152,50050104,57.13502888269476,64.48344846753834,NaN,NaN,NaN,NaN,NaN,NaN,0.3506533108573686,7.25903343014744,6.908380119290071,56.98461538461533,65.18072702470911,4891383840,17166767978.824379,33.98728561511841,19.230879031807426,36.78901155949622,57.142857142857146,14.285714285714286
2023-02-13,301.13,305.1,299.93,304.5,296.3914131764739,287.03328028607484,287.618491155881,295.8879662423167,290.7701999999998,279.6869000000002,283.1606000000002,294.96700000000016,294.96700000000016,315.7504550544312,274.1835449455691,39636720,60.61469495089139,64.32401744805172,NaN,NaN,NaN,NaN,NaN,NaN,0.16425412019585828,7.113697769534895,6.949443649339036,71.75384615384613,63.9384615384615,4931020560,17197204686.445267,35.822889742604914,18.106060321305375,36.555759669494904,50,7.142857142857143
2023-02-14,302.89,307.72,300.91,306.75,296.49448369213087,287.4237103794199,288.36874640466993,296.9224456478103,290.6638999999998,279.9188000000002,283.4212000000002,296.22750000000013,296.22750000000013,316.65560600617664,275.7993939938236,64079057,62.165128852677206,64.33926391226191,NaN,NaN,NaN,NaN,NaN,NaN,0.11904523861459904,7.098250197607285,6.979204958992686,72.45737450816738,67.06527868220961,4995099617,17243029210.32045,36.01790158428446,16.773618678821094,37.76978484452743,42.857142857142854,0
2023-02-15,304.9,309.27,304.2,309.1,296.61991171509476,287.8529438372532,289.1817367417417,298.08221272897123,290.6431499999998,280.2091000000002,283.75220000000024,297.78850000000017,297.78850000000017,317.1114068982783,278.46559310172205,43427298,63.769353391000045,64.14702206867591,NaN,NaN,NaN,NaN,63.769353391000045,NaN,0.17081206993320475,7.1927200464091925,7.021907976475988,80.74821353509887,74.9864780657041,5038526915,17283544224.036427,35.71448226221206,15.839075048838918,38.510702597824775,35.714285714285715,0
2023-02-16,304.38,308.43,303.15,303.3,296.6863802552431,288.15882613750557,289.7353941244185,298.5791448500216,290.5672499999999,280.48700000000025,284.06540000000024,299.19600000000014,299.19600000000014,315.5979967077047,282.7940032922956,59498630,57.310547030403,63.34420939343271,NaN,NaN,NaN,NaN,NaN,NaN,-0.23985557884572106,6.722088502918837,6.961944081764558,56.36822194199249,69.8579366617529,4979028285,17227426198.0137,33.365073463005615,15.958009797994578,38.522248390889175,28.571428571428573,7.142857142857143
2023-02-17,301.07,301.93,298.1,301.16,296.7308938845441,288.4162751248817,290.1834178842453,298.82494057859094,290.4789499999999,280.75490000000025,284.45500000000027,300.1200000000001,300.1200000000001,314.6742502383189,285.56574976168133,58230729,55.093322483450535,62.975317643405326,NaN,NaN,NaN,NaN,NaN,NaN,-0.6847209952053621,6.106042837757855,6.790763832963217,46.678023850085296,61.264819775725535,4920797556,17262243004.648163,31.419766055285464,20.68978545550776,37.88835417732036,21.428571428571427,0
2023-02-21,297.26,298.73,293.89,294.03,296.70401931852876,288.5274379936959,290.33426424172586,298.3682795711061,290.30109999999985,280.9504000000003,284.72500000000025,300.37350000000015,300.37350000000015,314.3046755067401,286.4423244932602,46526708,48.377774589887665,61.881401458365865,NaN,NaN,NaN,NaN,NaN,NaN,-1.444589854330225,4.985026515050436,6.4296163693806605,8.091674462113946,37.045973418063895,4874270848,17218407924.3837,28.884214383044448,23.69336572021392,36.450293975136795,14.285714285714286,0
2023-02-22,294.62,296.3599,292.56,294.25,296.67960121585685,288.6407560532267,290.48782250675623,297.976062469096,290.20734999999985,281.09350000000023,284.9330000000002,300.66750000000013,300.66750000000013,313.79817229807986,287.5368277019204,51389237,48.58602291672797,60.494301624454764,NaN,NaN,NaN,NaN,NaN,NaN,-1.8897108459821137,4.067477811903018,5.957188657885132,8.001893939393927,20.923864083864373,4925660085,17212729264.25678,27.62916802945216,24.184689663812158,33.91022408891291,7.142857142857143,0
2023-02-23,297.97,298.13,292.55,296.82,296.6809982186841,288.8027212798955,290.7361431927658,297.86596128156305,290.1451999999998,281.34300000000025,285.2286000000002,301.1220000000002,301.1220000000002,312.99942160569566,289.2445783943047,69294443,51.069279168468675,58.87354806030022,NaN,NaN,NaN,NaN,NaN,NaN,-1.9599414508327797,3.507261844344157,5.467203295176937,21.522177419354776,12.538581940287537,4994954528,17249487606.780075,27.89233529803849,22.629709343327935,30.89232206943267,0,100
2023-02-24,291.76,292.97,290.05,291.85,296.63292858466735,288.86306343276885,290.779823851873,297.29301258808084,290.1186999999998,281.58890000000025,285.3540000000002,301.0475000000001,301.0475000000001,313.1360497475728,288.9589502524274,74331958,46.4017929087711,57.39555768708744,NaN,NaN,NaN,NaN,NaN,NaN,-2.2682345018766172,2.6319101678311654,4.900144669707783,8.579599618684531,12.701223659144398,4920622570,17266797788.780075,25.730733476863648,23.737769798190637,27.85407221357796,0,100
2023-02-27,295.07,296.49,293.34,293.94,296.6061332753672,288.96359683013975,290.9037523282701,296.97367805588266,290.0845999999998,281.79300000000023,285.4598000000002,300.93150000000014,300.93150000000014,313.24403389841217,288.6189661015881,48995009,48.53206296078438,56.27830326463005,NaN,NaN,NaN,NaN,NaN,NaN,-2.253856779193379,2.0828236957160584,4.336680474909437,18.54146806482361,16.21441503428764,4969617579,17236467545.113407,28.443150491242886,22.453408828022525,25.825272886801766,7.142857142857143,92.85714285714286
2023-02-28,293.3,296.124,292.96,293.56,296.5758234915327,289.0546147146914,291.00791890363206,296.6485658600843,290.0931999999998,281.9073000000003,285.6008000000002,301.0960000000001,301.0960000000001,312.91228266417204,289.2797173358282,48243141,48.157289843148575,54.872762692092415,NaN,NaN,NaN,NaN,NaN,NaN,-2.190481604812301,1.5985784688940612,3.789060073706362,18.046272493573227,15.055780059027123,4921374438,17206521423.456013,27.356208737143838,22.05432316971828,23.320934064161996,0,85.71428571428571
2023-03-01,293.26,293.93,290.2,291.2,296.5223327105224,289.0970975916282,291.0154514956465,296.12965482579057,290.09344999999985,281.99950000000024,285.8870000000002,300.9250000000001,300.9250000000001,313.2012380230931,288.64876197690717,58286972,45.792217426308966,53.72434083861465,NaN,NaN,45.792217426308966,NaN,NaN,NaN,-2.221084432001677,1.012704533704266,3.233788965705943,5.983350676378663,14.190363744925167,4863087466,17179487519.552526,26.090404831686087,24.45766253895766,20.280866980917523,0,78.57142857142857
2023-03-02,288.66,294.43,288.37,293.61,296.4933542755918,289.18646199575437,291.11719849581726,295.8896876995248,290.0517999999999,282.13800000000026,286.2742000000002,300.5595000000001,300.5595000000001,313.24309172315066,287.8759082768496,53738557,48.56994176434687,52.96960408354011,NaN,NaN,NaN,NaN,NaN,NaN,-1.999514042039006,0.7343964131571852,2.7339104551961912,25.0717703349283,16.367131168293398,4916826023,17218682968.717545,24.136375611173385,24.887584033104247,17.835474400205086,28.571428571428573,100
2023-03-03,295.39,299.92,294.87,299.68,296.5250621932476,289.3942548275216,291.4529946332362,296.2506698233796,290.05799999999994,282.44380000000024,286.8728000000002,299.9575000000001,299.9575000000001,311.5621212777347,288.3528787222655,60511540,54.84591242324252,52.806095765007804,NaN,NaN,NaN,NaN,NaN,NaN,-1.3933715044073973,0.9921960746869445,2.385567579094342,54.114832535885235,28.38998451573073,4977337563,17273442916.796753,29.007188237069325,22.959384818291554,16.686169648178424,21.428571428571427,92.85714285714286
2023-03-06,300.94,304,299.82,300.02,296.5598376938123,289.6046656230162,291.78895562801125,296.6096536497244,290.0272499999999,282.7799000000002,287.4824000000002,299.6495000000001,299.6495000000001,310.898707038708,288.4002929612922,56736294,55.17586438979369,52.41760786778655,NaN,NaN,NaN,NaN,55.17586438979369,NaN,-0.9404610266098072,1.2099912958320829,2.15045232244189,55.74162679425832,44.97607655502395,5034073857,17222135933.227375,32.54315311162059,21.718752448231466,15.764474375505744,14.285714285714286,85.71428571428571
2023-03-07,300.07,301.01,295.72,296.34,296.5576502540729,289.7380385809763,291.9674279563245,296.58397234975064,290.0532499999999,283.11580000000026,287.9402000000002,299.2870000000001,299.2870000000001,310.4719936968978,288.10200630310237,65955756,50.845175498991914,51.609039771094736,NaN,NaN,NaN,NaN,NaN,NaN,-0.8617392585948072,1.0732782491983812,1.9350175077931884,38.133971291865926,49.33014354066983,4968118101,17171640505.665937,30.37841864222527,25.42957356077426,13.794064942531161,7.142857142857143,78.57142857142857
2023-03-08,296.77,298.43,294.88,297.82,296.5702109480622,289.89807742095695,292.1969405854883,296.701689268822,290.09444999999994,283.4674000000002,288.56140000000016,298.6840000000001,298.6840000000001,308.765554245237,288.60244575476315,50876265,52.461224090888784,50.80131624965822,NaN,NaN,NaN,NaN,NaN,NaN,-0.6904152264110033,1.0719984747794342,1.7624137011904375,47.10867397806574,46.99475735472999,5018994366,17205032533.116642,28.985018197559416,25.34849702202202,11.518352847743568,0,71.42857142857143
2023-03-09,298.33,300.98,291.8299,292.66,296.53130337643967,289.95276895717564,292.2150997782142,296.31676648131514,290.11434999999994,283.7058000000003,289.0674000000002,298.09850000000006,298.09850000000006,308.15126534092894,288.0457346590712,71456691,46.69689296909043,50.04319810242161,NaN,NaN,NaN,NaN,NaN,NaN,-0.8922066697084559,0.6471553640548677,1.5393620337633236,27.447216890595147,37.56328738684227,4947537675,17146540989.863464,25.711462508485617,26.25038334251008,9.071583278826829,0,64.28571428571429
2023-03-10,292.83,294.35,287.38,288.55,296.4518874224452,289.92499135406325,292.071370375147,295.5770744354756,290.08969999999994,283.9839000000003,289.56680000000017,297.4420000000001,297.4420000000001,308.1659668033617,286.71803319663854,98593561,42.674743350012925,49.1561567357475,NaN,NaN,42.674743350012925,NaN,NaN,NaN,-1.248239357203737,-0.020937162741347493,1.2273021944623894,7.039711191335834,27.198534019998906,4848944114,17081047706.157583,23.53132374874216,29.438006858386746,8.39729331794823,71.42857142857143,100
2023-03-13,286.73,294.47,285.19,290.69,296.3945552092866,289.9401400401214,292.01719898788633,295.1116387749541,290.1069499999999,284.19730000000027,290.1786000000002,296.9915000000001,296.9915000000001,308.04997417140635,285.9330258285938,97123603,45.31586391463899,48.937448830372595,NaN,NaN,NaN,NaN,NaN,NaN,-1.2805782577698381,-0.37342062774990836,0.9071576300199298,29.23976608187134,21.24223138793411,4946067717,17099049063.610168,20.98053865184489,28.805076046603446,8.814701938266206,64.28571428571429,100
2023-03-14,294.31,297.93,293.45,297.37,296.4042611276021,290.08726597992097,292.2271127530673,295.326720796387,290.13749999999993,284.4562000000003,290.7972000000002,296.6350000000001,296.6350000000001,307.1485445973136,286.1214554026866,73602545,52.649424048108585,49.22769176832834,NaN,NaN,NaN,NaN,NaN,NaN,-0.8156860144582925,-0.11244988805293588,0.7032361264053566,64.75279106858056,33.67742278059591,5019670262,17154250972.360168,23.21841900119041,26.400619650927332,8.797949918822866,57.142857142857146,92.85714285714286
2023-03-15,294.71,299.27,293.24,298.93,296.42939285767574,290.26236962388293,292.4899710764764,295.66989024435014,290.1354999999999,284.74060000000026,291.45020000000017,296.2440000000001,296.2440000000001,305.75787702252273,286.73012297747744,83631535,54.194342095598294,49.450910548837605,NaN,NaN,NaN,NaN,NaN,NaN,-0.3883966680478116,0.21774029134559214,0.6061369593934037,73.04625199362046,55.67960304802412,5103301797,17228451422.152874,23.149028462632934,24.561672512666416,8.265404153227026,50,85.71428571428571
2023-03-16,298,307.18,297.19,306.81,296.53268248098243,290.59004547291494,293.05154083818326,296.73085307822157,290.1240499999999,285.11760000000027,292.29680000000025,296.1295000000001,296.1295000000001,305.05889746005306,287.2001025399472,98556824,61.09879858757125,50.50069666875191,NaN,NaN,NaN,NaN,NaN,NaN,0.3971375673719474,1.102558918608338,0.7054213512363906,98.31741700773077,78.70548668997726,5201858621,17319707740.67139,29.342537218729454,21.84665333413241,9.023599656093543,100,78.57142857142857
2023-03-17,306.72,309.15,303.37,305.36,296.6205164861468,290.88251981998593,293.5342255111957,297.55267659458144,290.10944999999987,285.41700000000026,293.0892000000002,296.2325000000001,296.2325000000001,305.5302908666374,286.93470913336273,89923732,59.32670335815727,51.27174241142139,NaN,NaN,NaN,NaN,NaN,NaN,0.7697097959438494,1.6675585961662023,0.8978488002223529,84.18196994991666,85.18187965042263,5111934889,17291703810.290768,29.648001135836292,20.438921370514276,9.496295026416677,100,71.42857142857143
2023-03-20,304.26,306.3,302.01,305.97,296.7135461728518,291.18128180374856,294.0219029421292,298.35432644271657,290.10929999999985,285.69220000000024,293.9770000000002,296.47300000000007,296.47300000000007,306.4892509952442,286.4567490047559,56359491,59.85422555955915,52.10723781973643,NaN,NaN,NaN,NaN,NaN,NaN,0.9936246503021118,2.1398796130999926,1.1462549627978809,86.7278797996663,89.7424222524379,5168294380,17339392610.36769,28.19577824589033,20.990593156775443,9.776185646451788,92.85714285714286,64.28571428571429
2023-03-21,307.94,310.8,306.395,310.34,296.84913277809704,291.56066236209017,294.66182831694766,299.49581916245785,290.0890999999998,285.9535000000003,294.80780000000027,297.2885000000001,297.2885000000001,308.90444640998413,285.6725535900161,49757048,63.50588669556995,53.37249991039793,NaN,NaN,NaN,NaN,63.50588669556995,NaN,1.350315700194712,2.834149588041271,1.483833887846559,98.20382663022242,89.70455879326846,5218051428,17378757720.987442,31.838133398779306,19.813851098206833,11.208281447685447,100,57.142857142857146
2023-03-22,310.27,315.25,305.95,306.12,296.94138021314086,291.84896607769235,295.1111683829497,300.1266935279381,290.0886999999998,286.23540000000025,295.51940000000025,297.8820000000001,297.8820000000001,310.0176427106095,285.74635728939074,75791914,58.01772357493723,54.04734146829724,NaN,NaN,NaN,NaN,NaN,NaN,1.220258588091257,3.00915712296063,1.7888985348693731,69.62741184298073,84.85303942428982,5142259514,17305736694.165936,33.5055519544018,17.750438183015852,13.294407417065154,100,50
2023-03-23,309.92,314.15,307.01,309.75,297.0688291662439,292.20344199694597,295.6852402110693,301.0431989062297,290.1013499999998,286.6042000000003,296.25780000000026,298.52850000000007,298.52850000000007,311.7021969374487,285.3548030625514,74575981,61.12952404979785,54.49617087019406,NaN,NaN,NaN,NaN,NaN,NaN,1.2901224114666903,3.401551549202736,2.111429137736046,81.7032601463739,83.17816620652569,5216835495,17288398300.8242,30.547472641739436,16.18331867842362,14.658708874325507,92.85714285714286,42.857142857142854
2023-03-24,309.32,310.99,306.95,310.89,297.20635325414196,292.5734728484916,296.28150530083127,301.9809894865888,290.10644999999977,286.90090000000026,296.9246000000002,299.4805000000001,299.4805000000001,313.32109026919125,285.639909730809,57245803,62.08011928068512,54.98933193382915,NaN,NaN,NaN,NaN,NaN,NaN,1.3197839941756513,3.76115913045561,2.4413751362799587,85.49567531603456,78.94211576846307,5274081298,17342810153.180634,29.15294853351992,15.512331821991927,15.415223697959092,85.71428571428571,35.714285714285715
2023-03-27,311.6,312.7,307.89,308.76,297.3213149133047,292.8939981386205,296.770858034132,302.6266095354851,290.1120499999998,287.2090000000003,297.5188000000002,300.2215000000001,300.2215000000001,314.37946634406626,286.06353365593395,50287407,59.16855635080479,55.58385913753007,NaN,NaN,NaN,NaN,NaN,NaN,1.1110008667313425,3.8301262196941366,2.719125352962794,78.40984697272118,81.86959414504322,5223793891,17310714032.70454,29.50673252751164,14.654559730055686,17.184082670791245,78.57142857142857,28.571428571428573
2023-03-28,308.17,308.2,304.774,307.12,297.4188142674012,293.1757011457765,297.1767067386759,303.0545514844865,290.1506499999998,287.5291000000003,298.0418000000002,300.8995000000001,300.8995000000001,315.0151657299512,286.783834270049,48585917,56.95370517663826,55.90475064365503,NaN,NaN,56.95370517663826,NaN,NaN,NaN,0.7924484305060195,3.7096858910953188,2.9172374605892992,72.9540918163673,78.95320470170768,5175207974,17328667847.9182,28.119104043485294,17.641703089877957,18.341443596891022,71.42857142857143,21.428571428571427
2023-03-29,310.88,313.35,310.05,312.72,297.5710648717057,293.562716964672,297.78624765088466,303.97507039072593,290.27004999999986,287.9995000000003,298.6654000000002,301.9755000000001,301.9755000000001,316.2495918800333,287.70140811996697,53274266,62.16215866580373,57.009412479134554,NaN,NaN,NaN,NaN,NaN,NaN,0.8820274989824775,4.019771834317396,3.1377443353349186,91.58349966733209,80.98247948547352,5228482240,17361601030.536385,32.12003753137122,16.347675515856753,20.591790053225534,64.28571428571429,14.285714285714286
2023-03-30,315.24,316.32,312.8088,315.68,297.7512532809424,294.0006829653716,298.48796342928136,305.08982559160916,290.47139999999985,288.5514000000003,299.42140000000023,303.07900000000006,303.07900000000006,317.99359674278236,288.16440325721777,58354808,64.60031095763543,58.57552445110759,NaN,NaN,NaN,NaN,NaN,NaN,1.0522306534282366,4.453032652120214,3.4008019986919775,97.9441053646001,87.49389894943317,5286837048,17398682725.572155,34.31929129283857,15.634044835963271,22.467094668553816,100,7.142857142857143
2023-03-31,315.91,321.17,315.6,320.93,297.98188757665446,294.5339367680375,299.36804329479975,306.5984136305035,290.6964999999999,289.1139000000003,300.3370000000002,304.14150000000006,304.14150000000006,320.8552838624246,287.42771613757554,62138097,68.47980944881445,60.23009198926298,NaN,NaN,NaN,NaN,68.47980944881445,NaN,1.407789296046983,5.1605386187507065,3.7527493227037234,99.14070891514498,96.2227713156924,5348975145,17455466013.494957,37.896297245165364,14.57397858407868,24.519392343210594,100,0
2023-04-03,318.77,320.42,317.4201,320.15,298.2024658097226,295.04118554490805,300.1830219891213,307.8890409037889,290.8832499999999,289.6395000000003,301.08640000000025,305.1480000000001,305.1480000000001,323.12452535947153,287.17147464052863,47126839,67.29973481323339,61.27654275820047,NaN,NaN,NaN,NaN,NaN,NaN,1.4728570467484117,5.593820631139238,4.120963584390826,96.34801288936613,97.81094238970373,5301848306,17494109738.704494,36.229259826207326,13.932877225664257,27.236204084701903,92.85714285714286,7.142857142857143
2023-04-04,320.6,321.63,317.8251,319.07,298.41010296584477,295.51700365292965,300.92368779346947,308.9538941510471,291.12164999999993,290.13480000000027,301.68860000000024,306.2845000000001,306.2845000000001,324.75710617779094,287.81189382220924,45875384,65.61374254396421,62.09221421879803,NaN,NaN,NaN,NaN,NaN,NaN,1.329937536845554,5.783385505447768,4.453447968602214,89.5253682487725,95.00469668442787,5255972922,17478253680.069996,36.0129601610563,13.252306552362706,30.324729090356588,100,0
2023-04-05,318.1,319.06,314.07,315.92,298.5843307970304,295.9210233825746,301.5117784682354,309.61733280332834,291.3277999999999,290.6608000000003,302.2396000000002,307.18950000000007,307.18950000000007,325.68815127515614,288.690848724844,62795706,60.82730616031565,62.07282190256549,NaN,NaN,NaN,NaN,NaN,NaN,0.9290139574834182,5.614715415456487,4.685701457973069,70.89704383282375,85.59014165698746,5193177216,17462019920.40266,33.684474150110645,17.251315390570834,31.583229772879612,92.85714285714286,0
2023-04-06,314.24,318.55,312.82,318.05,298.77801904780625,296.35922093935534,302.1603361753634,310.4204439649161,291.5126499999999,291.0138000000003,302.84600000000023,308.45900000000006,308.45900000000006,326.2669307051619,290.65106929483824,46916496,62.803256967963854,62.32114716040882,NaN,NaN,NaN,NaN,NaN,NaN,0.7222353565065287,5.5884956536062305,4.866260297099702,81.75331294597358,80.72524167585661,5240093712,17500748546.245594,31.1952044658658,17.58857057280871,32.26219576285002,85.71428571428571,7.142857142857143
2023-04-10,315.07,317.92,313.25,317.87,298.9679890075296,296.7851769603582,302.77640142338834,311.12992549206695,291.69865,291.31290000000024,303.33660000000026,309.92500000000007,309.92500000000007,325.6401360159503,294.20986398404983,45134736,62.516269238672,62.5112931374883,NaN,NaN,NaN,NaN,NaN,NaN,0.49891781882747477,5.489907570634045,4.990989751806571,77.69340294257242,76.78125324045658,5194958976,17544916799.676003,29.24548425417799,16.489273673568114,33.208122691733124,78.57142857142857,0
2023-04-11,317.83,317.89,315.31,315.83,299.13577021143476,297.162302169064,303.2883072499221,311.57755163567964,291.85355,291.61680000000024,303.72800000000024,311.18200000000013,311.18200000000013,324.3585725437099,298.00542745629036,40113594,59.21374483945738,62.20471157633741,NaN,NaN,NaN,NaN,NaN,NaN,0.15710268104513325,5.187368103112988,5.030265422067854,65.59088751779774,75.01253446878124,5154845382,17520973026.51321,28.22437561088783,15.913549239555646,33.53757270002239,71.42857142857143,35.714285714285715
2023-04-12,317.82,318.42,312.565,313.04,299.27412075659464,297.47671202710234,303.6707265734546,311.7168324322816,291.9457,291.8533000000003,304.18340000000023,311.96550000000013,311.96550000000013,323.52849005446365,300.4025099455366,62813305,54.939162054457206,61.984814324874556,NaN,NaN,54.939162054457206,NaN,NaN,NaN,-0.2892872591085718,4.6686563481821395,4.957943607290711,49.038917892738624,64.10773611770291,5092032077,17468351461.86334,26.00532457412515,18.348423478419598,32.57508436693634,64.28571428571429,28.571428571428573
2023-04-13,314.83,319.65,313.63,319.17,299.4720897042902,297.9062820859716,304.27854121763284,312.42665791492146,292.07930000000005,292.19060000000025,304.6744000000002,312.9775000000001,312.9775000000001,323.2732406241487,302.68175937585147,54613792,61.51309340977871,62.012212136301756,NaN,NaN,NaN,NaN,NaN,NaN,-0.2079092557170119,4.698057037644446,4.905966293361458,85.40579022306609,66.67853187786748,5146645869,17514256077.73045,25.359938255653347,16.747561895260972,31.840456830065914,57.142857142857146,21.428571428571427
2023-04-14,317.59,320.36,315.61,318.57,299.6621186624565,298.31546461892265,304.83899058164724,313.01173811350037,292.25445,292.52820000000025,305.0274000000002,313.56550000000004,313.56550000000004,323.72753222785013,303.40346777214995,56278284,60.581468362980594,61.90516564218,NaN,NaN,NaN,NaN,NaN,NaN,-0.22902150952730782,4.6196894064523235,4.848710915979631,81.84622686283814,72.09697832621428,5090367585,17528118307.68413,24.70135026928651,15.688289953717485,31.253002227378396,50,14.285714285714286
2023-04-17,318.15,319.1999,316.04,318.84,299.85294335238234,298.7218910621123,305.38804977452384,313.5668106741194,292.42965000000004,292.86840000000024,305.16980000000024,314.2395000000001,314.2395000000001,323.9115121484517,304.56748785154844,43007023,60.86867556939508,62.02660272922217,NaN,NaN,NaN,NaN,NaN,NaN,-0.2572225778865862,4.527182693621398,4.784405271507985,83.44803037494054,83.56668248694825,5133374608,17561328674.09519,23.63058385194253,15.008226157817115,30.444689658540664,42.857142857142854,7.142857142857143
2023-04-18,320.99,321.42,317.64,318.86,300.04206829414966,299.12066549652593,305.9163615480719,314.0709239432509,292.62255000000005,293.23810000000026,305.42340000000024,314.8840000000001,314.8840000000001,323.96580466645514,305.8021953335451,46746940,60.891406541128696,62.307867112400054,NaN,NaN,NaN,NaN,NaN,NaN,-0.3037565849371324,4.404709540336569,4.708466125273701,76.07944732297076,80.45790152024982,5180121548,17544757007.534344,25.487156674054123,14.214434070297207,30.83737646119898,35.714285714285715,0
2023-04-19,316.41,319.79,316.28,318.71,300.22781885838697,299.5085731104561,306.41807285991223,314.5127407105603,292.80545,293.5657000000003,305.7258000000002,315.3025000000001,315.3025000000001,324.2789511361458,306.32604886385445,38960127,60.607050440429276,62.19678795344474,NaN,NaN,NaN,NaN,NaN,NaN,-0.369498613396285,4.246592858528345,4.61609147192463,67.78819635962475,75.77189135251201,5141161421,17559741671.765114,24.20684532476085,15.446764706839081,30.09091295191711,28.571428571428573,0
2023-04-20,315.69,319.27,314.97,316.28,300.3875420538259,299.8406805736154,306.8048151007,314.68105111907835,292.95205,293.8403000000003,305.8538000000002,315.8105000000001,315.8105000000001,323.7396777000934,307.8813222999068,62462142,56.04127789830445,61.5854284492068,NaN,NaN,NaN,NaN,NaN,NaN,-0.5884956632101508,3.8804718929119417,4.4689675561220925,40.981798124655,61.616480602416836,5078699279,17535337858.146507,22.702284365549584,16.380220724925536,28.574541242404795,21.428571428571427,57.142857142857146
2023-04-21,315.91,317.4,314.1,316.61,300.54895954582764,300.1727463048309,307.1893321555745,314.864760536309,293.0911,294.1372000000003,306.09860000000026,316.15350000000007,316.15350000000007,323.5820376084266,308.7249623915735,59002285,56.52031577558737,60.73117890111916,NaN,NaN,NaN,NaN,NaN,NaN,-0.7145917513457309,3.5757278669399284,4.290319618285659,44.62217319360195,51.13072255929389,5137701564,17566090564.26772,21.593068377144238,16.868002662066576,26.277161982211883,14.285714285714286,50
2023-04-24,316.38,317.7391,313.74,315.95,300.70220372945124,300.4851671700818,307.5328877573167,314.96811667570813,293.19595000000004,294.4696000000003,306.38400000000024,316.4065000000001,316.4065000000001,323.43462428743203,309.3783757125682,44043063,55.224126774764954,59.86863546979998,NaN,NaN,NaN,NaN,NaN,NaN,-0.8373999392191838,3.24356969426168,4.080969633480864,37.34142305570868,40.98179812465521,5093658501,17570726038.553608,20.298728296752042,16.396497205232464,23.861843119046718,7.142857142857143,42.857142857142854
2023-04-25,314.29,314.97,309.89,309.99,300.7946196127403,300.67338168156533,307.62924510016705,314.4940103256407,293.26915,294.7638000000003,306.5898000000003,316.46800000000013,316.46800000000013,323.24442265503,309.69157734497026,57121644,45.153771532042015,58.4072089689484,NaN,NaN,45.153771532042015,NaN,NaN,NaN,-1.2880345411498424,2.4709264570435607,3.758960998193403,0.8673026886385298,27.610299645983044,5036536857,17515853278.175655,18.490027840149725,20.596407376760986,20.94675924496837,0,100
2023-04-26,313.44,314.935,311.34,311.87,300.9048224026633,300.89509689579177,307.795549213886,314.2441045803416,293.3833,294.94890000000026,306.73720000000026,316.70550000000014,316.70550000000014,322.4016020882291,311.0093979117712,55400496,48.35308359495564,57.516193071422684,NaN,NaN,NaN,NaN,NaN,NaN,-1.4172552022946103,1.9873919953251402,3.4046471976197505,17.17259323503914,18.46043965979545,5091937353,17476787838.019886,17.14734608904111,19.100767642615953,19.027225687890915,57.142857142857146,92.85714285714286
2023-04-27,315.7,320.86,315.05,320.35,301.09830675686567,301.2803425018157,308.287880617263,314.8256184298329,293.55385,295.2152000000003,307.00920000000025,317.0870000000001,317.0870000000001,322.68548586669925,311.48851413330095,65430392,59.75636256658442,57.29855775703844,NaN,NaN,NaN,NaN,NaN,NaN,-0.9138190791094174,2.2623733487329787,3.176192427842396,90.7198612315699,36.253252385082526,5157367745,17530731310.942432,23.21664980332812,16.723199508716583,18.196250987154592,50,85.71428571428571
2023-04-28,320.11,322.65,318.96,322.56,301.3118559433645,301.7017218582154,308.84757157344876,315.56222619842026,293.7384,295.51530000000025,307.27840000000026,317.4310000000001,317.4310000000001,323.4695855959585,311.3924144040417,59712635,62.10465573046674,57.26915679216664,NaN,NaN,NaN,NaN,62.10465573046674,NaN,-0.4382908671799566,2.6283288438674504,3.066619711047407,99.29467084639518,69.06237510433475,5217080380,17587531134.47902,24.53572531251286,15.851048852101485,17.739968397165182,100,78.57142857142857
2023-05-01,322.09,323.63,321.09,322.19,301.5195986702962,302.10743033627057,309.3708040607645,316.19344275095165,293.916,295.86080000000027,307.6562000000003,317.4940000000001,317.4940000000001,323.7012261115363,311.28677388846387,41013386,61.45806702128758,57.42946551944022,NaN,NaN,NaN,NaN,NaN,NaN,-0.16883338710800766,2.8555779771623975,3.024411364270405,89.51965065502186,93.17806091099565,5176066994,17582041153.67587,25.058570091378897,15.261053369900482,17.48339008670625,100,71.42857142857143
2023-05-02,322.12,322.45,317.61,319.38,301.69731410641265,302.44946141872066,309.76332154857766,316.49692439371813,294.05355,296.2378000000002,308.0206000000003,317.45550000000014,317.45550000000014,323.60564300643097,311.3053569935693,56519407,56.63546209449104,57.55062980801407,NaN,NaN,NaN,NaN,NaN,NaN,-0.1979927501480221,2.7769204265853773,2.9749131767333994,69.06841339155751,85.96091163099152,5119547587,17566860321.21719,23.28038422578669,19.280278870298016,16.921628750998742,92.85714285714286,64.28571428571429
2023-05-03,319.75,322.47,317.18,317.29,301.85246520983145,302.7433334698351,310.05848540941776,316.5724554038402,294.193,296.60540000000026,308.4858000000003,317.3665000000001,317.3665000000001,323.4719673039581,311.2610326960421,59882070,53.28625039528232,56.96299816412147,NaN,NaN,NaN,NaN,NaN,NaN,-0.36639079981075984,2.51692467696995,2.8833154767807097,53.85735080058245,70.81513828238728,5059665517,17509468620.85802,21.48578648065648,18.42063337224589,16.009310533299185,85.71428571428571,57.142857142857146
2023-05-04,317.06,318.23,315.115,316.17,301.9949282425695,303.00920805459083,310.29815264826414,316.5341263177602,294.28234999999995,296.92860000000024,308.9242000000003,317.3790000000001,317.3790000000001,323.4735841531392,311.28441584686095,50224520,51.52771366410351,56.316301399915965,NaN,NaN,51.52771366410351,NaN,NaN,NaN,-0.5504950440699878,2.1951966716932247,2.7456917157632126,45.70596797671052,56.21057738961682,5009440997,17493264562.238438,20.484431742719966,20.651706218542486,14.444407588281441,78.57142857142857,50
2023-05-05,318.47,323.76,316.2116,322.89,302.20283940433495,303.4028871030148,310.7919505836263,317.13944762083065,294.38165,297.3371000000002,309.44560000000024,317.6210000000001,317.6210000000001,324.1703416462778,311.0716583537224,51806098,60.0472974522295,56.25763153440413,NaN,NaN,NaN,NaN,NaN,NaN,-0.23320740423119846,2.4541824604742146,2.687389864705413,93.7274693583273,64.43026271187343,5061247095,17533128710.882282,26.19157976380629,18.401333721631396,14.098294559642289,100,42.857142857142854
2023-05-08,322.42,324.04,321.315,323.69,302.4166419973266,303.8046121108759,311.29775644309194,317.76330975218013,294.4632,297.7182000000002,310.0824000000003,317.91200000000015,317.91200000000015,324.9766517252805,310.8473482747198,36465796,60.92773560090364,56.260226467245204,NaN,NaN,NaN,NaN,NaN,NaN,0.004441169658613298,2.69294132677868,2.6885001571200666,97.52650176678429,78.98664636727403,5097712891,17560227146.441914,25.54810900422021,17.65739934690274,13.374692656173268,100,35.714285714285715
2023-05-09,322,322.88,321.32,321.64,302.6079191913831,304.15778810868034,311.7033346217942,318.1325183472106,294.56145,298.0481000000002,310.63640000000026,318.2025000000001,318.2025000000001,325.37776271293865,311.02723728706155,31768800,57.434907795808236,56.033644849772266,NaN,NaN,NaN,NaN,NaN,NaN,-0.0021748752665580184,2.685781563036869,2.687956438303427,83.03886925795032,91.43094679435399,5065944091,17541491700.288067,24.615994566367903,17.013174881465662,13.101242258997791,92.85714285714286,28.571428571428573
2023-05-10,324.12,326.01,321.6,325.14,302.83211900042403,304.57327745306293,312.2302626758415,318.7998975522381,294.6858,298.4344000000002,311.26800000000026,318.8075000000001,318.8075000000001,326.1774250335166,311.4375749664836,60446623,61.49366598822908,56.42310114190974,NaN,NaN,NaN,NaN,NaN,NaN,0.19264856410324294,2.9287671434324807,2.7361185793292377,94.60297766749378,91.72278289740946,5126390714,17578088635.301674,27.774453347381527,15.854061449560074,13.897405161928706,100,21.428571428571427
2023-05-11,325.7,326.75,324.12,326.2,303.06463522927555,305.00152938468545,312.77809551208304,319.50466921392973,294.8449499999999,298.92750000000024,311.9680000000003,319.1590000000001,319.1590000000001,327.20419210458266,311.11380789541755,44278548,62.655097056194215,56.86129980481023,NaN,NaN,NaN,NaN,NaN,NaN,0.34736321831405137,3.170322602221802,2.8229593839077505,96.7378410438908,91.4598959897783,5170669262,17603847638.5108,27.78964712997352,15.189425595850183,15.113961496815076,100,14.285714285714286
2023-05-12,326.74,327.17,322.94,325.03,303.28319607276535,305.39813276320655,313.25856235474646,320.0308911935555,294.9360499999999,299.4353000000002,312.59640000000024,319.48200000000014,319.48200000000014,327.91598743178866,311.0480125682116,48432836,60.48647331060393,57.23718170022729,NaN,NaN,NaN,NaN,NaN,NaN,0.3257229638436856,3.2301130887123577,2.904390124868672,87.6157407407405,92.98551981737502,5122236426,17603275146.359497,25.908370624750383,16.04962163205376,16.03271486905468,100,7.142857142857143
2023-05-15,325.51,327.03,323.96,326.79,303.517094619305,305.8217340946282,313.78920696828584,320.6746158417883,295.0209499999999,300.0057000000002,313.1386000000003,319.8795000000001,319.8795000000001,328.8850015962257,310.8739984037745,33375559,62.58440776326941,58.48222714531497,NaN,NaN,NaN,NaN,NaN,NaN,0.3809246535365993,3.3805459417894212,2.999621288252822,97.59949463044855,93.98435880502662,5155611985,17631432376.9165,24.6064023208244,15.243083121485423,17.326120826254712,92.85714285714286,0
2023-05-16,326.06,328.9025,326.02,327.16,303.75234740916267,306.24427401354643,314.31355179305893,321.2922714759037,295.0794499999999,300.58190000000025,313.6814000000002,320.2945000000001,320.2945000000001,329.8235827994993,310.76541720050085,40019151,63.02881713324165,59.53049382662111,NaN,NaN,NaN,NaN,NaN,NaN,0.3918208643199508,3.48939736865276,3.0975765043328094,87.42104313300881,90.8787595013993,5195631136,17623067576.057003,26.557788200853675,14.505988466144421,19.037545882942094,100,0
2023-05-17,328.24,331.71,327.04,331.12,304.0246623603153,306.7368626469416,314.97262819333116,322.22824562105575,295.1586999999999,301.1586000000002,314.37700000000024,320.91500000000013,320.91500000000013,331.5074265397303,310.32257346026995,47486124,67.48075579284838,60.082236199925674,NaN,NaN,NaN,NaN,NaN,NaN,0.6025884359866018,3.850812049316062,3.24822361332946,96.44471226272988,93.8217500087291,5243117260,17658555064.87071,29.168911444504715,13.377354950336171,20.52741187908129,100,0
2023-05-18,331.52,337.49,331.5,337.27,304.35546173981464,307.3414792281903,315.8470349308476,323.6607936571457,295.27339999999987,301.8637000000002,315.1660000000002,321.96450000000016,321.96450000000016,334.4942349931887,309.43476500681163,64213466,72.93211460306122,60.85562611939672,NaN,NaN,NaN,NaN,72.93211460306122,NaN,1.0659699829434413,4.5806860920087615,3.5147161090653203,99.01675977653619,94.29417172409164,5307330726,17718051681.949173,35.483945461669904,12.00525927900699,22.522860846383086,100,28.571428571428573
2023-05-19,337.49,338.205,335.43,336.51,304.6754073941448,307.9190736989192,316.6573472865006,324.8845275945604,295.3414999999999,302.55520000000024,316.04300000000023,322.9595000000001,322.9595000000001,336.7295522511578,309.1894477488424,61554926,71.34055119620102,61.561517846176244,NaN,NaN,NaN,NaN,NaN,NaN,1.2199842310782953,5.03969639791319,3.8197121668348943,92.65915980944133,96.04021061623581,5245775800,17704409779.430252,35.03777948650591,11.454092457552571,24.410492973905438,100,21.428571428571427
2023-05-22,336.25,338.67,336.24,337.64,305.0034132907205,308.507606893,317.48019641252023,326.09933449031655,295.40769999999986,303.2958000000002,317.02480000000025,324.04400000000015,324.04400000000015,338.8151399695314,309.2728600304689,43015948,72.30817437347557,62.68099729467514,NaN,NaN,NaN,NaN,NaN,NaN,1.2898541621436914,5.432029869514508,4.142175707370817,95.6272553597961,95.76772498192456,5288791748,17710959532.82943,34.377871453711826,10.978764917282003,27.424104406985244,100,14.285714285714286
2023-05-23,335.89,337.06,333,333.36,305.28556838235517,308.9997334891782,318.10293380810765,326.7908264436197,295.46574999999984,304.02840000000026,317.8782000000003,325.21250000000015,325.21250000000015,339.01755686332206,311.40744313667824,48216663,63.55548572566154,63.41451410398793,NaN,NaN,NaN,NaN,NaN,NaN,0.9551279683754794,5.336085667840166,4.380957699464687,77.45701549564848,88.58114355496197,5240575085,17671293608.09544,31.674885795014657,15.605797169445687,29.303085191883916,92.85714285714286,7.142857142857143
2023-05-24,331.37,332.905,329.56,331.65,305.54790103526705,309.44825361810535,318.6341913058289,327.2536048775607,295.52044999999987,304.6805000000002,318.56380000000024,326.2015000000001,326.2015000000001,338.8249278624928,313.57807213750743,62891169,60.409227320010594,64.04890793655272,NaN,NaN,60.409227320010594,NaN,NaN,NaN,0.5461901282461223,5.063695359772339,4.517505231526217,68.74220781533846,80.60882622359435,5177683916,17686992898.413826,29.620829801437065,20.46425005572667,30.57990051262012,85.71428571428571,0
2023-05-25,339.14,341.01,336.665,339.72,305.8879219204883,310.0476941405191,319.46108576442384,328.4408806035073,295.6336499999999,305.4149000000002,319.37960000000027,327.17000000000013,327.17000000000013,340.7825280532186,313.5574719467817,66862773,68.3677658193559,64.64322710563319,NaN,NaN,NaN,NaN,NaN,NaN,0.735066937565044,5.436338903482522,4.701271965917478,93.45011424219364,79.88311251772686,5244546689,17714153495.501286,37.98251982580153,17.460694496827582,31.975931818913264,100,0
2023-05-26,340.76,349.245,340.66,348.4,306.31092767252323,310.80714574169696,320.59594514621114,330.341749117459,295.74599999999987,306.2541000000002,320.21140000000025,328.4620000000001,328.4620000000001,344.7259485980411,312.1980514019591,63006952,74.34212024139737,65.60139743709702,NaN,NaN,NaN,NaN,NaN,NaN,1.3259945618043902,6.358765168172965,5.032770606368575,96.9740376007161,86.38878655274941,5307553641,17764757215.249683,44.69911209494528,15.041336760505306,34.21744445534788,100,0
2023-05-30,352.71,353.93,348.53,349.98,306.7454458051349,311.58284582601976,321.7482610228303,332.21205872532005,295.8754999999999,307.0965000000002,321.10380000000026,329.8515000000001,329.8515000000001,348.3320424974399,311.3709575025603,72652156,75.25816169127175,66.87448700105871,NaN,NaN,NaN,NaN,NaN,NaN,1.6818148223602156,7.135039134318845,5.453224311958629,87.78224559232913,92.73546581174628,5380205797,17731121957.842278,47.889798280876505,13.842149663621047,36.85250255316132,100,0
2023-05-31,348.37,350.6,346.51,347.99,307.1558393792132,312.30377957203916,322.77734882585656,333.7147197990991,295.9634999999999,307.9606000000002,321.94420000000025,331.28200000000015,331.28200000000015,350.70404170522835,311.85995829477196,65105378,71.7820716247832,67.60937311795543,NaN,NaN,NaN,NaN,NaN,NaN,1.6399594001168385,7.503173562104678,5.863214161987839,80.83252662149081,88.52960327151202,5315100419,17713134408.419296,45.03031007457372,15.964628705590373,38.30465487592853,92.85714285714286,0
2023-06-01,347.73,353.36,346.66,352.01,307.6021494351414,313.09004136269186,323.92372730327395,335.4571274372801,296.0582499999999,308.7927000000002,322.7776000000003,333.01800000000014,333.01800000000014,353.3141992500961,312.72180074990416,50488601,74.35861012892948,68.44533833743652,NaN,NaN,NaN,NaN,NaN,NaN,1.7308490548915998,8.026775480602339,6.295926425710739,93.80445304937071,87.47307508773024,5365589020,17743276856.777504,44.66471777113293,14.44322123754299,39.862671076113884,85.71428571428571,7.142857142857143
2023-06-02,353.8,355.83,352.01,354.65,308.07028725170716,313.9130108406584,325.1286791737338,337.28502006230104,296.1700999999999,309.63380000000024,323.7482000000003,334.9420000000001,334.9420000000001,355.77337691079833,314.1106230892019,53372113,75.91399826060426,69.54730440529369,NaN,NaN,NaN,NaN,NaN,NaN,1.808162835171271,8.556129969674828,6.747967134503557,96.29745842485094,90.3114793652375,5418961133,17763675622.479073,45.77002768166631,13.644808581926975,42.046431266817514,100,0
2023-06-05,354.43,357.495,353.85,354.9,308.5362545427349,314.72463438836814,326.2961819512345,338.96263719922473,296.30214999999987,310.45450000000017,324.6512000000003,336.54250000000013,336.54250000000013,358.32125283388837,314.7637471661119,47266228,76.06208097868391,70.50999534925187,NaN,NaN,NaN,NaN,76.06208097868391,NaN,1.7162692188293338,8.893303658040224,7.177034439210891,91.75536139793479,93.95242429071881,5466227361,17743640966.166313,45.765135504756685,12.91138473903984,44.36747372203349,100,0
2023-06-06,354.28,355.82,352.93,354.84,308.99698832837936,315.518998063846,327.41554736491156,340.47476698977476,296.4299499999999,311.2274000000002,325.5302000000003,338.1000000000001,338.1000000000001,360.427857040022,315.77214295997817,41390400,75.94140683454069,71.43232318505893,NaN,NaN,NaN,NaN,NaN,NaN,1.4994416990938202,9.051336563078166,7.551894863984346,91.28221966836306,93.11167983038293,5424836961,17756960368.242435,43.7568802115239,13.741738701002781,45.99979655085441,92.85714285714286,0
2023-06-07,355.13,357.12,348.18,348.82,309.3932372007338,316.17842384475995,328.2549376643268,341.2695510859867,296.5597499999999,311.9251000000002,326.33140000000026,339.4590000000001,339.4590000000001,360.905282568307,318.01271743169326,69225936,64.82818876174498,71.2428541114087,NaN,NaN,64.82818876174498,NaN,NaN,NaN,0.8319036786667642,8.591774462317801,7.759870783651037,68.94576695901195,83.99444934176994,5355611025,17697645975.651833,38.17604206249573,18.765648585678484,45.78351048542796,85.71428571428571,0
2023-06-08,349.12,353.62,348.89,353.15,309.82862787535333,316.9105342636756,329.2312146186669,342.4010224111308,296.7536999999999,312.6469000000002,327.2520000000003,340.8595000000001,340.8595000000001,362.03919260871635,319.6798073912838,47153922,68.40914243143041,70.91978467057793,NaN,NaN,NaN,NaN,NaN,NaN,0.5754792379570874,8.479219831097396,7.903740593140308,84.44603543941282,81.55800735559593,5402764947,17735428927.95204,35.554054577983905,17.4767958636009,44.68694933809199,78.57142857142857,28.571428571428573
2023-06-09,354.63,357.66,353.03,354.5,310.2731191402752,317.6548801198404,330.22214737871917,343.5533059910231,296.95569999999987,313.37650000000025,328.0876000000003,342.2745000000001,342.2745000000001,363.12642890357176,321.42257109642844,53196927,69.45337621612856,70.7849864577156,NaN,NaN,NaN,NaN,NaN,NaN,0.39868674555654415,8.402099025085988,8.003412279529444,88.75444839857644,80.71541693233374,5455961874,17716011475.116188,38.99715913603684,16.312947027068457,43.99311409282684,100,21.428571428571427
2023-06-12,356.19,360.59,355.2,360.49,310.7727895965909,318.50310031548713,331.40912199131844,345.1663244680685,297.1830999999999,314.20260000000025,328.9838000000003,344.04750000000007,344.04750000000007,364.762594858574,323.33240514142614,44817646,73.62003781892403,70.87869098953335,NaN,NaN,NaN,NaN,NaN,NaN,0.5762790425911355,8.723761082768362,8.147482040177227,99.67773122784413,90.95940502194446,5500779520,17759166128.68576,39.78282837593892,14.906772069924562,43.55716704786141,100,14.285714285714286
2023-06-13,363.29,364.11,360.03,363.26,311.2950503966248,319.3893755567646,332.6581760308746,346.8895316615858,297.3964999999999,315.08370000000025,329.8304000000003,345.8710000000001,345.8710000000001,366.60923319378236,325.13276680621783,57097804,75.29804556280382,71.71744526361495,NaN,NaN,NaN,NaN,NaN,NaN,0.7598768444012958,9.097328095678847,8.337451251277551,97.53979739507953,95.32399234050003,5557877324,17792473181.019093,42.50494492818998,14.033971393635145,44.726441029352564,100,7.142857142857143
2023-06-14,363.27,366.19,360.42,365.9,311.83838322849914,320.3103780209871,333.9617769708403,348.7000524557205,297.6887999999999,315.9159000000002,330.7454000000003,347.8080000000001,347.8080000000001,368.43027688689324,327.185723113107,69525642,76.81193167414848,72.88906700319622,NaN,NaN,NaN,NaN,NaN,NaN,0.9275860707750034,9.496933839746305,8.569347768971301,99.01778154106681,98.74510338799682,5627402966,17855010110.305054,41.97634548282916,12.884982988596938,47.208229083673885,100,0
2023-06-15,364.61,371.77,363.98,370.26,312.4196928481161,321.2994794463141,335.385236697474,350.75338079327094,298.0180499999999,316.72890000000024,331.7692000000003,349.76500000000004,349.76500000000004,371.09759243504686,328.4324075649532,71138823,79.09102390299172,73.65501400917022,NaN,NaN,NaN,NaN,79.09102390299172,NaN,1.1841972765848219,10.04959436470233,8.865397088117508,95.14625522340086,97.23461138651574,5698541789,17898570082.79671,45.13076572191331,11.514351034399663,48.80333765643166,100,0
2023-06-16,372.72,372.85,367.48,367.93,312.9720342128114,322.22285609094155,336.661501925024,352.3892492891499,298.3525999999999,317.5245000000003,332.8094000000003,351.29800000000006,351.29800000000006,373.21711458065397,329.37888541934615,80931971,74.85671803551752,73.6917709944645,NaN,NaN,NaN,NaN,NaN,NaN,1.0534393412772225,10.182196264714037,9.128756923436814,81.32118451025055,91.82840709157274,5617609818,17831202129.282745,43.29963248657371,10.671620217335134,49.575483976713144,100,0
2023-06-20,365.95,368.32,363.8899,366.9,313.5086308873108,323.1075520099328,337.8473253789447,353.77122554732614,298.6907499999999,318.31620000000026,333.7864000000003,352.8175,352.8175,374.63858051861826,330.99641948138174,49204722,72.99625270482443,73.53020606686114,NaN,NaN,NaN,NaN,NaN,NaN,0.7673024415558736,10.087884975381655,9.320582533825782,77.4107820804858,84.62607393804574,5568405096,17848863226.876976,40.65601769019304,14.967816609837897,48.93462591828872,92.85714285714286,7.142857142857143
2023-06-21,365.74,366.18,360.96,361.9,313.99013704763604,323.8757192968648,338.79056752094687,354.5453945428189,299.0032499999999,319.00180000000023,334.66700000000026,354.0305,354.0305,375.02338305593,333.03761694407,53378256,64.60247576338003,73.01737779104663,NaN,NaN,NaN,NaN,NaN,NaN,0.14367182340327211,9.500172313079872,9.3565004896766,58.19014891179822,72.3073718341782,5515026840,17814709323.61261,37.36216901407875,17.751342695129114,48.072482986135014,85.71428571428571,0
2023-06-22,360.63,366.33,360.22,366.17,314.50933966407746,324.7132298058378,339.8642707554195,355.65249982445516,299.3582499999999,319.7009000000003,335.6738000000003,355.67100000000005,355.67100000000005,375.008935670589,336.3330643294111,47603043,67.98790336887458,72.56232730818554,NaN,NaN,NaN,NaN,NaN,NaN,-0.06753928517551522,9.272076383207207,9.339615668382722,72.92257802999593,69.50783634075998,5562629883,17859819244.884296,34.28518816987872,17.286853468565784,46.77469958123155,78.57142857142857,0
2023-06-23,362.21,364.88,360.8227,362.54,314.98725668234533,325.46227476017765,340.7535150395207,356.3084522221261,299.7056999999999,320.42360000000025,336.66380000000026,357.2155000000001,357.2155000000001,373.2918422145648,341.1391577854354,48922911,62.51418266014167,71.60519762243823,NaN,NaN,NaN,NaN,NaN,NaN,-0.5131874081924046,8.698131408142217,9.211318816334622,58.20835022294286,63.107025721579,5513706972,17852310730.187405,31.815672203048038,16.041704675875444,45.266914751428835,71.42857142857143,21.428571428571427
2023-06-26,362,364.84,357.59,357.68,315.4120600984414,326.10024951740183,341.4172987634611,356.43907582001884,299.9992499999999,321.05420000000026,337.4340000000003,358.11350000000004,358.11350000000004,372.04360448632633,344.18339551367376,52685478,56.01217133104115,70.17306121903518,NaN,NaN,56.01217133104115,NaN,NaN,NaN,-1.159740567637547,7.761643106787687,8.921383674425234,38.50830968787999,56.546412646939594,5461021494,17800933305.434303,28.78802471869204,18.758323137368667,42.774291251661964,64.28571428571429,14.285714285714286
2023-06-27,359.25,364.57,358.51,363.83,315.89383064472554,326.8473732893345,342.2962282237175,357.14297336096945,300.31579999999997,321.68330000000026,338.3392000000003,358.8850000000001,358.8850000000001,372.2764980491197,345.4935019508805,49428091,61.47299269110499,69.13960306593262,NaN,NaN,NaN,NaN,NaN,NaN,-1.1930479647645065,7.4300737184696,8.623121683234107,63.437373327928526,53.38467774625045,5510449585,17838289849.457405,26.23309136994868,17.0935244643618,40.5523682788028,57.142857142857146,7.142857142857143
2023-06-28,361.98,366.52,361.9038,364.54,316.37787213084766,327.59376193707044,343.168532999258,357.8474520884962,300.60304999999994,322.2115000000002,339.2532000000003,359.6130000000001,359.6130000000001,372.564767601355,346.6612323986452,46498031,62.05860029824804,68.94177531853998,NaN,NaN,NaN,NaN,NaN,NaN,-1.184687663347452,7.142262104049792,8.326949767397243,65.31719532554261,55.754292780450385,5556947616,17844899616.785988,27.196561262196028,16.064813264845636,39.95545294406593,50,0
2023-06-29,364.24,364.89,362.14,363.81,316.8498336021825,328.31091516603936,343.97800229340476,358.4153137943537,300.86839999999995,322.78780000000023,340.1522000000003,360.4040000000001,360.4040000000001,372.30986813296494,348.4981318670353,46150967,61.031425994292846,68.41479557303015,NaN,NaN,NaN,NaN,NaN,NaN,-1.2398464096104753,6.77714175538415,8.016988164994626,54.38950554994956,61.048024734473564,5510796649,17854801096.978714,26.185549288488076,15.467615758530098,39.35853760932906,42.857142857142854,0
2023-06-30,367.55,370.49,367.23,369.42,317.3729198349966,329.1249564498802,344.9757276936634,359.4633791472724,301.24699999999996,323.44610000000023,341.1664000000003,361.27450000000005,361.27450000000005,373.1439742511973,349.4050257488028,58712501,65.72633712014387,68.14857849474554,NaN,NaN,NaN,NaN,NaN,NaN,-0.9244963023996977,6.861367786995004,7.7858640893947015,80.56657223796034,66.75775770448418,5569509150,17874972262.966446,31.294620271797196,14.096764887557395,39.13533391038003,35.714285714285715,0
2023-07-03,370.07,370.93,368.97,370.29,317.89945794609116,329.9401058271103,345.9684442546962,360.49448589515123,301.6182999999999,324.05020000000025,342.24660000000034,362.0565,362.0565,374.1361262773239,349.97687372267615,19432862,66.40236200505834,67.63303022232655,NaN,NaN,NaN,NaN,66.40236200505834,NaN,-0.6938382099083427,6.918566327009273,7.612404536917616,83.22411533420711,72.72673104070567,5588942012,17881714276.313385,31.05364897343401,13.71274344009221,38.65322951916073,28.571428571428573,0
2023-07-05,368.695,372.01,368.66,370.28,318.42065736951315,330.73891561271205,346.9218385976493,361.4264396194225,302.01419999999996,324.7093000000002,343.3200000000003,362.82550000000003,362.82550000000003,374.94300877861565,350.7079912213844,34460883,66.38615342022885,66.99646649785691,NaN,NaN,NaN,NaN,NaN,NaN,-0.582933056369126,6.883738216456209,7.466671272825335,83.15858453473105,82.31642403563283,5554481129,17880582724.931293,31.110238612945864,13.057978535405185,37.97574294736468,21.428571428571427,57.142857142857146
2023-07-06,366.51,367.91,364.52,367.46,318.90861102752797,331.46606579859895,347.7272566918591,362.00106441757276,302.4049,325.3671000000002,344.3502000000003,363.4565000000001,363.4565000000001,375.15194573753604,351.7610542624642,49374728,61.8045665358864,65.92451184512392,NaN,NaN,NaN,NaN,NaN,NaN,-0.7308995693526281,6.55304681113455,7.283946380487178,64.67889908256863,77.0205329838356,5505106401,17916849118.064037,28.58308039205114,17.835824220617674,35.84186247592892,14.285714285714286,50
2023-07-07,367.23,370.48,366.01,366.24,319.3795701217814,332.1546585550623,348.45324662551167,362.4047725682801,302.78085000000004,326.03250000000025,345.4752000000003,364.3275000000001,364.3275000000001,373.9427501267344,354.7122498732658,47133749,59.87921547333108,64.55223981443388,NaN,NaN,59.87921547333108,NaN,NaN,NaN,-0.9295910485487626,6.121957569801225,7.051548618349988,56.68414154652692,68.17387505460887,5457972652,17874565821.981262,30.421060307894997,16.701947281504722,33.682416306301675,7.142857142857143,42.857142857142854
2023-07-10,365.96,367.05,363.41,366.36,319.84703708574375,332.8319920490215,349.1554722480406,362.78146089511057,303.16900000000004,326.6511000000002,346.5650000000003,364.9880000000001,364.9880000000001,373.14562857696035,356.8303714230399,48498800,60.01117298822977,63.491843739627605,NaN,NaN,NaN,NaN,NaN,NaN,-1.0620258226473007,5.724016340040862,6.786042162688163,60.818307905686744,60.727116178260765,5506471452,17904677714.288956,28.814621447278544,19.591885201169593,30.72514848714757,0,35.714285714285715
2023-07-11,366.79,368.632,364.62,368.17,320.32786258737815,333.53175458270425,349.9011400030194,363.2946550955762,303.5920500000001,327.26530000000025,347.5214000000003,365.6715000000001,365.6715000000001,372.3575759044171,358.9854240955831,38214146,62.03923699156723,62.70919976010923,NaN,NaN,NaN,NaN,NaN,NaN,-1.0357173043725316,5.491395532222498,6.5271128365950295,73.37031900138716,63.62425615120028,5544685598,17934090795.756554,29.44085524326379,18.436285293567156,29.068221040821026,71.42857142857143,28.571428571428573
2023-07-12,372.34,374.19,370.3,372.82,320.8501724123794,334.30973964047246,350.7999188264304,364.2018308007594,304.0558000000001,327.9025000000002,348.5266000000003,366.2880000000001,366.2880000000001,373.21865249449456,359.3573475055057,61703696,66.71026424060696,62.85975607991116,NaN,NaN,NaN,NaN,NaN,NaN,-0.7276879273247054,5.617502927439148,6.345190854763853,91.74698795180721,75.31187161962704,5606389294,17952332248.30154,34.91301171154395,16.831980973687305,29.022503909146923,100,21.428571428571427
2023-07-13,376.05,379.99,375.46,379.15,321.4302701993209,335.1976655881859,351.91168671559,365.6254659625918,304.57400000000007,328.6610000000003,349.66580000000033,367.0825000000001,367.0825000000001,375.8438626223094,358.3211373776908,46960012,71.7976850934585,63.131883345952865,NaN,NaN,NaN,NaN,NaN,NaN,-0.15035655958093663,6.157245155287683,6.307601714868619,96.24999999999986,87.12243565106475,5653349306,17981876626.712135,39.529711408465865,15.141922609071528,29.854460156180995,100,14.285714285714286
2023-07-14,379.585,382.86,378.18,379.07,322.0037998490789,336.06642468544953,352.9767186090963,366.9058977756783,305.0975000000001,329.44010000000026,350.8596000000003,367.7410000000001,367.7410000000001,377.9138735369929,357.5681264630073,55148500,71.64865762083231,63.784345843145054,NaN,NaN,NaN,NaN,NaN,NaN,0.15677488233454095,6.503570317786796,6.346795435452255,85.00197863078743,90.99965552753152,5598200806,17947703410.90017,40.96658096389734,14.143671045761575,30.976673970782024,100,7.142857142857143
2023-07-17,379.8,383.5,379.31,382.61,322.60684661674975,336.9880796421733,354.13880807540625,368.401526558947,305.6381500000001,330.3259000000003,352.1660000000003,368.3585000000001,368.3585000000001,380.3963773460932,356.32062265390704,40868915,74.20056040246745,65.08351649110408,NaN,NaN,NaN,NaN,NaN,NaN,0.5091125290382328,6.983186096750046,6.474073567711813,96.43857543017212,92.56351802031982,5639069721,17971210352.463417,39.296563090833494,13.253003080531196,33.00991769983215,100,0
2023-07-18,381.96,387.13,380,385.74,323.2350371976776,337.9534642037144,355.3780705038217,370.0528097438092,306.16715000000005,331.24080000000026,353.55740000000037,369.24900000000014,369.24900000000014,383.4660712877022,355.03192871229805,55343438,76.23719864787908,66.13810263087365,NaN,NaN,NaN,NaN,76.23719864787908,NaN,0.8439888148611194,7.529059586288213,6.685070771427093,94.48985578485865,91.97680328193941,5694413159,18004975283.08053,40.439588728903466,11.948791220628326,35.387720030926076,100,0
2023-07-19,386.82,387.98,384.3,385.65,323.8560816036709,338.8979500610666,356.5652049938679,371.538256434875,306.7360500000001,332.1291000000003,354.8126000000003,370.18650000000014,370.18650000000014,386.03908625586234,354.33391374413793,54092958,76.05129278823433,67.13758066587266,NaN,NaN,NaN,NaN,NaN,NaN,0.9429493909836761,7.863757510156688,6.920808119173012,90.98297213622276,93.97046778375119,5640320201,17990570093.178352,39.5402119814445,11.329104213836914,37.51105047832386,100,0
2023-07-20,382.61,384.095,375.72,376.76,324.38248875189305,339.6476936242138,357.3571577392064,372.0355653458393,307.2835500000001,332.97820000000024,355.8740000000003,370.92950000000013,370.92950000000013,386.55016768737556,355.3088323126247,71941674,60.38692134538091,67.09154461952181,NaN,NaN,NaN,NaN,NaN,NaN,0.32511027979142426,7.327195968912292,7.002085689120868,54.33455433455421,79.9357940852119,5568378527,17936495724.48223,34.361656612626696,21.161722786788932,37.3712127248847,92.85714285714286,0
2023-07-21,379.18,379.92,375.191,375.63,324.89241423694887,340.3602145425462,358.0737397886493,372.37789245575937,307.7940500000001,333.7951000000002,356.95380000000034,371.40250000000015,371.40250000000015,386.9909160516525,355.8140839483478,60499643,58.7310169511387,66.5918788931643,NaN,NaN,NaN,NaN,NaN,NaN,-0.21513276241835833,6.733169736097921,6.948302498516279,49.73544973544963,65.01765873540889,5507878884,17887228622.517124,32.19886375792568,20.533849131644423,36.24500509124555,85.71428571428571,35.714285714285715
2023-07-24,376.62,377.58,374.34,376.23,325.40323598583495,341.07050732388194,358.785749993016,372.74475984092516,308.2645500000001,334.62180000000023,357.9756000000003,372.08700000000016,372.08700000000016,387.2552801925421,356.9187198074582,40380056,59.368130245891926,66.08943376750956,NaN,NaN,NaN,NaN,NaN,NaN,-0.5675247694067327,6.2388965367578635,6.806421306164596,52.17745217745217,52.08248541581869,5548258940,17893958631.85046,30.769880873533605,20.788216305034908,34.86097620370408,78.57142857142857,28.571428571428573
2023-07-25,376.95,380.47,376.93,378.78,325.93434806557786,341.8172299511318,359.569838228584,373.3195446179799,308.7485500000001,335.49760000000026,359.0272000000003,373.14200000000017,373.14200000000017,387.03701867574745,359.2469813242529,38894384,62.04965749064186,65.77968405825335,NaN,NaN,NaN,NaN,NaN,NaN,-0.6579644672987133,5.983965722041205,6.641930189339918,62.55596255596236,54.82295482295473,5587153324,17895716570.110348,32.97080942752056,19.564552990732167,33.764328428753146,71.42857142857143,21.428571428571427
2023-07-26,377.72,379.24,375.18,377.52,326.44763813457706,342.52421549665394,360.27376614118856,373.71958798769606,309.2373500000001,336.3367000000002,360.07700000000034,373.8265000000002,373.8265000000002,387.15646965485604,360.4965303451443,47075710,59.94452245637494,65.64682376685968,NaN,NaN,NaN,NaN,NaN,NaN,-0.8211221993323772,5.615527440174446,6.436649639506824,57.42775742775727,57.38705738705727,5540077614,17902905471.63744,31.084006406012932,20.91160086483935,33.507986575855675,64.28571428571429,14.285714285714286
2023-07-27,383.07,384.71,375.31,376.62,326.94686561582506,343.19937954622515,360.91479491996546,373.9958177031536,309.77495000000005,337.1061000000002,361.0736000000003,374.43050000000017,374.43050000000017,387.1010066591447,361.75999334085566,63940225,58.41991465993679,65.54258799447437,NaN,NaN,NaN,NaN,NaN,NaN,-0.9964593259024799,5.191075482128724,6.187534808031204,53.7647537647537,57.91615791615778,5476137389,17856786883.81829,34.46890359893851,18.300380222086183,33.61703093274138,57.142857142857146,7.142857142857143
2023-07-28,380.74,384.52,380.22,383.48,327.50938436591633,343.99701559481474,361.79970492310406,374.89907315999614,310.36030000000005,337.9407000000002,362.2000000000003,375.41400000000016,375.41400000000016,387.68153178106763,363.1464682189327,56902926,65.60141929350924,65.9418913019943,NaN,NaN,NaN,NaN,NaN,NaN,-0.6727425955165369,5.346606563635532,6.019349159152069,80.73630136986303,63.97627085412467,5533040315,17886164673.52062,30.96891810775898,16.4421527018368,34.444698735605904,50,0
2023-07-31,383.79,384.88,382.34,383.68,328.0682959642654,344.7828172662046,362.6577557104333,375.7353519066632,310.96495000000004,338.81410000000017,363.2512000000003,376.1270000000001,376.1270000000001,388.5744336310614,363.6795663689388,44019905,65.78694856628954,66.20958498590304,NaN,NaN,NaN,NaN,65.78694856628954,NaN,-0.4766906663623205,5.423485826199169,5.9001764925614895,75.67873303167416,70.05992938876363,5577060220,17888590967.496998,30.398463511832418,15.883705760449496,35.04301496997515,42.857142857142854,0
2023-08-01,382.31,383.56,380.69,382.79,328.61279053178515,345.5354347460817,363.4472554864948,376.40722315364764,311.5656000000001,339.6638000000002,364.1616000000003,376.7520000000001,376.7520000000001,389.21960217522286,364.2843978247774,41308457,64.12937199458656,66.02523553975873,NaN,NaN,NaN,NaN,NaN,NaN,-0.4394087065367138,5.350915609390597,5.790324315927311,61.95014662756612,72.78839367636778,5535751763,17907733910.984802,29.14362188224165,17.506010720009087,34.32903449349329,35.714285714285715,0
2023-08-02,379.26,379.26,373.13,374.39,329.06828515335945,346.10681227586224,363.8763827223185,376.21510666282404,312.0934500000001,340.4811000000002,364.91920000000033,376.95750000000015,376.95750000000015,389.1234621485312,364.7915378514691,72687107,51.054394507716694,64.54357192649145,NaN,NaN,NaN,NaN,NaN,NaN,-0.9818642234855846,4.5629940365703305,5.544858260055915,8.48484848484841,48.704576048029566,5463064656,17864927963.79557,25.483563121490054,25.13602850822803,31.191806352665406,28.571428571428573,100
2023-08-03,371.94,375.95,371.77,373.79,329.51327734088824,346.65499421099366,364.26515202732566,375.98414412350746,312.65870000000007,341.3335000000002,365.6422000000003,377.27400000000017,377.27400000000017,388.74466066098637,365.803339339014,47855381,50.266051209833144,63.01624289713437,NaN,NaN,NaN,NaN,NaN,NaN,-1.3592358999778957,3.845813385083545,5.205049285061441,12.461443553362333,27.632146221925634,5415209275,17863325151.991745,24.074637308081883,25.545149046553632,27.9269633384205,21.428571428571427,100
2023-08-04,375.75,378.1,371.53,372.04,329.9364288101331,347.15766759295417,364.5700480262541,375.6085113498401,313.1721500000001,342.14700000000016,366.41580000000033,377.5640000000002,377.5640000000002,388.1644139541534,366.96358604584697,61702759,47.94085550877193,61.14054969044184,NaN,NaN,NaN,NaN,NaN,NaN,-1.683646116447715,3.100491639501797,4.784137755949512,3.100303951368063,8.015531996526283,5353506516,17811201816.763435,24.814854329220314,23.359109434170527,24.602810440188147,14.285714285714286,100
2023-08-07,373.88,375.29,371.51,375.19,330.3867131005796,347.7127632841828,364.98651673110686,375.56865312604583,313.69070000000005,342.92520000000025,367.2866000000003,378.0055000000002,378.0055000000002,387.3655394763757,368.6454605236247,37230444,52.22480551654394,59.42537875248933,NaN,NaN,NaN,NaN,NaN,NaN,-1.6413110734270813,2.73249891416566,4.373809987592741,22.34365513054038,12.635134211756926,5390736960,17846462396.00153,23.565358663081124,22.209556154254056,20.929816069011956,7.142857142857143,100
2023-08-08,372.64,372.66,368.82,372,330.8007756567927,348.19369866469407,365.2615552906713,375.22878139975575,314.1982500000001,343.65590000000026,367.93220000000036,378.19700000000023,378.19700000000023,386.8762536545107,369.51774634548974,44726453,47.92385973085731,57.41627639124811,NaN,NaN,NaN,NaN,NaN,NaN,-1.7721895883692627,2.1585730021311633,3.930762590500426,19.80074719800751,15.081568759971985,5346010507,17875814130.78278,21.592240690009646,23.88579280366305,17.32875920729312,0,100
2023-08-09,372.29,372.45,367.14,367.91,331.17002167015795,348.584120473314,365.36541586750775,374.531754599779,314.69225000000006,344.26690000000025,368.32240000000036,377.95150000000024,377.95150000000024,387.4630935047261,368.4399064952744,51150900,43.03076612919975,56.176551018663744,NaN,NaN,NaN,NaN,NaN,NaN,-2.0581708566053782,1.358049019743703,3.416219876349081,4.340473506200892,15.494958611582929,5294859607,17839497955.076565,20.082712778392043,24.427783994368564,16.32792009492767,50,100
2023-08-10,370.97,374.36,367.035,368.59,331.5423597629922,348.9802765035454,365.4918701472133,373.96587320932383,315.15810000000005,344.8992000000003,368.6946000000004,377.4235000000002,377.4235000000002,387.74801117483275,367.0989888251677,72035265,44.053528461236496,55.12815898367072,NaN,NaN,NaN,NaN,NaN,NaN,-2.11727467100631,0.7696265375911935,2.8869012085975037,8.713925469318871,10.951715391175759,5366894872,17798046945.93322,20.646514896177575,22.129456204586432,14.995473038255183,42.857142857142854,100
2023-08-11,365.99,368,364.69,366.24,331.8876099146042,349.3220532064455,365.5212085728128,373.2300757608168,315.5970500000001,345.50190000000026,369.05960000000033,376.7820000000002,376.7820000000002,388.15835196357676,365.40564803642366,48707187,41.29441656858401,53.83717943529159,NaN,NaN,NaN,NaN,NaN,NaN,-2.219619597186406,0.11237671211449651,2.3319963093009024,7.677067855374005,6.910488943631257,5318187685,17794956761.863735,19.589703653486563,24.07445783186393,14.346257737224184,35.714285714285715,100
2023-08-14,365.43,370.47,364.7,370.35,332.2703202637126,349.7384481924565,365.7105729425064,372.95578283121523,316.02775,346.10200000000026,369.42640000000034,376.1690000000002,376.1690000000002,387.5443820155351,364.7936179844653,42130802,47.48881423337022,52.797119202629325,NaN,NaN,NaN,NaN,NaN,NaN,-1.9263810540557622,-0.07598000826880025,1.850401045786962,28.033680039623704,14.808224454772194,5360318487,17835335156.154896,21.34044344569453,22.25913123594535,12.674012352556405,28.571428571428573,92.85714285714286
2023-08-15,369.36,370.169,365.74,366.42,332.6101180720339,350.0687759510217,365.73839361142774,372.33332732348043,316.47020000000003,346.7050000000002,369.66180000000037,375.2030000000002,375.2030000000002,386.4437510424934,363.96224895750703,45539891,42.834566828690384,51.57497951493757,NaN,NaN,NaN,NaN,NaN,NaN,-1.9092739100761338,-0.5361913418082054,1.3730825682679284,8.56859831599811,14.759782070331939,5314778596,17803779065.50712,20.040240966237782,20.902956154711593,11.427093182321089,21.428571428571427,85.71428571428571
2023-08-16,365.87,367.43,362.44,362.54,332.90792784246145,350.3157308826846,365.6129664109796,371.400629483149,316.9185500000001,347.2329000000002,369.8146000000004,374.04750000000024,374.04750000000024,385.5042061147305,362.59079388527,53190525,38.792278503843846,50.17300550378807,NaN,NaN,NaN,NaN,NaN,NaN,-2.058594857647446,-1.2001610037913792,0.8584338538560669,0.4456327985740764,12.349303718065299,5261588071,17752720425.276657,18.71132820917179,23.902211752146886,10.108612672647263,14.285714285714286,100
2023-08-17,363.96,364.31,358.16,358.58,333.16337134651656,350.4793797760968,365.3371638066275,370.1796171514205,317.3053500000001,347.70980000000026,369.88940000000036,373.1385000000002,373.1385000000002,386.3418393881784,359.93516061182197,62604338,35.1467064551896,47.99766887247953,NaN,NaN,NaN,NaN,NaN,NaN,-2.304815516956066,-2.0225855423390158,0.28222997461705024,1.5718562874249982,3.528695800665728,5198983733,17698666923.686413,17.197687377036925,27.598378728571475,9.578458358406364,7.142857142857143,100
2023-08-18,355.26,359.41,354.71,358.13,333.41179551222285,350.63087720627306,365.05452993185776,369.0320345655709,317.70625000000007,348.2035000000003,370.07560000000035,372.2635000000002,372.2635000000002,386.9289413844043,357.5980586155961,61191389,34.74709228878082,45.7805362812289,NaN,NaN,34.74709228878082,NaN,NaN,NaN,-2.3696106037215463,-2.679783280034883,-0.31017267631333645,11.85441941074528,4.623969498914784,5137792344,17726528534.848114,16.124184059984184,30.45764459278013,9.536247733298604,0,100
2023-08-21,359.62,364.59,359.15,363.9,333.7151607310067,350.89363211307955,365.0092542482555,368.54326936884985,318.1502000000001,348.7713000000003,370.2906000000003,371.6470000000002,371.6470000000002,386.6269160211064,356.667083978894,50696518,43.60171607689667,44.314275144251056,NaN,NaN,NaN,NaN,NaN,NaN,-1.9149483000626042,-2.7038580513915917,-0.7889097513289876,37.43380855397146,16.953361417380577,5188488862,17764364539.09076,21.54257370012679,27.881507691191743,8.670444433257968,0,92.85714285714286
2023-08-22,366.55,366.56,362.68,363.38,334.0103332610464,351.14088692272156,364.9453619247945,368.0515294289594,318.6387000000001,349.2779000000002,370.46820000000037,370.87700000000024,370.87700000000024,385.894290168313,355.8597098316875,44613509,43.034950111688886,43.74145768739192,NaN,NaN,NaN,NaN,NaN,NaN,-1.5555828677823906,-2.7333883360569757,-1.177805468274585,37.06712270200941,28.785116888908714,5143875353,17735848687.977356,23.05879306768218,26.435268137915862,9.108688630245222,0,85.71428571428571
2023-08-23,364.58,370.22,364.36,369.11,334.35958367635936,351.4967109440538,365.1086810649986,368.15233615001085,319.18180000000007,349.81220000000025,370.64060000000035,370.4565000000002,370.4565000000002,385.17418633310035,355.7388136669,51770603,50.64773002905116,43.768720460193215,NaN,NaN,NaN,NaN,NaN,NaN,-0.8723803111803132,-2.2682808572499766,-1.3959005460696634,61.56477126977344,45.35523417525143,5195645956,17768006536.93981,25.78858298908876,24.065390350503645,9.143897262539245,7.142857142857143,78.57142857142857
2023-08-24,372.64,372.74,361.01,361.22,334.6268515004752,351.6892513213993,364.956183768332,367.49211365953363,319.6645000000001,350.21510000000023,370.5998000000003,369.6865000000002,369.6865000000002,384.6432219336114,354.729778066389,66842491,42.27084126720613,43.36371944293852,NaN,NaN,NaN,NaN,NaN,NaN,-0.8892257757797595,-2.5074327657943627,-1.6182069900146032,31.63265306122466,43.42151567766916,5128803465,17703557383.21347,22.125390292422303,24.703729924031713,9.321325611929273,0,71.42857142857143
2023-08-25,362.07,365.74,358.58,364.02,334.91932063977396,351.9334245625597,364.9194706793778,367.16143616814946,320.1466500000001,350.6538000000003,370.5622000000003,368.7135000000002,368.7135000000002,382.4352466453605,354.99175335463985,69960465,45.70297728419752,42.89787456919948,NaN,NaN,NaN,NaN,NaN,NaN,-0.659727159168582,-2.4428659389753307,-1.7831387798067486,47.37913486005082,46.85885306368297,5198763930,17739905557.766544,20.235860851434314,25.49239215484133,9.930844205771988,0,64.28571428571429
2023-08-28,366.99,367.71,364.25,366.76,335.2361433199752,352.2270201157763,364.99164829979435,367.1232041521352,320.6327500000001,351.1307000000002,370.49220000000037,367.86750000000023,367.86750000000023,379.75814653411675,355.9768534658837,40910019,48.90430953039233,42.9679066977377,NaN,NaN,NaN,NaN,NaN,NaN,-0.29018094982801546,-2.145864967091768,-1.8556840172637525,61.32315521628494,46.7783143791868,5239673949,17758350537.431286,21.736079040761226,24.33878068031418,9.974104601654005,14.285714285714286,57.142857142857146
2023-08-29,366.56,375.13,366.231,374.77,335.62951502823415,352.6734157570481,365.37511307235144,367.8514704233604,321.1900000000001,351.7192000000003,370.62900000000036,367.4665000000002,367.4665000000002,377.749348389395,357.18365161060547,58492371,56.9037692710354,43.9588354935831,NaN,NaN,NaN,NaN,NaN,NaN,0.48475262392413265,-1.2497432373585866,-1.7344958612827193,98.23702252693431,68.97977086775668,5298166320,17812110409.59771,28.219148611520755,21.779086082347177,10.196867280526169,100,50
2023-08-30,374.88,377.4467,373.86,376.86,336.03976861004276,353.15235801928475,365.8255007950043,368.7094256211356,321.6605500000001,352.3073000000002,370.8282000000004,367.5900000000002,367.5900000000002,378.25473440828677,356.92526559171364,41731511,58.71977371706102,45.006424440427715,NaN,NaN,NaN,NaN,NaN,NaN,1.094246426492153,-0.3666878281675281,-1.460934254659681,97.41959035392118,85.65992269904682,5339897831,17840189327.68294,29.807009149317192,20.828302360477206,11.21582034510823,100,42.857142857142854
2023-08-31,376.94,379.719,376.87,377.99,336.45718384775375,353.64419251395236,366.30253997951394,369.5932898476941,322.1107000000001,352.9085000000003,371.1500000000004,367.8000000000002,367.8000000000002,379.0917739969996,356.50822600300074,35730701,59.7083485029881,46.32170529288515,NaN,NaN,NaN,NaN,59.7083485029881,NaN,1.5043361470973347,0.41948592921198724,-1.0848502178853474,93.08648886400901,96.24770058162149,5375628532,17832551561.130116,31.60123965383289,20.075948848451294,12.075209911408198,100,35.714285714285715
2023-09-01,380.4,380.83,376.0801,377.59,336.8664656005124,354.1183669196167,366.7451854705134,370.35488129077083,322.57145000000014,353.5261000000002,371.37840000000034,368.07750000000016,368.07750000000016,380.0261164470806,356.1288835529197,39801177,59.1681890652482,47.155946352305,NaN,NaN,NaN,NaN,NaN,NaN,1.666875959415814,0.99874473138442,-0.6681312280313939,87.59571209800916,92.7005971053131,5335827355,17818054410.384266,31.10277362397732,18.85723673783791,13.675465239410297,100,28.571428571428573
2023-09-05,376.77,379.3093,375.83,378.07,337.27645101742274,354.59265668358466,367.18929584421875,371.0896545011736,323.01485000000014,354.1764000000002,371.68900000000036,368.22150000000016,368.22150000000016,380.572166824075,355.8708331759253,32344222,59.64003865367862,48.35633719694702,NaN,NaN,NaN,NaN,NaN,NaN,1.718096076186494,1.4794888672017237,-0.23860720898477034,89.43338437978564,90.03852844726794,5368171577,17827357104.304134,29.68142101966108,18.323979580572704,15.214863224565766,92.85714285714286,21.428571428571427
2023-09-06,377.28,377.63,372.7,374.74,337.6492226490902,354.991613976979,367.4854018895435,371.4373064534428,323.46135000000015,354.73210000000023,372.0302000000003,368.35850000000016,368.35850000000016,380.93254672328226,355.78445327671807,42998735,54.900169995660676,49.50690087493393,NaN,NaN,NaN,NaN,NaN,NaN,1.44979693361233,1.5736389580306422,0.12384202441831221,76.68453292496181,84.57120980091888,5325172842,17819943529.304134,27.586057227831578,21.14515858031821,15.288855485826966,85.71428571428571,14.285714285714286
2023-09-07,370.21,372.85,369.15,372.06,337.9916184436266,355.32960181901905,367.6647978938751,371.49661060073396,323.8976000000001,355.2670000000003,372.1948000000004,368.56600000000014,368.56600000000014,381.2401633254195,355.8918366745808,52060716,51.36225253229744,50.66515416615592,NaN,NaN,51.36225253229744,NaN,NaN,NaN,1.033471094800595,1.415680892919056,0.382209798118461,66.4241960183768,77.51403777437476,5273112126,17849772912.525757,25.56299739659632,24.25176581925212,13.818451710176253,78.57142857142857,7.142857142857143
2023-09-08,372.01,374.85,371.6,372.58,338.3357814441875,355.6711938622068,367.85755091764474,371.5997905435212,324.33640000000014,355.8044000000002,372.3556000000003,368.76550000000015,368.76550000000015,381.5599339069526,355.9710660930477,35847359,52.008489297342344,51.89811109533889,NaN,NaN,NaN,NaN,NaN,NaN,0.7480505134989177,1.3172729399921081,0.5692224264931904,62.92134831460674,68.67669241931512,5308959485,17835544268.49191,27.142369396787437,23.187080184090426,12.181901648658513,71.42857142857143,0
2023-09-11,375.66,377.49,373.66,376.97,338.72020152932,356.09295239958885,368.21490186205085,372.11123906318585,324.8118000000001,356.38550000000026,372.6188000000004,369.30200000000013,369.30200000000013,382.52067406359225,356.083325936408,39936634,57.180991401726246,52.86805933282671,NaN,NaN,NaN,NaN,NaN,NaN,0.8049104305942766,1.5753604647360362,0.7704500341417596,82.65168539325862,70.66574324208072,5348896119,17864636490.126373,28.91735706533697,21.641311783267682,12.293736880716533,64.28571428571429,28.571428571428573
2023-09-12,375.27,376.9517,372.5,372.79,339.0592044991775,356.42358700553757,368.39431747530375,372.17588296193003,325.24600000000015,356.92630000000025,372.6862000000004,369.42400000000015,369.42400000000015,382.72390135299804,356.12409864700226,41391024,51.49038156832568,53.47201872258648,NaN,NaN,NaN,NaN,NaN,NaN,0.524572509593668,1.4261656711338446,0.9015931615401767,63.86516853932601,69.81273408239711,5307505095,17828638191.134796,27.143284138137663,21.905696809703787,12.569186836023345,57.142857142857146,21.428571428571427
2023-09-13,373.03,375.84,371.88,374.21,339.40896365838967,356.77579320344773,368.6223834566644,372.36960839412717,325.6729500000001,357.50560000000024,372.76460000000037,369.81350000000015,369.81350000000015,383.1947141078243,356.43228589217597,46300677,53.19450374923698,53.653931131171184,NaN,NaN,NaN,NaN,NaN,NaN,0.403764603856962,1.4062989163613793,1.0025343125044173,70.24719101123594,72.25468164794019,5353805772,17836822654.240856,25.64241070939937,21.560154433449203,12.940036692699364,50,14.285714285714286
2023-09-14,375.99,378.27,373.89,377.27,339.7856903881569,357.18161908060716,368.9615056740501,372.83631235659124,326.12470000000013,358.11220000000026,372.9044000000004,370.5500000000001,370.5500000000001,383.8701456448282,357.22985435517205,48039388,56.722685428192506,54.68620571409878,NaN,NaN,NaN,NaN,NaN,NaN,0.49302067857759546,1.6188101607264116,1.1257894821488161,83.99999999999999,72.7041198501873,5401845160,17862926248.63355,27.486149615964596,20.227874362501765,13.63333603112595,42.857142857142854,7.142857142857143
2023-09-15,375.91,376.32,369.86,370.81,340.09438998628474,357.45148800970406,369.0339956476168,372.6433302273921,326.5652000000002,358.6608000000002,372.97140000000036,371.1615000000001,371.1615000000001,383.29772227052473,359.0252777294755,69811206,48.42398010441281,54.88056305839988,NaN,NaN,NaN,NaN,NaN,NaN,0.10059398230934136,1.2515319600354928,1.1509379777261515,39.56574185765988,64.60431095629859,5332033954,17813647750.28061,24.704810336935008,23.684351179740936,12.962886665117802,35.714285714285715,0
2023-09-18,369.32,371.79,369.03,370.66,340.3985254093068,357.7130427025812,369.09776052418084,372.4544416343071,327.0156500000001,359.26750000000027,373.05980000000034,371.7880000000001,371.7880000000001,382.36174976058845,361.2142502394118,36903545,48.247469207332394,54.833645892467025,NaN,NaN,NaN,NaN,NaN,NaN,-0.17071030254034558,0.9375500995507196,1.1082604020910651,30.337694362627808,51.30114540676255,5295130409,17820333175.09945,23.741164099011662,23.93352859010202,12.588218075781809,28.571428571428573,0
2023-09-19,369.32,370.6826,366.8,369.87,340.69177391269676,357.9537745302529,369.12804442519337,372.20830433580164,327.39820000000014,359.8475000000003,373.1300000000003,372.08650000000017,372.08650000000017,382.07346205056126,362.0995379494391,37621734,47.27018946107335,54.14553304889831,NaN,NaN,NaN,NaN,NaN,NaN,-0.39232940905564195,0.6178486407715127,1.0101780498271546,21.881682109764785,30.595039443350814,5257508675,17842206997.365868,22.416510378123,25.802806246834653,12.169797780416536,21.428571428571427,0
2023-09-20,370.95,371.31,364.46,364.54,340.92906969466,358.0841948365845,368.9481211144015,371.4779896371539,327.75230000000016,360.2894000000002,373.05740000000026,372.14450000000016,372.14450000000016,381.940175525429,362.3488244745713,45514189,41.205794793814,52.894534554380655,NaN,NaN,NaN,NaN,NaN,NaN,-0.8600271642299795,-0.06485590546031972,0.7951712587696598,0.48869883934050645,17.569358437244357,5211994486,17797755913.510395,20.267881918261114,26.603901453593977,11.86877377460095,14.285714285714286,100
2023-09-21,360.8,361.6,357.69,357.86,341.0975366628723,358.07975533486996,368.51329283540537,370.18103824313926,328.07885000000016,360.6424000000003,372.7582000000003,371.58200000000016,371.58200000000016,383.1430286739254,360.0209713260749,69734845,35.12392531019579,51.138504326324075,NaN,NaN,NaN,NaN,NaN,NaN,-1.5416384301689647,-1.131876778941546,0.4097616512274186,0.7346585998272084,7.701679849644166,5142259641,17734084968.07561,18.371512615624518,33.361951993724276,12.345475106739764,7.142857142857143,100
2023-09-22,359.63,361.8,357.59,357.91,341.2648248552815,358.07639384309033,368.09747743009535,369.01236793426887,328.4302000000001,360.99960000000027,372.33340000000027,371.41650000000016,371.41650000000016,383.64181516973554,359.1911848302648,51589689,35.20102012946059,49.42656368805353,NaN,NaN,NaN,NaN,NaN,NaN,-1.888588768275524,-1.9509743091169867,-0.06238554084146253,1.4733439843827818,0.8989004745168319,5193849330,17690337892.130245,17.577180952475132,31.416381711797108,12.612353717115578,0,100
2023-09-25,356.93,359.7,355.93,359.61,341.4473639114479,358.10676228184104,367.76463517793474,368.11690432148134,328.81985000000014,361.40190000000024,371.9442000000002,371.19600000000014,371.19600000000014,384.08789264613404,358.30410735386624,39167985,37.902956715085864,47.87391497815404,NaN,NaN,NaN,NaN,NaN,NaN,-1.897988789120176,-2.4348715272416825,-0.5368827381215066,16.472694717994678,6.226899100734889,5233017315,17727635787.66075,16.641287656552002,32.088088610266155,13.186673822042575,0,100
2023-09-26,356.99,357.54,353.2101,354.21,341.5743553153141,358.02959867229964,367.2330808572314,366.79243724324505,329.1882500000001,361.7711000000003,371.37620000000027,370.5685000000002,370.5685000000002,385.3466964731601,355.7903035268403,53657748,33.17143569737509,46.3218625282765,NaN,NaN,33.17143569737509,NaN,NaN,NaN,-2.144105558647333,-3.217014686430673,-1.07290912778334,3.9900398644845727,7.31202618895401,5179359567,17698760312.796482,15.165108230970104,33.01160627404383,14.888576170908342,42.857142857142854,100
2023-09-27,355.38,356.98,351.36,355.04,341.7083418295896,357.9703986985907,366.7549208236145,365.67315750579314,329.5442000000001,362.15980000000025,370.76220000000023,369.58200000000016,369.58200000000016,385.68164918870605,353.4823508112943,56065972,34.52436901637125,45.1191565628532,NaN,NaN,NaN,NaN,NaN,NaN,-2.123219056675697,-3.7269329486279617,-1.6037138919522644,13.675213675213717,11.379316085897656,5235425539,17716118816.58296,13.991397372677355,33.00451085375183,17.590343332777035,35.714285714285715,100
2023-09-28,354.11,360.17,353.24,358.01,341.870547383524,357.97118288277704,366.4119827521002,364.94333298143187,329.92405000000014,362.51100000000025,370.20940000000024,368.6395000000001,368.6395000000001,385.1268848441632,352.152115155837,56453312,39.26277478953939,44.20874838372441,NaN,NaN,NaN,NaN,NaN,NaN,-1.7946659355052046,-3.84704631133377,-2.0523803758285655,24.712002972872483,14.125752170856925,5291878851,17737380453.56997,16.97751303629646,29.92853662266054,19.001183647350565,28.571428571428573,92.85714285714286
2023-09-29,361.54,362.95,357.02,358.27,342.03372601652376,357.97710005341514,366.09268931084137,364.3077774593907,330.28750000000014,362.8568000000003,369.8396000000002,367.6535000000002,367.6535000000002,384.1448313895304,351.16216861046996,64829616,39.67435653199948,42.95827446445821,NaN,NaN,NaN,NaN,NaN,NaN,-1.4593520976890635,-3.8765704979398947,-2.4172184002508312,25.67818654775168,21.35513439861263,5356708467,17699882041.617188,19.342577975636566,27.56143270722487,19.224856562168135,21.428571428571427,85.71428571428571
2023-10-02,358.54,362.68,357.92,361.26,342.2250322253146,358.0421079731495,365.9031720829652,364.01751293944875,330.6505500000001,363.25300000000027,369.55220000000025,366.83700000000016,366.83700000000016,382.8908432781565,350.7831567218438,51625054,44.34511061257597,42.44789796761894,NaN,NaN,NaN,NaN,NaN,NaN,-0.9598300982650363,-3.6170060230821264,-2.65717592481709,36.789297658862836,29.059829059829,5408333521,17720705592.810463,18.10474727148517,25.797635363438655,19.71374459399706,14.285714285714286,78.57142857142857
2023-10-03,358.78,361.01,353.275,354.92,342.3513503126249,357.9802840528891,365.4724594522607,363.15108313569175,330.9926000000001,363.5508000000002,369.1260000000002,365.67950000000013,365.67950000000013,381.66491769863063,349.69408230136963,60478489,37.68272073589179,41.33991346666572,NaN,NaN,NaN,NaN,NaN,NaN,-0.976802529487923,-3.878179086676994,-2.901376557189071,13.22928279450021,25.232255667038242,5347855032,17685950986.00956,16.228547042363623,29.152555808096388,21.130205705614802,7.142857142857143,71.42857142857143
2023-10-04,355.77,360.61,355.3,359.75,342.5244712050366,358.0153279330299,365.24804927766223,362.82717045610207,331.4069000000001,363.8863000000003,368.74540000000025,364.9300000000002,364.9300000000002,380.54729297923916,349.3127070207612,54786686,44.5211212417305,40.46837316763271,NaN,NaN,NaN,NaN,NaN,NaN,-0.6015443053951772,-3.653306938933042,-3.051762633537865,33.61378205128202,27.877454168215024,5402641718,17722991325.508617,15.033031275344458,27.004961200488847,22.077833993376093,0,64.28571428571429
2023-10-05,359.74,360.15,355.14,358.69,342.68532223782233,358.02868777594017,364.99087087461663,362.43315422218757,331.8291000000001,364.2229000000003,368.3688000000002,364.2615000000002,364.2615000000002,379.7447945783346,348.77820542166575,45897390,43.39564681227008,40.10920650390823,NaN,NaN,NaN,NaN,NaN,NaN,-0.3746301602470772,-3.5200503338467115,-3.1454201735996343,35.87860988742037,27.5738915777342,5356744328,17742138140.89784,14.051490794680255,25.450264615929264,23.988370701024404,0,57.142857142857146
2023-10-06,355.65,365.91,354.85,364.7,342.904373757844,358.1607929684958,364.97946417365125,362.64904429626495,332.30385000000007,364.60200000000026,368.13040000000024,363.8675000000002,363.8675000000002,378.8778442665189,348.8571557334815,75049119,50.9645506655314,40.303283750922446,NaN,NaN,NaN,NaN,NaN,NaN,0.19945431678043146,-2.8961022776240952,-3.0955565944045267,66.86716791979941,45.453186619500606,5431793447,17800766024.094944,19.16125931102822,22.030555357632675,24.45709932666302,0,50
2023-10-09,362.3,367.11,360.78,366.56,343.1397531234376,358.32711389981273,365.041445970763,363.02151626804925,332.7889500000001,364.99600000000027,367.7920000000002,363.3470000000002,363.3470000000002,377.1796267931767,349.51437320682373,45304766,53.05664118886627,40.71660173147909,NaN,NaN,NaN,NaN,NaN,NaN,0.6957460735308012,-2.2258740024910253,-2.9216200760218265,76.19047619047618,59.64541799923199,5477098213,17838197923.9654,19.145663071190633,20.345556102482675,24.172505299521834,7.142857142857143,42.857142857142854
2023-10-10,366.9,371.28,366.39,368.59,343.3929894107666,358.53033936714314,365.1806049523017,363.55184805204453,333.26465000000013,365.3707000000003,367.49020000000024,363.1370000000002,363.1370000000002,376.50969322161166,349.7643067783888,46968806,55.29826371466153,41.723206654396755,NaN,NaN,NaN,NaN,NaN,NaN,1.1265256831472827,-1.5134629720877228,-2.6399886552350056,86.49598393574296,76.51787601533952,5524067019,17833491438.2926,23.101830024657406,19.128409315777237,23.879017971790518,0,35.714285714285715
2023-10-11,369.94,371.412,368.19,371.22,343.6698750882714,358.78161977571455,365.41744397378005,364.2821482375641,333.78695000000005,365.71020000000027,367.2588000000003,362.98750000000024,362.98750000000024,375.9213406901947,350.05365930980577,38215088,58.0904579799036,43.363673273661604,NaN,NaN,NaN,NaN,58.0904579799036,NaN,1.5293843875417599,-0.7282581708078055,-2.2576425583495654,99.04248952722945,87.24298321781619,5562282107,17867152027.90899,22.32792544699192,18.349479200785005,22.507888740913604,100,28.571428571428573
2023-10-12,371.73,373.74,367.5,369.93,343.9311698635125,359.0023797801558,365.59440695520044,364.8200388816056,334.2998,366.0444000000002,367.16960000000023,362.6205000000003,362.6205000000003,374.26469078335697,350.9763092166436,49587942,56.23501877739349,44.86610174851395,NaN,NaN,NaN,NaN,NaN,NaN,1.6399732719370541,-0.20767596842824787,-1.847649240365302,82.97587131367291,89.50478159221511,5512694165,17856185463.812836,23.500570390353413,16.913046698316094,21.654551585407344,100,21.428571428571427
2023-10-13,370.57,371.16,363.86,365.28,344.14359603402477,359.12668909143986,365.58207727068276,364.86384470240506,334.8083000000001,366.32080000000025,366.99940000000026,362.3440000000002,362.3440000000002,373.44725970151404,351.2407402984864,52519876,50.03156002867925,45.73243055662776,NaN,NaN,NaN,NaN,NaN,NaN,1.3434106620581265,-0.16838591279264392,-1.5117965748507705,62.198391420911356,81.40558408727124,5460174289,17824097977.927902,21.390904931546274,19.87099223303091,19.65343862390599,92.85714285714286,14.285714285714286
2023-10-16,366.62,370.48,366.47,369.41,344.39500303866134,359.33031901042125,365.73219188751875,365.29681187360455,335.35485000000006,366.68130000000025,366.9468000000002,362.2815000000002,362.2815000000002,373.20950306548326,351.3534969345172,44201059,54.80070473165204,47.2773783447904,NaN,NaN,NaN,NaN,NaN,NaN,1.364456869135876,0.19377451156907455,-1.1706823575668015,80.65236818588032,75.27554364015486,5504375348,17844710441.850597,20.012723034794874,18.590735887930546,17.270563549834968,85.71428571428571,7.142857142857143
2023-10-17,365.81,369.92,363.66,368.2,344.6318686800677,359.5059562577396,365.8289686762435,365.5733059808803,335.86365000000006,367.0468000000003,366.80700000000024,362.1980000000002,362.1980000000002,372.9163032238949,351.4796967761055,50999102,53.198693066679304,48.61125863409812,NaN,NaN,NaN,NaN,NaN,NaN,1.239574654632211,0.37878596072346227,-0.8607886939087488,72.97560975609746,71.94212312096305,5453376246,17867684478.214813,18.469960699243156,20.617981483194885,14.77330632788342,78.57142857142857,0
2023-10-18,365.67,367.91,362.02,363.37,344.8183177479277,359.58247197540817,365.7325385320771,365.3634673160346,336.3491,367.2833000000003,366.63440000000026,362.1395000000003,362.1395000000003,372.8187349444626,351.46026505553795,54280490,47.259649990620865,49.18246400560394,NaN,NaN,NaN,NaN,NaN,NaN,0.7959286802289883,0.1341221563774866,-0.6618065238515017,49.32812118250678,67.65203304149485,5399095756,17838286386.007683,17.070865672554397,21.066362119637045,13.549454130685731,71.42857142857143,0
2023-10-19,364.81,366.02,359.16,359.97,344.969080755411,359.59014579767734,365.5065566288584,364.84980376212656,336.82655000000005,367.3990000000003,366.47560000000027,362.24500000000023,362.24500000000023,372.7939364392495,351.696063560751,72274238,43.57207998355048,49.46087282357187,NaN,NaN,NaN,NaN,NaN,NaN,0.26518958846658525,-0.3303195382682702,-0.5955091267348555,32.71439042267305,51.67270712042576,5326821518,17783079825.20302,15.653406888126273,22.778900954925454,13.622144354737909,64.28571428571429,14.285714285714286
2023-10-20,359.46,360.04,354.37,354.6,345.0649107976457,359.4913310294065,365.0788485257659,363.87363197525735,337.27085000000005,367.4452000000003,366.19580000000025,362.0795000000003,362.0795000000003,372.99285232635197,351.1661476736486,72559723,38.466838191524,49.04099622206815,NaN,NaN,NaN,NaN,NaN,NaN,-0.41864078022275486,-1.118810102013299,-0.7001693217905441,6.474468604935468,29.50566007003842,5254261795,17716406781.67039,14.576099021107721,27.02531043484197,14.508020285684442,57.142857142857146,7.142857142857143
2023-10-23,353.26,359.26,351.1199,355.67,345.17043407329106,359.4156611080321,364.7098740737751,363.0923336918995,337.7413,367.5220000000003,365.98440000000016,361.8825000000003,361.8825000000003,373.1049184113351,350.66008158866543,60665185,39.9759705981662,49.204799783659176,NaN,NaN,NaN,NaN,NaN,NaN,-0.750638355510008,-1.6384672661780542,-0.8878289106680461,20.115295688348134,19.76805157198555,5314926980,17723562055.453083,13.174287986038118,28.266093028370427,15.07511171581562,50,100
2023-10-24,357.51,359.91,355.79,359.13,345.30933522679067,359.41000445242753,364.4910554826467,362.71496857838525,338.19295000000005,367.5932000000003,365.7600000000002,362.1285000000003,362.1285000000003,372.8729130132355,351.3840869867651,47082078,44.69907468281043,49.21751074373632,NaN,NaN,NaN,NaN,NaN,NaN,-0.6904750173552447,-1.750922682362102,-1.0604476650068573,35.411426121016305,20.667063471433302,5362009058,17752816938.87056,13.284639643142743,26.819268406354634,15.451545197574438,42.857142857142854,92.85714285714286
2023-10-25,356.7,356.88,349.75,350.34,345.35939159269327,359.2304004038646,363.93611213038605,361.53640014234855,338.59195000000005,367.5501000000003,365.43840000000023,361.8935000000003,361.8935000000003,373.4245836871024,350.3624163128982,71190536,36.780943458575855,48.74503193275815,NaN,NaN,NaN,NaN,NaN,NaN,-1.1678593272087634,-2.5202718240178115,-1.352412496809048,2.45935806586067,19.328693291741704,5290818522,17693408286.80885,11.840699674221417,30.90317570975204,16.575874026019786,35.714285714285715,100
2023-10-26,349.12,350.07,342.35,343.66,345.34248222361174,358.9220756433921,363.14097047821406,359.83388584307727,338.94610000000006,367.43770000000035,365.06080000000026,361.1760000000003,361.1760000000003,375.118110887489,347.2338891125115,78621425,32.12376506595275,47.39926153278826,NaN,NaN,32.12376506595275,NaN,NaN,NaN,-1.8198257561470685,-3.6271946919928837,-1.8073689358458151,4.17330359987258,14.014695928916518,5212197097,17641469262.521286,10.767135157745026,36.49849127078406,19.96688813965729,28.571428571428573,100
2023-10-27,346.43,348.84,344.08,345.31,345.34215901740663,358.65252959104765,362.4417167339704,358.450658619927,339.28490000000005,367.34240000000034,364.7954000000002,360.5280000000003,360.5280000000003,376.0637608117214,344.9922391882792,63476707,34.335449442171395,46.06203355088147,NaN,NaN,NaN,NaN,NaN,NaN,-2.011290826969355,-4.321482469557509,-2.310191642588154,9.42975469894865,5.3541387882273,5275673804,17610797744.433052,10.126129415276882,34.32560664054265,23.63842478059727,21.428571428571427,92.85714285714286
2023-10-30,347.83,350.54,346.45,349.2,345.38054549484536,358.4653507872645,361.9224337247951,357.5696435132673,339.63565,367.3462000000003,364.61680000000024,359.9250000000003,359.9250000000003,376.2180347080884,343.6319652919122,55298536,39.35271522985712,44.923065801966864,NaN,NaN,NaN,NaN,NaN,NaN,-1.7565499469362842,-4.505879076258509,-2.749329129322225,21.822236381012964,11.808431559944731,5330972340,17629861542.90738,11.486671558575372,32.23873218792431,26.356354547622573,14.285714285714286,85.71428571428571
2023-10-31,349.23,351.25,346.62,350.87,345.4351669327076,358.3149478013781,361.4890049512737,356.93158222628944,339.98515,367.32340000000033,364.35620000000023,359.7225000000002,359.7225000000002,376.35642782836516,343.08857217163524,47671906,41.4220090370396,43.73246230604801,NaN,NaN,NaN,NaN,NaN,NaN,-1.3731614402561338,-4.465780929642392,-3.092619489386258,27.142402038865836,19.464797706275817,5378644246,17669708254.833946,11.697494867012795,30.472490861427893,28.837904241416283,7.142857142857143,78.57142857142857
2023-11-01,351.72,357.5298,351.62,356.96,345.54984188860107,358.2881171518458,361.31139691396885,356.93428868092855,340.3622500000001,367.3480000000003,364.22780000000023,359.5830000000002,359.5830000000002,376.2604051938311,342.9055948061693,58992666,48.343803883765425,43.168804099360294,NaN,NaN,NaN,NaN,NaN,NaN,-0.6440331657934681,-3.8976609466280934,-3.2536277808346252,50.71155848663643,33.22539896883841,5437636912,17717325232.625614,18.158839913048155,28.088697691589992,29.207250548874423,0,71.42857142857143
2023-11-02,361.54,363.68,360.3,363.44,345.72785341209755,358.3901346339875,361.3948715447936,357.5538802351258,340.79005000000006,367.3775000000003,364.11440000000016,359.8205000000002,359.8205000000002,376.5753804531486,343.0656195468518,58162442,54.50406650925179,43.48826884797262,NaN,NaN,NaN,NaN,NaN,NaN,0.2899327587964349,-2.8912118323390814,-3.1811445911355163,74.97333807323135,50.94243286624454,5495799354,17767227919.54869,23.906513160389256,25.88803971124176,29.228381249055168,0,64.28571428571429
2023-11-03,364.75,369.02,364.52,367.71,345.94658123884284,358.5746864234135,361.6425236410762,358.5211297365424,341.25285,367.4220000000003,364.2442000000002,359.97100000000023,359.97100000000023,376.9510575970522,342.99094240294824,53280457,58.05388465090606,43.72063884220505,NaN,NaN,NaN,NaN,NaN,NaN,1.161629064607117,-1.72910826037662,-2.890737324983737,91.98404062386638,72.55631239457806,5549079811,17789487310.473137,28.606979430197306,24.19307147167857,29.562387796344378,0,57.142857142857146
2023-11-06,368.49,369.78,366.91,369.21,346.1780580424364,358.78528669225676,361.9392874198575,359.5391173806812,341.68550000000005,367.4551000000003,364.34800000000024,360.1035000000003,360.1035000000003,377.3267683018959,342.88023169810464,38848743,59.2565354584772,44.153341870190616,NaN,NaN,NaN,NaN,NaN,NaN,1.7691777025829802,-0.6792651967550114,-2.4484428993379916,97.92198323004011,88.29312064237928,5587928554,17812904845.452232,28.53257201607698,23.346400422645015,29.88391063391399,0,50
2023-11-07,370.27,373.58,369.045,372.7,346.4419579624122,359.0608255696378,362.36127614849056,360.79253477299727,342.10420000000005,367.4795000000003,364.4668000000002,360.30900000000025,360.30900000000025,378.0234651626604,342.5945348373401,50777398,61.98736520498441,45.205321528359434,NaN,NaN,NaN,NaN,NaN,NaN,2.3022798333665953,0.42940689237025254,-1.8728729409963427,97.18219660582773,95.69607348657807,5638705952,17843975910.380566,31.638512686361242,22.034197452863832,30.413738773337194,100,42.857142857142854
2023-11-08,373.08,373.79,370.62,372.94,346.7056200722389,359.3356607068727,362.77612806423605,361.949436223188,342.52705000000003,367.5296000000003,364.43020000000024,360.3950000000002,360.3950000000002,378.33576754208843,342.454232457912,35663373,62.1751172851845,46.534109907047586,NaN,NaN,NaN,NaN,NaN,NaN,2.548119472254494,1.3122763993217745,-1.2358430729327192,97.296437659033,97.46687249830028,5674369325,17860513815.210217,30.623124337747193,21.139764313833197,30.398052722930796,100,35.714285714285715
2023-11-09,373.64,374.8,369.57,370.07,346.9381014645549,359.54822188099405,363.0621622577954,362.722823249551,342.93875,367.56130000000036,364.2944000000002,360.4020000000002,360.4020000000002,378.35774626684105,342.4462537331594,53859421,58.456794244361795,47.961963910821716,NaN,NaN,NaN,NaN,NaN,NaN,2.396740612138327,1.7600826922401893,-0.6366579198981375,85.42372881355926,93.30078769280665,5620509904,17816952562.66146,28.563052465932138,21.068235416222453,29.339196822581226,100,28.571428571428573
2023-11-10,371.82,378.54,371.28,378.39,347.25105567883793,359.9213263982021,363.66325393396033,364.2149353210224,343.36400000000003,367.7262000000003,364.30240000000026,361.05750000000023,361.05750000000023,380.5676192974095,341.54738070259094,58368439,64.99281987607972,49.748881716387004,NaN,NaN,NaN,NaN,NaN,NaN,2.712985423690358,2.75457385971481,0.04158843602445217,99.58552086211651,94.10189577823625,5678878343,17872909082.69452,30.200406993363586,18.855920179172163,28.38971945222508,100,21.428571428571427
2023-11-13,376.79,378.28,375.24,377.21,347.5491546273072,360.26367637051493,364.1944988777266,365.45256052854404,343.76875,367.83660000000026,364.29480000000024,361.4475000000002,361.4475000000002,381.8990074016361,340.99599259836435,40733505,63.46767982301376,51.08949636925866,NaN,NaN,NaN,NaN,NaN,NaN,2.6932983688478336,3.4082113970842443,0.7149130282364107,96.32495164410047,93.77806710659208,5638144838,17884968344.0432,28.981551265446768,18.094915656267002,27.63090003024129,92.85714285714286,14.285714285714286
2023-11-14,383.71,386.26,383.18,385.33,347.92508343698574,360.76003921466315,365.02334205899217,367.34565000201604,344.24405,368.06450000000024,364.4400000000002,362.3040000000002,362.3040000000002,385.113763172801,339.4942368271994,67792634,68.8795664525303,53.38225515454112,NaN,NaN,NaN,NaN,NaN,NaN,3.0514534579005264,4.529229850612069,1.4777763927115424,97.88203142792074,97.93083464471256,5705937472,17911821270.497746,35.552774831880065,16.08621145089169,27.1380742710522,100,7.142857142857143
2023-11-15,387.25,387.75,384.235,385.62,348.30015723363266,361.25231566585796,365.83105413511015,369.0860642875383,344.69905,368.3439000000003,364.65760000000023,363.4165000000002,363.4165000000002,388.3931805440425,338.43981945595795,54141385,69.05587618124922,56.020263091348006,NaN,NaN,NaN,NaN,NaN,NaN,3.121010413768162,5.379039409921745,2.258028996153583,95.12250973208153,96.44316426803424,5760078857,17900346069.409554,35.856145938279006,15.37243294395495,26.105577186809917,100,0
2023-11-16,384.84,386.19,383.56,385.95,348.67478253479055,361.7413787219796,366.62003240432153,370.6921534030108,345.1242,368.5651000000003,364.93540000000024,364.71550000000025,364.71550000000025,391.478553245079,337.9524467549215,45343544,69.26923209084507,58.51553328053899,NaN,NaN,NaN,NaN,NaN,NaN,3.001472652770611,6.009869812116847,3.0083971593462357,95.64164648910409,96.21539588303546,5805422401,17937413985.607273,34.61839923588346,15.72774400031233,24.89712444038138,92.85714285714286,0
2023-11-17,385.21,387.07,384.29,386.04,349.0465757433996,362.2225395393661,367.3815997610148,372.15385307891455,345.49580000000003,368.7801000000003,365.20460000000026,366.28750000000025,366.28750000000025,394.1596810233606,338.4153189766399,46622745,69.33133823473828,60.656863495173354,NaN,NaN,NaN,NaN,NaN,NaN,2.747523150946218,6.442801098029008,3.6952779470827903,95.84245076586438,95.53553566235,5852045146,17949488941.146843,34.50634184741485,15.133083185883967,24.29483901544093,85.71428571428571,0
2023-11-20,386.05,391.41,386.05,390.74,349.4614356862514,362.78724172670536,368.2976154566613,373.92396230949413,345.9186,369.04940000000033,365.4800000000003,368.0410000000002,368.0410000000002,397.3939916022035,338.6880083977969,44536669,72.46133615630656,62.87395828940672,NaN,NaN,NaN,NaN,72.46133615630656,NaN,2.7105766956486574,7.083498816643612,4.3729221209949545,98.31615983915553,96.60008569804133,5896581815,17982891442.896843,37.883398347036234,14.029607934026366,24.396793852284077,100,0
2023-11-21,389.01,389.23,386.7,388.47,349.84958060479613,363.29581119746365,369.0886893603216,375.30929923239944,346.34299999999996,369.23990000000026,365.7936000000003,369.50800000000027,369.50800000000027,399.84901817670124,339.1669818232993,43336989,68.80870922436421,64.33573724230664,NaN,NaN,NaN,NaN,NaN,NaN,2.36059327071255,7.323663709385642,4.963070438673092,90.54966248794602,94.9027576976553,5853244826,18000191980.007515,35.77016302864855,13.246999607346613,26.14525381927697,92.85714285714286,0
2023-11-22,390.57,393.07,389.04,390.06,350.2496842803703,363.82579513414754,369.91109369913255,376.7141278769328,346.7439,369.43760000000026,366.11060000000026,371.49400000000026,371.49400000000026,401.75610660213596,341.23189339786455,44178572,69.9512744108828,65.43910923528028,NaN,NaN,NaN,NaN,NaN,NaN,2.0737069599695426,7.55520413863502,5.481497178665477,89.45709281961474,92.77430504890542,5897423398,17978376754.62786,38.82450772060182,12.398906625942836,29.545932797369115,100,0
2023-11-24,389.65,390.25,388.5,389.51,350.6403341880283,364.33439325030304,370.6796782599509,377.932782364844,347.1696,369.62990000000025,366.3554000000003,373.7865000000003,373.7865000000003,402.1544715700473,345.41852842995326,15718832,69.00958581890401,66.2216593187087,NaN,NaN,NaN,NaN,NaN,NaN,1.700111554275396,7.606636621509722,5.906525067234326,86.39143730886846,88.79939753880973,5881704566,17980801945.85072,37.83218647944789,12.870683371143867,32.46531002173942,92.85714285714286,0
2023-11-27,389.01,391.1499,388.28,389.17,351.0237139473514,364.82618744336634,371.4047889164234,379.0029935681922,347.60705,369.84700000000026,366.7226000000003,375.97950000000026,375.97950000000026,401.87646930142455,350.08253069857597,34139656,68.39660465136774,66.87452140391517,NaN,NaN,NaN,NaN,NaN,NaN,1.3012798674761603,7.5331249015795265,6.231845034103366,83.76690946930289,86.5384798659287,5847564910,17967836751.567158,37.55249991476305,12.31479582460613,35.36624266592331,85.71428571428571,0
2023-11-28,388.41,390.78,388.05,390.19,351.4134282364325,365.32844115735907,372.14146386087737,380.0684227521739,348.05949999999996,370.0865000000003,367.11320000000035,378.0290000000003,378.0290000000003,401.4983535488105,354.5596464511901,35491123,69.27824147354316,67.3952982802408,NaN,NaN,NaN,NaN,NaN,NaN,0.9913641274006117,7.471050193354131,6.479686065953519,87.74468085106385,85.96767587641172,5883056033,17987987389.167892,35.961382308067634,12.149979411750204,37.62324559907842,78.57142857142857,0
2023-11-29,392.69,394.14,389.46,389.81,351.795483676866,365.8132245007777,372.83434763103907,380.9961920138716,348.48605,370.32100000000025,367.51200000000034,379.9760000000002,379.9760000000002,400.3692208343628,359.58277916563765,38811745,68.51143259368035,67.84789223084765,NaN,NaN,NaN,NaN,NaN,NaN,0.6618212266261114,7.306962599236158,6.645141372610047,82.37688237688243,84.62949089908305,5844244288,17954980819.70208,38.56101539646022,11.268527759833749,40.22688338573495,100,7.142857142857143
2023-11-30,390.08,390.55,385.82,388.83,352.16398632684746,366.2690022334356,373.46162811609634,381.74226896493144,348.89644999999996,370.52760000000023,367.99780000000027,381.56950000000023,381.56950000000023,399.33063450765434,363.8083654923461,52834381,66.46813814756189,68.42013108107622,NaN,NaN,NaN,NaN,NaN,NaN,0.29745256243050555,7.016957075648179,6.719504513217673,76.7716535433071,82.29773892375111,5791409907,17969390196.338444,35.73896421074422,16.075773766071592,41.85888606388489,92.85714285714286,0
2023-12-01,387.75,390.54,386.0726,389.94,352.53986705991366,366.73773486247643,374.1078387782102,382.5230052539856,349.30064999999996,370.6988000000003,368.6394000000003,382.8945000000002,382.8945000000002,398.9167563641637,366.87224363583675,40490068,67.64517104268883,68.60958473583402,NaN,NaN,NaN,NaN,NaN,NaN,0.06305755469819463,6.7983264565904165,6.735268901892222,77.77777777777781,78.97543789932244,5831899975,17999004121.257458,33.262937064030126,14.962029897768293,42.91771460224205,85.71428571428571,0
2023-12-04,386.09,386.595,382.66,386.32,352.87598778568565,367.12550248896207,374.5867470614176,382.8846238012251,349.71574999999996,370.77050000000025,369.2076000000003,383.8250000000003,383.8250000000003,398.2985061404935,369.35149385950706,51186944,60.22098171677081,68.37767772824523,NaN,NaN,NaN,NaN,NaN,NaN,-0.3795863803263462,6.260785926484289,6.640372306810635,31.881533101045125,62.14365480737666,5780713031,18043036600.40358,29.657120385494608,18.421654424598284,42.93510307990315,78.57142857142857,0
2023-12-05,384.39,388.5,384.21,387.29,353.21841576791763,367.52479946937865,375.0849138433228,383.30418343920365,350.14639999999997,370.85270000000025,369.76120000000026,384.72900000000027,384.72900000000027,397.60902779496405,371.8489722050365,42932956,61.442142858253135,67.84643318579687,NaN,NaN,NaN,NaN,NaN,NaN,-0.6357643509508097,5.845666868122123,6.481431219072933,40.33101045296177,49.99677377726155,5823645987,18061750965.839478,30.606427044566892,17.235918246566065,42.23864608542771,71.42857142857143,92.85714285714286
2023-12-06,390.27,390.37,384.7,385.05,353.53514794933136,367.87183314325233,375.4757015357415,383.47045168308904,350.6015,370.87710000000027,370.37800000000027,385.3465000000003,385.3465000000003,396.98484743419465,373.7081525658059,41994072,57.084066958006794,66.99130395556526,NaN,NaN,57.084066958006794,NaN,NaN,NaN,-0.9650454602981897,5.275124393700196,6.240169853998386,20.818815331010406,31.010452961672417,5781651915,18024941347.17281,30.80568350298919,15.789364603599093,41.684528356338475,64.28571428571429,85.71428571428571
2023-12-07,388.07,391.27,386.96,390.43,353.9022609050594,368.31852951665326,376.06214461277125,384.1332658085091,351.0824,370.9240000000002,371.08580000000023,386.22100000000034,386.22100000000034,396.5542606663476,375.8877393336531,49593545,63.73697351665706,66.59614262883755,NaN,NaN,NaN,NaN,NaN,NaN,-0.8343946087874805,5.197176593014035,6.0315712018015155,67.68292682926837,42.94425087108016,5831245460,18055203765.583485,29.332058237980522,14.365069866213545,41.45096395946569,57.142857142857146,78.57142857142857
2023-12-08,388.67,392.62,388.4801,392.17,354.2830344283921,368.79083586285816,376.693825216192,384.8986690648416,351.55915,370.9892000000002,371.76900000000023,387.3260000000003,387.3260000000003,394.86253342054243,379.7894665794582,46687525,65.59465169471856,66.32923644740757,NaN,NaN,NaN,NaN,NaN,NaN,-0.6527107903023106,5.215682713923627,5.868393504225938,82.8397212543556,57.11382113821144,5877932985,18091741583.464954,29.531099076756952,13.492666841596831,41.32597172352539,50,71.42857142857143
2023-12-11,391.74,395.79,391.53,395.52,354.6933524937812,369.32012624181147,377.43210658026294,385.9102243919996,352.0775,371.17680000000024,372.51400000000024,388.18250000000035,388.18250000000035,395.34649853426225,381.01850146573844,41198021,68.89814180800842,66.07472256538627,NaN,NaN,NaN,NaN,NaN,NaN,-0.3443305641063512,5.437980299092999,5.78231086319935,97.94364051789765,82.82209620050719,5919131006,18127717320.112843,32.36118792302367,12.641871279809132,41.173698821916155,100,64.28571428571429
2023-12-12,395.56,398.79,394.41,398.67,355.13093107593266,369.9013118607855,378.26496514574285,387.12544111657104,352.60114999999996,371.40720000000033,373.2622000000003,389.2555000000003,389.2555000000003,395.93651332127206,382.5744866787286,39221152,71.65418738062723,66.27797100511934,NaN,NaN,NaN,NaN,NaN,NaN,0.015315981137034917,5.801455839620644,5.786139858483609,99.25604463732174,93.34646880319166,5958352158,18164789367.893665,34.71926320384324,11.816826585595939,41.40689953298529,100,57.142857142857146
2023-12-13,399.62,404.36,398.8399,403.74,355.61460340353534,370.5713848932452,379.2639861204196,388.70778005785,353.15205000000003,371.68230000000034,374.2386000000003,390.1760000000003,390.1760000000003,399.1272510856917,381.22474891430886,55408129,75.42831879946208,66.66918846144644,NaN,NaN,NaN,NaN,NaN,NaN,0.5107370020870565,6.42456111109243,5.913824109005374,97.14285714285711,98.11418076602548,6013760287,18207750968.758305,40.00452307834155,10.828173018729599,41.82175010828506,100,50
2023-12-14,404.98,406.3,400.34,403.39,356.08998048409717,371.22125845971556,380.2101043117757,390.1060867190072,353.71299999999997,371.92840000000035,375.1114000000003,391.0645000000003,391.0645000000003,401.44417721073285,380.68482278926774,55447808,74.68900375850491,67.07486117141792,NaN,NaN,NaN,NaN,NaN,NaN,0.7182322346277843,6.811614402290104,6.09338216766232,87.69035532994914,94.69641903670932,5958312479,18209053434.046894,39.36169376642499,9.894380166914091,42.57844892868222,100,42.857142857142854
2023-12-15,404.18,406.5399,403.57,405.34,356.580030429529,371.89687710407765,381.19559041719623,391.55693560291127,354.27165,372.2066000000003,376.04440000000034,392.0340000000003,392.0340000000003,403.8451953670672,380.22280463293333,62896645,76.09485004033718,67.6247358420586,NaN,NaN,NaN,NaN,NaN,NaN,0.879527548318066,7.192791603059902,6.313264054741836,94.97527209075409,93.26949485452012,6021209124,18221127031.58031,37.87642866446066,9.431456571103295,43.25827802584167,100,35.714285714285715
2023-12-18,404.93,407.99,404.6,407.08,357.08251768893666,372.5935726069672,382.2106653027964,393.0353226883483,354.80865,372.5112000000003,376.8920000000003,393.0860000000003,393.0860000000003,406.2453440565638,379.9266559434368,46609985,77.30610868126973,68.19815492832478,NaN,NaN,NaN,NaN,NaN,NaN,0.9880039504481148,7.5482689928019795,6.560265042353865,96.40742202921427,93.02434981663917,6067819109,18242713366.8163,38.128437593138834,8.946331916202839,44.15104254421159,100,28.571428571428573
2023-12-19,407.54,409.28,407.345,409.16,357.60070159252933,373.31766027811636,383.26750195758865,394.5710062418389,355.35434999999995,372.76800000000037,377.7440000000003,394.00700000000023,394.00700000000023,408.8511680130327,379.1628319869678,35711855,78.69577318080749,68.92560782740529,NaN,NaN,NaN,NaN,78.69577318080749,NaN,1.077134114678402,7.906682685701867,6.829548571023465,99.54921111945924,96.97730174647586,6103530964,18273995844.45196,38.840086471475594,8.63588379677938,44.78306256311118,100,21.428571428571427
2023-12-20,408.35,410.4699,402.9,403.08,358.053231924942,373.90701353993586,384.0444626651342,395.381386599759,355.88805,372.9620000000004,378.43380000000036,394.7375000000003,394.7375000000003,409.8552708343176,379.619729165683,54042443,65.97765648524683,68.8905734229542,NaN,NaN,65.97765648524683,NaN,NaN,NaN,0.6262589380211363,7.612372243549885,6.9861133055287485,73.42708891437934,89.7945740210176,6049488521,18222523485.532333,34.4147997154893,14.342202943604434,45.01303498227777,100,14.285714285714286
2023-12-21,407.06,408.14,404.47,407.77,358.54792613464406,374.57756772726384,384.97487589395246,396.5612545426391,356.4378,373.2118000000004,379.1648000000003,395.6230000000003,395.6230000000003,411.5918435398119,379.65415646018863,45568914,70.00463650620078,69.05910667034792,NaN,NaN,NaN,NaN,NaN,NaN,0.5464433656510765,7.669167512592594,7.1227241469415175,90.29158680901399,87.75596228095087,6095057435,18258904117.145412,31.80614098661625,13.255056913134776,45.243007401444366,92.85714285714286,7.142857142857143
2023-12-22,409,409.97,406.4787,408.38,359.04376766564263,375.24692282177347,385.89272389811117,397.68684934810204,357.0164,373.55170000000044,379.93380000000036,396.56650000000025,396.56650000000025,413.19531989195326,379.93768010804723,34314003,70.4938179151175,69.79288068451554,NaN,NaN,NaN,NaN,NaN,NaN,0.4417633054812802,7.674928278793118,7.233164973311838,92.04147769031871,85.25338447123734,6129371438,18261963707.88064,32.905074334616494,12.548287392041596,46.77280943513648,85.71428571428571,0
2023-12-26,409.25,411.56,409.15,410.88,359.5595510719547,375.9525283104512,386.8726170785774,398.94333988637806,357.6280499999999,373.9226000000004,380.8458000000004,397.6520000000002,397.6520000000002,415.02548623619475,380.2785137638057,22722545,72.47505790515743,70.5809460450087,NaN,NaN,NaN,NaN,NaN,NaN,0.44659468447616124,7.791408328907039,7.344813644430878,97.46835443037973,93.26713964323748,6152093983,18271863571.88479,33.75473897422451,11.924603130796333,48.190161899250725,100,0
2023-12-27,410.95,411.7875,410.08,411.5,360.0763714592984,376.6564386409373,387.8383968009861,400.13921227815155,358.2321,374.31720000000035,381.6876000000003,398.71750000000026,398.71750000000026,416.7317719808214,380.7032280191791,31980481,72.95997502805233,71.71493947858339,NaN,NaN,NaN,NaN,NaN,NaN,0.3988173554799639,7.8433353387808324,7.444517983300869,98.84200986808972,96.11728066292939,6184074464,18293074637.613926,33.18393654946793,11.59145561416434,49.33278373979662,100,0
2023-12-28,412.67,412.92,410.94,411.3,360.5860593054745,377.3424497569584,388.75845967153566,401.2021444421371,358.80174999999997,374.6783000000004,382.54960000000034,399.79200000000026,399.79200000000026,418.11387064682197,381.47012935317855,27029152,72.51616315884914,72.34202445302567,NaN,NaN,NaN,NaN,NaN,NaN,0.2673310042931698,7.778681738667331,7.511350734374161,93.37149497338366,96.56061975728437,6157045312,18275874268.15938,33.99347090346542,11.200681092892351,50.488597948015396,100,0
2023-12-29,411.28,411.64,407.58,409.52,361.0729641880071,377.9796289696919,389.5726377236323,401.9943211619336,359.3546999999999,375.05350000000044,383.4726000000004,400.82650000000024,400.82650000000024,418.89038360788084,382.76261639211964,42662120,68.5211903736087,72.55106293008926,NaN,NaN,NaN,NaN,NaN,NaN,-0.011171018755520734,7.497386960929759,7.50855797968528,84.10472183263194,92.1060755580351,6114383192,18273982844.119972,31.638176327207805,16.158692809290645,50.13916236283345,92.85714285714286,0
2024-01-02,405.84,406.09,400.24,402.59,361.4860690219573,378.46696304949995,390.08312251878397,402.0510524798447,359.8336,375.4003000000004,384.3250000000004,401.4590000000002,401.4590000000002,418.8262817677176,384.09171823228274,58026946,55.66387349005806,71.60575805023566,NaN,NaN,NaN,NaN,NaN,NaN,-0.695855588158965,6.638738494486574,7.334594082645539,44.19232847109646,73.88951509237069,6056356246,18262575837.64134,27.028428729367747,25.328617557947354,47.241223143809535,85.71428571428571,0
2024-01-03,399.93,401,397.89,398.33,361.85267530034577,378.8602905138663,390.40652947883166,401.6966665293833,360.29844999999995,375.6977000000004,385.1996000000004,402.05950000000024,402.05950000000024,418.0688828425404,386.0501171574601,47002803,49.51339124243224,70.02427261179317,NaN,NaN,NaN,NaN,NaN,NaN,-1.4272560540025108,5.5505240151424005,6.977780069144911,2.927478376580152,43.741509560102834,6009353443,18228872863.142944,25.038622856762967,27.14490004184683,44.01421831752486,78.57142857142857,0
2024-01-04,396.44,399.59,396.06,396.28,362.19523574511845,379.20523525616596,390.6368616561324,401.1807935265849,360.75,375.9981000000004,386.0118000000004,402.50900000000024,402.50900000000024,417.2922687859934,387.7257312140071,39432797,46.83172429829401,67.98165871885259,NaN,NaN,46.83172429829401,NaN,NaN,NaN,-2.005305875407667,4.471147724885327,6.476453600292994,1.3048635824434773,16.141556810040015,5969920646,18194355202.312916,23.631467244495305,28.53282629135181,40.58558873835578,71.42857142857143,100
2024-01-05,396.45,399.56,395.34,396.75,362.539064245167,379.5526563402023,390.87659257157816,400.7588131907197,361.18204999999995,376.26210000000043,386.76420000000036,403.09400000000016,403.09400000000016,415.85511343101433,390.332886568986,44922810,47.533331972444415,66.04196787699114,NaN,NaN,NaN,NaN,NaN,NaN,-2.2915451464120986,3.612022167277871,5.90356731368997,8.020477815699783,4.084273258241128,6014843456,18179451900.417183,22.037030856556637,27.75885308485528,37.13314744201411,64.28571428571429,100
2024-01-08,397.99,405.24,397.8399,404.95,362.96106360591165,380.0555740364359,391.4284909021045,401.15797383922256,361.67619999999994,376.6474000000004,387.85640000000035,403.8200000000002,403.8200000000002,415.19327041792,392.4467295820804,42473796,57.95729924472455,64.74642853444736,NaN,NaN,NaN,NaN,NaN,NaN,-1.881344645930091,3.5518865062773557,5.433231152207447,54.6643913538111,21.329910917318113,6057317252,18218596714.149376,27.75908815326365,24.218520648784793,33.32488877836982,57.142857142857146,92.85714285714286
2024-01-09,401.91,406.69,401.71,405.75,363.3868241670469,380.5643745505659,391.9901187098651,401.5953096640585,362.15619999999996,377.0795000000004,389.09820000000036,404.4990000000002,404.4990000000002,414.5542272972509,394.44377270274947,39132860,58.81696324435812,63.42577528895369,NaN,NaN,NaN,NaN,NaN,NaN,-1.5240953242660051,3.528111996874941,5.052207321140946,59.21501706484642,40.63329541145243,6096450112,18242956526.599174,27.860292343829812,22.41282149771548,29.670944850519735,50,85.71428571428571
2024-01-10,406.07,409.515,405.17,408.5,363.8357114887678,381.1175552525349,392.6375650349684,402.25289921986246,362.64424999999994,377.57870000000037,390.3620000000004,405.1480000000002,405.1480000000002,414.4485324578366,395.84746754216377,33962774,61.71493973929236,62.21285861455975,NaN,NaN,NaN,NaN,NaN,NaN,-1.0908442094370958,3.6886520593445766,4.779496268781672,74.85779294653011,62.91240045506254,6130412886,18261051767.522076,30.29292669599593,20.945473617797855,26.429736431011502,42.857142857142854,78.57142857142857
2024-01-11,409.79,411.2004,404.242,409.35,364.28858998141686,381.6766135643659,393.29295464144025,402.92881357987557,363.1472,378.0909000000004,391.56500000000034,405.6820000000002,405.6820000000002,414.65405349958166,396.7099465004187,54536198,62.591176474787716,61.97096718524124,NaN,NaN,NaN,NaN,NaN,NaN,-0.7514356890499254,3.8402016574692652,4.591637346519191,79.69283276450521,71.25521425862725,6184949084,18286583084.865833,29.676898817824277,18.82041882084822,25.088099936271583,35.714285714285715,71.42857142857143
2024-01-12,410.4,411.25,408.15,409.56,364.7390517726465,382.228759830418,393.93087798883477,403.56035514369694,363.65939999999995,378.54750000000035,392.7388000000004,405.9730000000002,405.9730000000002,415.0511343898043,396.89486561019606,39594952,62.817596395896146,61.457607177362334,NaN,NaN,NaN,NaN,NaN,NaN,-0.5277688752185083,3.931926252496055,4.459695127714563,80.88737201365184,78.47933257489571,6224544036,18283006766.620674,28.373658077441767,17.946834572191097,23.75535209241747,28.571428571428573,64.28571428571429
2024-01-16,408.31,411.12,406.83,409.52,365.184633347048,382.76918042783547,394.5422161069197,404.12794036810675,364.1434,379.0089000000004,393.7900000000004,406.2795000000002,406.2795000000002,415.40192396511145,397.157076034889,43903027,62.739701605450655,60.90374172667185,NaN,NaN,NaN,NaN,NaN,NaN,-0.403123228670764,3.955791091876108,4.358914320546872,80.65984072809997,80.41334850208567,6180641009,18294161614.972656,26.537872727839662,18.776447977028496,21.77977178562197,21.428571428571427,57.142857142857146
2024-01-17,406.17,407.585,402.92,407.21,365.6027961993162,383.2531570530268,395.038991945864,404.4214698568585,364.60105,379.38990000000035,394.66540000000043,406.37300000000016,406.37300000000016,415.49332258197626,397.25267741802406,54385974,58.24767456428156,59.88750005946643,NaN,NaN,58.24767456428156,NaN,NaN,NaN,-0.4910235596613681,3.745134870970162,4.23615843063153,67.51990898748565,76.35570724307915,6126255035,18339803863.249184,23.968544663730302,22.69425893069975,18.561263639590617,14.285714285714286,50
2024-01-18,410.52,413.575,409.1601,412.99,366.07431066499464,383.8420054282144,395.7429530460262,405.2375203466815,365.06134999999995,379.9076000000003,395.5710000000005,406.66850000000017,406.66850000000017,416.2334344482444,397.10356555175593,59562505,65.00019724880421,59.31894450380586,NaN,NaN,NaN,NaN,NaN,NaN,-0.190131668773037,3.9984938446652336,4.188625513438271,96.79188374006044,81.65721115188201,6185817540,18383581609.62498,30.376902698295094,20.620788365585028,16.483157310010792,100,42.857142857142854
2024-01-19,415.22,421.34,414.625,421.18,366.62262598176085,384.58137165735866,396.7404842991232,406.7558517422356,365.56649999999996,380.4792000000003,396.6104000000004,407.26950000000016,407.26950000000016,418.7114569567161,395.8275430432842,70325123,71.9280508051606,59.27693647854239,NaN,NaN,NaN,NaN,NaN,NaN,0.4929083228447988,4.804760916994269,4.31185259414947,99.3846153846155,87.89880270405388,6256142663,18450555423.71061,37.53542554705024,18.26337540965303,15.347829827334083,100,35.714285714285715
2024-01-22,423.41,424.7275,421.12,421.73,367.1709580615443,385.31698806018323,397.7204653070007,408.1819611001179,366.0798,381.02890000000036,397.5910000000004,408.20200000000017,408.20200000000017,421.07643140489506,395.3275685951053,44880639,72.32423415581813,59.54858246298592,NaN,NaN,NaN,NaN,NaN,NaN,0.8909748661903798,5.425571176887445,4.534596310697065,89.80008507018292,95.32552806495296,6301023302,18420852713.908115,40.382156901799185,17.340997236008405,15.8857362405485,100,28.571428571428573
2024-01-23,422.43,423.7,420.57,423.48,367.7312470360563,386.0726912669123,398.73064313809874,409.63891718582096,366.61760000000004,381.5160000000003,398.60180000000037,408.9875000000002,408.9875000000002,423.47642939452106,394.4985706054793,33003806,73.60088759409665,60.82979775613153,NaN,NaN,NaN,NaN,NaN,NaN,1.1641087516715656,5.989732250286522,4.825623498614957,95.75499787324543,94.97989944268129,6334027108,18449217007.24358,38.56239466829747,17.351401851221066,18.36349285139273,92.85714285714286,21.428571428571427
2024-01-24,427.44,429.85,425.33,425.83,368.30934408047364,386.85996470717146,399.79336301503605,411.1809250728856,367.1565,382.0057000000003,399.7170000000004,409.86000000000024,409.86000000000024,426.0940444744739,393.6259555255266,46948016,75.25182656585203,62.66825742209009,NaN,NaN,NaN,NaN,NaN,NaN,1.3802564969124456,6.550944119755513,5.170687622843068,88.35120254998542,91.30209516447127,6380975124,18412655720.44712,43.77443148446893,15.791725457419261,21.43072404867276,100,14.285714285714286
2024-01-25,428.36,429.04,423.98,426.35,368.886863044847,387.6419456040592,400.83479975954447,412.6255988754679,367.6989,382.4893000000003,400.67620000000034,410.6335000000002,410.6335000000002,428.3909471982686,392.8760528017318,44367205,75.61522298837323,64.7242216142386,NaN,NaN,NaN,NaN,75.61522298837323,NaN,1.4294234029429225,6.957466876521721,5.528043473578799,89.85801217038541,91.32140419787208,6425342329,18409849889.300877,40.648762204848026,16.56918046745027,23.76557875980762,92.85714285714286,7.142857142857143
2024-01-26,424.44,426.21,423.15,423.81,369.43336192002266,388.3581447010085,401.7357880042682,413.69077993494716,368.23879999999997,382.9515000000003,401.6082000000003,411.24900000000014,411.24900000000014,429.9140860163937,392.5839139836066,37137028,70.19335946706758,66.3427950067117,NaN,NaN,NaN,NaN,NaN,NaN,1.1728125470941952,6.994059157446543,5.821246610352348,81.13095554215695,86.4467234208426,6388205301,18388732755.73225,38.76367436731366,17.003636629238162,25.731920852863688,85.71428571428571,0
2024-01-29,424.27,428.35,423.61,428.15,370.0176070750473,389.1461022316816,402.77163945508124,415.06784851257123,368.81435,383.45230000000026,402.46460000000036,412.09150000000017,412.09150000000017,432.1582498862982,392.0247501137021,38694724,73.6676749225567,67.46496469798542,NaN,NaN,NaN,NaN,NaN,NaN,1.1743905291272991,7.289234771761471,6.114844242634172,93.95877754086695,88.31591508446978,6426900025,18424162102.17951,39.203413895807756,15.832401455752553,28.278590876648007,78.57142857142857,0
2024-01-30,427.1,427.68,424.38,425.3,370.5676806364896,389.86202099937105,403.6551045744898,416.04233913042157,369.345,383.9579000000002,403.2582000000004,412.8805000000002,412.8805000000002,433.70727937173854,392.0537206282619,36738956,68.05755225456497,68.12500677014306,NaN,NaN,NaN,NaN,NaN,NaN,0.8761878759504542,7.21007908757224,6.333891211621785,83.10434459710356,86.06469256004249,6390161069,18407907897.40375,37.019286213032174,14.950335766365658,30.53782968487283,71.42857142857143,0
2024-01-31,420.85,422.8699,416.79,416.97,371.0293952570221,390.39881266274983,404.1772573362745,416.13068778466715,369.837,384.40700000000027,403.8786000000003,413.59950000000026,413.59950000000026,433.942872852083,393.25612714791754,64010649,54.8981068327231,67.63809013395954,NaN,NaN,54.8981068327231,NaN,NaN,NaN,0.05400299705134248,6.401394957935963,6.347391960884621,52.17229855180099,76.4118068965905,6326150420,18347687414.95912,32.603650314660904,23.805496947521554,30.34882762844095,64.28571428571429,28.571428571428573
2024-02-01,418.79,422.375,417.81,421.88,371.53537142361887,391.0222025110122,404.87148253877353,416.67824132898454,370.3521999999999,384.9000000000002,404.5954000000003,414.7770000000002,414.7770000000002,434.15194784506673,395.4020521549337,51008622,59.82869143324822,67.44076977384957,NaN,NaN,NaN,NaN,NaN,NaN,-0.20868071456801474,6.086541067674602,6.295221782242617,70.40475306349786,68.56046540413415,6377159042,18387633926.16394,30.144295577190956,22.009803485879104,29.863920498529154,57.142857142857146,21.428571428571427
2024-02-02,423.8,430.24,422.79,429.01,372.10725827512516,391.77443612465555,405.81809106666475,417.8526945357479,370.90295,385.4204000000002,405.3608000000003,416.4135000000002,416.4135000000002,434.76462887533035,398.0623711246701,59602435,65.69371838858622,67.6462070590417,NaN,NaN,NaN,NaN,NaN,NaN,0.035241219587615724,6.3392733067271365,6.304032087139521,95.49780380673492,72.69161847401126,6436761477,18427555557.123672,37.28078310742901,19.55303421101286,30.484069098314897,100,14.285714285714286
2024-02-05,429.07,429.61,425,428.45,372.6678825708951,392.50068491426634,406.7056169071877,418.8619617228195,371.4516499999999,385.97700000000026,406.1604000000003,417.99850000000026,417.99850000000026,434.68261972502177,401.31438027497876,39889209,64.89235271762935,67.79996785276875,NaN,NaN,NaN,NaN,NaN,NaN,0.09306881045651849,6.420368100210169,6.32729928975365,93.44802342606141,86.45019343209806,6396872268,18447370370.27118,34.96318300303821,18.337498743369476,31.48866060721259,92.85714285714286,7.142857142857143
2024-02-06,429.61,430.22,425.22,427.59,373.21437130153294,393.19552283675614,407.5246123225921,419.6932034635034,372.0082,386.5108000000003,406.91100000000034,419.1305000000002,419.1305000000002,435.1798258113523,403.0811741886481,35846134,63.60907377190592,68.18292493902763,NaN,NaN,NaN,NaN,NaN,NaN,0.011867232540706318,6.342133330429533,6.330266097888827,87.42878286898879,92.12487003392839,6361026134,18445506371.303177,33.42220068739225,17.096118692392366,33.60196871603832,85.71428571428571,0
2024-02-07,430.41,432.83,429.09,431.99,373.79920342788586,393.9637303053352,408.48403929033356,420.8643269431697,372.58509999999995,387.05800000000033,407.76060000000035,420.4425000000002,420.4425000000002,436.18928618001047,404.69571381999,37712661,67.18463112033666,68.33895592985138,NaN,NaN,NaN,NaN,NaN,NaN,0.18343544982423943,6.5595604101691265,6.376124960344887,95.38588299917619,92.08756309807546,6398738795,18466278585.650772,34.585346333406505,15.882636967630138,34.882544495496674,100,0
2024-02-08,432.11,433.56,431.42,432.79,374.3861765281059,394.73256732899193,409.4372142201244,422.0001053295345,373.1692999999999,387.6778000000003,408.6330000000003,421.65700000000027,421.65700000000027,437.2784187575564,406.03558124244415,29889892,67.80403522088423,68.04438338811735,NaN,NaN,NaN,NaN,NaN,NaN,0.2742793120820881,6.718974100447497,6.444694788365409,95.40846750149086,92.74104445655195,6428628687,18474658929.202175,34.57102134541664,15.401825213462491,35.15545574773786,100,0
2024-02-09,433.94,437.845,433.1401,437.05,375.00969715966704,395.57053629277425,410.52006856443325,423.4334286314836,373.80459999999994,388.3417000000003,409.57020000000034,423.0420000000002,423.0420000000002,438.96218416975876,407.12181583024164,36943905,70.94864966336337,67.94612735294201,NaN,NaN,NaN,NaN,70.94864966336337,NaN,0.5299485059044642,7.107130420745989,6.577181914841525,96.22417478033714,95.67284176033473,6465572592,18499117806.050674,38.16023019602152,14.300546673238737,35.55290772213128,100,50
2024-02-12,436.94,439.14,434.65,435.34,375.6099986804664,396.3580504255906,411.4933992089653,424.56738780943755,374.4219499999999,388.9964000000003,410.48080000000033,424.33100000000024,424.33100000000024,439.8455569063013,408.8164430936992,33203305,68.07442229646692,67.55137983168275,NaN,NaN,NaN,NaN,NaN,NaN,0.4933251099066922,7.19383830222489,6.700513192318198,82.9977628635346,91.54346838178753,6432369287,18476119525.750008,37.56368715053876,13.385053792573034,36.233023047089816,100,42.857142857142854
2024-02-13,427.28,431.27,425.3305,428.55,376.1367648627503,396.9955147735987,412.16228551449603,424.9466842085387,374.96295,389.6365000000003,411.2752000000003,425.28250000000025,425.28250000000025,439.30986308073926,411.25513691926125,64491669,58.0228423150576,66.32073809948314,NaN,NaN,NaN,NaN,NaN,NaN,-0.049899879714962125,6.638138342674495,6.688038222389457,52.61744966442957,77.27979576943376,6367877618,18481543145.358646,32.5595275506054,24.00539260161738,33.957677393864735,92.85714285714286,35.714285714285715
2024-02-14,431.26,433.65,428.8799,433.22,376.7047572521757,397.7128313127354,412.98807823941775,425.73461904582075,375.5162499999999,390.3901000000003,412.1408000000003,426.58300000000025,426.58300000000025,438.29963108572355,414.86636891427696,45092722,62.161126888166024,65.35973123518262,NaN,NaN,NaN,NaN,NaN,NaN,-0.15071202285360386,6.499648193822452,6.650360216676056,73.51230425055942,69.70917225950787,6412970340,18518506113.072575,33.52048682437771,22.370177661771397,32.3766950883771,85.71428571428571,28.571428571428573
2024-02-15,433.92,434.98,431.33,434.51,377.27993379693015,398.44148811842376,413.8320751712053,426.57036961288543,376.07784999999996,391.1561000000003,413.10460000000035,427.6590000000002,427.6590000000002,438.0638967317764,417.254103268224,38796137,63.23920380077638,64.86300583044753,NaN,NaN,NaN,NaN,NaN,NaN,-0.1843038261680192,6.419980433966032,6.604284260134051,79.28411633109619,68.4712900820284,6451766477,18547310916.160244,33.666038241309394,21.254291144496154,31.2038527844554,78.57142857142857,21.428571428571427
2024-02-16,434.89,434.99,429.85,430.57,377.81018321188606,399.0776962744946,414.4884643801776,426.95128679261063,376.63379999999995,391.8657000000003,413.9702000000003,428.12850000000026,428.12850000000026,438.16241503844765,418.09458496155287,53716475,57.82062346471957,63.73107358345917,NaN,NaN,NaN,NaN,NaN,NaN,-0.507348600983164,5.970098508905096,6.47744710988826,61.65548098434002,71.4839671886652,6398050002,18508643414.7011,31.2983375295627,21.78453588403684,29.45081331642518,71.42857142857143,14.285714285714286
2024-02-20,428.55,430.08,423.5,427.32,378.30281820480263,399.6369498136135,414.99166185546477,426.9864023361715,377.18395,392.5968000000003,414.81560000000025,428.40800000000024,428.40800000000024,438.01578559288856,418.8002144071119,53999452,53.73089022006746,62.707740580995065,NaN,NaN,NaN,NaN,NaN,NaN,-0.9496918116751205,5.29033234529436,6.24002415696948,47.11409395973149,62.68456375838923,6344050550,18517342414.56736,28.345374746196782,28.20323940132898,26.435545715897234,64.28571428571429,7.142857142857143
2024-02-21,424.55,425.7,421.63,425.61,378.7735364316205,400.1512676390865,415.40806727289754,426.8553163993933,377.73114999999996,393.30250000000024,415.5192000000003,428.5145000000002,428.5145000000002,437.9470446725093,419.08195532749113,50179697,51.660426469135054,62.476477697881634,NaN,NaN,51.660426469135054,NaN,NaN,NaN,-1.3431768667170312,4.561053073573191,5.9042299402902225,36.568213783403735,48.44592957582508,6293870853,18565302862.06859,26.20268160526581,28.555608205451964,25.628395653676442,57.142857142857146,0
2024-02-22,434.49,439.12,433.71,438.07,379.36355099448997,400.9021336264313,416.2967705170976,427.923381504213,378.30705,394.1031000000002,416.4372000000003,429.1265000000002,429.1265000000002,439.3389889717903,418.9140110282101,53887751,62.8836075223048,62.69468598995711,NaN,NaN,NaN,NaN,NaN,NaN,-0.7780537714764595,4.931662725944648,5.709716497421107,93.88920616790409,59.19050463701311,6347758604,18598273001.77469,38.048430930176046,23.93018389759126,26.14140923544528,50,0
2024-02-23,439.65,440.59,435.79,436.78,379.9348589447936,401.6125864259079,417.1000344183879,428.76686898000224,378.8725,394.8882000000002,417.26240000000035,429.64800000000025,429.64800000000025,440.2960281742134,418.9999718257871,39853861,61.29686033891903,62.38062470069516,NaN,NaN,NaN,NaN,NaN,NaN,-0.5174378810025431,5.062919146167928,5.580357027170471,79.9050632911392,70.12082774748235,6307904743,18574858858.437187,37.61519917145383,22.53361730270907,25.70437534253717,100,85.71428571428571
2024-02-26,437.6,438.6,436.355,436.55,380.4981936816613,402.3044163976721,417.86277816668644,429.50811955333535,379.44705,395.6411000000002,418.02000000000027,430.2850000000002,430.2850000000002,440.98399527988096,419.58600472011943,33043238,61.00130946052906,62.10269303947371,NaN,NaN,NaN,NaN,NaN,NaN,-0.39251705357301603,5.089710710204201,5.482227763777217,78.69198312236304,84.16208419380213,6274861505,18547555871.13652,36.54106963034708,21.89015336935305,25.26734144962906,92.85714285714286,78.57142857142857
2024-02-27,437.67,437.99,435.025,437.6,381.0663708589582,403.003338845243,418.6367868660321,430.2787748339701,380.00935,396.4679000000002,418.6972000000003,430.75750000000016,430.75750000000016,441.8645101737235,419.65048982627684,33713220,61.904366882181826,61.98092826163627,NaN,NaN,NaN,NaN,NaN,NaN,-0.27661458355548785,5.136459534332857,5.413074117888345,84.2299578059074,80.94233473980323,6308574725,18572400183.345627,35.11487922663648,22.786531422482337,24.479828066680295,85.71428571428571,71.42857142857143
2024-02-28,435.43,436.67,434.3,435.27,381.60571045240135,403.6422826304857,419.2890697340308,430.75412961168723,380.5547,397.2231000000002,419.3348000000003,431.2560000000002,431.2560000000002,442.23267235545086,420.27932764454954,32938821,58.65838034840957,61.371910349355765,NaN,NaN,NaN,NaN,NaN,NaN,-0.38751368736165226,4.92868200868628,5.316195696047933,71.9409282700422,78.28762306610423,6275635904,18566423941.560818,33.5455809525261,22.750026757644438,23.202541278872907,78.57142857142857,64.28571428571429
2024-02-29,438.23,440.09,435.02,439,382.1767979105864,404.342435449684,420.0620473915198,431.53945060105036,381.12455,398.02620000000024,420.0080000000004,432.3575000000002,432.3575000000002,441.6746924418849,423.0403075581155,42495152,62.085782889283244,60.96346375424141,NaN,NaN,NaN,NaN,NaN,NaN,-0.24713584467576055,5.007275890203232,5.2544117348789925,91.61392405063303,82.5949367088609,6318131056,18590647016.369495,35.88033090046704,21.183658117530364,22.302219841459685,71.42857142857143,57.142857142857146
2024-03-01,439.9,446.58,439.84,445.61,382.8079740507796,405.15961494572986,421.06392788597,432.87950292475983,381.71864999999997,398.8353000000002,420.7786000000004,433.5440000000002,433.5440000000002,443.2573462822509,423.8306537177495,43853029,67.26503260620794,60.70034825015889,NaN,NaN,NaN,NaN,67.26503260620794,NaN,0.22773682592624578,5.5390827672868,5.311345941360554,96.11222444889792,86.55569225652441,6361984085,18621877660.167717,40.84401009817993,19.069675988633396,21.649494339828276,100,50
2024-03-04,445.61,446.04,443.77,444.02,383.4170489358465,405.92912752106196,421.9641660080888,433.94050264621126,382.30295,399.6099000000002,421.4758000000004,434.29450000000026,434.29450000000026,444.77944058155265,423.80955941844786,34325687,64.96607104845077,60.47832316101488,NaN,NaN,NaN,NaN,NaN,NaN,0.36354686274404635,5.7657795197906125,5.402232657046566,89.73947895791582,92.48854248581561,6327658398,18595112697.17653,39.57046922481422,18.475071987826738,20.855641163765167,92.85714285714286,42.857142857142854
2024-03-05,440.94,440.95,433.65,436.05,383.9407598917087,406.52558044143694,422.51655165483044,434.1414071560959,382.82759999999996,400.2845000000002,422.1352000000004,434.67450000000025,434.67450000000025,444.8303406347698,424.5186593652307,57917135,54.846990850642754,60.25147662784239,NaN,NaN,NaN,NaN,NaN,NaN,-0.12826566909961734,5.241900570672044,5.370166239771661,57.79559118236482,81.21576486305953,6269741263,18575278061.902557,34.307706588007555,28.997031496331022,20.374668214278415,85.71428571428571,35.714285714285715
2024-03-06,440.32,441.99,436.89,438.79,384.48652347487575,407.1644798386362,423.15472609973904,434.58413028408677,383.3352,400.9602000000002,422.7556000000004,435.2345000000002,435.2345000000002,444.99340050154217,425.4755994984582,46234460,57.30888222094106,59.90488772304061,NaN,NaN,NaN,NaN,NaN,NaN,-0.3038987194170648,4.990292840500331,5.294191559917396,68.77755511022058,72.10420841683377,6315975723,18563492807.392754,33.03396350994541,26.798440354895426,19.69405617833387,78.57142857142857,28.571428571428573
2024-03-07,442.42,446.72,440.86,445.45,385.09312523134463,407.9226089507424,424.02905056641595,435.61897501893566,383.87989999999996,401.71540000000016,423.49700000000036,435.90750000000025,435.90750000000025,446.4994948545554,425.3155051454451,44526666,62.64085008033921,59.86214817158081,NaN,NaN,NaN,NaN,NaN,NaN,-0.021291732591715906,5.2675768941777505,5.2888686267694665,94.93822239936213,73.83712289731587,6360502389,18588719519.187973,35.649858201731924,24.164312763285555,19.451377444931556,100,21.428571428571427
2024-03-08,445.81,448.64,438.34,439.02,385.62971104993824,408.5383988725099,424.6169309363604,435.9428821599894,384.38679999999994,402.45280000000014,424.05980000000034,436.2190000000002,436.2190000000002,446.79236256821355,425.6456374317869,72095957,55.44130774603978,59.69219704881797,NaN,NaN,NaN,NaN,NaN,NaN,-0.3016081845131078,4.911858396128082,5.21346658064119,64.38356164383559,76.03311305113947,6288406432,18526143028.354965,31.340767491121795,24.200780828138573,19.08942548882708,100,14.285714285714286
2024-03-11,437.51,438.66,435.44,437.39,386.1447388006851,409.1097177067176,425.1178356055227,436.08070290665705,384.90694999999994,403.13260000000014,424.5776000000003,436.2360000000002,436.2360000000002,446.8157436641437,425.6562563358567,45859992,53.75465890483856,59.693894812015905,NaN,NaN,NaN,NaN,NaN,NaN,-0.6130472782045739,4.447157482885473,5.060204761090047,58.348759718622716,72.55684792060684,6242546440,18535827747.16242,29.98417198131081,26.659595675509863,19.49070551908674,92.85714285714286,7.142857142857143
2024-03-12,439.73,444.02,436.46,443.66,386.7170299568972,409.7938817125252,425.8449793072669,436.8025407250707,385.467,403.88720000000023,425.2248000000003,436.6520000000002,436.6520000000002,447.70194769213515,425.6020523078653,55300909,58.93043974935927,60.21318147488906,NaN,NaN,NaN,NaN,NaN,NaN,-0.42211048597849743,4.532566653616925,4.9546771395954226,66.7778519012678,63.170057754575396,6297847349,18585861902.924324,33.65086247421548,24.270453017561717,20.340573966629076,85.71428571428571,0
2024-03-13,442.65,442.67,439.12,440.25,387.2496963254853,410.3969731637623,426.4098820795309,437.1308701798259,385.96964999999994,404.6560000000002,425.8394000000004,437.2370000000002,437.2370000000002,447.7342893643542,426.7397106356462,37928691,55.30513225641639,59.67186181303989,NaN,NaN,NaN,NaN,NaN,NaN,-0.5430963538274032,4.275806697311168,4.818903051138571,44.02935290193475,56.38532150727511,6259918658,18572079364.504604,31.807395450806407,22.940865111297594,19.870278770181773,78.57142857142857,57.142857142857146
2024-03-14,441.5,442.03,436.39,439.14,387.76601775508243,410.96614201200464,426.90910239013755,437.3222158769853,386.4233499999999,405.4477000000003,426.57040000000035,437.5330000000002,437.5330000000002,447.89348473764653,427.17251526235384,52195208,54.13763010279101,59.16048822474504,NaN,NaN,NaN,NaN,NaN,NaN,-0.7052285697247793,3.9373673389825967,4.642595908707376,36.624416277518385,49.143873693573674,6207723450,18570783738.77411,29.635404705622214,24.679650921597744,18.73101510237354,71.42857142857143,50
2024-03-15,436.07,438.8733,432.7417,433.92,388.2252613595095,411.4206738533511,427.1840395513086,436.9981953172724,386.84304999999995,406.24090000000024,427.2822000000004,437.50350000000014,437.50350000000014,447.90153880543005,427.10546119457024,73069824,48.90872452141769,58.29673215766565,NaN,NaN,48.90872452141769,NaN,NaN,NaN,-1.1453345205007155,3.210927758081482,4.356262278582197,7.4114842467435835,29.35508447539893,6134653626,18525797342.792637,27.353425115598746,27.16990327586823,16.96407319675834,64.28571428571429,100
2024-03-18,438.73,441.04,437.24,437.48,388.7153582614049,411.9367001136808,427.58780270615927,437.0440814775322,387.2904999999999,407.05900000000025,428.1062000000004,437.84900000000016,437.84900000000016,447.749866426687,427.9481335733133,47323802,52.29294279227289,57.6102018655293,NaN,NaN,NaN,NaN,NaN,NaN,-1.1736684045034318,2.889176772952908,4.06284517745634,29.803815502286636,24.613238675516225,6181977428,18484451284.203163,27.61344199743968,24.87451773969972,15.815946826183874,57.142857142857146,92.85714285714286
2024-03-19,435.45,438.98,433.33,438.57,389.2114243483561,412.4640921906376,428.0184771098393,437.18940705110055,387.72329999999994,407.85340000000025,428.94260000000037,438.41150000000016,438.41150000000016,447.0540419292596,429.7689580707407,43004105,53.31264204754796,57.22836341546776,NaN,NaN,NaN,NaN,NaN,NaN,-1.097380827311384,2.6911191433171098,3.788499970628494,36.65989445412409,24.62506473438479,6224981533,18521214085.46865,25.75406891548326,27.859447703113897,14.726690203812952,50,85.71428571428571
2024-03-20,439.78,444.11,438.06,443.77,389.75429574787495,413.08401115715964,428.6361838898456,437.816130189091,388.1688999999999,408.7877000000002,429.7190000000004,439.3195000000002,439.3195000000002,445.9800329365602,432.6589670634402,43653490,57.93220367946823,56.93167918619526,NaN,NaN,NaN,NaN,NaN,NaN,-0.6947259147792928,2.920092577154378,3.6148184919336708,69.36779404087228,45.27716799909436,6268635023,18559961067.50171,30.00810816702725,25.852053562557444,13.41850313349891,42.857142857142854,78.57142857142857
2024-03-21,448.88,449.34,445.67,445.87,390.312660964314,413.73323865899806,429.312019815734,438.5831654091776,388.6237499999999,409.80980000000017,430.52140000000037,439.7095000000002,439.7095000000002,446.92225668513123,432.4967433148692,39345652,59.66782028261047,56.38902116308115,NaN,NaN,NaN,NaN,NaN,NaN,-0.3048694520590476,3.233731676859861,3.5386011289189088,79.09424459131374,61.70731102877006,6307980675,18524903769.943127,34.26795773412253,24.12831407398252,12.06283696225886,100,71.42857142857143
2024-03-22,445.35,447.49,444.49,446.38,390.8705449348183,414.37970918060205,429.9813523719797,439.325721084494,389.08144999999996,410.82050000000015,431.2790000000003,440.18950000000024,440.18950000000024,447.82395996772715,432.5550400322733,28253899,60.098376793899526,56.04132871632749,NaN,NaN,NaN,NaN,60.098376793899526,NaN,-0.044246956036792184,3.4832924338729185,3.5275393899097107,82.16684841218691,76.87629568145766,6336234574,18532249783.683125,32.99200090058819,24.694468274898664,10.494337473040058,92.85714285714286,64.28571428571429
2024-03-25,443.55,446.26,442.54,444.76,391.406758418054,414.98129909781784,430.5609071809217,439.84327145739934,389.5611499999999,411.7761000000002,431.9872000000003,440.6000000000002,440.6000000000002,448.29023016554265,432.90976983445773,27789154,57.98102096912644,56.2651880105049,NaN,NaN,NaN,NaN,NaN,NaN,-0.014118844731199065,3.509890833995712,3.524009678726911,72.4068127458837,77.88930191646146,6308445420,18537628329.618607,31.381305496928334,25.968045453424672,10.569339716714227,85.71428571428571,57.142857142857146
2024-03-26,446.3,447.225,443.09,443.32,391.923308085536,415.54246149192045,431.061263762062,440.17438846145654,390.0119999999999,412.7006000000002,432.6624000000003,440.88600000000025,440.88600000000025,448.5340151672703,433.2379848327302,34142043,56.08935811161368,56.17807914555294,NaN,NaN,NaN,NaN,NaN,NaN,-0.11852015453648512,3.3758594855563047,3.49437964009279,63.73122548694756,72.7682955483394,6274303377,18507284434.086563,30.950297080359775,24.57663228745048,10.644829867811799,78.57142857142857,50
2024-03-27,446.44,446.54,441.93,444.83,392.44974283095354,416.12241274950617,431.60121420276545,440.6177800365559,390.4636499999999,413.5793000000002,433.3686000000003,441.3640000000002,441.3640000000002,448.7383702103223,433.98962978967813,41359240,57.64967830938837,55.82156687619931,NaN,NaN,NaN,NaN,NaN,NaN,-0.11323677038257207,3.3528336771145746,3.4660704474971467,72.82854268208195,69.65552697163774,6315662617,18517960680.42062,29.079551836584844,24.612055673218318,9.867587920492905,71.42857142857143,42.857142857142854
2024-03-28,444.78,445.64,443.65,444.01,392.96278021572016,416.674642200011,432.08783325363737,440.940848604503,390.8812499999999,414.3850000000002,434.1046000000003,441.61450000000025,441.61450000000025,448.9910099470353,434.2379900529652,36839641,56.476051931402885,55.89547717515382,NaN,NaN,NaN,NaN,NaN,NaN,-0.18791917591843355,3.231171477599105,3.4190906535175385,67.88827771518778,68.14934862807243,6278822976,18494449954.757305,28.28478534333984,23.939389282454172,9.543690986059383,64.28571428571429,35.714285714285715
2024-04-01,444.97,447.53,443.02,444.95,393.48006598471795,417.2345502752583,432.59223194957315,441.3226725469313,391.2896999999999,415.1574000000003,434.74380000000036,441.5815000000001,441.5815000000001,448.8918249585233,434.27117504147697,38728951,57.543090305657756,56.16607941806949,NaN,NaN,NaN,NaN,NaN,NaN,-0.1960602199989543,3.1740153785188454,3.3700755985177997,73.55150828699333,71.42277622808768,6317551927,18488868176.896996,29.13662773420086,22.442365757378667,10.051504445848924,57.142857142857146,28.571428571428573
2024-04-02,440.08,441.43,438.03,441.11,393.9539956764123,417.70733145792644,432.9262620691977,441.30241801865213,391.6657499999999,415.8764000000002,435.14240000000035,441.43600000000015,441.43600000000015,448.6617439754856,434.2102560245147,44259665,51.94099987903993,55.66683371304668,NaN,NaN,NaN,NaN,NaN,NaN,-0.4666692330046196,2.786739057262025,3.253408290266645,50.41660892983038,63.95213164400383,6273292262,18524796610.838173,26.407880319396646,27.09389772539411,8.986300333084138,50,21.428571428571427
2024-04-03,438.96,444,438.95,442.1,394.43306039605,418.19035459737347,433.2860164978566,441.37837820735194,392.0249499999999,416.57040000000023,435.54980000000035,441.7385000000001,441.7385000000001,448.5305343785533,434.9464656214469,39949750,53.20584456376915,55.5168845921433,NaN,NaN,NaN,NaN,NaN,NaN,-0.5782993626422552,2.5305340869638258,3.108833449606081,56.38107517034904,60.116397462390914,6313242012,18534685162.81837,28.086370255074673,25.236427365142916,8.211272350621169,42.857142857142854,14.285714285714286
2024-04-04,446.33,446.95,435.11,435.34,394.8400946209649,418.52995153603933,433.3665648704897,440.8032945685565,392.3619999999999,417.19440000000026,435.7870000000003,441.56600000000014,441.56600000000014,448.80907503752604,434.32292496247425,57267660,44.57838413428749,54.83408130867876,NaN,NaN,44.57838413428749,NaN,NaN,NaN,-1.0777016056234858,1.761706442576724,2.8394080482002098,15.6540127603429,40.81723228684077,6255974352,18479642428.7981,23.942022033325642,26.298250254091315,7.8945459731639485,35.714285714285715,7.142857142857143
2024-04-05,436.78,443.17,435.96,440.47,395.29412353020905,418.9644079412663,433.6451309539999,440.77155222869396,392.72984999999994,417.89840000000027,436.0798000000003,441.3170000000002,441.3170000000002,448.348165194977,434.28583480502334,54744634,51.063422897098675,54.987988335513116,NaN,NaN,NaN,NaN,NaN,NaN,-1.03272408330623,1.5485029440674225,2.5812270273736524,44.59712679575295,38.87740490881496,6310718986,18493385533.866062,21.665252267050487,23.797414652106188,8.205497833513698,28.571428571428573,0
2024-04-08,441.41,442.5,439.2,440.6,395.744928271202,419.3928355067858,433.91787091658813,440.7552139211993,393.1233499999999,418.5205000000003,436.36480000000034,441.3960000000002,441.3960000000002,448.3573142436736,434.43468575632676,28144944,51.2191961952861,54.911292150014056,NaN,NaN,NaN,NaN,NaN,NaN,-0.9656321985340202,1.374186779206127,2.3398189777401472,45.409119300437496,35.220086285511115,6338863930,18489121148.41152,20.76884079088883,22.812783809401044,8.167763831399432,21.428571428571427,7.142857142857143
2024-04-09,442.96,443.24,437.44,442.23,396.20746629835423,419.8450565858593,434.24383676299647,440.8956697382279,393.5036499999999,419.1707000000003,436.73320000000035,441.6380000000002,441.6380000000002,448.3577577336562,434.91824226634424,39521568,53.22949414094764,54.905353013828325,NaN,NaN,NaN,NaN,NaN,NaN,-0.7902691604310315,1.3519825272013577,2.142251687632389,50.03513703443446,46.68046104354164,6378385498,18514878308.246002,19.260466258775864,23.35981207747259,8.574288389653413,14.285714285714286,0
2024-04-10,437,439.24,436.28,438.37,396.62699399687807,420.2118871485156,434.4056470860162,440.6551297631586,393.8827999999999,419.7011000000003,436.9376000000003,441.37350000000026,441.37350000000026,448.1700852454633,434.5769147545372,61502191,48.16720120863705,54.20785283734038,NaN,NaN,NaN,NaN,NaN,NaN,-0.9047944722995518,1.0112585972579495,1.9160530695575013,22.90934645115952,39.45120092867716,6316883307,18540227184.266273,17.829864873519597,23.072806386084814,8.958430237832172,7.142857142857143,71.42857142857143
2024-04-11,440.26,446.33,437.96,445.37,397.111999031735,420.7100676010202,434.83562171009396,441.10416502381014,394.3212499999999,420.2986000000003,437.3390000000004,441.6295000000002,441.6295000000002,448.62044979235185,434.6385502076485,45474550,56.28630147617854,53.96631577973809,NaN,NaN,NaN,NaN,56.28630147617854,NaN,-0.4998905410839558,1.2911898932025565,1.7910804342865123,82.6086956521741,51.85105971258937,6362357857,18575270296.27344,24.594045195026833,20.739154523038668,8.325569407384673,0,64.28571428571429
2024-04-12,441.1,442.24,436.88,438.27,397.521531379678,421.0577890346634,434.9703032116589,440.834244545352,394.6934499999999,420.8218000000002,437.7650000000004,441.5860000000001,441.5860000000001,448.6488277622593,434.52317223774094,53664995,48.06279142671168,53.10663111065325,NaN,NaN,NaN,NaN,NaN,NaN,-0.6893338646348062,0.9294131034930047,1.6187469681278108,25.44283413848614,43.65362541393993,6308692862,18549439011.366726,22.14712442461555,19.941393907376565,7.672487164856184,35.714285714285715,57.142857142857146
2024-04-15,442.06,442.15,430.21,431.06,397.85524748535283,421.2558526181354,434.8169579876723,439.90336411246136,395.02604999999994,421.2720000000003,437.9486000000003,441.4430000000001,441.4430000000001,449.2023533235279,433.6836466764723,63453622,41.441383294110814,51.925228419580705,NaN,NaN,NaN,NaN,NaN,NaN,-1.2468204126972426,0.060221452256257635,1.3070418649535003,4.907621247113298,37.65305034592452,6245239240,18495019824.65986,19.24689741884496,24.645380982390858,7.876794083043324,28.571428571428573,100
2024-04-16,430.9,433.76,429.7,431.1,398.18604104271253,421.45078622965747,434.6711949293322,439.06494848270313,395.36249999999995,421.67560000000026,437.9904000000003,441.12400000000014,441.12400000000014,449.95887272116425,432.289127278836,47618961,41.48954304892765,50.8823844865317,NaN,NaN,NaN,NaN,NaN,NaN,-1.540245139044711,-0.6182645588523883,0.9219805801923225,7.851934941110686,12.734130108903381,6292858201,18480241526.41848,18.36617363873286,24.092435026569753,8.020235504838968,21.428571428571427,100
2024-04-17,433.1,433.12,424.9,425.84,398.46120481343183,421.5377013538227,434.3248735595545,437.8054295795885,395.6445999999999,422.04930000000024,437.9382000000003,440.48750000000007,440.48750000000007,451.5260685212965,429.4489314787036,56880536,37.161450386695414,49.41893963491077,NaN,NaN,NaN,NaN,NaN,NaN,-1.9875023102545102,-1.5623973076258153,0.42510500262869494,4.153778170570031,5.6377781195980115,6235977665,18436370164.102177,16.699980218396416,27.204313992439232,9.134868856183726,14.285714285714286,100
2024-04-18,426.49,428.24,422.83,423.41,398.7094515317061,421.57477657453904,433.89683930231706,436.4344362862944,395.9101999999999,422.3828000000002,437.8546000000003,439.46950000000015,439.46950000000015,452.6557784362799,426.2832215637204,46549363,35.327947822658686,47.90836077000048,NaN,NaN,NaN,NaN,NaN,NaN,-2.3225988093025967,-2.478143508999551,-0.15554469969695434,2.348178137651989,4.784630416444242,6189428302,18399801810.543953,15.691033112260055,27.872404691556866,10.53784844885719,7.142857142857143,100
2024-04-19,422.22,422.75,413.07,414.65,398.86806395427624,421.4376522859343,433.14206129046147,434.35972806855204,396.1320499999999,422.6342000000002,437.5078000000004,437.9085000000001,437.9085000000001,454.6159621352005,421.20103786479973,75230990,29.64885126087799,45.915915123944785,NaN,NaN,NaN,NaN,NaN,NaN,-2.9685009992182296,-3.8661709487197413,-0.8976699495015117,4.66351829988189,3.72182486936797,6114197312,18349129697.44478,13.955596329341896,35.229366006915754,12.700271989249073,0,100
2024-04-22,417.31,421.18,413.94,418.82,399.06659068109934,421.3858175872029,432.5804118280904,432.8797539667852,396.3888499999999,422.93070000000023,437.2284000000003,436.53050000000013,436.53050000000013,454.6981817177949,418.36281828220535,47807663,35.00505462628588,44.706204748748064,NaN,NaN,NaN,NaN,NaN,NaN,-2.943422707359054,-4.576948333700329,-1.6335256263412754,16.971664698937428,7.994453712157102,6162004975,18365769933.737595,12.881310107520388,32.51744875081371,15.698154576986356,14.285714285714286,92.85714285714286
2024-04-23,420.77,426.28,418.8715,425.07,399.3253310723322,421.458771694387,432.28588587404766,432.1359678747104,396.6829999999999,423.2795000000002,436.98880000000025,435.5460000000001,435.5460000000001,453.95554578470694,417.13645421529327,44335944,42.11812494280583,43.91422477582211,NaN,NaN,NaN,NaN,NaN,NaN,-2.359652097590611,-4.583090748329539,-2.2234386507389283,35.41912632821724,19.018103109012184,6206389716,18395656318.360462,17.2476874236055,29.958418418206495,17.23967835585017,7.142857142857143,85.71428571428571
2024-04-24,428.2,429.73,424.2,426.51,399.59582529051795,421.5587960172704,432.05938054565365,431.60016141045224,396.98374999999993,423.64650000000023,436.8122000000003,434.70550000000014,434.70550000000014,453.1534933596902,416.2575066403101,48405226,43.64833629489075,43.84779278729377,NaN,NaN,NaN,NaN,NaN,NaN,-1.7578910251487052,-4.42080243217481,-2.6629114070261046,40.40889957907397,30.933230202076214,6254830021,18387685128.93008,19.91591639121024,28.187546189323903,18.13293395612238,0,78.57142857142857